id,date,content,likes,replies,retweets,quote_tweets,date_only,hour,day_name,day_index,popularity_score,controversiality_score
1486851048153231366,2022-01-27 23:58:08,"Sopir mobil Pajero bernama Muhammad Fajri (37), tersangka yang menabrak empat tukang becak hingga menewaskan satu orang di Palembang, Sumatera Selatan, bebas. https://t.co/Wt0CCQxLIV",423,156,169,54,2022-01-27,23,Thursday,4,592,210
1486849217381478401,2022-01-27 23:50:52,Robins Gosens resmi diperkenalkan sebagai rekrutan anyar Inter Milan. Ia dipinjam dari Atalanta dengan Inter punya opsi untuk mempermanenkan Gosens. https://t.co/eVipFK2Ohp,10,0,1,1,2022-01-27,23,Thursday,4,11,1
1486848976074813442,2022-01-27 23:49:54,Manajemen Manchester United kabarnya puas dengan kinerja Ralf Rangnick sejauh ini. Ada kemungkinan Rangnick bakal dipermanenkan musim depan. https://t.co/S6Iswcz69j,6,1,1,0,2022-01-27,23,Thursday,4,7,1
1486848171099758593,2022-01-27 23:46:42,"Warga Ciputat, Tangerang Selatan (Tangsel), digegerkan penemuan ular piton sepanjang tiga meter. Penemuan ular piton itu berawal dari kucing mengerang. https://t.co/lRqVRgn6Ve",7,0,4,0,2022-01-27,23,Thursday,4,11,0
1486847512229163012,2022-01-27 23:44:05,"KSAD Jenderal Dudung Abdurachman menyampaikan rasa kehilangan atas gugurnya seorang prajurit TNI usai berkontak senjata dengan KKB di Kabupaten Puncak, Papua. https://t.co/clPx9OUgqz",104,120,6,12,2022-01-27,23,Thursday,4,110,132
1486846851341033474,2022-01-27 23:41:28,"Di sebagian besar kariernya, Sergio Ramos dan Lionel Messi merupakan rival sengit. Namun, Ramos mengungkap dia berbicara dengan Messi sebelum bergabung PSG. https://t.co/R6XEIE5MwL",3,0,2,0,2022-01-27,23,Thursday,4,5,0
1486845407179292672,2022-01-27 23:35:43,Foto AHY jogging menggunakan rompi 'militer' viral di media sosial. Apa sih manfaat olahraga pakai weight vest seperti itu? Dokter olahraga angkat bicara. https://t.co/fEaMu24m5P,51,35,7,8,2022-01-27,23,Thursday,4,58,43
1486845168766623748,2022-01-27 23:34:47,Komisi III DPR RI lapor ke Jaksa Agung terkait vonis ringan polisi pemerkosaan mahasiswi Universitas Lambung Mangkurat (ULM) Banjarmasin. https://t.co/hjkoF28GNp,15,2,7,0,2022-01-27,23,Thursday,4,22,2
1486844355587579906,2022-01-27 23:31:33,Damkar hanya butuh waktu 10 menit untuk mengevakuasi korban. Korban berhasil dikeluarkan dengan selamat dan tanpa cedera. https://t.co/7JsaWD81xC,10,1,2,1,2022-01-27,23,Thursday,4,12,2
1486843440088457220,2022-01-27 23:27:54,Masyarakat Indonesia yang ingin ke Malaysia tak perlu lagi menukarkan Rupiah ke Ringgit.  https://t.co/BXnFC0uStA,10,1,4,0,2022-01-27,23,Thursday,4,14,1
1486842557195857932,2022-01-27 23:24:24,Pemuda di Tangsel memperkosa ABG berusia 15 tahun. Pemuda itu lalu ancam korban dengan video syur lantaran diputusin. https://t.co/sMf6Y5GVxp,2,1,1,0,2022-01-27,23,Thursday,4,3,1
1486841105777897472,2022-01-27 23:18:38,Gubernur Sumut Edy Rahmayadi bercerita soal dirinya yang ingin menjadi kaya. Edy mengatakan dirinya juga ingin membelikan pesawat tempur untuk cucunya. https://t.co/sZ7jpp9od2,10,14,0,4,2022-01-27,23,Thursday,4,10,18
1486840068241248264,2022-01-27 23:14:31,Pandemi Corona di Amerika Serikat berdampak pada sektor pendidikan. Gubernur di negara bagian harus jadi guru pengganti karena pendidik kena Corona. https://t.co/GVwI9HZgJw,4,0,0,0,2022-01-27,23,Thursday,4,4,0
1486839301157658627,2022-01-27 23:11:28,"Di mana saja lokasi vaksin booster COVID-19 Jakarta Selatan? Buat yang memenuhi syarat, ini lokasi, jenis vaksin, hingga kuota per harinya. https://t.co/j5uHPovXaK",1,0,1,0,2022-01-27,23,Thursday,4,2,0
1486838699833040897,2022-01-27 23:09:04,Tidak sedikit yang menganggap tangan yang sering berkeringat adalah ciri-ciri penyakit jantung. Padahal tangan berkeringat bisa menjadi gejala hipertiroid. https://t.co/YfignqfE76,4,0,1,1,2022-01-27,23,Thursday,4,5,1
1486838434211807241,2022-01-27 23:08:01,"Di bawah pengelolaan PT Taman Wisata Candi (TWC), TMII melakukan revitalisasi besar-besaran. Setelah Snowbay Waterpark ditutup, bagaimana nasib wahana lainnya?  https://t.co/4WZkd0NzHU",6,0,1,0,2022-01-27,23,Thursday,4,7,0
1486837056831725570,2022-01-27 23:02:33,Polisi mengungkap alasan ormas GMBI mendatangi Polda Jabar. Peserta aksi berunjuk rasa atas ketidakpuasan penanganan kasus pembunuhan di Karawang https://t.co/1pfWbZOvmY,5,0,1,0,2022-01-27,23,Thursday,4,6,0
1486835841326620676,2022-01-27 22:57:43,"Rizky Billar punya rencana mengikuti jejak Raffi Ahmad, Gading Marten dan Atta Halilintar membeli klub sepakbola. Ini alasan Rizky Billar batal beli PSMS Medan:  https://t.co/MPGuMSUK32",9,11,2,3,2022-01-27,22,Thursday,4,11,14
1486834809976545280,2022-01-27 22:53:37,"Tidak hanya obat kuat ataupun ramuan herbal saja, menjaga ereksi agar tahan lebih lama bisa didapat dari sayur, buah, hingga kopi. https://t.co/l8Xb2ZKTRn",11,1,4,1,2022-01-27,22,Thursday,4,15,2
1486833395724341251,2022-01-27 22:48:00,"Eks pramugari Siwi Widi Purwanti muncul dalam dakwaan tindak pencucian uang mantan pegawai Ditjen Pajak, Wawan Ridwan. KPK pun bergerak melacak. https://t.co/PtuBPGju0Y",10,3,6,1,2022-01-27,22,Thursday,4,16,4
1486832387216625665,2022-01-27 22:43:59,Distributor yang juga menjual merek sepeda Avand dan Genio Bike ini menargetkan pertumbuhan hingga 50%.  https://t.co/KMXDxhachQ,6,0,1,0,2022-01-27,22,Thursday,4,7,0
1486831519247306755,2022-01-27 22:40:32,Ada yang udah pernah ke sini? https://t.co/OYxNdrQhS0,151,22,22,31,2022-01-27,22,Thursday,4,173,53
1486830534986813443,2022-01-27 22:36:38,Spanduk peringatan pembongkaran yang mereka pasang sudah dicopot warga. Satpol PP baru mengetahui informasi ini sekarang. Mereka akan patroli. https://t.co/4mypQ38QkV,3,0,1,0,2022-01-27,22,Thursday,4,4,0
1486829654036168714,2022-01-27 22:33:08,Menkes Budi Gunadi Sadikin mengungkapkan ciri-ciri pasien Corona (COVID-19) yang bisa dirawat di rumah sakit. Apa saja? https://t.co/nkl5EslTKS,0,0,1,0,2022-01-27,22,Thursday,4,1,0
1486828536895877122,2022-01-27 22:28:41,Lumpur Lapindo disebut memiliki potensi 'harta karun' berupa logam tanah jarang. Inilah penjelasan dan kegunaannya. https://t.co/FF3JjEJMQb,13,1,6,1,2022-01-27,22,Thursday,4,19,2
1486827181879799814,2022-01-27 22:23:18,Identitas motor yang menabrak korban belum diketahui. Saat ini polisi masih menyelidiki pengendara motor tersebut. https://t.co/TTe8quUZDd,5,0,0,0,2022-01-27,22,Thursday,4,5,0
1486826324069081091,2022-01-27 22:19:54,"Sebagai ibu kota yang menggantikan Jakarta, Jazilul berharap IKN tak hanya menjadi ibu kota pemerintahan, namun juga pusat budaya, industri, dan ekonomi. https://t.co/IlGA0gszSR",10,1,3,2,2022-01-27,22,Thursday,4,13,3
1486825021175701506,2022-01-27 22:14:43,"VICTON main game TMI bareng tim K-Talk. Yuk, intip keseruannya di sini! #VICTON  https://t.co/poIgz16i2M",0,0,0,0,2022-01-27,22,Thursday,4,0,0
1486824455041126403,2022-01-27 22:12:28,"Empat pelajar SMK di Kabupaten Bekasi, Jawa Barat, tersengat listrik saat memperbaiki Wi-Fi di tiang listrik. Akibatnya, dua pelajar di antaranya tewas. https://t.co/huPq5OZcid",1,1,1,0,2022-01-27,22,Thursday,4,2,1
1486823192203251713,2022-01-27 22:07:27,"Jenderal Andika Perkasa melayat tiga jenazah anggota TNI di Timak, Papua, yang gugur ditembak KKB. Ketiga jenazah disemayamkan di Mako Yonif 754/ENK/20/3. https://t.co/9C0ZwLREuc",56,13,13,3,2022-01-27,22,Thursday,4,69,16
1486822022634098688,2022-01-27 22:02:48,#terpopuler Binary option kembali bikin heboh usai ada yang mengungkapkan afiliator yang bekerja sama dengan broker dituding mengambil untung besar dari kerugian membernya.  https://t.co/hZUwtSXw2x,7,4,2,1,2022-01-27,22,Thursday,4,9,5
1486820747154804746,2022-01-27 21:57:44,"DKI Jakarta mencatatkan total 2.404 kasus varian Omicron pada Kamis (27/1/2022). Dari jumlah tersebut, 1.095 kasus merupakan transmisi lokal. https://t.co/IB613fkmbZ",6,0,0,0,2022-01-27,21,Thursday,4,6,0
1486818740960432134,2022-01-27 21:49:46,BMKG mengeluarkan prakiraan cuaca untuk wilayah DKI Jakarta. BMKG memprediksi sejumlah wilayah Jakarta diguyur hujan disertai angin kencang. https://t.co/JtXjmDbJu8,10,1,2,1,2022-01-27,21,Thursday,4,12,2
1486817748999188483,2022-01-27 21:45:49,"Shandy Aulia dan keluarga menghabiskan liburan akhir tahun di Amerika Serikat. Demi anak bisa main salju, Shandy terbang ke Aspen. https://t.co/xqWS9X5HgM",9,1,0,1,2022-01-27,21,Thursday,4,9,2
1486816964165185541,2022-01-27 21:42:42,"Seorang anak perempuan 3 tahun menjadi korban penganiayaan ayah tirinya di Sukabumi. Polres Sukabumi Kota memberikan pasal berlapis bagi tersangka, MBF (25). https://t.co/99y7RsMZh1",4,0,0,0,2022-01-27,21,Thursday,4,4,0
1486815895813074951,2022-01-27 21:38:27,Della Dartyan sempat tampil seksi di dalam Love For Sale pada 2018. Ia menjelaskan soal penampilan dan perubahan perannya di karakter tersebut.  https://t.co/B6JJa6ZrkK,6,0,0,0,2022-01-27,21,Thursday,4,6,0
1486814452666322945,2022-01-27 21:32:43,"WHO melaporkan adanya versi baru COVID-19 varian Omicron yaitu BA.2. Meski peneliti masih menyelidiki varian BA.2, berikut langkah-langkah pencegahannya: https://t.co/5F1n7axPWB",8,3,1,2,2022-01-27,21,Thursday,4,9,5
1486812888182439937,2022-01-27 21:26:30,Popularitas member BTS kembali tak diragukan. Jimin BTS disebutkan turut berkontribusi pada ekspor tteokbokki dan gochujjang di Korea pada 2021.  https://t.co/7aPHXHgOj4,989,32,307,9,2022-01-27,21,Thursday,4,1296,41
1486811656550334467,2022-01-27 21:21:37,Panduan vaksin booster lengkap. Cek di sini informasinya. https://t.co/Dq3iLXt8RE,3,0,3,0,2022-01-27,21,Thursday,4,6,0
1486810303581102084,2022-01-27 21:16:14,"Restoran fast food identik dengan lokasi di mal atau tempat biasa, tapi tahukah kamu kalau ada restoran fast food mewah di dunia? Seperti ini informasinya.  https://t.co/SUrvlfbUfQ",2,0,2,0,2022-01-27,21,Thursday,4,4,0
1486808901374914565,2022-01-27 21:10:40,"Ratusan mahasiswa ULM menggeruduk kantor Kejati Kalsel lantaran oknum polisi yang memperkosa mahasiswi, Bripka Bayu Tamtomo, hanya divonis 2 tahun 6 bulan bui. https://t.co/lp07aCkTZT",46,12,16,3,2022-01-27,21,Thursday,4,62,15
1486806061537546240,2022-01-27 20:59:23,"Kapolda Maluku Irjen Pol Lotharia Latif mengatakan korban tewas akibat bentrokan warga di Pulau Haruku, Maluku Tengah, bertambah jadi 3 orang. https://t.co/8p1i65PRqI",5,0,2,0,2022-01-27,20,Thursday,4,7,0
1486804356074717192,2022-01-27 20:52:36,Seorang anak perempuan balita menjadi korban penganiayaan ayah tirinya di Kota Sukabumi. https://t.co/ciFlCPXukO,7,0,0,0,2022-01-27,20,Thursday,4,7,0
1486802929344557056,2022-01-27 20:46:56,Balapan Formula E Jakarta bakal digelar di Ancol pada Juni 2022. PT Jakarta Propertindo (JakPro) menargetkan tiket Formula E bisa dijual mulai Februari. https://t.co/UMlyDwNPwJ,3,4,1,2,2022-01-27,20,Thursday,4,4,6
1486801569089667072,2022-01-27 20:41:32,"Diego Simeone masih terikat kontrak dengan Atletico Madrid. Eks penggawa Atletico Kieran Trippier, berharap Simeone akan menjajal Premier League di masa depan. https://t.co/swc1sbuDu1",4,1,0,0,2022-01-27,20,Thursday,4,4,1
1486800008900972545,2022-01-27 20:35:20,"Tifatul Sembiring sempat bicara soal polemik 'jin buang anak' dan kemudian mengklarifikasi pernyataannya. Anaknya sendiri, Fathan Sembiring, mengkritik keras. https://t.co/MpD2uBf3om",10,5,0,1,2022-01-27,20,Thursday,4,10,6
1486798433813938177,2022-01-27 20:29:04,"Tubagus Joddy, sopir rombongan keluarga Vanessa Angel, menjalani sidang hari ini. Kronologi main HP hingga mengantuk saat mengemudi terungkap di persidangan. https://t.co/MgcWAooWJ3",6,0,0,0,2022-01-27,20,Thursday,4,6,0
1486796839424831497,2022-01-27 20:22:44,Pemerintah melaporkan tambahan kasus Corona pada hari ini sebanyak 8.077. Provinsi yang melaporkan kasus terbanyak adalah DKI Jakarta dengan 4.149 kasus. https://t.co/1vMjJNBzuI,5,1,5,0,2022-01-27,20,Thursday,4,10,1
1486795602822561792,2022-01-27 20:17:49,Wajah pria itu tak sempurna. Ketidaksempurnaan seperti itu hanya bisa diakibatkan oleh sebuah ledakan yang luar biasa. #Podcast #TawaSetan  https://t.co/8Ox6Fj9Izx,3,0,1,1,2022-01-27,20,Thursday,4,4,1
1486794287497072649,2022-01-27 20:12:36,Anies menyebut pemindahan Ibu Kota ke Kaltim tidak berdampak pada kemacetan Jakarta. Anies menyebut sektor pemerintahan hanya menyumbang 7% macet Jakarta. https://t.co/cTWr45SY5c,178,124,28,16,2022-01-27,20,Thursday,4,206,140
1486792792902930437,2022-01-27 20:06:39,"Gejala COVID Omicron varian baru diklaim relatif ringan dibanding varian Corona lainnya. Bahkan, disebut mirip penyakit flu biasa. Kok bisa? Simak informasinya. https://t.co/D9DXI1iKkH",7,0,1,0,2022-01-27,20,Thursday,4,8,0
1486790969408339971,2022-01-27 19:59:25,"Dalam ilmu medis, kedutan mata kiri bawah dapat menandakan adanya masalah kesehatan di dalam tubuh. Lalu, apa sih penyebabnya? Yuk cari tahu di sini. https://t.co/SDyqzRma5I",7,0,3,0,2022-01-27,19,Thursday,4,10,0
1486789597216620546,2022-01-27 19:53:57,Sejumlah peristiwa terjadi di Jabar hari ini (27/1/2022). Mulai 752 anggota GMBI diamankan polisi usai demo ricuh hingga rampok kejam perkosa wanita di Sukabumi https://t.co/BOXOqWfSYM,4,1,2,0,2022-01-27,19,Thursday,4,6,1
1486787356623581194,2022-01-27 19:45:03,"Setiap tahun, tanggal 27 Januari diperingati sebagai Hari Peringatan Holocaust. Auschwitz jadi saksi bisu kejahatan rezim Nazi di bawah Hitler. https://t.co/VBfNIj7GxV",8,2,1,0,2022-01-27,19,Thursday,4,9,2
1486785233135542283,2022-01-27 19:36:37,Presiden Turki Recep Tayyip Erdogan mengumumkan bahwa Presiden Israel Isaac Herzog akan melakukan kunjungan resmi ke Turki pada bulan Februari mendatang. https://t.co/g6QBbRPNam,15,5,2,2,2022-01-27,19,Thursday,4,17,7
1486782831875473408,2022-01-27 19:27:04,"China semakin mengembangkan kapabilitas teknologinya, termasuk untuk keperluan militer. Mereka telah memamerkan robot canggih. https://t.co/dtGe9cYW04",10,1,0,0,2022-01-27,19,Thursday,4,10,1
1486781344189460480,2022-01-27 19:21:10,Banyak masyarakat yang bertanya-tanya terkait vaksin Pfizer untuk usia berapa? Apakah boleh untuk anak-anak? Jangan asal suntik! Cek dulu di sini jawabannya. https://t.co/cEhOmoa0PY,11,1,1,0,2022-01-27,19,Thursday,4,12,1
1486776978636165122,2022-01-27 19:03:49,Al Ghazali klarifikasi soal foto berbusana Jawa dikira prewedding. Begini kata Al Ghazali:  https://t.co/ifTrBlprsZ,4,1,1,0,2022-01-27,19,Thursday,4,5,1
1486774075406102538,2022-01-27 18:52:17,Falcon Pictures remake The Invisible Guest. Reza Rahadian jadi bintangnya! https://t.co/E9eeUnLcWR,8,0,2,0,2022-01-27,18,Thursday,4,10,0
1486771689937592322,2022-01-27 18:42:48,Film Mengejar Surga bisa bikin terenyuh. Sang produser yakin capai 400 ribu penonton. https://t.co/xIgrcgcQUX,2,0,1,0,2022-01-27,18,Thursday,4,3,0
1486769527417409543,2022-01-27 18:34:12,"Indonesia menang 4-1 lawan Timor Leste. Sempat tertinggal lebih dulu, skuad Garuda membalas 4 gol di babak kedua. https://t.co/7ekA2Tj8EH",5,1,2,0,2022-01-27,18,Thursday,4,7,1
1486767332814897162,2022-01-27 18:25:29,Donny van de Beek belum juga dapat kepercayaan mengisi skuad utama Manchester United. Dulu Solskjaer menahannya pergi dan kini Rangnick melakukan hal serupa. https://t.co/t751mBcCuh,4,0,2,0,2022-01-27,18,Thursday,4,6,0
1486765799708807168,2022-01-27 18:19:24,Sebanyak 1.273 peneliti Indonesia yang masuk daftar ilmuwan terbaik dunia dengan 343 di antaranya berasal dari UGM. Dua peneliti banhkan nangkring di top 15. https://t.co/aV9s7hT20X,18,1,4,0,2022-01-27,18,Thursday,4,22,1
1486762540646416389,2022-01-27 18:06:27,Axiata Group Berhad dan XL Axiata mengungkapkan dampak pelanggan usai mereka mencaplok penyedia layanan internet Link Net.  https://t.co/VecR2KscaT,8,1,4,1,2022-01-27,18,Thursday,4,12,2
1486760462708625408,2022-01-27 17:58:11,Nurul Arifin bicara alasan masukkan barang kesayangan Maura Magnalia ke peti. Ini kata Nurul Arifin:  https://t.co/aTfb85pB3S,5,0,1,0,2022-01-27,17,Thursday,4,6,0
1486758326562086913,2022-01-27 17:49:42,"Tidak banyak yang tahu, ruam kulit bisa menjadi salah satu gejala COVID-19. Kira-kira ruam seperti apa yang bisa jadi pertanda terinfeksi COVID-19? https://t.co/ZDafztwlmF",7,2,4,0,2022-01-27,17,Thursday,4,11,2
1486756799541821444,2022-01-27 17:43:38,"PT Tamaris Hidro akan menerbitkan surat utang yaitu Penawaran Umum Obligasi Tamaris Hydro I Tahun 2022, dengan nilai sebanyak banyaknya l Rp 750 miliar.  https://t.co/pOFNj5dQxc",1,0,1,0,2022-01-27,17,Thursday,4,2,0
1486754757075107841,2022-01-27 17:35:31,"Operasi Kereta Cepat Jakarta-Bandung diproyeksi mundur ke Juni 2023 dari rencana sebelumnya Desember 2022. Lalu, sudah sejauh apa perkembangannya?  https://t.co/MwRzkAtudx",6,3,3,3,2022-01-27,17,Thursday,4,9,6
1486753515183689729,2022-01-27 17:30:35,"Kementerian Perhubungan resmi mengoperasikan Kapal Tol laut KM Kendhaga Nusantara 9 resmi beroperasi di Kepulauan Sula, Maluku Utara.  https://t.co/EFQNTh99Gj",13,0,2,0,2022-01-27,17,Thursday,4,15,0
1486752234960568325,2022-01-27 17:25:29,"Situasi Bandara Internasional Jawa Barat (BIJB) Kertajati, Majalengka masih terlihat sepi pengunjung. Ini penampakannya.  https://t.co/7db1UVsvdq",7,2,2,3,2022-01-27,17,Thursday,4,9,5
1486751430807625733,2022-01-27 17:22:18,"PT Bank Mandiri (Persero) Tbk memperkirakan pertumbuhan kredit perseroan di angka 8,86% pada tahun ini.  https://t.co/gghLYeoIMc",3,0,1,0,2022-01-27,17,Thursday,4,4,0
1486750030329487360,2022-01-27 17:16:44,Pada diaspora Indonesia yang berada di Belanda resmi membentuk Asosiasi Pengusaha Indonesia (Aspindo).  https://t.co/9dQayhNEfU,4,0,0,0,2022-01-27,17,Thursday,4,4,0
1486749196329836544,2022-01-27 17:13:25,Pemerintah saat ini sedang mendorong perekonomian yang bisa meningkatkan kelestarian lingkungan hidup. Salah satunya ialah wejangan khusus dari Sandiaga Uno bagi para pengusaha.  https://t.co/ENaMN53Px1,7,0,0,0,2022-01-27,17,Thursday,4,7,0
1486748099766898690,2022-01-27 17:09:04,Penyidik Jampidsus Kejagung memanggil dua purnawirawan TNI untuk diperiksa sebagai saksi dalam kasus dugaan tindak pidana korupsi Proyek Satelit Kemhan 2015. https://t.co/WCpNnc4QE0,16,2,2,0,2022-01-27,17,Thursday,4,18,2
1486747615878340626,2022-01-27 17:07:08,Kesenian akrobatik Lais masih bisa dijumpai di wilayah Jawa Barat. Atraksi ketangkasan akrobatik ini khas dari tanah Sunda.  https://t.co/XFJx9jySQ0,3,0,1,0,2022-01-27,17,Thursday,4,4,0
1486746975869542407,2022-01-27 17:04:36,AC Milan mendapatkan amunisi baru di bursa musim dingin. Milan mengumumkan telah resmi menuntaskan transfer Marko Lazetic dari Red Star Belgrade. https://t.co/XmH2GXGPaE,6,0,0,0,2022-01-27,17,Thursday,4,6,0
1486745435393957897,2022-01-27 16:58:28,"Timnas Indonesia menang telak melawan Timor Leste dengan skor 4-1. Awalnya, netizen sempat dibikin was-was, karena bermain buruk di babak pertama. https://t.co/3rLjkE6LBH",14,0,0,2,2022-01-27,16,Thursday,4,14,2
1486745133542432776,2022-01-27 16:57:16,Jokowi mengatakan kebijakan pemerintah dalam transisi menuju energi baru dan terbarukan menjamin kepastian investasi.  https://t.co/TGgwiU2mtu,3,1,0,0,2022-01-27,16,Thursday,4,3,1
1486743025338433536,2022-01-27 16:48:54,"Dinas Kesehatan DKI Jakarta rutin memeriksa sampel kasus COVID-19 untuk mendeteksi mutasi. Ditemukan, hampir 90% hasil WGS positif varian Omicron. https://t.co/8aGD2uSvmS",14,0,5,0,2022-01-27,16,Thursday,4,19,0
1486742771268562954,2022-01-27 16:47:53,NTRL sampai Danilla Riyadi ramaikan liga futsal para musisi. Seperti ini keseruannya. https://t.co/dcKn0vk5fJ,5,0,1,0,2022-01-27,16,Thursday,4,6,0
1486742226663350280,2022-01-27 16:45:43,Pembesaran pembuluh darah vena yang terjadi pada buah zakar rentan menyerang pria usia produktif. Kondisi ini bisa menyebabkan masalah pada sperma. https://t.co/nDUhjmYKXM,8,0,0,0,2022-01-27,16,Thursday,4,8,0
1486741008285118464,2022-01-27 16:40:53,"Penyebutan air minum sebagai air putih ternyata diperkirakan sudah terjadi selama 150 tahun. Bagaimana sejarahnya dan siapa yang pertama kali menyebutkan?

via: detikedu  https://t.co/EpLulO1NUG",12,4,3,1,2022-01-27,16,Thursday,4,15,5
1486739095594455044,2022-01-27 16:33:17,"Kebakaran rumah terjadi di Jalan Pangeran Jayakarta, Mangga Dua Selatan, Jakpus. Sebanyak 20 unit mobil pemadam kebakaran diterjunkan ke lokasi. https://t.co/OtLEtkAb87",8,1,4,3,2022-01-27,16,Thursday,4,12,4
1486737915875323911,2022-01-27 16:28:36,"Gempa bumi berkekuatan M 5,3 mengguncang wilayah Barat Daya Kabupaten Pangandaran. Warga merasakan gempa ini sekitar 10 detik. https://t.co/ts19iTQ3Vv",90,3,17,6,2022-01-27,16,Thursday,4,107,9
1486737913492738048,2022-01-27 16:28:35,"Gempa magnitudo (M) 5,3 terjadi di Pangandaran, Jawa Barat. Gempa tersebut tak berpotensi tsunami. https://t.co/ZjTiiJrJDh",14,0,2,0,2022-01-27,16,Thursday,4,16,0
1486736735027412996,2022-01-27 16:23:54,Kampanye ini diharapkan dapat mendorong seluruh stakeholder untuk terus mengikutsertakan dan memberdayakan penyandang disabilitas dalam pembangunan perekonomian  https://t.co/hYVx5qiXcZ,4,0,0,0,2022-01-27,16,Thursday,4,4,0
1486735668860571648,2022-01-27 16:19:40,Menteri Keuangan Sri Mulyani Indrawati menilai 2023 akan jadi masa paling kritis bagi anggaran pendapatan dan belanja negara (APBN).  https://t.co/nK2uBpskxs,16,16,4,2,2022-01-27,16,Thursday,4,20,18
1486734551246278661,2022-01-27 16:15:13,"Euromericas Sport Marketing merilis daftar jersey klub terlaku di Eropa selama 2021. Dikutip dari Football Italia, berikut urutannya! https://t.co/CUcGbpsORz",5,1,2,0,2022-01-27,16,Thursday,4,7,1
1486733154966593538,2022-01-27 16:09:40,Menkes Budi Gunadi Sadikin memastikan subvarian Omicron BA.2 alias 'Son of Omicron' sudah terdeteksi di Indonesia. Subvarian 'siluman' ini sulit dideteksi SGTF. https://t.co/zUIVrgV6Ph,134,138,56,55,2022-01-27,16,Thursday,4,190,193
1486731944977072131,2022-01-27 16:04:52,"Jokowi mengungkapkan, ekonomi digital di Indonesia berkembang pesat. Hal itu ditandai dengan munculnya decacorn dan unicorn.  https://t.co/vEFqn4eHVP",18,16,0,3,2022-01-27,16,Thursday,4,18,19
1486730754826518540,2022-01-27 16:00:08,Kanyanat Chetthabutr menghancurkan Timnas Indonesia di ajang Piala Asia Wanita 2022 dan striker Thailand itu rupanya pernah berlatih di kuil! https://t.co/F1q2qe4izg,3,2,0,2,2022-01-27,16,Thursday,4,3,4
1486729632170659844,2022-01-27 15:55:41,"Bukan cuma imun tubuh saja yang butuh booster, kadang otak kita juga butuh booster supaya pikiran tetap jernih. Yuk coba teka-teki untuk booster IQ ini. https://t.co/eFAiMYbYvM",16,5,1,0,2022-01-27,15,Thursday,4,17,5
1486728502288154631,2022-01-27 15:51:11,Dusan Vlahovic akan segera bergabung dengan Juventus dan bisa memakai nomor punggung yang ditinggalkan Cristiano Ronaldo. https://t.co/isDRt2jKIR,11,0,0,1,2022-01-27,15,Thursday,4,11,1
1486728213208322061,2022-01-27 15:50:02,Ketua Umum DPP LSM GMBI Fauzan Rachman memohon maaf kepada Kapolda Jabar Irjen Suntana atas kerusakan yang terjadi saat aksi di depan Mapolda Jabar. https://t.co/JQEdhaVXxD,29,32,7,6,2022-01-27,15,Thursday,4,36,38
1486726539026653190,2022-01-27 15:43:23,"Terpidana sempat menghilang saat dieksekusi tujuh tahun silam, akhirnya ditangkap di tempat persembunyiannya di Banjarmasin, Kalimantan Selatan (Kalsel). https://t.co/nvvaBFh4S2",15,0,1,0,2022-01-27,15,Thursday,4,16,0
1486725863588519948,2022-01-27 15:40:42,Sekjen PDIP Hasto Kristiyanto merespons desakan untuk memecat Arteria Dahlan dari PDIP. Hasto menyebut pihak PDIP sudah memberikan sanksi peringatan berat kepada Arteria Dahlan. https://t.co/KaaitezZp9,21,33,4,2,2022-01-27,15,Thursday,4,25,35
1486724826496602119,2022-01-27 15:36:35,Inggris mencabut pembatasan virus Corona usai kasus Omicron disebut menurun. Warga tak lagi diwajibkan memakai masker. https://t.co/GelIIcT0yO,49,4,16,3,2022-01-27,15,Thursday,4,65,7
1486723046459129860,2022-01-27 15:29:30,Polisi berhasil meringkus anggota ormas GMBI yang menunggangi patung Maung Lodaya saat aksi demo anarkis. Tampang penunggang itupun beredar. https://t.co/IJFDYmpqO7,71,42,28,10,2022-01-27,15,Thursday,4,99,52
1486722284765122566,2022-01-27 15:26:29,Video aksi kejar-kejaran maling di Jakarta Utara viral di media sosial. Pengejar maling adalah seorang lansia. https://t.co/VwmSIqoEUH,13,5,1,0,2022-01-27,15,Thursday,4,14,5
1486720717756321796,2022-01-27 15:20:15,Eks Direktur Pemeriksaan dan Penagihan Ditjen Pajak Angin Prayitno melalui tim pengacara membalas serangan jaksa. Kuasa hukum sebut jaksa memutarbalikan fakta. https://t.co/gAX7AXfomW,6,0,0,0,2022-01-27,15,Thursday,4,6,0
1486719314707107841,2022-01-27 15:14:41,Pria berinisial S itu menjadi sasaran amukan massa setelah dipergoki curi motor. S juga sempat ditelanjangi oleh warga. https://t.co/tc5lru8ZvB,5,1,0,0,2022-01-27,15,Thursday,4,5,1
1486718784010211345,2022-01-27 15:12:34,Seorang pengendara mobil cekcok dengan petugas Dishub Jakarta Pusat gegara parkir liar. Pengendara marah karena tak terima mobilnya diderek. https://t.co/aThvaQv5wq,7,1,3,0,2022-01-27,15,Thursday,4,10,1
1486718542552526856,2022-01-27 15:11:37,"Ada bocoran duel UFC Charles Oliveira vs Justin Gaethje untuk pertaruhan sabuk juara kelas ringan. Kabarnya, duel keduanya akan digelar pada awal Mei nanti. https://t.co/yItQyCf1Dd",4,1,0,0,2022-01-27,15,Thursday,4,4,1
1486717252888002574,2022-01-27 15:06:29,Video aksi kejar-kejaran maling di Jakarta Utara viral di media sosial. Pengejar maling adalah seorang lansia. https://t.co/E4sYcq1TZk,7,0,3,0,2022-01-27,15,Thursday,4,10,0
1486716898083364873,2022-01-27 15:05:05,Adam Deni buka suara terkait foto diduga dirinya hina Presiden Jokowi yang dibawa Jerinx sesudah persidangan. Adam Deni meminta Jerinx menyebut nama bukan inisial. Bahkan ia bertanya AD itu siapa?  https://t.co/DaAo9QXc6N,8,2,0,1,2022-01-27,15,Thursday,4,8,3
1486715692321624064,2022-01-27 15:00:17,"Indonesia semakin dekat untuk mewujudkan pemindahan ibu kota negara (IKN). Jejak maju itu ditandai oleh dukungan politik Dewan Perwakilan Rakyat (DPR), yang telah menyetujui Rancangan Undang-Undang IKN menjadi undang-undang (UU). https://t.co/lCwbewPQvs",12,0,2,1,2022-01-27,15,Thursday,4,14,1
1486714770937958400,2022-01-27 14:56:37,Manchester City kabarnya bakal mendaratkan Julian Alvarez dari River Plate. Berikut profil calon pemain The Citizens itu! https://t.co/5uOZpEbysB,7,0,2,0,2022-01-27,14,Thursday,4,9,0
1486714006081392645,2022-01-27 14:53:35,"Seekor beruang madu yang kena jerat warga di Jorong Sungai Kapur, Nagari Lubuk Gadang Selatan, Kabupaten Solok Selatan berhasil diselamatkan BKSDA Sumbar. Setelah dilakukan observasi tim memutuskan satwa beruang tersebut layak untuk di lepasliarkan. https://t.co/Qrzkp8zetn",11,0,3,0,2022-01-27,14,Thursday,4,14,0
1486713589360574471,2022-01-27 14:51:56,"Gelaran Piala Dunia Antarklub 2021 akan digelar di Abu Dhabi, Uni Emirat Arab, awal Februari nanti. Namun, lokasi tuan rumah sedang digempur rudal! https://t.co/eQ6wdy0Km6",14,2,4,1,2022-01-27,14,Thursday,4,18,3
1486712472585179145,2022-01-27 14:47:29,"Sejauh ini dilaporkan sudah ada 3 pasien Omicron meninggal dunia di Indonesia. Menkes mengungkap kondisi klinisnya, termasuk komorbid yang diidapnya. https://t.co/acavwRXZXD",14,0,9,2,2022-01-27,14,Thursday,4,23,2
1486711907914436611,2022-01-27 14:45:15,"Kasus varian Omicron terus bertambah di Indonesia sejak pertama kali terdeteksi 15 Desember 2021. Saat ini, jumlahnya sudah mendekati angka 2 ribu kasus! https://t.co/Bfc0GyV4xz",3,4,2,2,2022-01-27,14,Thursday,4,5,6
1486711407793954821,2022-01-27 14:43:16,"""Kemarin itu minyak datang 100 karton. Cuma ya gitu, sehari langsung habis. Hari ini minyak tidak ada di list barang datang"" kata salah satu karyawan minimarket  https://t.co/CT5UxDmsgr",13,2,3,6,2022-01-27,14,Thursday,4,16,8
1486711079245733888,2022-01-27 14:41:57,"Memesan makanan secara online, wanita ini dikejutkan dengan polisi yang mengantar pesanan. Bukan tanpa alasan, ternyata pengantar aslinya baru saja ditangkap!  https://t.co/wWOj5Bk9jI",9,0,3,1,2022-01-27,14,Thursday,4,12,1
1486711077404491785,2022-01-27 14:41:57,Menteri Keuangan Sri Mulyani Indrawati khawatir panasnya hubungan Rusia dan Ukraina akan berdampak ke Indonesia. Ini sederet faktanya.  https://t.co/MkvukRCVSg,18,2,4,6,2022-01-27,14,Thursday,4,22,8
1486709724837908480,2022-01-27 14:36:34,"Gempa bermagnitudo (M) 4,7 mengguncang Kabupaten Selayar, Sulawesi Selatan (Sulsel). Pusat gempa 49 kilometer dari Selayar. https://t.co/VEn32nNtB7",16,0,1,0,2022-01-27,14,Thursday,4,17,0
1486709493761150981,2022-01-27 14:35:39,"Jokowi menegaskan, Indonesia tak akan mengekspor sumber daya itu dalam bentuk mentah.  https://t.co/xjpNNksekL",25,27,3,5,2022-01-27,14,Thursday,4,28,32
1486709491693326344,2022-01-27 14:35:39,Ayu Thalia sudah selesai menjalani pemeriksaan sebagai tersangka atas kasus pencemaran nama baik yang dilaporkan oleh Nicholas Sean. Humas Polres Jakut pun menjelaskan alasan tak dilakukan penahanan terhadap Ayu. https://t.co/n7B4DalPx6,2,0,1,1,2022-01-27,14,Thursday,4,3,1
1486709305046831106,2022-01-27 14:34:54,RUPS memutuskan untuk memberhentikan dengan hormat Elfien Goentoro sebagai Direktur Utama PTDI.  https://t.co/dcwj5GdPZS,2,0,1,0,2022-01-27,14,Thursday,4,3,0
1486709076339793931,2022-01-27 14:34:00,"Isak tangis keluarga selimuti rumah duka Serda Rizal di Jalan Bojongsuren Tengah, Kecamatan Dayeuhkolot, Kabupaten Bandung, Kamis (27/1). Rizal ialah salah satu prajurit TNI yang gugur akibat ditembak KKB Papua pada dini hari tadi. https://t.co/82fFSuyHuZ",102,15,17,7,2022-01-27,14,Thursday,4,119,22
1486709060342714369,2022-01-27 14:33:56,"PT Bank Mandiri (Persero) Tbk mencatat kinerja positif di tahun 2021. Bank Mandiri mencatat laba sebesar Rp 28,03 triliun atau tumbuh 66,8% dibanding tahun 2020  https://t.co/FFYABAL7HJ",3,0,3,1,2022-01-27,14,Thursday,4,6,1
1486708420409397254,2022-01-27 14:31:23,"Pemerintah memangkas harga minyak goreng, yaitu jenis curah menjadi Rp 11.500/liter, dan kemasan sederhana menjadi Rp 13.500/liter. Tapi ingat, jangan borong! https://t.co/JabPncZe6S",7,4,2,1,2022-01-27,14,Thursday,4,9,5
1486708413367140359,2022-01-27 14:31:22,"Jokowi mengatakan peluang ini harus dimanfaatkan untuk mewujudkan tata kelola yang lebih adil, memberikan kesejahteraan dan kemakmuran.  https://t.co/5miep5bTwP",11,2,1,0,2022-01-27,14,Thursday,4,12,2
1486708018712653826,2022-01-27 14:29:48,Kementerian Perdagangan mengungkap dampak dari kebijakan Domestic Market Obligation (DMO) minyak goreng.  https://t.co/spx6lBQj7t,10,1,3,1,2022-01-27,14,Thursday,4,13,2
1486707680701943819,2022-01-27 14:28:27,"Indonesia meraih kemenangan besar 4-1 atas Timor Leste dalam laga uji coba. Sempat tertinggal dulu, skuad Garuda berhasil membalikkan keadaan! https://t.co/BMaWDVyHdN",14,3,4,1,2022-01-27,14,Thursday,4,18,4
1486707659072053255,2022-01-27 14:28:22,Harga minyak goreng turun lagi mulai 1 Februari 2022. Apakah subsidi dari BPDPKS tetap berlanjut?  https://t.co/4RSgJ7YlmV,7,3,1,1,2022-01-27,14,Thursday,4,8,4
1486707319064965125,2022-01-27 14:27:01,"Bareskrim Polri menjadwalkan pemanggilan terhadap Edy Mulyadi besok, Jumat (28/1). Edy dipanggil sebagai saksi terkait ucapannya soal Kalimantan yang disebut sebagai tempat jin buang anak. https://t.co/nP9anMy6ux",11,9,7,4,2022-01-27,14,Thursday,4,18,13
1486707299481792512,2022-01-27 14:26:56,"Mendag Muhammad Lutfi mematok harga minyak goreng. Minyak goreng curah Rp 11.500/liter, kemasan sederhana Rp 13.500/liter, dan kemasan premium Rp 14.000/liter, namun ada pedagang yang mengaku belum tahu!  https://t.co/njxY0slo2q",7,0,3,0,2022-01-27,14,Thursday,4,10,0
1486706957452988419,2022-01-27 14:25:34,"Aliansi Masyarakat Sunda kembali mendatangi Gedung DPR RI, menuntut Arteria Dahlan dipecat dari anggota DPR dan diproses hukum. Mereka merasa sakit hati atas ucapan Arteria soal ‘kajati berbahasa Sunda’. https://t.co/OCug8jmTPM",8,2,4,1,2022-01-27,14,Thursday,4,12,3
1486706939740536838,2022-01-27 14:25:30,Jubir Satgas COVID-19 menanggapi soal kemunculan varian BA.2 yang disebut juga sebagai 'Son of Omicron'. Seberapa berbahayanya? Berikut penjelasannya: https://t.co/iATSEZwbAZ,3,0,1,0,2022-01-27,14,Thursday,4,4,0
1486706911835734017,2022-01-27 14:25:24,Anggota ormas GMBI (Gerakan Masyarakat Bawah Indonesia) yang menunggangi patung Maung Lodaya telah berhasil ditangkap. https://t.co/18vD5TAoF9,20,2,10,5,2022-01-27,14,Thursday,4,30,7
1486706298288840711,2022-01-27 14:22:57,Rocky Gerung mengatakan Presiden Joko Widodo bisa ditempeleng oleh Presiden Soekarno karena pemindahan dinilai telah menggusur warga setempat. Tanggapan Rocky tersebut dibantah oleh PDIP. https://t.co/ygNYCdFNXJ,19,18,1,1,2022-01-27,14,Thursday,4,20,19
1486705784767631371,2022-01-27 14:20:55,Pengembangan kawasan Bumi Serpong Damai (BSD) dijadikan rujukan dalam pengembangan Ibu Kota Negara (IKN) Nusantara di Kalimantan Timur.  https://t.co/STdEQsR1z6,5,0,2,0,2022-01-27,14,Thursday,4,7,0
1486705783580631044,2022-01-27 14:20:55,Menteri Kesehatan Budi Gunadi Sadikin memaparkan status vaksinasi dari pasien yang terpapar varian Omicron di Indonesia. Berikut penjelasan detailnya: https://t.co/DR3FYUqqxU,0,0,2,0,2022-01-27,14,Thursday,4,2,0
1486705779058962432,2022-01-27 14:20:54,Afiliator trading dari binary option sedang ramai menjadi pergunjingan!  https://t.co/mKEFGeC9iM,7,3,5,2,2022-01-27,14,Thursday,4,12,5
1486705754002411524,2022-01-27 14:20:48,Gini Wijnaldum masih sulit berbahasa Prancis sehingga tidak kunjung bersinar di Paris Saint-Germain. Maka Wijnaldum akan lebih intens belajar bahasa lokal. https://t.co/BdZT9NJZlc,2,0,0,0,2022-01-27,14,Thursday,4,2,0
1486705234315468801,2022-01-27 14:18:44,Rumah sakit di Jakarta sudah mulai penuh akibat peningkatan kasus Covid-19. Pihak Staf Presiden mengungkap masyarakat mulai kesulitan mencari rumah sakit. https://t.co/zYdagxsBnC,188,101,81,33,2022-01-27,14,Thursday,4,269,134
1486704668688490502,2022-01-27 14:16:29,Menteri Keuangan Sri Mulyani Indrawati bicara soal subsidi minyak goreng. Kenapa minyak goreng curah tak disubsidi?  https://t.co/q5LFFdfjIe,7,5,2,1,2022-01-27,14,Thursday,4,9,6
1486703683236737029,2022-01-27 14:12:34,"Ekonom Faisal Basri mengkritik proyek ibu kota baru, singgung ada pembisik Jokowi. Siapakah dia?  https://t.co/N5LZLmcjIM",10,2,5,0,2022-01-27,14,Thursday,4,15,2
1486703186828271617,2022-01-27 14:10:36,"Grand Inna Samudra Beach Palabuhanratu, Sukabumi seperti berada di posisi strategis untuk menyaksikan momen sunset dan sunset. Beginilah keadaan sore di sana.  https://t.co/dDD55NarcZ",7,0,3,0,2022-01-27,14,Thursday,4,10,0
1486702519543910400,2022-01-27 14:07:56,"Indra Kesuma, Youtuber yang dijuluki Crazy Rich dari Medan itu merupakan salah satu afiliator yang kini menjadi perbincangan publik!  https://t.co/yn1WFyNL0y",203,39,53,35,2022-01-27,14,Thursday,4,256,74
1486701456602411010,2022-01-27 14:03:43,"Untuk mendinginkan makanan panas, biasanya orang akan meniup hingga makanan agak dingin. Tapi pria ini justru membuat kipas angin mungil yang menempel di sendok  https://t.co/RIiUtXYG64",6,2,3,0,2022-01-27,14,Thursday,4,9,2
1486700785073283076,2022-01-27 14:01:03,"Anak Bupati Langkat ikut terseret dalam kasus yang tengah menjerat ayahnya. Video perayaan ultahnya yang bertema BTS, kembali viral dan menuai reaksi negatif. #detikNetwork  https://t.co/v7VlTqetAV",6,1,4,0,2022-01-27,14,Thursday,4,10,1
1486699769594589185,2022-01-27 13:57:01,"Menkes beberkan daerah yang bakal menjadi medan perang pertama melawan Omicron. Dari DKI Jakarta hingga Banten, bisa menyebar ke sini. https://t.co/DA9lAfjxQF",5,0,1,2,2022-01-27,13,Thursday,4,6,2
1486698703893278732,2022-01-27 13:52:47,Sekjen PDIP Hasto Kristiyanto menyerahkan kasus Edy Mulyadi soal Kalimantan tempat jin buang anak ke pihak kepolisian. Ia juga sempat menyoroti pentingnya elite politik disiplin berbicara di tahun-tahun politik. https://t.co/KSF8NYfU1Z,4,2,1,0,2022-01-27,13,Thursday,4,5,2
1486698179231891457,2022-01-27 13:50:42,"Vanessa Angel dan Bibi Andriansyah meninggal dunia usai kecelakaan mobil di Tol Jombang. Kini, sang sopir, Joddy diadili. https://t.co/rlyzFJmQZY",5,2,2,0,2022-01-27,13,Thursday,4,7,2
1486697688259338240,2022-01-27 13:48:45,"Polisi telah menetapkan 2 tersangka terkait bentrokan maut yang mengakibatkan tempat karaoke Double O di Sorong, Papua Barat, terbakar. Kedua tersangka saat ini ditahan. https://t.co/y9An49YmFn",3,0,3,0,2022-01-27,13,Thursday,4,6,0
1486696915358134274,2022-01-27 13:45:40,"Tubagus Joddy menjalani sidang perdana di PN Jombang, Kamis (27/1) atas kasus kecelakaan yang menyebabkan Vanessa Angel-Bibi meninggal dunia. Joddy didakwa dengan empat pasal sekaligus. Simak selengkapnya: https://t.co/zxtQqprY5u",7,0,2,0,2022-01-27,13,Thursday,4,9,0
1486695858515099652,2022-01-27 13:41:28,Menkes membeberkan kriteria pasien COVID-19 yang harus dirawat di rumah sakit. Hal ini ia sampaikan menyusul kenaikan kasus COVID-19 di Tanah Air. https://t.co/VUSkQbk3EB,1,0,2,0,2022-01-27,13,Thursday,4,3,0
1486694744445132807,2022-01-27 13:37:03,Peneliti asal Inggris menyebutkan sebagian besar yang terinfeksi varian Omicron adalah mereka yang sudah pernah terinfeksi COVID-19 sebelumnya. https://t.co/8X4VAiYYfV,7,4,10,8,2022-01-27,13,Thursday,4,17,12
1486693885065760773,2022-01-27 13:33:38,Gubernur BI Perry Warjiyo mengatakan pernyataan IMF itu sudah sejalan dengan komitmennya bersama pemerintah.  https://t.co/691xuY7Gue,3,1,2,0,2022-01-27,13,Thursday,4,5,1
1486693045617762308,2022-01-27 13:30:18,"Taman Mini Indonesia Indah atau TMII kini tengah direvitalisasi. Jika sudah rampung nanti, harga tiket lama akan kembali diberlakukan.  https://t.co/lY5Z9awQxW",7,1,2,1,2022-01-27,13,Thursday,4,9,2
1486691959838318593,2022-01-27 13:25:59,Para ilmuwan tengah mencari relawan yang bersedia ditulari virus Corona. Mereka meneliti respons imun yang bisa menangkal infeksi pada level paparan tertentu. Ada yang tertarik? https://t.co/IcG0mP7V9J,11,5,1,3,2022-01-27,13,Thursday,4,12,8
1486691095291572225,2022-01-27 13:22:33,"Sirclo, startup e-Commerce enabler mengawali 2022 dengan mengakuisisi Warung Pintar. Ini misi besar Sirclo usai akuisisi Warung Pintar:  https://t.co/ynkSBH964X",3,1,0,0,2022-01-27,13,Thursday,4,3,1
1486690238734995462,2022-01-27 13:19:08,Kantor Google ataupun beberapa perusahaan teknologi lain memang menyenangkan karena fasilitasnya berlimpah ruah. Ini potretnya:  https://t.co/b03aTmhfbe,13,1,2,0,2022-01-27,13,Thursday,4,15,1
1486689759049170945,2022-01-27 13:17:14,Samsung akan mengenalkan Galaxy S22 series dalam hitungan hari. Bocoran terbaru mengungkap spesifikasi lengkap dan harga trio ponsel itu. https://t.co/EApMTYKG3i,5,0,0,0,2022-01-27,13,Thursday,4,5,0
1486689518409375758,2022-01-27 13:16:17,Berbagai brand merilis sunscreen yang memudahkan untuk touch up atau reapply bahkan di bawah makeup sekalipun. Berikut rekomendasinya:  https://t.co/EbuAS1SQaG,0,0,2,0,2022-01-27,13,Thursday,4,2,0
1486687793241862146,2022-01-27 13:09:25,"Pada tahun macan air di 2022 ini, bagaimana peruntungan shio kamu? Ini shio yang diprediksi kurang beruntung di 2022:  https://t.co/04CGcGz2JH",9,0,2,0,2022-01-27,13,Thursday,4,11,0
1486687501171544064,2022-01-27 13:08:16,Polisi mengamankan 725 orang anggota Ormas GMBI yang melakukan demo anarkis di Mapolda Jabar. Belasan di antaranya diketahui positif narkoba. https://t.co/JROMDWRq4T,72,19,30,10,2022-01-27,13,Thursday,4,102,29
1486686976980013062,2022-01-27 13:06:11,"Agar stunting pada anak dapat teratasi dengan baik, Ibu berperan dalam memberikan gizi terbaik untuk anak. Caranya dengan memberikan makanan sehat. Apa saja?  https://t.co/M1SLj4BMQx",8,0,0,0,2022-01-27,13,Thursday,4,8,0
1486685610890960903,2022-01-27 13:00:45,NCT Dream akan menyapa penggemar melalui album baru. SM Entertainment mengkonfirmasi mereka akan kembali dengan album baru pada Maret 2022. https://t.co/2XUkPA7O3j,6,0,1,0,2022-01-27,13,Thursday,4,7,0
1486685562530529290,2022-01-27 13:00:34,"Meski usianya baru menginjak 9 tahun, ia semangat mengikuti latihan selama setahun bersama pelatih profesional IGBA https://t.co/LSOfYFjGOO.",23,0,3,1,2022-01-27,13,Thursday,4,26,1
1486685291117268998,2022-01-27 12:59:29,Nia Daniaty dikabarkan rujuk dengan Farhat Abbas gegara kasus Olivia Nathania. Begini jawaban Nia Daniaty:  https://t.co/SyNCVPykTq,4,0,0,0,2022-01-27,12,Thursday,4,4,0
1486685018311249929,2022-01-27 12:58:24,Polisi memburu anggota ormas pedemo yang menunganggi Macan Lodaya di Polda Jabar saat berunjuk rasa! https://t.co/Fc3qhKMtxD,18,17,1,4,2022-01-27,12,Thursday,4,19,21
1486684798852681731,2022-01-27 12:57:31,Cakra Khan jadi demam panggung dan kikuk ketika bernyanyi di depan banyak orang. Ini kata Cakra Khan:  https://t.co/mTOJBi6S82,6,0,0,2,2022-01-27,12,Thursday,4,6,2
1486684775914090496,2022-01-27 12:57:26,Demo Arteria dilakukan oleh masyarakat Sunda siang tadi di depan Gedung DPR RI. Ini desakan masyarakat Sunda saat demo. https://t.co/EEoEsF1pVw,6,0,1,0,2022-01-27,12,Thursday,4,7,0
1486684503401713664,2022-01-27 12:56:21,Pemasok ban untuk balapan MotoGP akan menguji coba berbagai spesifikasi ban di Pertamina Mandalika International Street Circuit! https://t.co/aUPiDBLAtU,11,0,3,0,2022-01-27,12,Thursday,4,14,0
1486684095564455939,2022-01-27 12:54:44,"KPK mengatakan Bupati Koltim Andi Merya mengajukan pinjaman Dana PEN sebesar Rp 350 miliar. Namun, dana PEN itu hanya disetujui Rp 150 miliar. https://t.co/Ly6LGjVwME",3,0,0,0,2022-01-27,12,Thursday,4,3,0
1486684094205501444,2022-01-27 12:54:43,Kejaksaan terlebih dahulu meneliti berkas kasus pembakaran lahan melibatkan bos perusahaan sawit PT BMI yang dinyatakan penyidik sudah lengkap. https://t.co/tLafGQE5EG,4,0,0,0,2022-01-27,12,Thursday,4,4,0
1486683856640122887,2022-01-27 12:53:47,Sebelumnya dikabarkan jika Vicky Prasetyo sudah menikah puluhan kali. Ia disebut-sebut sudah pernah mengucapkan ijab kabul hingga 24 kali. Ini bantahan Vicky:  https://t.co/nA9XR4LhNL,3,0,0,4,2022-01-27,12,Thursday,4,3,4
1486683855432130561,2022-01-27 12:53:47,Prakiraan cuaca besok sudah dapat dilihat sebelum merencanakan kegiatan. Berikut informasi untuk Jabodetabek. https://t.co/uszf3A6lBB,2,0,0,0,2022-01-27,12,Thursday,4,2,0
1486683615610220551,2022-01-27 12:52:49,Tanaka Koki batal debut menjadi idol KPop karena dinilai terlalu belia. Ini potret dan sederet faktanya yang berumur 12 tahun:  https://t.co/lFQQwvQ9Vj,6,0,1,0,2022-01-27,12,Thursday,4,7,0
1486683270754545670,2022-01-27 12:51:27,Maura Magnalia punya pemikiran yang berbeda. Tato dan piercing jadi cara putri Nurul Arifin itu mencari kepuasan. https://t.co/pWpZdZJfnC,4,1,3,1,2022-01-27,12,Thursday,4,7,2
1486682406228799490,2022-01-27 12:48:01,"Kasus Omicron di Indonesia semakin bertambah, jumlahnya nyaris 2 ribu kasus. Bagaimana status vaksinasi dan gejalanya? https://t.co/5fHt98AUx0",4,0,0,0,2022-01-27,12,Thursday,4,4,0
1486681832716439556,2022-01-27 12:45:44,"Omicron masih meroket, muncul 'siluman' turunan Omicron BA.2 yang sulit terdeteksi dengan skrining SGTF. Pakar membeberkan perbedaan BA.2 vs Omicron. https://t.co/sI9odq2IN0",11,0,5,3,2022-01-27,12,Thursday,4,16,3
1486681205105958914,2022-01-27 12:43:15,Polisi memburu anggota ormas pedemo yang menunganggi Macan Lodaya di Polda Jabar saat berunjuk rasa! https://t.co/a3nNOOROUI,104,59,23,7,2022-01-27,12,Thursday,4,127,66
1486680675952508928,2022-01-27 12:41:08,"Ratusan mahasiswa ULM Banjarmasin menggeruduk kantor Kejaksaan Tinggi Kalimantan Selatan gegara pemerkosa mahasiswi, Bripka Bayu Tamtomo, divonis ringan. https://t.co/jUD6cu7QfW",12,0,2,2,2022-01-27,12,Thursday,4,14,2
1486680168773136394,2022-01-27 12:39:08,Tingkat keterisian tempat tidur isolasi di rumah sakit (RS) DKI Jakarta telah mencapai 45 persen. Ini kriteria pasien Corona Omicron yang diisolasi di RS: https://t.co/hJTOC8HUkn,11,0,3,1,2022-01-27,12,Thursday,4,14,1
1486679904083230726,2022-01-27 12:38:04,Aliansi Borneo Bersatu mendatangi Gedung DPR RI untuk mendorong Edy Mulyadi diproses hukum negara dan juga adat. Mereka melakukan audiensi dengan Komisi III DPR. https://t.co/q7BJjnRWDk,16,4,4,0,2022-01-27,12,Thursday,4,20,4
1486679415165698048,2022-01-27 12:36:08,Putri Fadzilah dari Brunei menggelar serangkaian prosesi pernikahan selama 10 hari. Ini penampilannya:  https://t.co/jkteh0rrRG,10,1,0,0,2022-01-27,12,Thursday,4,10,1
1486678920246308866,2022-01-27 12:34:10,"Seorang ayah berinisial RC di Kota Pangkalpinang, Bangka Belitung, menjadi tersangka kasus pencurian handphone (HP). Kasusnya sempat diproses polisi dan akhirnya dibebaskan di tingkat kejaksaan. https://t.co/pqS1fYHqOU",23,0,7,3,2022-01-27,12,Thursday,4,30,3
1486678429722361857,2022-01-27 12:32:13,Menteri Investasi Bahlil Lahadalia menegaskan investasi asing yang ada di Indonesia bukan cuma dari China.  https://t.co/CkzCchZUGG,2,0,1,0,2022-01-27,12,Thursday,4,3,0
1486677841743908868,2022-01-27 12:29:53,Kabar baik untuk gamer yang memainkan Call of Duty di PlayStation. Activision masih akan merilis setidaknya tiga game Call of Duty baru untuk PlayStation. https://t.co/MsfezDmZoz,6,0,0,0,2022-01-27,12,Thursday,4,6,0
1486677819711266816,2022-01-27 12:29:48,"Ketua Umum Partai Gerindra, Prabowo Subianto, ditanya oleh awak media terkait Pilpres 2024. Prabowo pun tertawa lepas saat mendengar pertanyaan itu. https://t.co/V67bfI00iP",14,3,1,2,2022-01-27,12,Thursday,4,15,5
1486676526708011022,2022-01-27 12:24:39,"Jesse Lingard terancam batal pindah ke Newcastle United, karena MU mematok biaya peminjaman yang mahal! https://t.co/BYTTgqZZIZ",2,0,1,0,2022-01-27,12,Thursday,4,3,0
1486676508269846530,2022-01-27 12:24:35,"Bripda Randy Bagus resmi dipecat dari Polri. Bripda Randy merupakan tersangka kasus aborsi terhadap kekasihnya, Novia Widyasari. https://t.co/wjhBRzkTOq",120,26,28,12,2022-01-27,12,Thursday,4,148,38
1486676285862596614,2022-01-27 12:23:42,Spotify mengumumkan kemitraannya dengan Stripe untuk mempermudah podcaster memperoleh cuan dari kontennya dan mempererat hubungan dengan pendengarnya. https://t.co/NsLEP08gFv,3,0,0,0,2022-01-27,12,Thursday,4,3,0
1486676033818574854,2022-01-27 12:22:42,Gejala Omicron yang lebih ringan memunculkan harapan COVID-19 bakal jadi endemi. Sejumlah negara seperti Inggris sudah bersiap ke arah itu. RI bagaimana? https://t.co/zNRuICWUcN,27,6,5,4,2022-01-27,12,Thursday,4,32,10
1486675720013336579,2022-01-27 12:21:27,"CSR disesuaikan dengan isu sosial yang meliputi kondisi lingkungan di area lokasi kerja, dan kebutuhan masyarakat.  https://t.co/bdcsTckgjc",4,0,0,0,2022-01-27,12,Thursday,4,4,0
1486675243036909569,2022-01-27 12:19:33,d'Videocaster Hunt 2022 bakal tur ke tujuh kota di Indonesia. Bintang Emon akan menjadi juri di ajang tersebut. https://t.co/BokYeE727S,2,0,0,0,2022-01-27,12,Thursday,4,2,0
1486674738781081605,2022-01-27 12:17:33,Jamie Lee Curtis kembali memerankan Laurie Strode di film terbaru Halloween yang diberi judul Halloween Ends. Ini bocoran penampilannya:  https://t.co/4B0oxnbhIf,3,0,1,0,2022-01-27,12,Thursday,4,4,0
1486674205269762052,2022-01-27 12:15:26,Balai Konservasi Borobudur (BKB) mengusulkan wisatawan naik Candi Borobudur dengan memakai sandal upanat. Uji coba pun telah dilakukan pada Rabu (26/1)  https://t.co/XbMRnEGTH6,5,0,1,1,2022-01-27,12,Thursday,4,6,1
1486674203373940736,2022-01-27 12:15:25,Dorce Gamalama disebut akan menjual kediamannya yang berbentuk rumah gadang. Dapat bantuan dari Jokowi hingga Megawati diharapkan Dorce tak jadi jual rumah. https://t.co/qyxqzjzYU5,4,0,3,0,2022-01-27,12,Thursday,4,7,0
1486673609754034181,2022-01-27 12:13:04,"Hadits adalah salah satu sumber utama panduan hidup muslim yang berasal dari Nabi Muhammad. Hadits identik dengan sunnah, khabar, dan atsar.

 via: detikedu
 https://t.co/4yVneBsBhD",29,0,6,1,2022-01-27,12,Thursday,4,35,1
1486673328412798980,2022-01-27 12:11:57,Menteri Investasi/Kepala BKPM Bahlil Lahadalia membandingkan jumlah investasi yang ada di Jakarta dan Jawa Barat. Siapa lebih baik?  https://t.co/7hExXEDtri,16,9,2,2,2022-01-27,12,Thursday,4,18,11
1486671765183021064,2022-01-27 12:05:44,"725 pedemo dari organisasi masyarakat (Ormas) GMBI diamankan polisi. Mereka melakukan aksi demo yang berujung perusakan di Mapolda Jabar, Kota Bandung. https://t.co/tFgAOZpsGY",19,7,5,2,2022-01-27,12,Thursday,4,24,9
1486671045465620484,2022-01-27 12:02:52,"Pierre-Emerick Aubameyang kabarnya dilego Arsenal ke AC Milan. Tetapi, Rossoneri tak tertarik dengan sang mantan itu! https://t.co/3oruzGayHk",3,1,0,0,2022-01-27,12,Thursday,4,3,1
1486669937536114689,2022-01-27 11:58:28,"2 tahun Aliando Syarief menghilang dari dunia hiburan. Kini, Aliando muncul dan mengumumkan dirinya tengah mengidap OCD. https://t.co/bVzqmytOGg",96,13,26,4,2022-01-27,11,Thursday,4,122,17
1486669698938847234,2022-01-27 11:57:31,Memilih jenis bahan bakar minyak (BBM) yang tepat perlu dilakukan oleh pemilik kendaraan. Yuk kenali BBM yang cocok buat mobilmu! https://t.co/hJhiLg42mm,5,0,1,0,2022-01-27,11,Thursday,4,6,0
1486668944350011393,2022-01-27 11:54:31,"KPK menetapkan mantan Dirjen Bina Keuangan Daerah Kemendagri Ardian Noervianto sebagai tersangka. Ardian tercatat memiliki harta Rp 7,3 miliar. https://t.co/7DSjwztUkf",6,2,1,1,2022-01-27,11,Thursday,4,7,3
1486668121561837568,2022-01-27 11:51:15,KPK mengungkap mantan Pramugari Siwi Widi akan mengembalikan uang Rp 647 juta yang diterima dari hasil dugaan korupsi Ditjen Pajak. Bagaimana kelanjutannya? https://t.co/HJGrV9CUYg,12,5,1,1,2022-01-27,11,Thursday,4,13,6
1486666782660308998,2022-01-27 11:45:56,Ratusan mahasiswa ULM Banjarmasin menggeruduk kantor Kejati Kalsel gegara pemerkosa mahasiswi divonis ringan Bripka Bayu Tamtomo . https://t.co/XgrDU4km4X,34,6,12,1,2022-01-27,11,Thursday,4,46,7
1486666541336829955,2022-01-27 11:44:59,AC Milan mendapat kabar buruk sepekan jelang Derby della Madonnina. Zlatan Ibrahimovic dan Franck Kessie mungkin absen. https://t.co/CuEy8RHhpF,3,1,0,0,2022-01-27,11,Thursday,4,3,1
1486665202238111749,2022-01-27 11:39:39,"Angka kecelakaan lalu lintas masih sangat tinggi. Dibanding Indonesia, rasio kematian akibat kecelakaan lalu lintas Timor Leste lebih besar. https://t.co/6USqCl2L43",4,0,0,0,2022-01-27,11,Thursday,4,4,0
1486664682505183233,2022-01-27 11:37:35,Indonesia akan menghadapi Timor Leste dalam laga ujicoba malam ini. Berikut starting line-up skuad Garuda! https://t.co/NUZcTrTVCY,6,0,0,0,2022-01-27,11,Thursday,4,6,0
1486664644404162562,2022-01-27 11:37:26,"Ibadah haji dan umrah merupakan ibadah yang diajarkan oleh Rasulullah SAW bagi muslim yang memiliki kesanggupan. Lalu, berapa kali beliau berhaji dan umrah?

via: detikedu https://t.co/dI41n5ndSp",16,2,1,0,2022-01-27,11,Thursday,4,17,2
1486664132371914754,2022-01-27 11:35:24,"Sekjen DPR hari ini mengantarkan UU IKN ke Mensesneg, untuk kemudian diteruskan ke Presiden Jokowi. Pemerintah punya waktu 30 hari untuk mengkaji lagi UU IKN. https://t.co/4YAC3GBKME",11,1,3,0,2022-01-27,11,Thursday,4,14,1
1486662805214404623,2022-01-27 11:30:08,Kampung miliarder Tuban mengaku uang simpanan habis dan tak kunjung diberi pekerjaan usai pembebasan lahan. Ini klarifikasi kades. https://t.co/jEvGPGnveH,25,20,3,5,2022-01-27,11,Thursday,4,28,25
1486662537881993223,2022-01-27 11:29:04,Panitia Penyelenggara Piala Dunia Basket 2023 mulai membuka penjualan tiket pre-sale mulai awal Maret mendatang. Berikut harganya tiketnya! https://t.co/W1LbiA0B6u,2,0,0,0,2022-01-27,11,Thursday,4,2,0
1486662275058610180,2022-01-27 11:28:01,Apa Itu Omicron BA.2 yang merupakan varian COVID-19 terbaru? Simak fakta terkait Omicron BA.2 di sini:  https://t.co/jX1u7sXdeU,5,0,1,0,2022-01-27,11,Thursday,4,6,0
1486661774678106117,2022-01-27 11:26:02,"Kasus aktif Corona di Indonesia melonjak, menembus 35 ribu orang. Hampir setengahnya disumbang DKI Jakarta, ini sebaran kasus aktif Corona terbaru: https://t.co/5XqbNcrYM8",8,2,2,1,2022-01-27,11,Thursday,4,10,3
1486661442355015681,2022-01-27 11:24:43,"Sebuah studi yang dilakukan terhadap siswa SMA di Swiss menunjukkan sisi lain yang positif dari penutupan sekolah terhadap kesehatan siswa. Bagaimana hasilnya?

via: detikedu  https://t.co/u39ULNfsFc",8,1,2,1,2022-01-27,11,Thursday,4,10,2
1486661177476325378,2022-01-27 11:23:40,Casemiro bicara soal pentingnya vaksin COVID-19. Apa kata gelandang Real Madrid itu? https://t.co/pYI2TsiTQ5,2,0,0,0,2022-01-27,11,Thursday,4,2,0
1486661158262251520,2022-01-27 11:23:35,Dorce Gamalama tengah berjuang melawan sakit yang diidapnya. Nia Daniaty ngaku sejak lama ingin menjenguknya namun dilarang. https://t.co/ty8qthaDe6,0,0,0,1,2022-01-27,11,Thursday,4,0,1
1486660673258012674,2022-01-27 11:21:39,"Indonesia mencatatkan 8.077 kasus baru COVID-19, total menjadi 4.309.270 kasus, Kamis (27/1/2022). Ini memperpanjang tren kenaikan dalam sepekan terakhir. https://t.co/umepLScMWt",7,1,7,1,2022-01-27,11,Thursday,4,14,2
1486660644749430787,2022-01-27 11:21:33,Masa depan Ousmane Dembele di Barcelona sedang jadi tanda tanya. Momen 'Leonardo PSG' menelepon agennya Dembele ikut memanaskan spekulasi. https://t.co/j6EoJujLyI,0,0,0,0,2022-01-27,11,Thursday,4,0,0
1486660351345278980,2022-01-27 11:20:23,Yoo Ah In kembali jadi perbincangan setelah diisukan gay. Pria yang disebut-sebut kekasihnya pamer foto mesra di Instagram. https://t.co/aYaPMxUIvf,6,0,1,1,2022-01-27,11,Thursday,4,7,1
1486659873681117191,2022-01-27 11:18:29,"Beredar video pengeroyokan yang dilakukan oleh sejumlah pelajar SMA terhadap pelajar SMP di Ngawi, Jawa Timur. Aksi pengeroyokan itu dikonfirmasi oleh kepolisian. https://t.co/JSFUVH5T8S",2,1,1,0,2022-01-27,11,Thursday,4,3,1
1486659356993236997,2022-01-27 11:16:26,Ayu Thalia dikabarkan sudah selesai diperiksa oleh penyidik sebagai tersangka. Ia tidak ditahan dan sudah diperbolehkan pulang. https://t.co/98pvVcMdSB,9,0,0,0,2022-01-27,11,Thursday,4,9,0
1486658923784462339,2022-01-27 11:14:42,"Tim gabungan Satpol PP Kota Magelang bersama TNI dan Polri menggelar operasi penyakit masyarakat (pekat) di pagi hari Kamis (27/1). Dari operasi tersebut diamankan 13 orang, termasuk di antaranya adalah 4 pasangan mesum. https://t.co/eZtHtc22di",2,2,1,1,2022-01-27,11,Thursday,4,3,3
1486658909322584066,2022-01-27 11:14:39,Satgas COVID-19 tengah memperhatikan sub varian Omicron. Perhatian utama tertuju pada sub varian Omicron BA.2 yang bisa menyebabkan perbedaan hasil tes PCR. https://t.co/eawqNT3mMB,3,1,1,1,2022-01-27,11,Thursday,4,4,2
1486658428248510466,2022-01-27 11:12:44,"Mengenang kepergian Kobe Bryant pada 26 Januari 2020, sebuah patung didirikan di lokasi kecelakaan tempat Kobe dan putrinya, Gianna, meninggal dunia. https://t.co/AKjKZbTDck",11,1,2,0,2022-01-27,11,Thursday,4,13,1
1486657916870569985,2022-01-27 11:10:42,Kasus baru COVID-19 di AS melonjak tinggi dalam seminggu terakhir. Jumlah yang dilaporkan menjadi jumlah tertinggi sejak pandemi dimulai pada tahun 2020. https://t.co/K1nFTGl1eS,4,1,2,1,2022-01-27,11,Thursday,4,6,2
1486657792836575233,2022-01-27 11:10:13,"#Foto 14 tahun lalu, Presiden Soeharto meninggal dunia. Selama hidupnya, Soeharto dikenal dengan sebutan The Smiling General dan memegang nilai-nilai filosofi Jawa. https://t.co/vPQ2QPB4bB",17,0,5,1,2022-01-27,11,Thursday,4,22,1
1486657293613678596,2022-01-27 11:08:14,"Jumlah ketersediaan tempat tidur di RS di Jakarta mengalami peningkatan. Berdasarkan data, jumlah tersebut didominasi pasien bergejala ringan dan tanpa gejala. https://t.co/hmgxsmudCy",6,0,2,0,2022-01-27,11,Thursday,4,8,0
1486656244890939392,2022-01-27 11:04:04,KPK menetapkan mantan Dirjen Keuda Kemendagri Ardian sebagai tersangka dugaan suap pengajuan dana PEN. Ardian belum ditahan karena mengaku sakit. https://t.co/ukD9JpUARh,1,0,1,0,2022-01-27,11,Thursday,4,2,0
1486655788349550600,2022-01-27 11:02:15,PDIP menjagokan Ahok sebagai calon Kepala Otorita Nusantara. Sekjen PDIP mengungkap soal Kepala Otorita ada dalam dialog antara Presiden Jokowi dengan Megawati. https://t.co/ZLL2vVv5HN,63,52,13,8,2022-01-27,11,Thursday,4,76,60
1486654936897183745,2022-01-27 10:58:52,PT Waskita Beton Precast Tbk (WSBP) berstatus PKPU sementara. Ini diputuskan Majelis Hakim Pengadilan Niaga di Pengadilan Negeri Jakarta Pusat 25 Januari 2022.  https://t.co/lYGx5UpvqW,3,0,4,2,2022-01-27,10,Thursday,4,7,2
1486653623077847040,2022-01-27 10:53:39,"Saat perayaan Imlek, orang Tionghoa mempercayai adanya makanan pembawa nasib buruk yang tidak boleh dihidangkan. Ada lobster hingga bubur, ini daftarnya!  https://t.co/Ch1FIPbA5i",5,1,3,0,2022-01-27,10,Thursday,4,8,1
1486652867666718720,2022-01-27 10:50:38,KPK menetapkan mantan Direktur Jenderal Bina Keuangan Daerah Kementerian Dalam Negeri (Dirjen Keuda Kemendagri) Ardian Noervianto sebagai tersangka. https://t.co/oCcLVugswe,9,0,2,1,2022-01-27,10,Thursday,4,11,1
1486652375532281859,2022-01-27 10:48:41,Presiden FIFA Gianni Infantino mendapat kritikan saat mengatakan menggelar Piala Dunia dua tahun sekali akan memberi banyak keuntungan bagi rakyat Afrika. https://t.co/BZqxIms2M4,4,2,2,0,2022-01-27,10,Thursday,4,6,2
1486652133554286597,2022-01-27 10:47:43,Aparatur sipil negara atau pegawai negeri sipil bakal pindah ke ibu kota baru di Kalimantan Timur. Semua PNS pusat ikut pindah?  https://t.co/6p8BZgBJaE,11,3,3,1,2022-01-27,10,Thursday,4,14,4
1486650868460138498,2022-01-27 10:42:42,"Bank Mandiri mencatatkan laba sebesar Rp 28,03 triliun atau tumbuh sebesar 66,8% dibanding tahun sebelumnya.  https://t.co/JRjRFYY6Gc",6,1,3,0,2022-01-27,10,Thursday,4,9,1
1486650355207516160,2022-01-27 10:40:39,"Mengenang kepergian Kobe Bryant dan putrinya pada 26 Januari 2020, sebuah patung didirikan di lokasi kecelakaan. https://t.co/WsHVv0WnRC",9,0,3,0,2022-01-27,10,Thursday,4,12,0
1486649845528113156,2022-01-27 10:38:38,"Seungri divonis 3 tahun penjara terkait kasus yang menjeratnya. Setelah mengajukan banding, ini keputusan pengadilan:  https://t.co/cIixfVxTvl",4,1,1,0,2022-01-27,10,Thursday,4,5,1
1486649828956422153,2022-01-27 10:38:34,"NATO adalah organisasi Pakta Pertahanan Atlantik Utara. Kini negara anggotanya tengah mempertimbangkan untuk membantu Ukraina menghadapi Rusia.

via: detikedu  https://t.co/xEWHHaR5NC",0,0,0,0,2022-01-27,10,Thursday,4,0,0
1486649581769306112,2022-01-27 10:37:35,Penetapan kepala otorita dianggap tidak demokratis karena tidak melibatkan aspirasi masyarakat lewat pilkada melainkan lewat penujukan langsung.  https://t.co/zX9EP3FWWu,8,19,0,0,2022-01-27,10,Thursday,4,8,19
1486649562555195393,2022-01-27 10:37:30,Salah satu mahakarya terbaik Sapardi Djoko Damono yakni buku kumpulan puisi Hujan Bulan Juni terbit di Rusia. https://t.co/yc8if3GK7Z,40,0,4,1,2022-01-27,10,Thursday,4,44,1
1486649064380940294,2022-01-27 10:35:32,"Suku bunga acuan Bank Indonesia (BI) saat ini sudah berada di level terendah selama 11 bulan yaitu 3,5%. Apakah masih bisa turun?  https://t.co/80orVNb6wf",4,0,2,1,2022-01-27,10,Thursday,4,6,1
1486648806011723788,2022-01-27 10:34:30,Naskah Spider-Man: No Way Home bisa dibaca dan di-download secara gratis. Kamu bisa download skrip Spider-Man: No Way Home di link ini:  https://t.co/AdQto9Hc28,9,0,2,0,2022-01-27,10,Thursday,4,11,0
1486648631310618628,2022-01-27 10:33:48,Tingkat keterisian tempat tidur atau bed occupancy rate isolasi RS rujukan COVID-19 di DKI Jakarta mencapai 45%. Akankah rem darurat ditarik lagi? https://t.co/RfZrTt13HK,8,2,6,1,2022-01-27,10,Thursday,4,14,3
1486648609378549764,2022-01-27 10:33:43,"Tim perwakilan Indonesia di Mobile Legends: Bang Bang Woman Invitational 2022, Bigetron Era Dan GPX Basreng bermain hari Ini, mulai dari pukul 11.00 WIB. https://t.co/oI18KAjwMP",3,0,0,0,2022-01-27,10,Thursday,4,3,0
1486647902403448842,2022-01-27 10:30:55,"Uut Permatasari hamil anak kedua. Namun, sat ini Uut justru terbaring di rumah sakit. Lekas pulih Uut Permatasari...  https://t.co/z3WxWOyZ6E",4,1,0,0,2022-01-27,10,Thursday,4,4,1
1486647622706282496,2022-01-27 10:29:48,"""Jika wacana itu benar-benar direalisasikan, pemerintah pusat harus ikut bertanggungjawab ketika angka pengangguran di daerah meningkat,"" ujar Suimi. https://t.co/mUZX3UqETX",5,4,2,0,2022-01-27,10,Thursday,4,7,4
1486647106739789824,2022-01-27 10:27:45,"Drama Korea Rookie Cops menandai debut akting Kang Daniel, eks member Wanna One. Ini sinopsis dan jadwal tayangnya:  https://t.co/PJNb5DuQth",7,1,3,1,2022-01-27,10,Thursday,4,10,2
1486647011491393540,2022-01-27 10:27:22,Menteri Perdagangan Muhammad Lutfi mengeluarkan kebijakan harga eceran tertinggi (HET) untuk minyak goreng curah hingga kemasan premium. Catat!  https://t.co/59quzfAwze,253,87,104,49,2022-01-27,10,Thursday,4,357,136
1486646849150894083,2022-01-27 10:26:44,"Sudah dua bulan Neymar tidak terlihat aksinya di lapangan hijau. Fans PSG pun bertanya-tanya, kapan Neymar main lagi? https://t.co/1mN4Td6TBl",2,0,0,1,2022-01-27,10,Thursday,4,2,1
1486646367980249091,2022-01-27 10:24:49,"Setelah dipamerkan tahun lalu, kini desain mobil listrik Wuling didaftarkan dalam Berita Resmi Desain Industri Ditjen Kekayaan Intelektual Kemenkumham! https://t.co/7lpv6JwiSs",7,1,1,0,2022-01-27,10,Thursday,4,8,1
1486645875707453445,2022-01-27 10:22:51,Empat bulan lagi perhelatan SEA Games 2022 segera dimulai. Komite Olimpiade Indonesia (KOI) berharap Chef de Mission bisa segera ditunjuk. https://t.co/pO9Awq0KAT,4,2,0,0,2022-01-27,10,Thursday,4,4,2
1486645304434831361,2022-01-27 10:20:35,Dekorasi penuh bunga memberi kesan dreamy bak negeri dongeng pada pernikahan Park Shin Hye dan Choi Tae Joon. Intip inspirasinya ini:  https://t.co/8UOVhbDu1L,9,0,1,0,2022-01-27,10,Thursday,4,10,0
1486644819392966659,2022-01-27 10:18:40,"Menyambut peluncuran Ioniq 5 dan MPV baru di Indonesia, Hyundai terus memperbanyak jaringan dealernya. https://t.co/ZRJC8AcNGo",2,1,0,0,2022-01-27,10,Thursday,4,2,1
1486644464798023680,2022-01-27 10:17:15,Majelis Adat Sunda menyiapkan hukum adat apabila proses hukum di kepolisian buntu. https://t.co/gNOlQ2rNWT,52,30,12,10,2022-01-27,10,Thursday,4,64,40
1486643933799239683,2022-01-27 10:15:08,Personel NCT Dream menghebohkan media sosial dengan video joget koplo Mendung Tanpo Udan. Ini fakta-fakta NCT Dream:  https://t.co/GU9MSmEr7U,3580,20,1018,58,2022-01-27,10,Thursday,4,4598,78
1486643720988639235,2022-01-27 10:14:18,"Pharrell Williams memberi bocoran soal kolaborasinya dengan merek perhiasan Tiffany &amp; Co. Belum dirilis resmi, produk mereka sudah mengundang hujatan. https://t.co/Dlc8aM1fQq",1,0,0,1,2022-01-27,10,Thursday,4,1,1
1486642809948057602,2022-01-27 10:10:41,"Tahun baru Imlek jadi momen spesial bagi masyarakat keturunan Tionghoa. Saat merayakan Imlek, biasanya mereka akan mengenakan baju serba merah atau gold. https://t.co/FzfZ90GT96",6,0,0,0,2022-01-27,10,Thursday,4,6,0
1486642316110667777,2022-01-27 10:08:43,Anya Geraldine dan Kiky Saputri curi perhatian usai dikabarkan membentuk kelompok dua pelakor. Ini adu gaya Anya Geraldine dan Kiky Saputri:  https://t.co/9hMTz3qOPo,21,2,2,0,2022-01-27,10,Thursday,4,23,2
1486642290873757697,2022-01-27 10:08:37,Wanita ini mengidap kondisi langka yang membuat tubuhnya seperti anak kecil. Ia khawatir menarik orang-orang pedofil karena penampilannya. https://t.co/dbrxEbM5Ew,6,0,0,0,2022-01-27,10,Thursday,4,6,0
1486642282405240836,2022-01-27 10:08:35,"Perbincangan halal atau haramnya makanan selalu menarik perhatian. Terbaru, eks menag Malaysia disorot lantaran penjelasannya soal kehalalan konsumsi penguin!  https://t.co/Xnjhqb93Sf",2,0,2,0,2022-01-27,10,Thursday,4,4,0
1486642034794545159,2022-01-27 10:07:36,KPK menetapkan mantan Direktur Jenderal Bina Keuangan Daerah Kementerian Dalam Negeri (Dirjen Keuda Kemendagri) Ardian Noervianto sebagai tersangka. https://t.co/evTG6vDufx,12,2,4,2,2022-01-27,10,Thursday,4,16,4
1486641510066106368,2022-01-27 10:05:31,Gubernur DIY Sri Sultan Hamengku Buwono tidak memberi toleransi lagi kepada pedagang kaki lima di sepanjang Jalan Malioboro. PKL itu akan digusur pekan ini.  https://t.co/xmEdl6OMM7,9,0,3,3,2022-01-27,10,Thursday,4,12,3
1486641493007912964,2022-01-27 10:05:27,"Menkes Gunadi Sadikin mengumumkan ada tiga pasien Omicron di Indonesia yang meninggal dunia, punya komorbid ini. Bagaimana status vaksinasinya? https://t.co/znEsesk4AS",5,2,4,1,2022-01-27,10,Thursday,4,9,3
1486641255140499458,2022-01-27 10:04:30,Tempat ngopi Rasa Koffie berinovasi dalam melakukan pelayanan di masa pandemi Corona. Kafe di kawasan Pasar Baru itu menggunakan robot untuk melayani pembeli.  https://t.co/Tpx2HHeo5Y,4,0,0,0,2022-01-27,10,Thursday,4,4,0
1486641237222383618,2022-01-27 10:04:26,Event International Youth Championship (IYC) batal digelar di Bali. Seluruh pertandingan tim muda klub Spanyol bersama Indonesia All Star dialihkan ke JIS. https://t.co/Xe26OlZAEU,13,0,2,4,2022-01-27,10,Thursday,4,15,4
1486641026748010496,2022-01-27 10:03:35,"Sesuai perhitungan kalender China, 2022 merupakan tahun macan air. Ini lima shio paling beruntung di tahun 2022:  https://t.co/Um3dGvKJo2",5,0,1,2,2022-01-27,10,Thursday,4,6,2
1486640999610863620,2022-01-27 10:03:29,Viral video nakes tampak tak menyuntikkan isi vaksin COVID-19 dalam pelaksanaan vaksinasi. Dinkes Kota Semarang memastikan ini adalah salah paham. https://t.co/WctOg5Fiax,4,0,0,0,2022-01-27,10,Thursday,4,4,0
1486640388895125506,2022-01-27 10:01:03,"Seungri menang banding di persidangan setelah divonis 3 tahun penjara. Hakim militer setuju memangkas hukuman Seungri menjadi 1, 5 tahun. https://t.co/n17qfmgRAn",5,0,2,1,2022-01-27,10,Thursday,4,7,1
1486640124276449283,2022-01-27 10:00:00,Sejumlah member iKON dan TREASURE terinfeksi COVID-19. Hal itu dibenarkan YG Entertainment. https://t.co/W08IEwBCZ4,10,0,2,0,2022-01-27,10,Thursday,4,12,0
1486639880226721798,2022-01-27 09:59:02,Polisi sudah menyita mobil pelaku. Namun sang pelaku belum terlacak keberadaannya. Korban hingga saat ini masih menjalani perawatan di rumah sakit. https://t.co/qG63uFOPHz,10,1,1,0,2022-01-27,9,Thursday,4,11,1
1486639367233933313,2022-01-27 09:57:00,Atta Halilinta makin percaya diri dengan penampilan barunya. Ia tampak mulai meninggalkan bandana yang selama ini jadi ciri khasnya. Ini potret Atta:  https://t.co/tpuNegq8mM,18,8,1,1,2022-01-27,9,Thursday,4,19,9
1486639237000794115,2022-01-27 09:56:29,"Menkes membeberkan data terkini pasien Omicron di Indonesia, ada tiga kasus yang meninggal dunia. https://t.co/YRaJzEJxQe",7,0,2,1,2022-01-27,9,Thursday,4,9,1
1486638910096785408,2022-01-27 09:55:11,Indeks Harga Saham Gabungan (IHSG) sore ini ditutup di zona hijau. IHSG bergerak naik turun bak roller coaster seharian.  https://t.co/5nY9jA8bOR,6,0,1,0,2022-01-27,9,Thursday,4,7,0
1486638892921114624,2022-01-27 09:55:07,"Adik Bibi Ardiansyah, Fuji beberapa waktu lalu turut serta menghadiri gathering sebuah acara kosmetik. Penampilannya berhasil mencuri perhatian. Ini potretnya:  https://t.co/PzURp1zCnr",3,0,0,1,2022-01-27,9,Thursday,4,3,1
1486638646593740804,2022-01-27 09:54:08,"Rohana Abdullah putus sekolah karena kendala identitas. Pemberitaan membuat anak TKI yang dibesarkan guru TK di Malaysia ini mendapat sejumlah bantuan.

via: detikedu  https://t.co/RlzEFxkqrb",6,1,0,0,2022-01-27,9,Thursday,4,6,1
1486638396298645507,2022-01-27 09:53:08,"Sebuah pertandingan di divisi dua sepakbola Kolombia memicu kontroversi, karena diduga terjadi match fixing. Presiden sampai Jaksa Agung turun tangan. https://t.co/NBmtYPjSZx",10,0,1,0,2022-01-27,9,Thursday,4,11,0
1486637781623398402,2022-01-27 09:50:42,"Jumlah kasus COVID-19 bertambah 8.077 kasus pada Kamis (27/1/2022), sehingga total menjadi 4.309.270. Pasien sembuh bertambah 1.643, meninggal 7. https://t.co/0aGpSgIanI",25,0,9,4,2022-01-27,9,Thursday,4,34,4
1486637634755702785,2022-01-27 09:50:07,"Teka-teki ini berisi kata tersembunyi yang berhubungan dengan kesehatan. Cari dari atas ke bawah, kiri ke kanan atau sebaliknya. Bisa juga menyilang. Bebas! https://t.co/Ha1xzoT0Yd",1,1,0,0,2022-01-27,9,Thursday,4,1,1
1486637375631601671,2022-01-27 09:49:05,Putaran pertama Proliga 2022 masuki tahap akhir. Dua tim elit putra Jakarta Pertamina Pertamax dan Surabaya Bhayangkara Samator akan saling berebut juara. https://t.co/Jz59Rhj3CS,2,0,0,0,2022-01-27,9,Thursday,4,2,0
1486636880829554693,2022-01-27 09:47:07,"Detikers yang masih memilih jurusan kuliah sesuai minat bisa menggunakan daftar jurusan kuliah IPA-IPS yang selalu dicari di dunia kerja. Apa saja?

via: detikedu  https://t.co/btRJVe3sep",7,0,4,0,2022-01-27,9,Thursday,4,11,0
1486636858259947524,2022-01-27 09:47:02,Kementerian Keuangan mengatakan pemblokiran anggaran kementerian dan lembaga (K/L) dilakukan dalam rangka mengantisipasi ketidakpastian perkembangan COVID-19.  https://t.co/fcO4MbpHRW,7,0,1,1,2022-01-27,9,Thursday,4,8,1
1486636682183118848,2022-01-27 09:46:20,"""Untuk menghadapi tantangan ke depan. Menghadapi perubahan iklim untuk memimpin Indonesia menjadi Nol Zero Emmission. Jakarta sudah tidak spesial-spesial amir""  https://t.co/ANmEhK65JK",4,3,0,0,2022-01-27,9,Thursday,4,4,3
1486636680853733379,2022-01-27 09:46:19,"Penyebab varises bisa beragam, biasanya dipicu oleh aktivitas sehari-hari. Menekuk kaki setelah olahraga juga salah satu faktor risiko varises loh. https://t.co/0iBJwMVY7Q",3,0,0,0,2022-01-27,9,Thursday,4,3,0
1486636054283227139,2022-01-27 09:43:50,"Melihat negara lain berlomba-lomba dalam bidang antariksa, Indonesia juga punya misi sebelum 100 tahun merdeka:   https://t.co/nV35wcXnst",9,3,2,2,2022-01-27,9,Thursday,4,11,5
1486634485110169600,2022-01-27 09:37:36,Pengembangan vaksin Merah Putih dipastikan berlanjut meski menghadapi sejumlah tantangan. Ini perkembangan terkini vaksin Merah Putih:  https://t.co/fHeuY1pucz,5,3,0,0,2022-01-27,9,Thursday,4,5,3
1486634197959720963,2022-01-27 09:36:27,"Pembahasan mengenai afiliator binary option ramai ketika para trader yang mengaku sebagai korban berteriak di media sosial, salah satunya melalui Youtube.  https://t.co/WJcgS6MP94",3,1,0,1,2022-01-27,9,Thursday,4,3,2
1486633968543875078,2022-01-27 09:35:33,YouTube berencanaterjun ke dunia NFT tahun ini. CEO YouTube Susan Wojcicki mengatakan NFT bisa jadi sumber pendapatan baru bagi kreator. https://t.co/WCUjDwiwlj,5,0,0,0,2022-01-27,9,Thursday,4,5,0
1486633952387473409,2022-01-27 09:35:29,Set top box gratis TV digital bersumber dari penyelenggara mux dan pemerintah. Alat ini diberikan kepada rumah tangga miskin untuk menikmati siaran TV digital. https://t.co/0ze0Clnsol,5,0,1,0,2022-01-27,9,Thursday,4,6,0
1486633595464781836,2022-01-27 09:34:04,"Vivo V23 5G resmi dirilis di Indonesia. HP Vivo V23 5G Rp 5 jutaan ini menawarkan sejumlah keunggulan, seperti kamera selfie 50 MP. Ini wujudnya:  https://t.co/h7Xtp4DU0l",9,0,1,0,2022-01-27,9,Thursday,4,10,0
1486633581116112898,2022-01-27 09:34:00,"PT Bank Central Asia Tbk (BCA) dan entitas anak mencatat laba bersih Rp 31,4 triliun atau tumbuh 15,8%.  https://t.co/RepCJio0ru",39,1,6,3,2022-01-27,9,Thursday,4,45,4
1486633270636863491,2022-01-27 09:32:46,Hubungan Rusia-Ukraina yang tengah memanas dikhawatirkan mengancam keselamatan WNI. KBRI mengimbau WNI rajin melaporkan kondisi!  https://t.co/RVQNddoXJo,5,1,0,0,2022-01-27,9,Thursday,4,5,1
1486633268514537474,2022-01-27 09:32:46,"Game onlinedan E-Sport tengah dilirik masyarakat Indonesia. Lalu, gimana caranya menghasilkan cuan di game online dan E-sport? Nah simak pembahasannya di d'Mentor, Kamis 27 Januari 2022, pukul 19.00 WIB, live streaming di https://t.co/6U64NYs6NJ! https://t.co/IO5rRA5mZN https://t.co/Ma1GMLVAtQ",4,0,0,0,2022-01-27,9,Thursday,4,4,0
1486632385596772358,2022-01-27 09:29:15,LS Cable &amp; System mengumumkan telah menyelesaikan pembangunan Pabrik Kabel Listrik tahap pertama di Indonesia dengan nama PT LSAG Cable Indonesia (LSAGI).  https://t.co/urCcYxHbxy,5,0,0,0,2022-01-27,9,Thursday,4,5,0
1486631889796481029,2022-01-27 09:27:17,Rencana pemindahan ibu kota negara (IKN) ke Kalimantan Timur semakin dekat. Sejumlah pro-dan kontra berdatangan terkait rencana ini. https://t.co/vdRymbaMVI,7,5,2,0,2022-01-27,9,Thursday,4,9,5
1486631375197380608,2022-01-27 09:25:14,"""...tentu ini menjadi informasi yang menarik buat penyidik kan, tentu akan ditanya lho ini beli MINI Cooper uangnya dari mana, misalnya kan seperti itu,"" kata Wakil Ketua KPK. https://t.co/bxMcp8nlSd",10,3,2,0,2022-01-27,9,Thursday,4,12,3
1486630833687601152,2022-01-27 09:23:05,"Manchester United sedang menjaga tempat di posisi empat besar Liga Inggris dan enam laga berikutnya, seperti laga final! https://t.co/fIHO6KoXAf",6,0,1,0,2022-01-27,9,Thursday,4,7,0
1486630812439224331,2022-01-27 09:23:00,"Belakangan ini ramai adanya dugaan perbudakan manusia yang dilakukan Bupati Langkat, Terbit Rencana Perangin Angin. Bagaimana perbudakan muncul di dunia?

via: detikedu  https://t.co/8loIKiAIwk",3,0,0,1,2022-01-27,9,Thursday,4,3,1
1486630319830745095,2022-01-27 09:21:03,"Samsung memamerkan kemampuan system on a chip terbarunya yang bakal dipakai di Galaxy S22, yaitu Exynos 2200. Termasuk kemampuan ray tracingnya. https://t.co/RMu7OB1fOP",6,0,0,0,2022-01-27,9,Thursday,4,6,0
1486629946743308290,2022-01-27 09:19:34,"Dalam melakukan pengawasan terhadap distribusi set top box gratis TV digital kepada rumah tangga miskin, Kementerian Kominfo akan mengandalkan QR Code. https://t.co/OvrFRMNxkS",11,1,2,3,2022-01-27,9,Thursday,4,13,4
1486629409125814275,2022-01-27 09:17:26,"Dua kelompok yang bersitegang hingga mengakibatkan kebakaran di tempat karaoke Double O, Sorong, berjanji tak akan melakukan bentrok lagi. Mereka pun menyerahkan proses hukum ke pihak kepolisian. https://t.co/niyEtOk5Yz",7,0,1,0,2022-01-27,9,Thursday,4,8,0
1486627751276605442,2022-01-27 09:10:50,"Sungguh berat perjuangan Nurhayati, seorang ibu dengan anak hidrosefalus bernama Vivi (2). Vivi pernah terhenti napasnya, bahkan kejang-kejang. Pengobatannya terhenti karena keterbatasan biaya.

Ayo bantu Vivi dengan donasi di @berbuatbaik_id atau link https://t.co/84N0e7dASS. https://t.co/nbN41QP6V9",10,0,4,0,2022-01-27,9,Thursday,4,14,0
1486627388884766724,2022-01-27 09:09:24,"Meski memiliki banyak individu hebat dan kompeten, indeks inovasi riset Indonesia makin merosot setiap tahunnya sejak 2016. Inikah penyebabnya? https://t.co/eI7ck20q2v",4,0,0,1,2022-01-27,9,Thursday,4,4,1
1486626885127872517,2022-01-27 09:07:24,"Gegara Omicron, RI kembali diterpa lonjakan kasus COVID-19. Menular cepat dengan gejala seringan flu biasa, akankah Omicron memicu gelombang seperti di 2021? https://t.co/w5JXI2XlII",7,2,0,1,2022-01-27,9,Thursday,4,7,3
1486626284172152832,2022-01-27 09:05:00,Yusril Ihza Mahendra bicara soal kabar dirinya memiliki lahan di IKN. Dia membantah kabar dirinya memiliki lahan 160 hektare di kawasan IKN. https://t.co/RFKElunxdb,5,0,1,0,2022-01-27,9,Thursday,4,6,0
1486626064415744000,2022-01-27 09:04:08,"AHY mengatakan, rompi militer tersebut berisi pemberat besi di dalamnya. Tujuannya agar lebih membakar kalori saat dia sedang berlari. https://t.co/3Rk2qCps4o",111,46,16,11,2022-01-27,9,Thursday,4,127,57
1486625986925969412,2022-01-27 09:03:50,Titi Kamal tampak mengunggah foto jadulnya di media sosial. Foto unggahan Titi Kamal itu pun langsung menyita perhatian. #TitiKamal  https://t.co/YtYlqmynPE,3,0,0,0,2022-01-27,9,Thursday,4,3,0
1486625254386581504,2022-01-27 09:00:55,"Tahun 2022 menjadi tahun keberuntungan bagi pemilik Shio Kuda. Namun, ada pula hal negatif yang mungkin terjadi. Simak prediksinya di sini, yuk. #detikNetwork  https://t.co/NZBs1wx5hg",1,0,0,0,2022-01-27,9,Thursday,4,1,0
1486624565757456384,2022-01-27 08:58:11,Toyota Motor Corp mengumumkan akan memangkas produksi mereka di Jepang hingga 65.000 unit. Karena meningkatnya kasus penularan COVID-19 di kalangan pekerja yang membuat pasokan suku cadang terhambat. https://t.co/ZWO6ZhLKJs,2,1,0,0,2022-01-27,8,Thursday,4,2,1
1486624322059968512,2022-01-27 08:57:13,"Suporter meminta Wali Kota Medan Bobby Nasution agar mengembalikan kejayaan PSMS Medan. Suporter PSMS menilai, performa manajemen saat ini cukup mengecewakan. https://t.co/eKIndlNxYL",11,5,1,6,2022-01-27,8,Thursday,4,12,11
1486624301893754885,2022-01-27 08:57:08,Semua stakeholder penerbangan nasional diharapkan dapat menjiwai dan menjalankan semangat perjanjian tersebut untuk perkembangan dunia penerbangan nasional.  https://t.co/owFhOu09JF,1,0,1,0,2022-01-27,8,Thursday,4,2,0
1486624078178009094,2022-01-27 08:56:15,"Brasil tanpa Neymar pada laga Kualifikasi Piala Dunia 2022 akhir bulan ini. Namun, tidak usah khawatir karena Philippe Coutinho sudah kembali beraksi! https://t.co/8F4Jn5UhdK",5,0,0,0,2022-01-27,8,Thursday,4,5,0
1486623582771949569,2022-01-27 08:54:16,Manga Shojo atau komik bagi pembaca perempuan tak kalah populer ketimbang shonen. Ini deretan komikus shojo terbaik dari dekade 2000:  https://t.co/d8nvHAHI1B,6,0,1,1,2022-01-27,8,Thursday,4,7,1
1486623313464115200,2022-01-27 08:53:12,"Di Mojokerto ada hidangan nasi plus lauk pauk lengkap bernama sego jamu. Selain enak dan murah, kuliner ini diyakini kaya khasiat.  https://t.co/gxsC7mFQsQ",3,0,0,0,2022-01-27,8,Thursday,4,3,0
1486622811338817537,2022-01-27 08:51:12,Jokowi akan menerbitkan Peraturan Presiden (Perpres) untuk memindahkan pegawai negeri sipil (PNS) ke ibu kota negara (IKN) di Kalimantan Timur.  https://t.co/SiVT0yD4X8,17,0,1,5,2022-01-27,8,Thursday,4,18,5
1486622792384716802,2022-01-27 08:51:08,"Perayaan Imlek harus berlangsung meriah dengan menyajikan aneka kue khas Imlek. Seperti kue keranjang, kue ku, hingga wajik yang melambangkan keberuntungan.  https://t.co/hI5EFi5Q0g",2,0,0,0,2022-01-27,8,Thursday,4,2,0
1486622505431351298,2022-01-27 08:50:00,KSAL Laksamana Yudo Margono mengatakan pihaknya mengajukan 22 KRI untuk dihapus. Ini alasannya. https://t.co/Wi8uvSBWI5,5,0,1,0,2022-01-27,8,Thursday,4,6,0
1486622484980027392,2022-01-27 08:49:55,Happy Salma meluncurkan buku anak berjudul Cerita Kina yang diilustrasikan oleh Heavenly Poetrysanny tentang pengalaman putrinya.  https://t.co/7EwAsJ3Is0,3,0,0,0,2022-01-27,8,Thursday,4,3,0
1486622228749893633,2022-01-27 08:48:54,"""Kami sudah mulai kerja sama dengan Thailand dan Malaysia. Kemungkinan juga nanti dengan Singapura dan Saudi,"" kata Gubernur BI Perry Warjiyo.  https://t.co/ybaUcJyMzQ",4,0,0,0,2022-01-27,8,Thursday,4,4,0
1486621958393499651,2022-01-27 08:47:49,"Khaby Lame menjadi viral di TikTok karena memposting video dirinya bereaksi terhadap klip ""life-hack"" yang dibagikan orang lain. Berapa sih jumlah hartanya? #khabylame   https://t.co/iiOtVjXbn8",13,1,3,0,2022-01-27,8,Thursday,4,16,1
1486621947555467265,2022-01-27 08:47:47,Pakar epidemiologi menilai Omicron BA.2 yang disebut sulit terdeteksi ada potensi mendominasi di dunia. Se-mengkhawatirkan apa varian ini? https://t.co/o2D3iQSpir,3,1,6,5,2022-01-27,8,Thursday,4,9,6
1486621728679903232,2022-01-27 08:46:54,"Tanpa basa-basi, Marcello Tahitoe datang dengan kabar bahagia. Ia menikahi kekasihnya, Cindy Maria, di Bali pada Selasa (25/1/2022). https://t.co/r4klXZUecm",6,0,1,0,2022-01-27,8,Thursday,4,7,0
1486621711806124034,2022-01-27 08:46:50,"Di luar lapangan hijau, ada yang menarik dari industri otomotif. Ternyata Timor Leste merupakan salah satu negara yang menjadi penikmat mobil buatan Indonesia. https://t.co/G6aKk1d7Bx",5,0,1,1,2022-01-27,8,Thursday,4,6,1
1486620668879900672,2022-01-27 08:42:42,"Jaksa mendakwa sopir mendiang Vanessa, Tubagus Joddy (24) dengan pasal berlapis. Pemuda kelahiran 16 April 1997 itu didakwa dengan 4 pasal sekaligus. https://t.co/HSalktANRh",8,0,2,0,2022-01-27,8,Thursday,4,10,0
1486620362821582848,2022-01-27 08:41:29,"Salju menuruni Yerussalem. Akibatnya, jalan ditutup, transportasi kota dihentikan!  https://t.co/2CbHqLBAKN",20,3,1,0,2022-01-27,8,Thursday,4,21,3
1486620328306659328,2022-01-27 08:41:20,"Perbedaan malam dan siang di tiap negara melahirkan rentang puasa Ramadhan yang berbeda-beda. Bahkan, ada sejumlah negara yang berpuasa selama 20 jam.

via: detikedu  https://t.co/LMlN2Lq1eQ",6,0,2,1,2022-01-27,8,Thursday,4,8,1
1486620312355713026,2022-01-27 08:41:17,"Xavi Hernandez belum berhenti memanggil rekan-rekannya dulu untuk kembali gabung ke Barcelona. Selanjutnya, Iniesta diminta Xavi untuk pulang! https://t.co/9cBL9OEYHo",1,0,1,0,2022-01-27,8,Thursday,4,2,0
1486620039092613123,2022-01-27 08:40:12,Bank sentral Amerika (AS) The Federal Reserve akan menaikkan suku bunga acuan. Selain itu bank sentral juga akan mengakhiri pembelian aset pada Maret.  https://t.co/koqQJ6tnuy,2,0,0,0,2022-01-27,8,Thursday,4,2,0
1486619780085862403,2022-01-27 08:39:10,"Merasa jago cuap-cuap di depan kamera? Atau andal dalam me-review tempat makan, gadget hingga barang-barang unik? detikcom lagi cari host. Ayo ikutan d'Videocaster Hunt 2022! https://t.co/gVJs4oAz8j",5,0,2,0,2022-01-27,8,Thursday,4,7,0
1486619760506851330,2022-01-27 08:39:05,"Banyak misteri di luar angkasa yang belum teridentifikasi oleh ilmu pengetahuan. Terbaru, astronom menemukan obyek misterius yang belum pernah ditemukan. https://t.co/uZxopuSdbN",7,1,3,2,2022-01-27,8,Thursday,4,10,3
1486619508114706436,2022-01-27 08:38:05,Olike kembali menghadirkan speaker anyarnya ke Indonesia. Tidak tanggung-tanggung ada lima model yang diboyong dan semuanya dibanderol murah. Ini daftarnya:  https://t.co/T79rrAiktw,3,0,0,0,2022-01-27,8,Thursday,4,3,0
1486618862506450948,2022-01-27 08:35:31,"Dinar Candy mengutarakan bela sungkawa atas tragedi pembakaran Double O Club, Sorong. Dinar Candy seharusnya tampil saat valentine 2022. #DinarCandy  https://t.co/zzjO7reDoE",5,0,0,0,2022-01-27,8,Thursday,4,5,0
1486618576790380545,2022-01-27 08:34:23,"China menang dalam sengketa dagang melawan Amerika Serikat di Organisasi Perdagangan Dunia (World Trade Organization/WTO), dan hasilnya...  https://t.co/SbHqqcDgK8",4,0,1,0,2022-01-27,8,Thursday,4,5,0
1486618278722166784,2022-01-27 08:33:12,Menteri Kelautan dan Perikanan Sakti Wahyu Trenggono mengajak anak-anak makan ikan biar pintar.  https://t.co/iZi2uDIDfq,6,3,0,1,2022-01-27,8,Thursday,4,6,4
1486617503082205192,2022-01-27 08:30:07,"Sebagian dari kita mungkin memiliki cita-cita untuk bekerja sebagai seorang polisi. Nah bagi kamu yang berminat, cek informasi penerimaan Polri berikut ini.  https://t.co/0fUiVcB89f",1,0,2,0,2022-01-27,8,Thursday,4,3,0
1486617486594387968,2022-01-27 08:30:03,Ulah hacker yang menyusup di sesi video conference atau Zoombombing terjadi lagi. Kali ini di saat webinar Riset Pengembangan Vaksin COVID-19 yang digelar BRIN.  https://t.co/I1Yx2Rrkg4,271,82,100,67,2022-01-27,8,Thursday,4,371,149
1486617221694693380,2022-01-27 08:29:00,"Setelah ramai-ramai soal Lee Zii Jia, Asosiasi Bulutangkis Malaysia (BAM) kembali diterpa keriuhan kabar mendepak tiga pelatihnya, termasuk asal Indonesia. https://t.co/6kTu4Kbbb8",0,1,1,0,2022-01-27,8,Thursday,4,1,1
1486616446256009216,2022-01-27 08:25:55,"Badai musim dingin melintasi Istanbul, hujan salju lebat menutupi kota dan Bandara Istanbul. Bandara tersibuk di Eropa ini pun sempat ditutup.  https://t.co/B81bWzapPA",5,0,1,0,2022-01-27,8,Thursday,4,6,0
1486615921355599872,2022-01-27 08:23:50,Range Rover tidak mau ketinggalan dalam persaingan mobil ramah lingkungan. Bisa tebak harganya berapa? https://t.co/CvBQ6i3vjW,15,3,0,0,2022-01-27,8,Thursday,4,15,3
1486615901893967872,2022-01-27 08:23:45,Menambah kamera atau webcam eksternal di perangkat gadget bisa dilakukan dengan mudah untuk menghasilkan tampilan yang maksimal. Ini keunggulannya:   https://t.co/2B3snUQ9bp,2,0,0,0,2022-01-27,8,Thursday,4,2,0
1486615634448424961,2022-01-27 08:22:41,"Meski sudah uzur, bek tengah itu rupanya menjelma jadi prajurit tangguh mengawal lini pertahanan Chelsea! https://t.co/uKrUpDnnCO",11,0,1,0,2022-01-27,8,Thursday,4,12,0
1486615368344944646,2022-01-27 08:21:38,Ekonom Senior Faisal Basri menyampaikan kritikan pedas kepada pemerintah yang ingin buru-buru memindahkan Ibu Kota Negara (IKN) ke Kalimantan.  https://t.co/7JDJR75bTm,6,4,2,1,2022-01-27,8,Thursday,4,8,5
1486615355220967426,2022-01-27 08:21:35,"Ekonom Senior, Faisal Basri mengkritik soal pembangunan ibu kota negara (IKN) baru. Pasalnya, pandemi Covid-19 belum berlalu dan utang RI masih tinggi. https://t.co/Zko5gxeMJB",6,1,1,1,2022-01-27,8,Thursday,4,7,2
1486614993705607168,2022-01-27 08:20:09,"DJ Indah Cleo ditemukan tewas dalam kondisi memilukan. Polisi menemukan jenazah sang disk jockey di dalam kelab Double O Sorong, Papua, Selasa, (25/1/2022). https://t.co/kxM2Jdm2uN",8,1,0,0,2022-01-27,8,Thursday,4,8,1
1486614992438935552,2022-01-27 08:20:08,"Pelaksanaan SEA Games yang berlangsung di Hanoi, 12-23 Mei dan akan menerapkan sistem bubble yang terbagi dalam enam klaster. https://t.co/pYDlI5mRyL",3,0,0,0,2022-01-27,8,Thursday,4,3,0
1486614723907006465,2022-01-27 08:19:04,"Nekat berbonceng tiga, seorang pelajar tewas kecelakaan di Jalan Raya Timur, Tasikmalaya, Jawa Barat. Diketahui motor pelajar tersebut bertabrakan dengan truk yang datang dari arah berlawanan. https://t.co/zAffZtYHYB",4,1,2,1,2022-01-27,8,Thursday,4,6,2
1486614706722852867,2022-01-27 08:19:00,Kecelakaan beruntun melibatkan 2 truk dan 2 sepeda motor di Jombang. Kecelakaan ini mengakibatkan 1 korban luka berat dan 5 korban luka ringan. https://t.co/goYbay5fZt,1,0,0,0,2022-01-27,8,Thursday,4,1,0
1486614469513990148,2022-01-27 08:18:04,"Anggaran kementerian dan lembaga (K/L) sebesar Rp 39,7 triliun diblokir. Alasannya untuk menggantikan kebijakan refocusing atau pemangkasan anggaran.  https://t.co/dt537Phikm",1,0,1,1,2022-01-27,8,Thursday,4,2,1
1486614451637956612,2022-01-27 08:17:59,"Punya cara unik menyantap sashimi, netizen ini temukan fungsi sup miso. Menurutnya sup miso yang disajikan bisa untuk 'merebus' ikan mentah hingga matang.  https://t.co/4yphJl47ZS",0,0,0,0,2022-01-27,8,Thursday,4,0,0
1486614232448008194,2022-01-27 08:17:07,"Omicron di Indonesia nyaris menyentuh dua ribu kasus hingga hari ini Kamis (27/1/2022). Ada 1.998 orang yang terpapar Omicron, 606 di antaranya transmisi lokal. https://t.co/o9rapw9K9G",7,3,7,1,2022-01-27,8,Thursday,4,14,4
1486614214588481539,2022-01-27 08:17:03,"Kekayaan miliarder rokok elektrik atau vape asal China, Chu Lam Yiu anjlok lebih dari 65%. Ternyata ini penyebabnya!  https://t.co/rnEPVsj9mk",3,1,3,0,2022-01-27,8,Thursday,4,6,1
1486613692309544960,2022-01-27 08:14:58,Shandy Aulia memenuhi panggilan polisi soal tuduhan pencemaran nama baik yang dilaporkan Laura Aprilya Bakkara. Shandy juga menyerahkan bukti ke penyidik. https://t.co/6Vfu79iKNz,1,0,0,0,2022-01-27,8,Thursday,4,1,0
1486613460548993024,2022-01-27 08:14:03,"Romelu Lukaku mengaku kesulitan di Chelsea, karena tak dimainkan di posisi favoritnya oleh Thomas Tuchel. Kini hal serupa diungkap Christian Pulisic. https://t.co/uDTumOfFE6",4,0,0,1,2022-01-27,8,Thursday,4,4,1
1486613440869416965,2022-01-27 08:13:58,Mortal Kombat 2 sedang dalam tahap pengembangan awal. Naskahnya ditulis oleh Jeremy Slater. https://t.co/IMdlg7bRne,5,0,1,0,2022-01-27,8,Thursday,4,6,0
1486613179744595972,2022-01-27 08:12:56,"Memperingati 3 dekade perilisan album Swami I dan II, Iwan Fals bersama Musica Studio resmi merilis lagi dengan konsep piringan hitam. #IwanFals  https://t.co/ftRPI2bkOv",4,1,2,0,2022-01-27,8,Thursday,4,6,1
1486612921828446212,2022-01-27 08:11:55,Kantor Google dan beberapa perusahaan teknologi memang menyenangkan karena fasilitasnya berlimpah. Namun perancangnya malah menyesal dengan kondisi itu. Lho kenapa?  https://t.co/4xcKs8uO8E,2,0,0,0,2022-01-27,8,Thursday,4,2,0
1486612903717392387,2022-01-27 08:11:50,"""Tolong tulis di media ya, kalau bisa sekarang nggak perlu lagi lewat negara orang, langsung saja ke Indonesia. Sekarang nggak ada lagi pungli kok,"" papar Menteri Investasi Bahlil Lahadalia.  https://t.co/V6fMVo5vZS",1,3,0,4,2022-01-27,8,Thursday,4,1,7
1486612565610405889,2022-01-27 08:10:30,"Bandara Sentani merupakan pintu gerbang udara utama Papua. Sejarahnya, bandara ini dibuat oleh Jepang, kemudian direbut Amerika Serikat, lalu dikuasai Belanda.  https://t.co/NRsnsgNQAi",3,0,2,0,2022-01-27,8,Thursday,4,5,0
1486612547797196803,2022-01-27 08:10:25,"Menjadi jajanan khas di pasar dan penjual kaki lima India, panipuri banyak penggemarnya. Tampil beda dengan topping keju, penjual panipuri ini justru dihujat.  https://t.co/OTwK2L5B2U",1,0,0,0,2022-01-27,8,Thursday,4,1,0
1486612322219184137,2022-01-27 08:09:32,Ekonom Senior Faisal Basri mengatakan ada pembisik Presiden Joko Widodo di balik proyek ibu kota baru.  https://t.co/MYprfjcE2S,6,12,5,0,2022-01-27,8,Thursday,4,11,12
1486612303420211209,2022-01-27 08:09:27,"Ponsel layar lipat Google kabarnya akan dilepas dengan harga yang lebih murah dari Galaxy Z Fold 3. Kini prediksi harganya sudah terungkap, sekitar Rp 20 juta. Minat beli?  https://t.co/xpLghjZsq6",2,3,0,0,2022-01-27,8,Thursday,4,2,3
1486611779052613632,2022-01-27 08:07:22,"Sarung tangan dari Bellissimo Apparel, dipilih oleh Presiden Jokowi, membuat produsen apparel dan bengkel dari Tangerang Selatan ini kebanjiran pesanan! https://t.co/TRWMikgD6p",6,0,0,0,2022-01-27,8,Thursday,4,6,0
1486611752192249856,2022-01-27 08:07:16,KPK angkat bicara mengenai kemungkinan jeratan pidana bagi Siwi Widi Purwanti. Begini penjelasannya. https://t.co/PDous7pLFv,1,3,1,0,2022-01-27,8,Thursday,4,2,3
1486611500253028355,2022-01-27 08:06:16,Manchester City memang bernafsu untuk menjuarai Liga Champions musim ini. Tapi... https://t.co/PfuyGMdg0z,3,0,0,0,2022-01-27,8,Thursday,4,3,0
1486611262813446150,2022-01-27 08:05:19,"DJ Indah Cleo menjadi salah satu korban tewas akibat bentrokan maut di Sorong, Papua Barat beberapa waktu lalu. Berikut fakta-faktanya:  https://t.co/G9vhLE1izQ",6,1,4,3,2022-01-27,8,Thursday,4,10,4
1486611253787254786,2022-01-27 08:05:17,"Dalam perjalanannya, KPK kerap digugat praperadilan oleh para tersangka yang berargumen soal OTT. Begini kisahnya.... https://t.co/tVFx9strCp",1,1,0,0,2022-01-27,8,Thursday,4,1,1
1486610368214491141,2022-01-27 08:01:46,Punya nama yang unik bahkan sedikit nyeleneh. Beberapa tempat makan ini terkenal sebagai jagoan kuliner enak yang selalu diburu banyak orang.  https://t.co/bKK8XzPgNw,7,1,4,2,2022-01-27,8,Thursday,4,11,3
1486610357036765184,2022-01-27 08:01:43,"Perusahaan induk dari platform media sosial Facebook dan Instagram, Meta, kabarnya akan ikut terjun ke dunia NFT!  https://t.co/WTSYuoAKTS",4,0,1,1,2022-01-27,8,Thursday,4,5,1
1486609941939068930,2022-01-27 08:00:04,Satgas Waspada Investasi (SWI) secara tegas menyatakan bahwa afiliator dari broker binary option seperti Binomo melanggar peraturan perundang-undangan!  https://t.co/BKF3Rfjh1r,11,5,7,3,2022-01-27,8,Thursday,4,18,8
1486609743267471361,2022-01-27 07:59:17,Menteri Keuangan Sri Mulyani Indrawati mulai mewaspadai tingginya kasus COVID-19 varian Omicron di Tanah Air.  https://t.co/DtsmvKniyD,9,1,1,2,2022-01-27,7,Thursday,4,10,3
1486608986707275777,2022-01-27 07:56:16,"Harga emas spot turun 0,3% menjadi US$1,813,89 per ounce setelah sebelumnya sempat turun sebanyak 0,4%. Perak, platinum, dan paladium semuanya jatuh.  https://t.co/yOoUTFI9mX",6,0,1,1,2022-01-27,7,Thursday,4,7,1
1486608521948979201,2022-01-27 07:54:26,Olahan otak kambing termasuk ekstrem untuk sebagian orang Indonesia. Bule asal Amerika ini penasaran untuk mencobanya. Ia malah mual karena rasanya yang aneh!  https://t.co/760uj3roS0,1,0,0,0,2022-01-27,7,Thursday,4,1,0
1486608496057622528,2022-01-27 07:54:19,Timnas Indonesia akan menghadapi Timor Leste dalam laga uji coba hari ini. Berikut link live streaming pertandingan tersebut. https://t.co/xgz5nFNw9G,5,1,0,0,2022-01-27,7,Thursday,4,5,1
1486607985514356738,2022-01-27 07:52:18,Realisasi investasi tahun 2021 mencapai target selama setahun penuh.  https://t.co/9pHnAesG5B,3,0,0,0,2022-01-27,7,Thursday,4,3,0
1486607970045673472,2022-01-27 07:52:14,"Pelatih sepakbola, yang sempat melatih Werder Bremen, tersandung kasus sertifikat vaksinasi COVID-19. Ia memalsukan statusnya, yang ternyata belum divaksinasi. https://t.co/3sajqxgoF1",6,0,0,1,2022-01-27,7,Thursday,4,6,1
1486607402757771264,2022-01-27 07:49:59,"Para peneliti melaporkan, seekor kelinci Arktik mencetak rekor perjalanan terpanjang dalam sejarah. Kelinci tersebut berjalan hingga 388 km. 

via: detikedu https://t.co/C1TuLRaMhY",19,1,8,0,2022-01-27,7,Thursday,4,27,1
1486607082761633793,2022-01-27 07:48:43,Bank Indonesia (BI) akan memberikan insentif bagi perbankan yang menyalurkan kredit atau pembiayaan kepada sektor prioritas.  https://t.co/bOJTkL6iOc,5,0,0,1,2022-01-27,7,Thursday,4,5,1
1486606431956656128,2022-01-27 07:46:07,"XL Axiata memperluas jangkauan jaringan layanan 4G di 132 titik Terdepan, Terluar, dan Tertinggal di wilayah Sumatera. Ini lokasinya:  https://t.co/32q8d4K4ZV",9,0,0,0,2022-01-27,7,Thursday,4,9,0
1486606404928614405,2022-01-27 07:46:01,Kim Chae Hyun dan Seo Young Eun Kep1er dinyatakan positif COVID-19. Hal itu disampaikan oleh manajemen. https://t.co/FWB10omBFz,3,0,0,0,2022-01-27,7,Thursday,4,3,0
1486606069476610054,2022-01-27 07:44:41,Spaghetti bolognese merupakan sajian pasta klasik yang populer. Memakai saus daging cincang dengan paduan saus dan pasta tomat yang asam segar.  https://t.co/YWkm0cLdaM,2,0,1,0,2022-01-27,7,Thursday,4,3,0
1486605576423489538,2022-01-27 07:42:43,PT Pupuk Kalimantan Timur (Pupuk Kaltim/PKT) memastikan kesiapan stok pupuk subsidi bagi petani di seluruh wilayah tanggung jawab distribusi perusahaan cukup.  https://t.co/M2Jd0CUrbs,4,1,0,1,2022-01-27,7,Thursday,4,4,2
1486605564872384512,2022-01-27 07:42:41,"DJ Indah Cleo menjadi salah satu korban akibat bentrokan maut di Sorong, Papua Barat pada Selasa (25/1). 17 karyawan serta tamu tewas mengenaskan usai kelab malam Double O Sorong dibakar. https://t.co/j5WYCfAMQ8",5,1,1,0,2022-01-27,7,Thursday,4,6,1
1486605344386203653,2022-01-27 07:41:48,Timnas Indonesia akan melakoni dua laga uji coba lawan Timor Leste di FIFA Matchday kali ini. Nanti malam akan menjadi duel pertama! https://t.co/6Rcz92qQtQ,6,1,0,0,2022-01-27,7,Thursday,4,6,1
1486605310324363268,2022-01-27 07:41:40,"Sejumlah pengurus harian DPC dan PAC PPP Kabupaten Banjarnegara, Jawa Tengah ramai-ramai mengundurkan diri gegara SK kepengurusan yang baru. https://t.co/BzYFSWn1wa",4,2,1,0,2022-01-27,7,Thursday,4,5,2
1486605049652551681,2022-01-27 07:40:38,Industri baja di Indonesia disebut akan sulit berkembang jika tak mendapat dukungan pasokan bahan baku baja impor.  https://t.co/ciNqe7JvWP,4,1,1,0,2022-01-27,7,Thursday,4,5,1
1486604814255636487,2022-01-27 07:39:42,"Viral video seorang pejalan kaki mengeluhkan akses ke Stasiun Sawah Besar, Jakarta Pusat, yang rusak parah. PT KAI memberikan penjelasan bahwa jalan tersebut bukan akses bagi pejalan kaki ke stasiun. https://t.co/IdXHfKLhFL",6,0,1,0,2022-01-27,7,Thursday,4,7,0
1486603615989116929,2022-01-27 07:34:56,"Broker atau pialang binary option kembali bikin heboh. Setelah berkali-kali dicap bodong, muncul lagi member yang teriak merasa dirugikan oleh Binomo cs.  https://t.co/Oinj8cHup7",6,3,2,2,2022-01-27,7,Thursday,4,8,5
1486603471402975235,2022-01-27 07:34:21,"Bintang Meteor Garden, Ann Yeh An Tin mengumumkan pernikahan. Ia menikah dengan Tony, pengusaha kaya raya dari Shanghai. https://t.co/wFxd4z7Y2v",6,1,1,1,2022-01-27,7,Thursday,4,7,2
1486602895126634501,2022-01-27 07:32:04,"Kota Surabaya menjadi gudangnya kuliner enak dan merakyat. Di sini, makanan rasa bintang lima bisa dinikmati dengan harga kaki lima. Dobel nikmatnya! https://t.co/TUkXoDHDUb",9,1,2,2,2022-01-27,7,Thursday,4,11,3
1486602528947122176,2022-01-27 07:30:37,"Bergabung ke Sevilla, Anthony Martial akan berteman dengan Erik Lamela yang dulu gontok-gontokkan di laga MU vs Spurs! https://t.co/4NucE7HUm9",5,0,0,0,2022-01-27,7,Thursday,4,5,0
1486602275342667781,2022-01-27 07:29:36,"Warga mulai sulit cari RS, bagaimana ketersediaan tempat tidur ruang isolasi di RS rujukan COVID di DKI? https://t.co/MMtIS11MJp",8,0,0,0,2022-01-27,7,Thursday,4,8,0
1486602025035091968,2022-01-27 07:28:37,Kementerian Kominfo memaparkan mekanisme distribusi set top box gratis TV digital kepada masyarakat tidak mampu atau rumah tangga miskin. https://t.co/sopXLPd0QK,8,1,3,0,2022-01-27,7,Thursday,4,11,1
1486601768163332096,2022-01-27 07:27:35,"Zyrex akan menyediakan perangkat seperti komputer, server, kiosk system, dan perangkat IoT, juga mengintegrasikannya ke sistem Diagnos yang saat ini sudah ada. https://t.co/lxLvCU1z0z",3,0,1,0,2022-01-27,7,Thursday,4,4,0
1486601250594508803,2022-01-27 07:25:32,Menteri Keuangan Sri Mulyani Indrawati mewaspadai kondisi geopolitik yang memanas belakangan ini yaitu antara Rusia dan Ukraina.  https://t.co/J303kV96oN,45,0,12,1,2022-01-27,7,Thursday,4,57,1
1486601249357275136,2022-01-27 07:25:32,Sebanyak 17 korban kebakaran di tempat karaoke Sorong telah diketahui identitasnya. Hari ini tim DVI Polri juga mulai melakukan identifikasi terhadap 17 korban tersebut. https://t.co/cRxHDk8MPV,3,0,1,0,2022-01-27,7,Thursday,4,4,0
1486600450581405697,2022-01-27 07:22:21,"Sebanyak 1.273 peneliti Indonesia masuk daftar ilmuwan terbaik dunia World Top 100 Scientists 2022 AD Scientific Index 2022. Berikut 25 penelitinya.

via: detikedu  https://t.co/fq6q33hiDi",11,0,5,0,2022-01-27,7,Thursday,4,16,0
1486600168128630784,2022-01-27 07:21:14,Erling Haaland menyebut nama tiga pesepakbola terbaik di dunia pada saat ini dan tidak ada nama Cristiano Ronaldo. https://t.co/DbfYUa5u1m,2,0,0,0,2022-01-27,7,Thursday,4,2,0
1486599682289766401,2022-01-27 07:19:18,Luna Maya dipasangkan dengan Tora Sudiro dalam serial terbaru Turut Berduka Cita. Begini kesan keduanya saat dijadikan suami-istri:  https://t.co/C9QCzoxTUQ,8,0,1,0,2022-01-27,7,Thursday,4,9,0
1486599665348976641,2022-01-27 07:19:14,"Tak cuma motor dengan knalpot brong, polisi juga mengincar mobil yang pakai knalpot bising. https://t.co/6XkCXGEmzR",9,0,2,2,2022-01-27,7,Thursday,4,11,2
1486599159906017280,2022-01-27 07:17:14,Ramalan zodiak cinta Aries saat ini cobalah untuk mendengar setiap saran ataupun kritikannya. Simak ramalan zodiak cinta hari ini: https://t.co/Pc4ri50tAN,1,0,2,0,2022-01-27,7,Thursday,4,3,0
1486599142847754240,2022-01-27 07:17:09,Ariel Tatum jadi istri Nicholas Saputra dalam proyek terbarunya yakni Sayap Sayap Patah. Ia ngaku deg-degan kala tampil perdana bersama sang aktor. https://t.co/jVDcCnLasP,24,5,4,1,2022-01-27,7,Thursday,4,28,6
1486598645483020288,2022-01-27 07:15:11,Apple AirPods jadi earphone true wireless stereo yang paling populer di dunia dan dilaporkan Apple mengajukan fitur untuk peredam bising. https://t.co/msyRu7OMxc,3,0,3,0,2022-01-27,7,Thursday,4,6,0
1486598399952666626,2022-01-27 07:14:12,Stok perangkat semikonduktor alias chip terus berkurang. Kekurangan tersebut telah mengakibatkan gangguan besar bagi industri-industri besar.  https://t.co/yei6Sk4Npu,1,0,4,1,2022-01-27,7,Thursday,4,5,1
1486597600392454144,2022-01-27 07:11:02,"Sedikitnya tiga perusahaan farmasi asal AS hingga China bakal merilis vaksin khusus melawan Omicron. Sinovac hingga Moderna, bakal lebih menjanjikan yang mana? https://t.co/PeoR2PrfqJ",2,3,3,0,2022-01-27,7,Thursday,4,5,3
1486596801578909704,2022-01-27 07:07:51,Riset terbaru menyebut pasien COVID-19 varian Omicron bergejala lebih enteng dibanding pasien Delta. Berkat vaksin atau infeksi natural? Begini paparan CDC: https://t.co/IqLnf8EfeN,2,0,3,0,2022-01-27,7,Thursday,4,5,0
1486596783409176579,2022-01-27 07:07:47,Berbagai macam pemandangan aneh terekam Google Earth yang kadang bikin orang bertanya-tanya. Ini potretnya:  https://t.co/5irbrZMS7n,3,0,3,0,2022-01-27,7,Thursday,4,6,0
1486596515384770561,2022-01-27 07:06:43,Sudah setahun lalu Mitsubishi e-Canter diperkenalkan di Indonesia. Kapan truk listrik ini bisa mulai dipesan? https://t.co/b0HxFNYwX9,9,0,2,0,2022-01-27,7,Thursday,4,11,0
1486595929687875585,2022-01-27 07:04:23,"Xiaomi meresmikan kehadiran jajaran ponsel Redmi Note 11 secara global dalam acara ""Rise to the Challenge"". Ini harga dan spesifikasi Redmi Note 11:  https://t.co/2uwocKiKJs",2,0,1,0,2022-01-27,7,Thursday,4,3,0
1486595915754487811,2022-01-27 07:04:20,"Bagi penggemar game Mobile Legends: Bang Bang yang belum tahu, ada cara ampuh buat kalian jadi streamer handal dan profesional. Sudah daftar belum nih? https://t.co/05lbLxi8CD",2,1,1,0,2022-01-27,7,Thursday,4,3,1
1486595313578262528,2022-01-27 07:01:57,Della Dartyan kembali memerankan karakter lamanya di Arini by Love Inc. Ia ngaku bersyukur dan bisa menjawab pertanyaan netizen soal karakternya itu. https://t.co/wkw5hIXhfu,5,0,1,0,2022-01-27,7,Thursday,4,6,0
1486594972245766151,2022-01-27 07:00:35,Mantan pejabat Ditjen Pajak Wawan Ridwan didakwa menerima suap dan gratifikasi. Jaksa penuntut umum KPK mengakan uang tersebut digunakan untuk membeli sejumlah aset dan diberikan kebanyak pihak. Kemana saja aliran dana tersebut? #detiknetwork  https://t.co/XUwVdE9Idm,18,3,5,6,2022-01-27,7,Thursday,4,23,9
1486594693421047810,2022-01-27 06:59:29,Busi merupakan salah satu komponen penting pada kendaraan bermotor. Kapan waktu yang tepat mengganti komponen ini? https://t.co/txfDrL9rz7,7,0,1,0,2022-01-27,6,Thursday,4,8,0
1486594197687881730,2022-01-27 06:57:30,"Yayasan Anak Bangsa Bisa, GoTo Group mengajak industri teknologi berkolaborasi di program Generasi GIGIH mengembangkan talenta teknologi muda Indonesia. https://t.co/paCGAbnh1R",6,0,0,0,2022-01-27,6,Thursday,4,6,0
1486593952073588737,2022-01-27 06:56:32,MINI membuat proyek resmi yang memungkinkan untuk pemilik MINI tua mengkonversi mobilnya jadi mobil listrik! https://t.co/j7lh5fceEl,8,0,2,1,2022-01-27,6,Thursday,4,10,1
1486593713128235008,2022-01-27 06:55:35,"Dengan meluncurnya kohort ke-6, total 246 founder dari 112 startup yang berasal dari lebih 15 sektor bergabung dengan komunitas Surge. https://t.co/gKKa811748",3,0,0,0,2022-01-27,6,Thursday,4,3,0
1486593119885877250,2022-01-27 06:53:14,Polisi menjelasakan kondisi DJ Indah Cleo saat ditemukan tewas. DJ Indah Cleo jadi korban tewas dalam bentrokan maut di Sorong. https://t.co/ZzyskIRw0n,29,3,3,0,2022-01-27,6,Thursday,4,32,3
1486592490769563654,2022-01-27 06:50:44,Peneliti keamanan di Trend Micro memprediksi pelaku serangan siber pada 2022 akan berfokus pada serangan ransomware ke jaringan server dan layanan terbuka.  https://t.co/9Frn1piuPQ,2,0,2,0,2022-01-27,6,Thursday,4,4,0
1486592194878361605,2022-01-27 06:49:33,"Usia Jose Mourinho baru saja bertambah, bertambah pula masa-masa Mourinho berpuasa meraih trofi! https://t.co/O4BZwxZpsv",12,0,1,2,2022-01-27,6,Thursday,4,13,2
1486592173487398913,2022-01-27 06:49:28,"Creator Battle Tournament, kompetisi esports antar gaming creator dari MainGames Indonesia kembali digelar, kini dengan hadiah total Rp 100 juta. https://t.co/mVZiCWYcOZ",2,0,0,0,2022-01-27,6,Thursday,4,2,0
1486591654232535044,2022-01-27 06:47:24,Vivo V23 5G resmi meluncur pada 25 Januari 2022 dengan membawa fitur menarik. Ini spesifikasi lengkap dan harganya di Indonesia:  https://t.co/TjxiuJ7qb4,6,0,1,1,2022-01-27,6,Thursday,4,7,1
1486591633034465280,2022-01-27 06:47:19,"""Intinya, keluarga sangat terkejut (dengan kejadian itu), karena Indah baru di Papua. Baru dua hari,"" kata Alex Rajes mewakili keluarga DJ Indah. https://t.co/4za1BOPChq",6,0,2,0,2022-01-27,6,Thursday,4,8,0
1486591342440550403,2022-01-27 06:46:10,"Turnamen Mobile Legends wanita terbesar, Mobile Legends: Bang Bang Woman Invitational akan segera digelar. Ini jadwal dan link live streamingnya:  https://t.co/TO2atPLM2O",6,0,1,1,2022-01-27,6,Thursday,4,7,1
1486591320034578434,2022-01-27 06:46:04,Timnas Putri Indonesia akan berhadapan dengan Filipina dalam laga terakhir Grup B Piala Asia Wanita 2022. Laga dimainkan Kamis (27/1) malam ini. https://t.co/062UzeEv3P,12,0,1,0,2022-01-27,6,Thursday,4,13,0
1486590988202172419,2022-01-27 06:44:45,"Produsen sasis-mesin truk dan bus asal Jepang tersebut meresmikan Hino Total Support Training Center (HTSCC), yang merupakan fasilitas pelatihan driver! https://t.co/lr4YUOfi7V",7,0,1,0,2022-01-27,6,Thursday,4,8,0
1486590752578842624,2022-01-27 06:43:49,Arteria Dahlan dilaporkan ke MKD DPR buntut pernyataannya yang mengkritik Kajati menggunakan bahasa Sunda! https://t.co/0aNVJyi9zN,21,3,2,1,2022-01-27,6,Thursday,4,23,4
1486590732110553090,2022-01-27 06:43:44,Momen penalti dari Eric Bailly yang gagal mengantar Pantai Gading ke perempatfinal Piala Afrika 2021. Gayanya meniru Bruno Fernandes? https://t.co/jHDyOYVc0D,3,0,0,0,2022-01-27,6,Thursday,4,3,0
1486590460411920387,2022-01-27 06:42:39,"Susan Wojcicki, CEO Youtube, mengungkapkan tertarik merambah ke NFT. Ini disampaikan bersamaan dengan informasi rencana Youtube ke depan. https://t.co/AJu2RZyxdZ",6,0,1,0,2022-01-27,6,Thursday,4,7,0
1486590436504444933,2022-01-27 06:42:34,Siwi Widi jadi perbincangan usai namanya muncul dalam sidang kasus korupsi Ditjen Pajak. Siwi sempat menjadi buah bibir karena tudingan menjadi 'gundik'. https://t.co/d7s7twLVUk,8,5,3,1,2022-01-27,6,Thursday,4,11,6
1486589697052844033,2022-01-27 06:39:37,"Video sebuah mobil sedang menabrak sejumlah motor dan warga di objek wisata Situ Cisanti, Kabupaten Bandung viral di media sosial. https://t.co/nVkd4MzHFi",6,0,1,0,2022-01-27,6,Thursday,4,7,0
1486589670263865345,2022-01-27 06:39:31,"Menjelang hari pernikahannya, Venna Melinda dan Ferry Irawan tampak menghabiskan waktu bersama di Bali. Ini potret kebersamaan mereka:  https://t.co/SmCXxvAl7a",6,0,1,0,2022-01-27,6,Thursday,4,7,0
1486589066145579015,2022-01-27 06:37:07,"Kita memperoleh apa yang kita inginkan melalui negosiasi. Umumnya dalam teks negosiasi, terdapat struktur yang perlu diikuti agar proses negosiasi berhasil.

via: detikedu  https://t.co/b4NpNWyFmU",5,0,3,0,2022-01-27,6,Thursday,4,8,0
1486588761915936769,2022-01-27 06:35:54,"Ghozali Everyday bertandang ke Kantor Pelayanan Pajak Pratama Semarang Timur. Ia mendaftarkan diri, untuk memperoleh NPWP. https://t.co/lT6MGzaxXT",114,21,10,3,2022-01-27,6,Thursday,4,124,24
1486588274042978306,2022-01-27 06:33:58,Tes kepribadian jadi salah satu cara untuk mengungkapkan karakter dan sifat asli yang kamu miliki. Ikuti tes ini:  https://t.co/IyoexTbU2P,6,0,1,3,2022-01-27,6,Thursday,4,7,3
1486587994802954242,2022-01-27 06:32:52,Detik-detik insiden tabrak lari yang terjadi di Indramayu terekam kamera CCTV. Korbannya seorang wanita yang tengah mengendarai motor. Ngeri! https://t.co/S6k3wlrfnB,4,0,2,0,2022-01-27,6,Thursday,4,6,0
1486587343620431873,2022-01-27 06:30:16,"Vitor Pereira apes betul, baru juga masa penjajakan dengan Everton untuk jadi manajer, Pereira sudah mendapat penolakan keras dari fans The Toffees. Duh! https://t.co/UMPu9OSctp",5,0,1,0,2022-01-27,6,Thursday,4,6,0
1486586861174861827,2022-01-27 06:28:21,Rumah para crazy rich bikin terkesima dengan segala kemewahan dan kemegahannya. Ini potret rumah-rumahnya:  https://t.co/KdvUZzPesQ,5,0,1,0,2022-01-27,6,Thursday,4,6,0
1486586795739525121,2022-01-27 06:28:06,"Polisi merilis daftar 17 orang korban tewas bentrokan di tempat hiburan malam Double O di Sorong, Papua Barat. Ini daftarnya. https://t.co/YZR1vIM1OU",4,0,1,1,2022-01-27,6,Thursday,4,5,1
1486586436476416000,2022-01-27 06:26:40,Para afiliator dari broker binary option tengah menjadi pergunjingan banyak orang. Bahkan analis menyebut afiliator kaya dari trading itu hanya ngibul!  https://t.co/oYVDt5ZZLp,12,1,4,0,2022-01-27,6,Thursday,4,16,1
1486586157777440768,2022-01-27 06:25:34,Sederet sindiran ditulis Kalina Oktarani buat Vicky Prasetyo. Ada tudingan soal selingkuh. Hmm...  https://t.co/wLfzwhKxGf,5,0,1,0,2022-01-27,6,Thursday,4,6,0
1486586138001301504,2022-01-27 06:25:29,"Baru saja memulai bulan di 2022, Stephen King sudah mengumumkan bakal menerbitkan novel fantasi berjudul Fairy Tale pada 6 September 2022. https://t.co/M4LyAwoyqw",2,0,1,0,2022-01-27,6,Thursday,4,3,0
1486585595933642753,2022-01-27 06:23:20,Dokter yang viral disebut menyuntik vaksin kosong di Medan kini membantah dirinya melakukan hal tersebut. Padahal sebelumnya dokter G telah meminta maaf di depan publik. Hal ini diungkapkan oleh kuasa hukumnya. https://t.co/J4eGJP3OXQ,6,0,2,0,2022-01-27,6,Thursday,4,8,0
1486584973717131268,2022-01-27 06:20:51,"Mahasiswa keamanan siber diganjar hadiah oleh Apple berupa uang tunai senilai Rp 1,4 miliar karena berhasil menemukan kerentanan pada webcam di Mac. https://t.co/JeC9ejLrML",24,1,7,0,2022-01-27,6,Thursday,4,31,1
1486584672750551043,2022-01-27 06:19:40,"Setelah kehilangan pekerjaan karena pandemi, ia malah menemukan bisnis baru yang tak hanya 'cuan' tapi hanya perlu kerja dua jam sehari. Ini profesinya:  https://t.co/RdUkBu15Iv",11,1,1,0,2022-01-27,6,Thursday,4,12,1
1486583773009526788,2022-01-27 06:16:05,"Mengawali 2022, Samsung mengerahkan Galaxy A03 Core untuk pasar smartphone entry-level. Ini reviewnya dari detikINET:  https://t.co/fg0ysKCT3p",8,0,2,0,2022-01-27,6,Thursday,4,10,0
1486583241565949958,2022-01-27 06:13:58,"Vaksin booster kini sudah banyak tersedia untuk warga Surabaya. Booster yang tersedia yakni AstraZeneca dan Moderna. Jadi buruan vaksin, cak dan ning! https://t.co/ixO17DAJsm",4,0,2,0,2022-01-27,6,Thursday,4,6,0
1486583221793996804,2022-01-27 06:13:54,Ruben Dias mengungkap bagaimana rasanya dilatih Pep Guardiola. ia mengaku tak pernah bisa relaks sebab dituntut selalu konsisten! https://t.co/eEzM7fzogl,3,0,0,0,2022-01-27,6,Thursday,4,3,0
1486582689276870662,2022-01-27 06:11:47,Musisi Ello menikahi kekasihnya Cindy Maria di Pulau Dewata. Ini sosok Cindy Maria:  https://t.co/nectLbsoh2,3,1,1,0,2022-01-27,6,Thursday,4,4,1
1486582672403189762,2022-01-27 06:11:43,"Eks Menteri PPN Adrinof Chaniago, menjawab tudingan ekonom Faisal Basri terkait adanya pembagian jatah konsesi di pembangunan ibu kota baru. Menurut Adrinof, rencana jangka panjang tidak bisa dibenturkan dengan persoalan jangka pendek. https://t.co/envJypTa2o",3,0,2,0,2022-01-27,6,Thursday,4,5,0
1486582370002251776,2022-01-27 06:10:31,Komnas HAM melihat langsung kerangkeng di rumah Bupati Langkat nonaktif dan mendapat informasi soal warga dikerangkeng lalu dipekerjakan tanpa gaji. https://t.co/BiRCLgLcEq,6,2,3,0,2022-01-27,6,Thursday,4,9,2
1486582127353384961,2022-01-27 06:09:33,"Masyarakat mampu diimbau segera membeli Set Top Box. Ajakan ini agar TV analog dapat menerima siaran TV digital, ketika digitalisasi penyiaran dilakukan. https://t.co/NcsArlCghB",17,10,3,1,2022-01-27,6,Thursday,4,20,11
1486581843877109760,2022-01-27 06:08:25,"Selama bertahun-tahun lamanya, semesta DC hanya mengenalkan satu karakter Robin yang jadi sahabat dari Batman.  https://t.co/UF1oT6kNRt",4,1,1,0,2022-01-27,6,Thursday,4,5,1
1486581820145733635,2022-01-27 06:08:19,"Maura Magnalia, diungkapkan Nurul Arifin dan Mayong Suryo Laksono sempat alami stres. Mendiang Maura bahkan sampai ke psikolog. https://t.co/uupS8w0E41",2,1,1,0,2022-01-27,6,Thursday,4,3,1
1486581253356892160,2022-01-27 06:06:04,"Produser Turut Berduka Cita, Sunil Samtani ingin serial ini mampu mendulang kesuksesan seperti film Arisan yang disutradarai Nia Dinata. https://t.co/JPOagzSPkO",7,1,1,1,2022-01-27,6,Thursday,4,8,2
1486581233593245696,2022-01-27 06:06:00,Punya berat badan berlebih. Wanita ini putuskan untuk ubah gaya hidupnya dan diet ketat. Ia juga membuang satu makanan yang sukses menurunkan berat badan!  https://t.co/re5D2m75ie,2,0,2,0,2022-01-27,6,Thursday,4,4,0
1486580693450829830,2022-01-27 06:03:51,"Seorang WNA Yordania mengamuk gegara ketinggalan pesawat di Bandara Internasional I Gusti Ngurah Rai, Bali, hingga memukul tiga petugas. Waduh... https://t.co/I8jxnsQuYc",25,13,0,5,2022-01-27,6,Thursday,4,25,18
1486580648123027463,2022-01-27 06:03:40,Kepala Sadio Mane terbentur keras ke tanah usai dilanggar kiper Tanjung Verde di babak 16 besar Piala Afrika 2021. Kondisi Mane disebut sudah mulai membaik. https://t.co/EnwV7oVQRV,5,0,0,0,2022-01-27,6,Thursday,4,5,0
1486580269574414336,2022-01-27 06:02:10,"Virus Corona varian Omicron disebut lebih cepat menular dibandingkan varian Delta, sehingga dapat memicu gelombang COVID-19 baru. Ahli mengungkap penyebabnya:  https://t.co/11nebMHN7e",11,4,4,3,2022-01-27,6,Thursday,4,15,7
1486579920579051521,2022-01-27 06:00:47,Hubungan saudara seperti adik dan kakak selalu penuh dinamika. Netizen bagikan alasan mengapa mereka pelit berbagi makanan ke saudara sendiri!  https://t.co/9YNk0QH3vL,1,0,0,2,2022-01-27,6,Thursday,4,1,2
1486579911846465542,2022-01-27 06:00:44,"Pinjaman online ilegal masih gentayangan mencari mangsa. Tak tanggung, rentenir online ini pun menghalalkan segala cara untuk menggaet 'nasabah' baru.  https://t.co/QCv6rnNJwi",3,0,1,1,2022-01-27,6,Thursday,4,4,1
1486579137221431297,2022-01-27 05:57:40,DJ Indah Cleo jadi salah satu korban karena bentrokan yang terjadi di Sorong. Ia tewas karena insiden tersebut. Ini sosok DJ Indah Cleo:  https://t.co/lRQ5W2jNdl,8,1,3,0,2022-01-27,5,Thursday,4,11,1
1486579118653292548,2022-01-27 05:57:35,"Mario Balotelli kembali dipanggil masuk timnas Italia, nyaris empat tahun setelah aksi terakhirnya. Yuk kenang lagi golnya di Gli Azzurri sebelum ini. https://t.co/i7iFRvnZNM",1,1,1,0,2022-01-27,5,Thursday,4,2,1
1486578752272412675,2022-01-27 05:56:08,Bank Indonesia (BI) sudah memperluas kerja sama QRIS cross border atau antarnegara dengan Bank Negara Malaysia (BMN).  https://t.co/tBXDR9Z6FE,3,0,1,1,2022-01-27,5,Thursday,4,4,1
1486578751144144903,2022-01-27 05:56:08,"Polisi memastikan DJ Indah Cleo menjadi salah satu korban tewas akibat bentrok maut di tempat hiburan malam Double O Sorong, Papua Barat. https://t.co/0mU0mwuD5p",8,1,3,0,2022-01-27,5,Thursday,4,11,1
1486578253611601926,2022-01-27 05:54:09,El Salvador didesak untuk mencabut Bitcoin sebagai alat bayar resmi di negara tersebut oleh IMF. Pemimpin negara itu malah respons begini!  https://t.co/hcjMTCuOGT,6,3,2,1,2022-01-27,5,Thursday,4,8,4
1486578137144119297,2022-01-27 05:53:41,"PT Cinere Serpong Jaya (CSJ) telah merampungkan konstruksi Seksi II Ruas Tol Pamulang-Cinere sepanjang 3,64 kilometer (km). Kapan mulai beroperasi?  https://t.co/YOPTBUjVfO",6,0,0,0,2022-01-27,5,Thursday,4,6,0
1486577853282017280,2022-01-27 05:52:34,Samsung Electronics digugat atas pelanggaran paten di Amerika Serikat. Gugatan ini telah dilaporkan oleh Patent Troll Eropa. https://t.co/Czweh5qIZh,2,0,0,0,2022-01-27,5,Thursday,4,2,0
1486577491405905924,2022-01-27 05:51:07,Jose Mourinho dapat pesta ulang tahun kejutan dari para pemain AS Roma. Sudah ada kue ultah yang menunggu Mourinho di ruang ganti. https://t.co/Kat3jqaRHa,3,0,1,0,2022-01-27,5,Thursday,4,4,0
1486577189609000960,2022-01-27 05:49:55,"Meski masih di bawah naungan Kemenkeu, tunjangan yang diterima PNS di DJP berbeda dengan kementerian induknya. Berapa?  https://t.co/R06bQ0uLjh",4,1,1,0,2022-01-27,5,Thursday,4,5,1
1486576574690439172,2022-01-27 05:47:29,"Ayu Thalia menyambangi Polres Jakarta Utara pada Kamis (27/1) pukul 10:15 WIB. Ia diperiksa sebagai tersangka atas kasus pencemaran nama baik yang dilaporkan Nicholas Sean. Ditanya kesiapannya, Ayu pun bungkam seribu bahasa. https://t.co/8ECGCwV1Bd",5,0,0,0,2022-01-27,5,Thursday,4,5,0
1486576557095374850,2022-01-27 05:47:25,Iwa K terlibat dalam sebuah film Sayap Sayap Patah. Ia berperan sebagai seorang teroris. Begini cara Iwa K mendalami perannya:  https://t.co/j1LQZLhSBI,4,0,0,0,2022-01-27,5,Thursday,4,4,0
1486576332469379077,2022-01-27 05:46:31,Ray J buka suara soal kabar video seks kedua antara dirinya dan Kim Kardashian. Ia memohon agar Kim tak lagi membahas hal itu. https://t.co/zV7Ga2qMzH,4,1,0,0,2022-01-27,5,Thursday,4,4,1
1486576319576031234,2022-01-27 05:46:28,"Karya seni tari dapat ditampilkan secara tunggal, berpasangan, maupun berkelompok. Banyak tari tradisional Indonesia yang dilakukan secara berpasangan.Apa saja?

via: detikedu  https://t.co/rvSh3r5euq",2,0,3,1,2022-01-27,5,Thursday,4,5,1
1486576042861072384,2022-01-27 05:45:22,Hyunjae THE BOYZ dinyatakan positif COVID-19. Hal itu disampaikan langsung oleh manajemen. #Hyunjae #THEBOYZ  https://t.co/VJCiCbckrp,200,0,24,17,2022-01-27,5,Thursday,4,224,17
1486576012959879174,2022-01-27 05:45:15,Pengoperasioan PLTSa Surakarta untuk mendukung G20 di Indonesia dan meningkatkan penggunaan energi baru terbarukan.  https://t.co/8pNUlDhJex,4,0,0,0,2022-01-27,5,Thursday,4,4,0
1486574838642884616,2022-01-27 05:40:35,Ekonom Senior Faisal Basri buka-bukaan soal keganjilan pembangunan ibu kota negara (IKN) baru di Kalimantan Timur.  https://t.co/zXVnD8LOSv,4,1,2,0,2022-01-27,5,Thursday,4,6,1
1486574592177152004,2022-01-27 05:39:36,Binary option kembali bikin heboh usai ada yang mengungkapkan afiliator yang bekerja sama dengan broker dituding mengambil untung besar dari kerugian membernya.  https://t.co/8pyokNSY61,16,2,4,1,2022-01-27,5,Thursday,4,20,3
1486574542323658752,2022-01-27 05:39:24,Perempuan jadi makhluk yang dimuliakan oleh Allah SWT. Perempuan bahkan mempunyai hak istimewa. Ini kata ustaz:  https://t.co/BlH9rmCKzp,9,0,2,0,2022-01-27,5,Thursday,4,11,0
1486574525995229185,2022-01-27 05:39:20,"Kebakaran terjadi di Kampung Paku Haji, Desa Sundawenang, Kabupaten Sukabumi, Kamis (27/1/2022), pukul 02.30 WIB. Satu unit toko kelontong habis dilalap api. https://t.co/OKU6Z4fdfK",3,0,2,0,2022-01-27,5,Thursday,4,5,0
1486573990621720578,2022-01-27 05:37:13,"Mantan Kepala Bappenas, Andrinof Chaniago, menilai pembangunan IKN baru, Nusantara, dinilai dapat mengatasi ketimpangan di Indonesia. Sementara Peneliti Perhimpunan Demokrasi, Rocky Gerung, menilai pemindahan ibu kota ini justru menggusur masyarakat lokal. https://t.co/DS4cAyA2ua",5,7,1,0,2022-01-27,5,Thursday,4,6,7
1486573973592756225,2022-01-27 05:37:09,Nurul Arifin menceritakan keinginan Maura Magnalia yang belum tercapai. Ia ingin membuat buku. https://t.co/gbeImlM5TJ,3,0,0,0,2022-01-27,5,Thursday,4,3,0
1486573198372216835,2022-01-27 05:34:04,"Bupati Langkat ditetapkan KPK sebagai tersangka kasus dugaan suap usai diamankan dalam OTT. Selain itu, Terbit juga disorot karena kontroversi lain.  https://t.co/kIT9J4hCy8",12,3,3,0,2022-01-27,5,Thursday,4,15,3
1486572686537117700,2022-01-27 05:32:02,Presiden Jokowi menggunakan perlengkapan berkendara dari UMKM lokal. Untuk sarung tangannya dapat dibeli umum dengan harga Rp 400 ribuan! https://t.co/AqH0RAfHvd,6,0,1,0,2022-01-27,5,Thursday,4,7,0
1486572331598233606,2022-01-27 05:30:37,Wanita ini ungkap kisahnya dalam menemukan jodoh berawal dari kolom komentar di aplikasi TikTok:  https://t.co/d0ToxaeDH1,8,2,1,1,2022-01-27,5,Thursday,4,9,3
1486571787265757190,2022-01-27 05:28:27,Ingin menghidupkan kembali nomor yang sudah mati? Telkomsel memberikan kemudahan untuk mengaktifkan nomor tersebut. Ini cara mengaktifkannya:  https://t.co/jaR4ii0B9i,32,0,15,3,2022-01-27,5,Thursday,4,47,3
1486571486219579392,2022-01-27 05:27:16,"Melanie Putria tak menyangka saat mendengar kabar calon suaminya, Aldico Sapardan mengidap tumor otak sampai harus menjalankan operasi besar. https://t.co/ypzm9VIMQM",4,1,1,1,2022-01-27,5,Thursday,4,5,2
1486570889558859777,2022-01-27 05:24:53,Timnas Indonesia akan melakoni dua laga uji coba lawan Timor Leste di FIFA Matchday kali ini. Duel pertama akan dimainkan nanti malam! https://t.co/cES6tQPt1i,4,0,0,0,2022-01-27,5,Thursday,4,4,0
1486569944972152835,2022-01-27 05:21:08,Antusiasme masyarakat terhadap game online turut mendorong peningkatan penjualan voucher game online di Tokopedia. https://t.co/LmnY6jJI5C,4,1,0,1,2022-01-27,5,Thursday,4,4,2
1486569926420803589,2022-01-27 05:21:04,Rocky Gerung mengkritik pemindahan ibu kota yang ia sebut hanyalah ambisi pemerintah dan bukan mimpi dari Presiden Soekarno. Rocky pun bicara perbedaan Presiden Soekarno dan Presiden Joko Widodo dalam melihat makna dari ibu kota. https://t.co/UFvv2SWePe,42,49,6,3,2022-01-27,5,Thursday,4,48,52
1486568711716847616,2022-01-27 05:16:14,#Terpopuler Video siswi-siswi SD di Lamongan menyisihkan uang jajan untuk membantu sang guru tengah viral. Guru tersebut merasa kaget hingga terharu. https://t.co/kzUjmsYzmi,10,1,2,1,2022-01-27,5,Thursday,4,12,2
1486568690359406592,2022-01-27 05:16:09,Ibunda Novia dijadwalkan hadir menjadi saksi dalam sidang kode etik profesi Bripda Randy Bagus. Sidang digelar hari ini. https://t.co/TiWRECpIkN,4,0,2,0,2022-01-27,5,Thursday,4,6,0
1486568215245471747,2022-01-27 05:14:16,Nurul Arifin menyebut ada keinginan Maura yang belum terwujud yaitu menjadi seorang profesor. Nurul pun akan menghadiri wisuda Maura yang akan digelar pada Maret mendatang. https://t.co/p5cLwJBf1d,2,0,0,0,2022-01-27,5,Thursday,4,2,0
1486567972441317378,2022-01-27 05:13:18,Aktris mandarin era 90-an Wu Xuewen memutuskan untuk menghilang dari dunia hiburan. Ternyata ia pernah jadi korban kekerasan bos Triad. https://t.co/Jjerl9lKb4,4,0,0,0,2022-01-27,5,Thursday,4,4,0
1486567250798723073,2022-01-27 05:10:26,WeTV Original kembali menghadirkan konten terbaru mereka lewat drama komedi satir Turut Berduka Cita yang disutradarai Nia Dinata. https://t.co/E9UmFkvnt5,5,0,0,0,2022-01-27,5,Thursday,4,5,0
1486566740385583107,2022-01-27 05:08:24,Di trailer The Batman ada adegan Robert Pattinson terlihat tampil dengan eyeliner luntur. Ini penjelasan sutradara The Batman:  https://t.co/TLgUjnPxcE,3,0,0,0,2022-01-27,5,Thursday,4,3,0
1486566715463020545,2022-01-27 05:08:18,Erling Haaland menyebut nama tiga pesepakbola terbaik di dunia pada saat ini dantak ada Cristiano Ronaldo. https://t.co/XGGZK2QD7u,7,2,0,0,2022-01-27,5,Thursday,4,7,2
1486565864010878977,2022-01-27 05:04:55,"Ekonom Senior, Faisal Basri menyinggung soal pemakaian APBN untuk pembangunan Ibu Kota Negara (IKN). Lantaran hal itu dinilai tak sesuai janji Presiden Jokowi di awal. https://t.co/bQgwT7d3tj",15,6,1,0,2022-01-27,5,Thursday,4,16,6
1486565320995356674,2022-01-27 05:02:46,"Gejala Omicron memang amat mirip dengan flu biasa. Tak sepenuhnya pertanda baik, peneliti khawatir hal itu malah memperkuat lonjakan COVID-19 RI. Kenapa? https://t.co/fLGS5MIlt7",7,0,0,0,2022-01-27,5,Thursday,4,7,0
1486564792856887296,2022-01-27 05:00:40,Kisah viral wanita yang mengungkapkan bertemu jodoh karena iseng mengajak nikah seorang pria di kolom komentar TikTok. Ini kisah lengkapnya:  https://t.co/T7bIPINwS7,30,11,2,4,2022-01-27,5,Thursday,4,32,15
1486564772569100289,2022-01-27 05:00:35,Nasi ayam merupakan racikan nasi khas Hainan yang populer. Nasinya gurih pulen dengan irisan daging ayam yang empuk gurih. Makin enak dimakan hangat!  https://t.co/xHYxoSLI6p,4,0,2,0,2022-01-27,5,Thursday,4,6,0
1486564238747439106,2022-01-27 04:58:28,"Marissya Icha melalui kuasa hukumnya, Ahmad Ramzy, menegaskan tidak akan mencabut laporannya terhadap Medina Zein di Polda Metro Jaya. https://t.co/bl0jEgMywG",3,2,0,0,2022-01-27,4,Thursday,4,3,2
1486563996710940672,2022-01-27 04:57:30,"Seniman ini bikin animasi lucu dengan membuat hewan-hewan melakukan aktivitas seperti manusia dari senam, main wahana hingga belajar kripto. Ini potretnya:  https://t.co/Lmlnx1nzHQ",11,0,1,0,2022-01-27,4,Thursday,4,12,0
1486563712051855361,2022-01-27 04:56:22,"Seiring lonjakan kasus COVID-19 RI, vaksinasi COVID-19 booster kini digencarkan. Proteksi vaksin menurun dalam hitungan bulan, booster bakal semempan apa? https://t.co/CaksxLOhJR",4,0,1,0,2022-01-27,4,Thursday,4,5,0
1486563165047508992,2022-01-27 04:54:12,Netflix semakin gencar menggarap drama Korea menyusul popularitas Squid Game. Ini daftar drama Korea Netflix 2022: https://t.co/U4cT2dVG9U,3,1,2,0,2022-01-27,4,Thursday,4,5,1
1486563149683769345,2022-01-27 04:54:08,"Menemukan pasangan hidup bisa jadi perkara rumit bagi sebagian orang. Tak ingin dijodohkan, pria ini memiliki cara uniknya tersendiri. https://t.co/bN6Z0IY0yt",5,0,0,0,2022-01-27,4,Thursday,4,5,0
1486562890316460032,2022-01-27 04:53:06,Kasus COVID-19 di Jatim bertambah 238 pada Rabu (26/1). Tambahan ini membuat kasus aktif Corona di Jatim sebanyak 664. https://t.co/N41OHGVDSv,0,2,0,0,2022-01-27,4,Thursday,4,0,2
1486562641938104324,2022-01-27 04:52:07,Mie telur sering diolah menjadi mie goreng maupun mie rebus. Rasanya yang lezat membuat mie telur banyak digemari. Apa saja manfaat sehatnya?  https://t.co/LXflQVTAX8,9,0,0,0,2022-01-27,4,Thursday,4,9,0
1486562390363840518,2022-01-27 04:51:07,Penampilan Natalie Tong dalam TVB The Righteous Fists dihujat oleh warganet. Bahkan kemampuan aktingnya disebut mengerikan. https://t.co/OeGDidfqNe,3,0,0,0,2022-01-27,4,Thursday,4,3,0
1486561747335065600,2022-01-27 04:48:34,"Jaksa sebut mantan pramugari Siwi Widi dapat transferan dari eks pegawai pajak Wawan Ridwan dan anaknya Muhammad Farsha Kautsar, total Rp 647 juta. https://t.co/dI6HeyHGPW",88,55,31,30,2022-01-27,4,Thursday,4,119,85
1486561731245658115,2022-01-27 04:48:30,Bakmi atau mie merupakan sajian wajib imlek. Karena sajian ini penuh makna simbolik. Racikan bakmi goreng spesial ini bisa jadi pilihan untuk suguhan imlek.  https://t.co/9lZ88uVH2A,2,0,3,0,2022-01-27,4,Thursday,4,5,0
1486561504405164033,2022-01-27 04:47:36,"Postur tubuh yang baik dipengaruhi oleh tulang belakang. Namun, terdapat kelainan tulang belakang yang dapat merubah postur tubuh. Bagaimana penjelasannya?

via: detikedu  https://t.co/c8ASKcKTof",5,0,0,0,2022-01-27,4,Thursday,4,5,0
1486561482317963273,2022-01-27 04:47:31,Menteri Kesehatan Denmark Magnus Heunicke menjelaskan virus COVID-19 subvarian Omicron BA.2 bisa jadi lebih menular dari varian Omicron yang original. https://t.co/KDnu2Rp7sZ,6,5,4,3,2022-01-27,4,Thursday,4,10,8
1486561004142362625,2022-01-27 04:45:37,Kapolres Ngawi saat dikonfrimasi membenarkan kasus pengeroyokan itu terjadi di wilayahnya. https://t.co/pULxHPNq6G,3,0,0,0,2022-01-27,4,Thursday,4,3,0
1486560989160030208,2022-01-27 04:45:33,Pagar beton perumahan yang tutup akses jalan warga di Malang akhirnya dibongkar. Pembongkaran dilakukan untuk akses jalan bagi warga. https://t.co/sRdsp9iaHi,4,0,0,0,2022-01-27,4,Thursday,4,4,0
1486559751064465413,2022-01-27 04:40:38,"Getok harga di Maliboro pernah membuat penggemar kuliner risau. Lalu ada tips minum kopi untuk turunkan berat badan, sampai cara minum es teh manis yang elegan.  https://t.co/L3YcJBHfF7",4,0,0,2,2022-01-27,4,Thursday,4,4,2
1486559699864625158,2022-01-27 04:40:26,"Kamis (27/1/2022), laga uji coba Timnas Indonesia melawan Timor Leste digelar di Stadion Kapten I Wayan Dipta di Kabupaten Gianyar, Bali. Evan Dimas meminta para pemain timnas tidak meremehkan Timor Leste. https://t.co/tQQGQU6Eho",5,0,1,0,2022-01-27,4,Thursday,4,6,0
1486559504716247044,2022-01-27 04:39:39,"Dua kapal pengangkut beras terbakar di Pelabuhan Rakyat Lontangnge, Parepare, Sulawesi Selatan pada Kamis (27/1) dini hari. Kapal terbakar saat tengah proses bongkar muat. https://t.co/GXBdhbAW3S",4,1,0,0,2022-01-27,4,Thursday,4,4,1
1486559250792992775,2022-01-27 04:38:38,"Marketplace Non-Fungible Token (NFT) OpenSea kini semakin seru, kalau biasa hanya bisa menjual foto atau karya digital lain. https://t.co/S5m7Eg1eNx",5,1,0,0,2022-01-27,4,Thursday,4,5,1
1486559231327232004,2022-01-27 04:38:34,"Berkat penjualannya yang terus meningkat, ia memutuskan membeli sebuah freezer baru dengan kapasitas lebih besar agar produk yang dapat disimpan semakin banyak, dan hasilnya...  https://t.co/anDxqUbNN4",6,1,0,0,2022-01-27,4,Thursday,4,6,1
1486558722155593729,2022-01-27 04:36:32,"Awal pekan ini Lionel Messi datang ke Barcelona untuk hadir di acara ultah Xavi. Messi masih jadi idola, dikerubuti fans, tapi nyaris celaka kepentok kamera. https://t.co/56snDNkxPa",3,0,0,0,2022-01-27,4,Thursday,4,3,0
1486558704644329474,2022-01-27 04:36:28,"Produsen mobil listrik terbesar di dunia, Tesla melaporkan lonjakan laba 2021 menjadi US$ 5,5 miliar atau setara Rp 78,8 triliun!  https://t.co/57P25IZ1p9",5,0,0,0,2022-01-27,4,Thursday,4,5,0
1486558163847553028,2022-01-27 04:34:19,"Kepergian anak pertamanya di usia belia, membuat Nurul Arifin dan suaminya, Mayong Putro Laksono merasakan duka yang mendalam...  https://t.co/yXWxQ8rKVI",5,0,0,0,2022-01-27,4,Thursday,4,5,0
1486557943147417605,2022-01-27 04:33:27,"Manchester United limbung sejak ditinggalkan Sir Alex Ferguson. Untuk mencapai kestabilan, 'Setan Merah' mesti mulai melihat setidaknya 2-3 tahun ke depan. https://t.co/cCkevrZLXs",0,0,0,0,2022-01-27,4,Thursday,4,0,0
1486557920477200388,2022-01-27 04:33:21,"Setelah memakamkan Maura Magnalia, Nurul Arifin ngaku sudah lebih lega. Kepergian Maura Magnalia memberikan dirinya banyak pelajaran sebagai orang tua. https://t.co/1wLFF4KnM0",2,0,0,0,2022-01-27,4,Thursday,4,2,0
1486557424974712832,2022-01-27 04:31:23,"Di restoran Cabe Ijo, aneka seafood seperti kepiting, ikan dan udang ditawarkan hidup dan bisa dipilih sesuai selera. Dimasak langsung hingga terjamin lezatnya.  https://t.co/2Ov4C877KG",2,0,0,0,2022-01-27,4,Thursday,4,2,0
1486557406461054977,2022-01-27 04:31:19,"Kekayaan pengusaha dan investor kripto anjlok seiring merosotnya nilai aset mata uang digital tersebut, sampai Rp 386 T!  https://t.co/XNoOfewLZE",7,3,2,1,2022-01-27,4,Thursday,4,9,4
1486557148846907393,2022-01-27 04:30:17,Vicky Prasetyo mengakui dirinya datang ke rumah ibunda Kalina Oktarani. Kalina makin murka dan melarang konten yang dibuat Vicky Prasetyo tayang. https://t.co/FqCF3jVBNG,3,3,0,0,2022-01-27,4,Thursday,4,3,3
1486557124490678273,2022-01-27 04:30:12,"Boeing merugi hingga US$ 4 miliar atau sekitar Rp 57,2 triliun terkait masalah yang dihadapinya pada pesawat berbadan besar 787 Dreamliner.  https://t.co/YF0nWl0fbD",1,0,1,0,2022-01-27,4,Thursday,4,2,0
1486556870169047041,2022-01-27 04:29:11,"Pierre-Emerick Aubameyang semakin tersisihkan di Arsenal. Paling baru, striker Gabon itu tak dibawa Mikel Arteta ke dalam latihan tim ke Dubai! https://t.co/ofiuRQ5STR",1,0,0,0,2022-01-27,4,Thursday,4,1,0
1486556848115355651,2022-01-27 04:29:06,Mulai Februari 2022 PKL Malioboro akan direlokasi di dua lokasi baru denga nama Teras Malioboro 1 dan 2. Lokasi itu merupakan bekas gedung bioskop dan kantor.  https://t.co/aRgcUOhzYO,12,0,4,1,2022-01-27,4,Thursday,4,16,1
1486556237416251400,2022-01-27 04:26:40,"Mario Balotelli dipanggil lagi ke Timnas Italia usai tampil oke di Liga Turki. Pemanggilan Super Mario dipertanyakan eks Gli Azzurri, Emanuele Giaccherini. https://t.co/Q3SswkxbDY",0,0,0,0,2022-01-27,4,Thursday,4,0,0
1486555986085269509,2022-01-27 04:25:40,"Suharso menekankan bahwa pemerintah terbuka dengan siapapun yang ingin berinvestasi. Untuk saat ini, investor yang tertarik membangun IKN Nusantara berasal dari Asia, Eropa hingga Amerika. https://t.co/IMKh41I0VZ",4,0,0,2,2022-01-27,4,Thursday,4,4,2
1486555741150449666,2022-01-27 04:24:42,"Suku bunga acuan Bank Indonesia atau BI 7 days reverse repo rate saat ini berada di level 3,5%  https://t.co/mlAWUzj5dq",8,2,0,0,2022-01-27,4,Thursday,4,8,2
1486554707699118083,2022-01-27 04:20:35,"Direktur Jenderal Anggaran Kementerian Keuangan Isa Rachmatarwata memblokir anggaran kementerian dan lembaga (K/L) sebesar Rp 39,7 triliun. Ada apa?  https://t.co/kpi13l2Hmz",11,0,1,0,2022-01-27,4,Thursday,4,12,0
1486554706268901381,2022-01-27 04:20:35,"Mohamed Salah mengantarkan timnas Mesir ke babak perempatfinal Piala Afrika 2021, setelah mengalahkan Pantai Gading lewat adu penalti. https://t.co/8dBMw7fX6e",7,1,0,0,2022-01-27,4,Thursday,4,7,1
1486554174405943298,2022-01-27 04:18:28,Lionel Messi absen membela Argentina di jeda internasional kali ini. Pelatih timnas Argentina menyebut bahwa Messi masih merasakan efek COVID-19. https://t.co/lM5S0skUrd,2,0,0,0,2022-01-27,4,Thursday,4,2,0
1486553590152024070,2022-01-27 04:16:09,"Dear Libra, terus berkreasi dan berinovasi karena peruntungan nasib kamu lagi mujur. Simak ramalan zodiak hari ini: https://t.co/plGYf4fZqf",4,0,0,0,2022-01-27,4,Thursday,4,4,0
1486553575203430400,2022-01-27 04:16:05,Sebuah penelitian yang diterbitkan di jurnal ilmiah Plos One mengatakan bahwa perubahan iklim akan mempersulit penanaman kopi Arabika di tahun-tahun mendatang!  https://t.co/qXQ93gjX7K,9,2,1,2,2022-01-27,4,Thursday,4,10,4
1486553283338641409,2022-01-27 04:14:56,Pemkot Cirebon tengah melaksanakan vaksinasi booster pada pekan ini. Simak lokasi dan syaratnya ya: https://t.co/8cSO127MsP,0,0,0,0,2022-01-27,4,Thursday,4,0,0
1486553022096367617,2022-01-27 04:13:53,"Bagi detikers yang berkendara harus benar-benar memperhatikan marka jalan ya, jangan sampai kejadian yang ramai di media sosial ini terjadi lagi! https://t.co/3synLwcSqg",3,0,0,0,2022-01-27,4,Thursday,4,3,0
1486553004211855361,2022-01-27 04:13:49,Lembaga antariksa NASA telah mencoba mengantisipasi ancaman asteroid terhadap Bumi. Ini satu aspek dari asteroid yang disebut paling berbahaya:  https://t.co/9A9OblfAWi,4,0,0,0,2022-01-27,4,Thursday,4,4,0
1486552692826726400,2022-01-27 04:12:35,"""Saya mengingatkan kembali bahwa SPM wajib dipenuhi karena masyarakat sudah membayar tarif tol dan harus mendapatkan layanan yang baik,"" papar Menteri PUPR Basuki Hadimuljono  https://t.co/c5TdEcbWrr",6,0,0,2,2022-01-27,4,Thursday,4,6,2
1486552678616477696,2022-01-27 04:12:32,"Ekonom Senior Faisal Basri mencurigai adanya pembagian jatah terhadap para pemilik konsesi lahan di IKN Nusantara. Menanggapi hal itu, Kepala Bappenas, Suharso Monoarfa menilai pernyataan Faisal tak didasari informasi yang akurat. https://t.co/ZmQIjIn743",1,3,2,0,2022-01-27,4,Thursday,4,3,3
1486552390924910592,2022-01-27 04:11:23,"Video aksi pelaku curanmor di Kabupaten Pasuruan, Jawa Timur heboh di media sosial. Lantaran aksinya kepergok oleh sejumlah warga, alhasil pelaku pun lari terbirit-birit hingga motor miliknya tertinggal. https://t.co/qS1c6UNhuC",8,0,1,0,2022-01-27,4,Thursday,4,9,0
1486552373787041798,2022-01-27 04:11:19,"Indeks Harga Saham Gabungan (IHSG) hari ini dibuka melemah 13 poin (0,21%) ke level 6.586. Bursa Asia juga pagi ini bergerak di zona merah.  https://t.co/XSPoruvBz3",3,0,0,0,2022-01-27,4,Thursday,4,3,0
1486552134153867267,2022-01-27 04:10:22,Roberto Mancini memanggil lagi Mario Balotelli ke Timnas Italia karena penasaran dengan kualitas Super Mario saat ini. https://t.co/00DQrA6wBZ,3,1,1,0,2022-01-27,4,Thursday,4,4,1
1486552054906638336,2022-01-27 04:10:03,Mario Balotelli kembali dipanggil ke tim nasional Italia setelah hampir tiga tahun absen. Super Mario tak bisa menutupi rasa bahagianya! https://t.co/TRwxNQPEWJ,8,2,1,1,2022-01-27,4,Thursday,4,9,3
1486550111857659907,2022-01-27 04:02:20,Aksi pengeroyokan pelajar SMP yang dilakukan siswa SMA terjadi di Ngawi. Aksi tersebut terekam kamera ponsel dan videonya viral di aplikasi percakapan. https://t.co/JixLSRLE4r,3,0,1,3,2022-01-27,4,Thursday,4,4,3
1486550073882423296,2022-01-27 04:02:11,Salah satu PO yang siap menyuplai bus listrik Transjakarta adalah Mayasari Bakti! https://t.co/6d0v6L0kon,16,0,4,1,2022-01-27,4,Thursday,4,20,1
1486549764913127424,2022-01-27 04:00:57,Ayu Thalia memenuhi panggilan polisi. Ia datang ke Polres Metro Jakarta Utara untuk jalani pemeriksaan sebagai tersangka. #AyuThalia  https://t.co/6POUzdRIwc,4,0,0,0,2022-01-27,4,Thursday,4,4,0
1486549749591388162,2022-01-27 04:00:53,"Maura Magnalia meninggal dunia akibat serangan jantung pada Selasa (25/1), Bunda. Sebelumnya, Maura sempat meminta maaf kepada sang Ibunda. Simak kisahnya, yuk! #detiknetwork  https://t.co/ZkfkspYnSd",7,0,0,0,2022-01-27,4,Thursday,4,7,0
1486549239752761349,2022-01-27 03:58:52,"BKSDA Sumatera Utara menyita 7 hewan langka dari rumah Bupati Langkat nonaktif, Terbit Rencana Perangin Angin. Informasi awal keberadaan hewan-hewan tersebut diperoleh dari KPK. https://t.co/18t3eVrIqU",5,1,2,1,2022-01-27,3,Thursday,4,7,2
1486549008831197189,2022-01-27 03:57:57,"Pemilik motor Royal Enfield Bullet ini merasa beruntung bisa menemukan kembali motor kesayangannya. Padahal, motor itu telah menghilang 25 tahun yang lalu. https://t.co/IFkdagHK3k",11,0,0,0,2022-01-27,3,Thursday,4,11,0
1486548992658120706,2022-01-27 03:57:53,Kurs dolar Amerika Serikat (AS) terhadap rupiah pagi ini kembali menguat!  https://t.co/DLTYmYsqaF,24,5,0,0,2022-01-27,3,Thursday,4,24,5
1486548746326401024,2022-01-27 03:56:54,Neymar mengaku sempat berpikir untuk meninggalkan Paris Saint-Germain pada 2019 dan ingin kembali ke Barcelona. https://t.co/DBdpkCRpit,7,1,0,0,2022-01-27,3,Thursday,4,7,1
1486547607711358978,2022-01-27 03:52:23,"Harga emas batangan Antam hari ini turun Rp 12.000 ke level Rp 938.000 per gram. Harga logam mulia hari ini sedang turun, mau beli atau jual?  https://t.co/ySRmoyWbCC",8,0,1,0,2022-01-27,3,Thursday,4,9,0
1486547252780937218,2022-01-27 03:50:58,Yamaha melakukan gebrakan di awal tahun 2022 dengan meluncurkan skutik retro terbaru dengan nama Yamaha Fazzio. Seperti apa skema kreditnya ya? https://t.co/622Bt8OeD9,11,0,2,1,2022-01-27,3,Thursday,4,13,1
1486547011495206915,2022-01-27 03:50:00,Dusan Vlahovic kabarnya sudah dilepas Fiorentina untuk ke Juventus dan proses perpindahan menjadi sedikit terlambat karena COVID-19. https://t.co/rgpXebQi5D,6,0,0,0,2022-01-27,3,Thursday,4,6,0
1486547010190774276,2022-01-27 03:50:00,"Nicholas Sean, melalui kuasa hukumnya mengatakan menolak berdamai dengan Ayu Thalia. Dia ingin Ayu Thalia diproses secara hukum. https://t.co/qokzmtXtb3",15,4,2,0,2022-01-27,3,Thursday,4,17,4
1486546265827684353,2022-01-27 03:47:03,Delapan negara dipastikan lolos ke babak perempatfinal Piala Afrika 2021. Berikut ini daftar tim dan jadwal pertandingan selengkapnya! https://t.co/3kgzalFyy5,9,0,0,0,2022-01-27,3,Thursday,4,9,0
1486545055603175434,2022-01-27 03:42:14,Direktorat Lalu Lintas Polda Metro Jaya kembali menghadirkan pelayanan mobil SIM keliling di Jakarta yang tersebar di lima titik. https://t.co/mwye9nHVIl,9,1,0,0,2022-01-27,3,Thursday,4,9,1
1486545002931142657,2022-01-27 03:42:02,Manchester United masih melanjutkan pencarian manajer baru untuk musim depan. Louis Saha percaya Zinedine Zidane adalah pilihan paling pas. https://t.co/FU3dAMNcaL,8,1,0,1,2022-01-27,3,Thursday,4,8,2
1486544432497401859,2022-01-27 03:39:46,"Seorang siswa SD di Deli Serdang, Sumut, berinisial R (9), meninggal dunia usai mengikuti vaksinasi. Ini penjelasan Dinkes Deli Serdang. https://t.co/pRY5hNI4Nj",192,40,115,27,2022-01-27,3,Thursday,4,307,67
1486543944922148867,2022-01-27 03:37:49,"Ketua Satgas IDI Prof Zubairi mengingatkan, tingginya kasus COVID-19 membuat pembelajaran tatap muka bagi siswa tak lagi aman dan dianjurkan kembali daring. https://t.co/XkQbjgnfAP",37,5,10,3,2022-01-27,3,Thursday,4,47,8
1486543386681257985,2022-01-27 03:35:36,"Lagu Bento milik musisi legendaris, Iwan Fals sangat ikonik di telinga masyarakat. Iwan Fals jelaskan makna sebenarnya dibalik lagu Bento:  https://t.co/1sLmS5sIPr",19,6,4,0,2022-01-27,3,Thursday,4,23,6
1486543141008195584,2022-01-27 03:34:38,Jumlah kasus varian Omicron di Indonesia bertambah 1.600-an kasus sejak awal 2022. Naik drastis dibandingkan penambahan 136 kasus selama Desember 2021. https://t.co/1tjDHAmpvE,2,0,0,0,2022-01-27,3,Thursday,4,2,0
1486542606762921989,2022-01-27 03:32:30,Majelis Adat Sunda menyoroti Edy Mulyadi yang memakai iket Sunda saat menyampaikan pernyataan Kalimantan tempat 'jin buang anak'. https://t.co/UnXHGqTnzp,57,44,11,13,2022-01-27,3,Thursday,4,68,57
1486542066188435464,2022-01-27 03:30:21,"Anak Nia Daniaty, Olivia Nathania jadi sorotan usai ketahuan diduga menipu CPNS sebanyak 225 orang sampai merugikan Rp 9,7 miliar. https://t.co/xOrZRLaKGV",10,0,1,2,2022-01-27,3,Thursday,4,11,2
1486541569037680640,2022-01-27 03:28:23,"Kemampuan mengemudi orang ini bisa dibilang berada di atas rata-rata, ia mampu memutar balik mobil di jalanan sangat sempit! https://t.co/mnuCiCvyt7",16,7,1,0,2022-01-27,3,Thursday,4,17,7
1486541062734761986,2022-01-27 03:26:22,"Asnawi Mangkualam, kena sindir Safuwan Baharudin. Sindiran itu berkaitan dengan aksi Asnawi di Piala AFF 2020. https://t.co/q5aMs0i7br",2,1,0,0,2022-01-27,3,Thursday,4,2,1
1486540771994046466,2022-01-27 03:25:13,"Satgas COVID-19 Banyuwangi menutup sejumlah tempat yang menyediakan layanan swab antigen. Sebab, layanan itu tak ada izin Pemkab. https://t.co/eekk39kKs9",13,3,2,0,2022-01-27,3,Thursday,4,15,3
1486540544721494025,2022-01-27 03:24:19,Andrea Dovizioso tak mau buru-buru memikirkan kontrak di MotoGP 2023. Fokusnya adalah menjalani MotoGP 2022 sebaik mungkin dan melihat hasil-hasilnya! https://t.co/6JDTk130lH,3,0,0,1,2022-01-27,3,Thursday,4,3,1
1486540024216793091,2022-01-27 03:22:15,"Kecaman terhadap transfer Dusan Vlahovic ke Juventus bukan hanya datang dari suporter biasa Fiorentina, dari para politikus ikut berkomentar. https://t.co/N4Cq2ognuC",4,0,0,1,2022-01-27,3,Thursday,4,4,1
1486539534141636609,2022-01-27 03:20:18,Mobil bekas masih menjadi pilihan masyarakat Indonesia karena harganya yang ramah di kantong. Mobil bekas apa yang jadi incaran saat ini? https://t.co/0lRzXKokvc,3,0,0,0,2022-01-27,3,Thursday,4,3,0
1486538783692570625,2022-01-27 03:17:19,Mobil 'berpelat dewa' kerap merasa diistimewakan. Polri menegaskan pengguna pelat RF tidak kebal hukum karena sama dengan pelat hitam pada umumnya. https://t.co/NrMnRpjGxd,60,46,6,4,2022-01-27,3,Thursday,4,66,50
1486538280199991300,2022-01-27 03:15:19,"Rekaman CCTV ini menunjukkan detik-detik penyerangan rental Playstation (PS) di Jalan Syech Yusuf, Kelurahan Korumba, Kota Kendari, Minggu (23/1). Penyerangan diduga dilakukan oleh sekelompok geng motor. https://t.co/C6gqBsg6Hp",2,0,1,0,2022-01-27,3,Thursday,4,3,0
1486537565578702858,2022-01-27 03:12:28,"Yuk merapat! Ini informasi vaksin booster COVID-19 di Jakarta Pusat yang tersedia mulai hari ini. Lengkap dengan lokasi, syarat, dan cara daftarnya: https://t.co/XbnBMYwH9c",3,1,0,0,2022-01-27,3,Thursday,4,3,1
1486537541855723522,2022-01-27 03:12:23,"Polisi menggerebek perusahaan pinjol ilegal di Golf Island, Pantai Indah Kapuk 2, Jakarta Utara. Hasil pemeriksaan, dari total 98 karyawan, mayoritas adalah anak di bawah umur. https://t.co/WtHOnYlM0Z",7,0,1,0,2022-01-27,3,Thursday,4,8,0
1486536722385154054,2022-01-27 03:09:07,"Bupati Langkat, Sumatera Utara (Sumut), Terbit Rencana Perangin Angon punya harta puluhan miliar, berikut ini isi garasinya. https://t.co/lHqyX8XnJp",7,2,2,0,2022-01-27,3,Thursday,4,9,2
1486535993310294026,2022-01-27 03:06:13,Bupati Sleman Kustini Sri Purnomo positif COVID-19. Ini kronologi aktivitas Kustini hingga mengumumkan terpapar COVID. https://t.co/Mv9bXgdNh5,6,2,0,0,2022-01-27,3,Thursday,4,6,2
1486535498764009476,2022-01-27 03:04:16,"Sebuah gedung di permukiman padat penduduk Mumbai, India, ambruk. Belum diketahui apakah ada korban dalam peristiwa tersebut. #India https://t.co/mPXX7k4I85",0,0,0,0,2022-01-27,3,Thursday,4,0,0
1486534871237464070,2022-01-27 03:01:46,Staf yang bekerja menceritakan mudahnya melamar di kantor pinjol ilegal di PIK Jakut. Tanpa syarat langsung masuk. https://t.co/NjM7TxkM1B,10,0,1,1,2022-01-27,3,Thursday,4,11,1
1486534270592208899,2022-01-27 02:59:23,"Daffa berhasil menjadi lulusan terbaik di UMM. Ia diketahui juga fasih berbahasa asing. Simak tips dari Daffa berikut ini.

via: detikedu  https://t.co/qtt4xjFBgn",3,0,0,0,2022-01-27,2,Thursday,4,3,0
1486533521023848453,2022-01-27 02:56:24,Keterangan baru mengenai kasus korupsi mantan pegawai di Ditjen Pajak tersingkap. Duit korupsi disebut mengalir ke mantan pramugari Garuda Siwi Widi. https://t.co/TM0RKHPzeS,1133,162,257,393,2022-01-27,2,Thursday,4,1390,555
1486532771044548614,2022-01-27 02:53:25,Nagita Slavina kembali jadi sorotan usai kedapatan mengenakan topi 'bolong' seharga motor. Ini penampilannya:   https://t.co/GzuYxEA29l,5,2,0,0,2022-01-27,2,Thursday,4,5,2
1486532288284397568,2022-01-27 02:51:30,Erling Haaland mengaku masih bisa lebih baik lagi di lapangan. Satu hal yang paling diinginkan Haaland adalah terbebas dari cedera! https://t.co/bzIjmiFOQb,4,0,0,0,2022-01-27,2,Thursday,4,4,0
1486531790366031885,2022-01-27 02:49:31,"Inilah daftar paspor yang benar-benar sakti. Karena, berkas ini yang mampu membuka semua pintu negara!  https://t.co/epWkY7lpJN",10,0,0,0,2022-01-27,2,Thursday,4,10,0
1486531004361842691,2022-01-27 02:46:24,Manchester United kesulitan sejak kepergian Sir Alex Ferguson di 2013. Mantan asisten Sir Alex mengungkap kesalahan utama MU. https://t.co/0PsKlygfFe,10,0,2,1,2022-01-27,2,Thursday,4,12,1
1486530263454789635,2022-01-27 02:43:27,"KKB menyerang pos TNI di Kabupaten Puncak, Papua. Satu prajurit gugur dan satu lainnya mengalami luka usai terkena tembakan senjata api. https://t.co/PRuyvG1saS",33,45,10,5,2022-01-27,2,Thursday,4,43,50
1486530018272497668,2022-01-27 02:42:29,"Dear Taurus, boleh saja mengikuti ajakan teman selama tidak mengganggu keuangan. Simak ramalan zodiak hari ini:  https://t.co/FirzCNXPnZ",3,0,0,0,2022-01-27,2,Thursday,4,3,0
1486528945994579976,2022-01-27 02:38:13,"Berawal dari coba-coba membuat pizza di rumah, ternyata pizza buatan Amrih disukai suami, anak-anak dan tetangganya.  https://t.co/H1MGkfQmfx",5,0,0,0,2022-01-27,2,Thursday,4,5,0
1486528153724112896,2022-01-27 02:35:04,KKB melakukan penyerangan terhadap pos TNI di Papua. Insiden itu berlanjut hingga terjadi kontak tembak dan menyebabkan dua prajurit TNI gugur. https://t.co/xEj7Gnbhae,23,26,10,1,2022-01-27,2,Thursday,4,33,27
1486527406618079234,2022-01-27 02:32:06,Presiden Reccep Tayyip Erdogan berencana mengubah nama resmi Turki. Apa nama barunya nanti dan kenapa diganti?  https://t.co/pTnNCFwxxW,11,4,2,1,2022-01-27,2,Thursday,4,13,5
1486527157882998791,2022-01-27 02:31:07,"Di bawah pengelolaan PT Taman Wisata Candi (TWC), TMII melakukan revitalisasi besar-besaran. Setelah Snowbay Waterpark ditutup, bagaimana nasib wahana lainnya?  https://t.co/n6rTDURVPk",22,6,6,0,2022-01-27,2,Thursday,4,28,6
1486526683817684992,2022-01-27 02:29:14,Menteri BUMN Erick Thohir mengungkapkan penyebab harga tiket Garuda Indonesia lebih mahal dibandingkan maskapai lainnya. Apa katanya?  https://t.co/PwAXbfqr5g,19,4,3,1,2022-01-27,2,Thursday,4,22,5
1486526668294569990,2022-01-27 02:29:10,"Viral video pejalan kaki merekam akses Stasiun Sawah Besar, Jakarta Pusat. PT KAI menyebut area yang rusak itu bukan akses bagi pejalan kaki di stasiun. https://t.co/Pf5vrsmgK7",11,0,0,0,2022-01-27,2,Thursday,4,11,0
1486525929736318982,2022-01-27 02:26:14,Siti Badriah lakukan pemotretan kehamilan dan memperlihatkan perut buncitnya. Wajah sang pedangdut ini terlihat glowing. Ini potretnya: https://t.co/Sdn4SaNzxG,4,1,0,0,2022-01-27,2,Thursday,4,4,1
1486525916188753920,2022-01-27 02:26:11,Restorasi dan revitalisasi TMII dpercayakan pada sosok yang ambil andil revitalisasi GBK. Nantinya akan dibagi ke 4 zona khusus.  https://t.co/eMywKK42dV,20,3,4,1,2022-01-27,2,Thursday,4,24,4
1486524902144421893,2022-01-27 02:22:09,"Momen matahari terbit di Grand Inna Samudra Beach Palabuhanratu, Sukabumi bisa jadi yang terbaik. Saat waktu tiba, matahari akan keluar dari balik perbukitan.  https://t.co/acpGLolQq7",9,1,2,1,2022-01-27,2,Thursday,4,11,2
1486524860050378753,2022-01-27 02:21:59,"Vendor akuarium besar di Prancis memutuskan untuk tidak lagi menjual akuarium mangkuk, karena akuarium kecil ini membuat ikan stres dan cepat mati!  https://t.co/ozo1yT8zaU",6,0,4,0,2022-01-27,2,Thursday,4,10,0
1486524145680756739,2022-01-27 02:19:09,"Denmark mengklaim telah lulus ujian dari virus Corona. Untuk itu, semua pembatasan yang berlaku selama pandemi akan dihapus dan kembali ke kehidupan sebelum ada Covid-19. https://t.co/hfmxcVQeeH",10,0,1,0,2022-01-27,2,Thursday,4,11,0
1486522869018415108,2022-01-27 02:14:04,Sedang merasa putus asa karena gagal melakukan sesuatu? Ini kata-kata bijak Islami singkat tapi bermakna yang bisa jadi penyemangat: https://t.co/MZtpaZCG21,15,0,2,0,2022-01-27,2,Thursday,4,17,0
1486521593861914626,2022-01-27 02:09:00,"#Foto Kabupaten Kepulauan Seribu melakukan pengamanan aset tanah timbul ini berupa pulau gosong, dimana terlihat saat air sedang surut, sehingga dicatat menjadi aset Pemprov DKI Jakarta. https://t.co/jclklCFa5b

Foto: Agung Pambudhy/detikcom https://t.co/JiEjnZ2KWA",9,0,7,0,2022-01-27,2,Thursday,4,16,0
1486520553792016392,2022-01-27 02:04:52,"Sedang menjalani long distance relationship? Jika sedang berjauhan, yuk kirim puisi rindu untuk kekasih. https://t.co/kyosFrILPM",3,1,2,1,2022-01-27,2,Thursday,4,5,2
1486519508953141248,2022-01-27 02:00:43,Matahari terlambat terbenam di sejumlah wilayah Indonesia. Fenomena ini akan terjadi pada 25-31 Januari. Apa penyebab hal ini terjadi? Selengkapnya di #CNNIndonesia  #detiknetwork  https://t.co/aZy9VrBgz6,22,3,4,2,2022-01-27,2,Thursday,4,26,5
1486518766750085122,2022-01-27 01:57:46,Sebagian besar orang akan membuang kulit salak. Padahal kulit salak bisa diolah jadi teh yang berkhasiat untuk penderita diabetes hingga obat sembelit. Ini caranya!  https://t.co/XrDRRTlEs3,9,0,1,0,2022-01-27,1,Thursday,4,10,0
1486518014610755586,2022-01-27 01:54:47,Gubernur Bank Sentral The Federal Reserve Jerome Powell makin gesit menaikkan suku bunga.  https://t.co/iIzpQadE16,6,1,0,1,2022-01-27,1,Thursday,4,6,2
1486517271392567300,2022-01-27 01:51:50,Penerapan sistem transaksi Tol Nontunai Nirsentuh Multi Lane Free Flow (MLFF) akan dimulai pada Desember 2022 mendatang. Seperti apa sistemnya akan berjalan?  https://t.co/Sl4FQTrbgo,10,2,1,3,2022-01-27,1,Thursday,4,11,5
1486516535925657602,2022-01-27 01:48:54,"Anang Hermansyah saat ini memiliki proyek ASIX Token, yaitu token kripto yang memiliki berbagai pengembangan di dalamnya seperti game sampai stable coin.  https://t.co/97P5JuVKMi",6,1,1,0,2022-01-27,1,Thursday,4,7,1
1486515528692908032,2022-01-27 01:44:54,Kopi sudah lama dikenal dengan beragam manfaat sehatnya. Salah satunya adalah membantu melancarkan sistem pencernaan.  https://t.co/6Qwjg7o7hK,16,1,3,2,2022-01-27,1,Thursday,4,19,3
1486514543333363717,2022-01-27 01:40:59,IHSG diprediksi melemah hari ini. Berikut sejumlah rekomendasi saham hari ini yang bisa dicermati.  https://t.co/5khptI2aqC,4,0,0,0,2022-01-27,1,Thursday,4,4,0
1486514542159056896,2022-01-27 01:40:59,"Kebanyakan orang memilih kopi di pagi hari untuk mengusir kantuk. Padahal selain kopi, ada alternatif minuman lain yang juga bikin mata tetap melek dan fokus, ini diantaranya.  https://t.co/CfAvQDQfgU",8,0,1,1,2022-01-27,1,Thursday,4,9,1
1486513534112571395,2022-01-27 01:36:59,Nutrisi yang cukup juga berpengaruh pada penampilan tubuh. Menjalani 6 pola makan sehat ini diakui dapat membantu terlihat lebih muda hingga 10 tahun!  https://t.co/GJfLmnaeau,7,0,1,1,2022-01-27,1,Thursday,4,8,1
1486513261143023627,2022-01-27 01:35:54,Marcello Tahitoe atau akrab disapa Ello baru saja melepas masa lajang. Penyanyi berambut gondrong ini ternyata penggemar berat burger dan nasi goreng!  https://t.co/iIOEiKaBLp,8,3,1,2,2022-01-27,1,Thursday,4,9,5
1486512137103192066,2022-01-27 01:31:26,"""Tantangan dengan ekspor kami adalah perubahan iklim. Kami mengalami salah satu kekeringan terburuk dalam sejarah negara kami."" papar Menteri Pertanian dan Menteri untuk Wilayah Utara Australia, David Littleproud
  https://t.co/jL4UhfQwbc",13,2,2,1,2022-01-27,1,Thursday,4,15,3
1486511280194306058,2022-01-27 01:28:01,"Penerapan penyesuaian tarif listrik atau tariff adjusment pelanggan non subsidi ada di tangan pemerintah. Jadi, apakah listik naik tahun ini?  https://t.co/R1ReDmeOOu",6,4,2,1,2022-01-27,1,Thursday,4,8,5
1486509500194607107,2022-01-27 01:20:57,Pelayanan ruang udara atau FIR di atas wilayah Kepulauan Riau dan Natuna akhirnya diambil alih Indonesia dari Otoritas Navigasi Penerbangan Singapura. Ini visualnya.  https://t.co/rIkFWPVVbU,32,2,2,1,2022-01-27,1,Thursday,4,34,3
1486508218033614851,2022-01-27 01:15:51,"3 ruas tol Trans Jawa, yaitu Kanci-Pejagan, Pejagan-Pemalang, Pemalang-Batang, menjalani perbaikan dan perawatan berkala.  https://t.co/2Oy2qMvu2f",4,1,0,1,2022-01-27,1,Thursday,4,4,2
1486508208172769282,2022-01-27 01:15:49,"Nelayan menjemur ikan teri di Pulau Kelapa, Kepulauan Seribu, Jakarta, Rabu (26/1/2022). Dalam satu hari nelayan bisa mendapatkan hingga 20 kilogram ikan teri.  https://t.co/6V3SblhCju",13,2,0,0,2022-01-27,1,Thursday,4,13,2
1486507705598676996,2022-01-27 01:13:49,Penasaran nggak sih berapa gaji di PT Unilever Indonesia Tbk (UNVR)? Cek visual berikut supaya jelas ya!  https://t.co/R1dVG6WtHF,3,1,0,0,2022-01-27,1,Thursday,4,3,1
1486507190143922177,2022-01-27 01:11:46,Ekonom Senior Faisal Basri mencium aroma tidak sedap dalam pembangunan ibu kota baru di Kalimatan Timur. Apakah itu?  https://t.co/myR353wVTp,23,13,3,2,2022-01-27,1,Thursday,4,26,15
1486506082579238912,2022-01-27 01:07:22,Unilever akan segera memangkas 1.500 pegawai di seluruh dunia. Berikut visualnya.  https://t.co/TX9Yd0zCF0,28,1,13,2,2022-01-27,1,Thursday,4,41,3
1486504477192511490,2022-01-27 01:00:59,Terdapat istilah bahasa Indonesia yang tercantum dalam Al-Qur'an. Seperti apa sejarahnya? Ini penjelasan Ustaz Adi Hidayat. https://t.co/x8RzKHnAHi,6,1,1,0,2022-01-27,1,Thursday,4,7,1
1486503743713685507,2022-01-27 00:58:05,"PKS memperkenalkan anggota Dewan Pakar yang merupakan pemeluk kristiani, Evalina Heryanti. PSI berharap langkah PKS bukan hanya gimik politik. https://t.co/drTTNHDvVi",27,33,5,10,2022-01-27,0,Thursday,4,32,43
1486503494270042114,2022-01-27 00:57:05,Tak semua jurnal internasional punya reputasi. Berikut daftar database jurnal yang diakui Kemendikbudristek. https://t.co/Yf5y9F9df5,16,0,2,0,2022-01-27,0,Thursday,4,18,0
1486502670483570689,2022-01-27 00:53:49,"Rocky mengatakan cara Sukarno melihat bangsa berbeda dengan Jokowi. Sukarno, sebut Rocky, mengutamakan keakraban, bukan menggusur. https://t.co/wD6parZyym",88,95,15,3,2022-01-27,0,Thursday,4,103,98
1486502172036583428,2022-01-27 00:51:50,"Pasukan elite TNI AU, Paskhas berubah nama jadi Korps Pasukan Gerak Cepat (Kopasgat). Anggota Komisi I DPR RI TB Hasanuddin mendukung perubahan nama tersebut. https://t.co/5nUw69luIH",8,4,0,2,2022-01-27,0,Thursday,4,8,6
1486501674692886534,2022-01-27 00:49:51,"Seorang pemuda, AY ditemukan tewas dengan tangan dan kaki terikat tali serta mulut dilakan di kamar mandi di Bekasi. Ini kronologi AY dibunuh temannya, Tegar. https://t.co/Z7s0HoxVfK",5,1,0,0,2022-01-27,0,Thursday,4,5,1
1486500696627236868,2022-01-27 00:45:58,"Ritual Kimsin digelar di Tempat Ibadah Tri Dharma (TITD) Liong Hok Bio Magelang, Jateng. Ritual Kimsin yaitu membersihkan patung dewa-dewi jelang Imlek. https://t.co/D5Umokl4jN",10,0,0,1,2022-01-27,0,Thursday,4,10,1
1486500193365336067,2022-01-27 00:43:58,Polri bergerak cepat mengusut kasus dugaan ujaran kebencian Edy Mulyadi. Kasus tersebut kini telah dinaikkan ke tahap penyidikan. https://t.co/vlj1DpviXK,27,29,4,5,2022-01-27,0,Thursday,4,31,34
1486499704426872837,2022-01-27 00:42:02,"Salah satu kiai sepuh di Jawa Timur, KH Nurul Huda Dzajuli, menyurati Rais Aam PBNU KH Miftachul Akhyar dan Ketua Umum PBNU KH Yahya Cholil Staquf. https://t.co/r5VCyXbWh0",6,1,1,0,2022-01-27,0,Thursday,4,7,1
1486499193502023680,2022-01-27 00:40:00,Neymar mengaku sempat berpikir untuk meninggalkan Paris Saint-Germain pada 2019. Pemain asal Brasil itu ingin kembali ke Barcelona. https://t.co/LnyhwcaSNR,11,0,3,1,2022-01-27,0,Thursday,4,14,1
1486498701422075906,2022-01-27 00:38:02,"Balai Konservasi Sumber Daya Alam (BKSDA) Sumatera Utara menyita 7 hewan langka dari rumah Bupati Langkat nonaktif, Terbit Rencana Perangin Angin. https://t.co/zDbAJYRlRg",517,27,90,33,2022-01-27,0,Thursday,4,607,60
1486498199267418115,2022-01-27 00:36:03,"Home industry obat-obatan ilegal di Cibinong, Bogor beroperasi dengan kedok tempat service mesin. Dalam kasus ini polisi menetapkan tiga orang tersangka. https://t.co/TrgWQz4417",7,1,1,0,2022-01-27,0,Thursday,4,8,1
1486497692939345924,2022-01-27 00:34:02,"Kantor pinjol yang berada di Ruko Palladium Blok G7, Jalan Pulau Maju Bersama, PIK, Jakarta Utara, ini beroperasi sejak Desember 2021. https://t.co/dnNXLOOm7H",11,8,4,0,2022-01-27,0,Thursday,4,15,8
1486496955350106116,2022-01-27 00:31:06,"Masyarakat Tionghoa bersiap merayakan Imlek 2573 pada 1 Februari. Dalam kalender China, tahun tersebut merupakan tahun macan air. Siap-siap mengaum. https://t.co/wEznqJUgND",12,0,1,0,2022-01-27,0,Thursday,4,13,0
1486495935521865739,2022-01-27 00:27:03,"COVID-19 kembali 'ngegas', ditambah munculnya Omicron semakin bikin was-was. Sementara, sekolah tatap muka masih dilanjutkan. Ortu cemas? Cemas lah, masa nggak. https://t.co/0CUCSih4Hk",31,8,4,3,2022-01-27,0,Thursday,4,35,11
1486494539489628160,2022-01-27 00:21:30,Skor Indeks Persepsi Korupsi RI pada 2021 masih berada di bawah rata-rata. MAKI meminta Novel Baswedan dan eks pegawai lain yang dipecat ditarik kembali ke KPK. https://t.co/sIjvU3wVh6,7,5,5,1,2022-01-27,0,Thursday,4,12,6
1486494283150594051,2022-01-27 00:20:29,BNPT mengungkap dugaan sejumlah pondok pesantren (ponpes) terafiliasi kelompok terorisme. Sebanyak 119 ponpes dideteksi terafiliasi jaringan ISIS. https://t.co/onv0YqGFzk,25,17,10,3,2022-01-27,0,Thursday,4,35,20
1486493819797487616,2022-01-27 00:18:39,"Teka-teki berikut akan menguji apakah mata dan berpikir logika kamu masih lancar atau malah sudah buyar. Yuk coba! Kalau gagal, tandanya butuh tidur cepat. https://t.co/DIgphKDzdD",6,3,0,0,2022-01-27,0,Thursday,4,6,3
1486493120330178562,2022-01-27 00:15:52,"4 Cara Memperpanjang Mr P Secara Alami, Bisa Dilakukan dengan Tangan Kosong https://t.co/bBlXURwmLx",13,1,4,3,2022-01-27,0,Thursday,4,17,4
1486492329062146051,2022-01-27 00:12:43,Situasi pelik yang dihadapi Paulo Dybala di Juventus memicu sejumlah klub top siaga. Liverpool disebut sebagai salah satu yang mempertimbangkan kans transfer. https://t.co/pm6hCyKAtW,5,1,0,0,2022-01-27,0,Thursday,4,5,1
1486491806737051653,2022-01-27 00:10:39,"Nurul Arifin dan suaminya, Mayong Suryo, rela melepas kepergian Maura Magnalia. Mayong mengungkap Maura telah memilih jalan sendiri. https://t.co/4cQbYpetGh",6,0,0,0,2022-01-27,0,Thursday,4,6,0
1486491548879622148,2022-01-27 00:09:37,Korban disekap di dalam kamar mandi dengan kondisi tangan-kaki terikat dan mulutnya dilakban. Tersangka bernama Tegar sakit hati karena tak diajak lamar kerja. https://t.co/WD8GcC7uWG,11,3,4,1,2022-01-27,0,Thursday,4,15,4
1486490038267428866,2022-01-27 00:03:37,"Sayonara OTT KPK, ucapan itu tampaknya pas diungkapkan karena istilah OTT di KPK tak akan lagi digunakan. Kini, KPK hanya akan memakai istilah tangkap tangan. https://t.co/kKFocoyGGu",5,6,1,0,2022-01-27,0,Thursday,4,6,6
1486489519822020608,2022-01-27 00:01:33,Prasetio memandang pembangunan trek balapan idealnya dilakukan selama 2 tahun. https://t.co/byTHn0m7Ln,13,15,1,2,2022-01-27,0,Thursday,4,14,17
1486488773252853762,2022-01-26 23:58:35,Seorang pria dewasa berinisial T dilaporkan atas dugaan perkosaan remaja berusia 15 tahun di Ciputat. Pelaku juga memeras korban dengan ancaman video syur. https://t.co/8HNafW5bm2,8,1,0,3,2022-01-26,23,Wednesday,3,8,4
1486488519174508553,2022-01-26 23:57:35,Jumlah peserta didik dalam penerimaan SIPSS 2022 adalah berjumlah 100 orang. Lantas apa saja persyaratannya? https://t.co/7QgncfUI1c,4,1,0,0,2022-01-26,23,Wednesday,3,4,1
1486486973904732163,2022-01-26 23:51:26,BMKG mengeluarkan prakiraan cuaca untuk wilayah DKI Jakarta. BMKG menyebut ada potensi hujan yang disertai kilat dan angin di Jaksel dan Jaktim. https://t.co/xOkwo82428,3,1,0,0,2022-01-26,23,Wednesday,3,3,1
1486486487453556736,2022-01-26 23:49:30,BMKG mengeluarkan prakiraan cuaca untuk wilayah DKI Jakarta. BMKG menyebut ada potensi hujan yang disertai kilat dan angin di Jaksel dan Jaktim. https://t.co/GJjfpuJznz,5,0,1,0,2022-01-26,23,Wednesday,3,6,0
1486486252811661312,2022-01-26 23:48:34,Polri mengungkap sejumlah ciri atau tanda seseorang terpapar ekstremisme dan terorisme. Salah satunya intoleran. https://t.co/hRd45D9HdE,108,103,30,11,2022-01-26,23,Wednesday,3,138,114
1486484755981996035,2022-01-26 23:42:38,BMKG mengeluarkan prakiraan cuaca untuk wilayah DKI Jakarta. BMKG menyebut ada potensi hujan yang disertai kilat dan angin di Jaksel dan Jaktim. https://t.co/DGQSYLjio4,1,0,0,0,2022-01-26,23,Wednesday,3,1,0
1486483648144711681,2022-01-26 23:38:13,Kabar Bripda Randy Bagus Sasongko belum dipecat dari kepolisian mencuat ke publik. Polda Jatim memberikan penjelasan. https://t.co/YG9HDV81S4,91,26,32,5,2022-01-26,23,Wednesday,3,123,31
1486483422675615750,2022-01-26 23:37:20,Guinea Khatulistiwa menyusul langkah Mesir ke perempatfinal Piala Afrika 2021. Mereka menyingkirkan Mali di babak 16 besar lewat adu penalti. https://t.co/J4YBljfzRx,5,0,0,0,2022-01-26,23,Wednesday,3,5,0
1486482401228472322,2022-01-26 23:33:16,Jerinx 'SID' dan Adam Deni makin melebar. Kini kedunya saling sahut soal sosok 'AD' yang mengacungkan jari tengah ke foto Presiden Joko Widodo. https://t.co/emTvu5ki4p,14,4,1,0,2022-01-26,23,Wednesday,3,15,4
1486481560857632771,2022-01-26 23:29:56,Bantuan Sarana dan Prasarana kepada Rumah Sakit Fatmawati terus mengalir guna mewujudkan Rumah Sakit Nomor Satu di Indonesia. Apa saja sih? https://t.co/efmPc7roLa,3,0,0,0,2022-01-26,23,Wednesday,3,3,0
1486480561766268929,2022-01-26 23:25:58,"Gejala varian Omicron mirip flu biasa rupanya tak sepenuhnya pertanda baik. Hati-hati malah semakin memicu lonjakan kasus COVID-19 RI, begini penjelasan pakar. https://t.co/No7ZH8rtpx",45,37,25,4,2022-01-26,23,Wednesday,3,70,41
1486479563194572801,2022-01-26 23:21:59,Seorang bocah berusia 4 tahun di Kabupaten Cianjur dikabarkan mengalami 'sunat gaib'. Dinkes Cianjur menduga peristiwa itu akibat mengerut pada prepitium. https://t.co/mbPJUoPGSv,3,2,0,0,2022-01-26,23,Wednesday,3,3,2
1486478371840466944,2022-01-26 23:17:15,Apa mata uang dari negara Filipina? Selain itu bagaimana dengan kenampakan alam dan keadaan sosialnya? Simak penjelasan berikut ya! https://t.co/HoUESAeS0I,2,0,0,0,2022-01-26,23,Wednesday,3,2,0
1486477411269107714,2022-01-26 23:13:26,#terpopuler Warga menagih janji dari pihak Pertamina yang disebut menjanjikan warga yang telah menjual tanahnya akan mendapat pekerjaan di proyek!  https://t.co/a3llkJAbeH,14,4,2,2,2022-01-26,23,Wednesday,3,16,6
1486475087381417988,2022-01-26 23:04:12,"Gempa Bumi terjadi di Kabupaten Morowali. Berpusat di darat, gempa tersebut berkekuatan magnitudo 4,1. https://t.co/ghFK9tVRO9",8,0,1,0,2022-01-26,23,Wednesday,3,9,0
1486475085687005187,2022-01-26 23:04:12,Jet tempur siluman Amerika Serikat (AS) jatuh di Laut China Selatan. Berikut adalah tujuh fakta terkait insiden ini. https://t.co/D1OwL7GDvm,8,1,1,0,2022-01-26,23,Wednesday,3,9,1
1486473964780199936,2022-01-26 22:59:45,"Gusi bengkak merupakan masalah gigi yang kerap dialami oleh banyak orang. Penasaran dengan gejala, penyebab, dan cara mengobatinya? Simak di sini guys. https://t.co/FLSIQqOYkh",16,0,5,0,2022-01-26,22,Wednesday,3,21,0
1486472721605308419,2022-01-26 22:54:48,"Rider Yamaha RNF, Darryn Binder, mengaku menyadari kalau dirinya dibenci oleh banyak rider MotoGP. Dia akan terbuka pada siapaun yang mau mengajaknya mengobrol. https://t.co/JDmN3EwGP6",9,0,3,0,2022-01-26,22,Wednesday,3,12,0
1486471476505104388,2022-01-26 22:49:51,"Ketua DPRD DKI Prasetio Edi Marsudi mengkritik sumur resapan. Menurutnya, sumur resapan tidak berfungsi dan lebih baik jadi kolam ikan lele. https://t.co/D7n5ga1HAb",21,9,3,1,2022-01-26,22,Wednesday,3,24,10
1486470487169548289,2022-01-26 22:45:56,Prasetio memandang pembangunan trek balapan idealnya dilakukan selama 2 tahun. https://t.co/CM2WJCOHc1,16,12,3,3,2022-01-26,22,Wednesday,3,19,15
1486469494843260933,2022-01-26 22:41:59,"Penggawa Timnas Indonesia, Asnawi Mangkualam, kena sindir Safuwan Baharudin. Sindiran bek Singapura itu berkaitan dengan aksi Asnawi di Piala AFF 2020. https://t.co/MwFyye2gpv",9,0,2,0,2022-01-26,22,Wednesday,3,11,0
1486467954128601088,2022-01-26 22:35:52,"Tegar berencana menyekap korban di dalam kamar mandi. Lalu, 30 menit kemudian, korban tewas. https://t.co/AwkpJyCFZj",5,0,3,0,2022-01-26,22,Wednesday,3,8,0
1486466879384391685,2022-01-26 22:31:35,"Tiap manusia nantinya akan dibangkitkan kembali dan dihisab seluruh amalnya. Lantas, bagaimana dengan nasib hewan di akhirat kelak? https://t.co/zjjtmzAIg6",15,6,5,2,2022-01-26,22,Wednesday,3,20,8
1486464991138140167,2022-01-26 22:24:05,"Pemuda di Bekasi tewas dengan kondisi tangan dan kaki terikat serta mulut dilakban. Pelaku pembunuhan bernama Tegar (21) ditangkap di Banjarnegara, Jateng. https://t.co/gBRACi6zqV",10,1,3,0,2022-01-26,22,Wednesday,3,13,1
1486463599845515264,2022-01-26 22:18:34,"Polisi telah mempertemukan dua kelompok yang bentrok di Sorong, Papua Barat. Dua kelompok yang terlibat bentrokan maut itu menyepakati tidak lagi bentrok. https://t.co/oanc6R447S",8,1,6,2,2022-01-26,22,Wednesday,3,14,3
1486461766632722436,2022-01-26 22:11:16,"Seorang ayah inisial RC di Kota Pangkalpinang, Bangka Belitung, menjadi tersangka pencurian ponsel. Kasusnya sempat diproses polisi, namun dibebaskan jaksa. https://t.co/Xtu03qqGgf",3958,227,752,154,2022-01-26,22,Wednesday,3,4710,381
1486460195886833666,2022-01-26 22:05:02,Gubsu Edy menghadiri pelantikan DPP Paguyuban Warga Sunda Sumut. Dia mengingatkan soal penggunaan bahasa hingga ajakan membangun Sumut. https://t.co/ct5BXgOSua,7,1,1,0,2022-01-26,22,Wednesday,3,8,1
1486456543000338434,2022-01-26 21:50:31,"Dua warga tewas dan seorang polisi terluka akibat insiden bentrokan warga di Pulau Haruku, Maluku Tengah. Polisi akan menindak tegas pelaku. https://t.co/RnL3gaGpph",12,1,1,0,2022-01-26,21,Wednesday,3,13,1
1486455498161508356,2022-01-26 21:46:22,"Pilihannya menu-menu rumahan. Tetapi mengolahnya penuh rasa, membangun tekstur dan selera. Semakin komplit dengan suasana pekarangan rumah yang rimbun dan teduh.  https://t.co/0HjVUq1IU7",13,0,1,0,2022-01-26,21,Wednesday,3,14,0
1486453378750238722,2022-01-26 21:37:57,Anthony Martial menegaskan bahwa keputusannya untuk pindah ke Sevilla bukan karena uang. Martial ingin menikmati bermain sepakbola lagi. https://t.co/zHymCSOEEX,7,1,2,2,2022-01-26,21,Wednesday,3,9,3
1486451886194573313,2022-01-26 21:32:01,Manchester United masih melanjutkan pencarian manajer baru untuk musim depan. Eks penyerang MU Louis Saha percaya Zinedine Zidane adalah pilihan paling pas. https://t.co/HYnRSYobOA,7,0,1,0,2022-01-26,21,Wednesday,3,8,0
1486450624262811650,2022-01-26 21:27:00,Kasus video viral diduga vaksin kosong yang disuntikkan ke siswa SD di Medan terus bergulir. Kini dokter G membantah vaksin yang disuntikkan kosong. https://t.co/otp0OftpYX,9,7,1,0,2022-01-26,21,Wednesday,3,10,7
1486448521188450308,2022-01-26 21:18:38,Studi terbaru menyebut Corona varian Omicron yang sangat menular bisa bertahan hingga 21 jam di kulit manusia dan hingga delapan hari di permukaan plastik. https://t.co/Ps852XuCd0,27,3,9,3,2022-01-26,21,Wednesday,3,36,6
1486447036308328455,2022-01-26 21:12:44,Pengerjaan proyek Tol Cinere-Jagorawi (Cijago II) mendapat protes dari warga lantaran memutus akses Jalan Swadaya Ujung ke Tugu Tanah Baru. https://t.co/ZyEn3HIWiT,7,0,1,1,2022-01-26,21,Wednesday,3,8,1
1486444566202966021,2022-01-26 21:02:56,Anis Matta merespons Salim Segaf Al-Jufri yang ingin Partai Gelora mencari suara di 'kolam' yang berbeda. Anis Matta mempertanyakan maksud kata 'kolam'. https://t.co/O0EeHnzHP4,2,1,0,2,2022-01-26,21,Wednesday,3,2,3
1486440961458774027,2022-01-26 20:48:36,"Karakter pahwalawan Marvel dari Spiderman, Captain America hingga Thor selalu tampil menawan dan gagah. Namun ini wajah mereka jika diedit jadi cantik jelita:  https://t.co/8aqRGhF4Mj",8,1,0,2,2022-01-26,20,Wednesday,3,8,3
1486439426330959876,2022-01-26 20:42:30,Saat ini ada 90 sekolah di Jakarta yang harus ditutup kembali setelah ditemukannya kasus positif COVID-19 saat PTM berlangsung. Berikut rinciannya. https://t.co/gEv2YAqPqV,14,1,5,1,2022-01-26,20,Wednesday,3,19,2
1486435691676553222,2022-01-26 20:27:40,Sean Gelael adalah pebalap Indonesia yang kerap memamerkan aktivitasnya di Instagram. Begini gaya kerennya saat hangout hingga minum kopi!  https://t.co/fD4pw7hJV5,5,0,0,0,2022-01-26,20,Wednesday,3,5,0
1486432100454649856,2022-01-26 20:13:23,"Awal tahun 2022 ini rupanya kurang menggembirakan terhadap Bitcoin dan mata uang kripto lainnya, di mana harganya anjlok. https://t.co/Xd9RCS8fjg",3,1,0,1,2022-01-26,20,Wednesday,3,3,2
1486430489191792647,2022-01-26 20:06:59,Vivo V23 5G baru saja diluncurkan di Indonesia dan mengusung desain yang unik. Ini dia harga Vivo V23 5G di Indonesia dan deretan fitur unggulannya:  https://t.co/bSjJICyydd,2,0,0,0,2022-01-26,20,Wednesday,3,2,0
1486429549227352066,2022-01-26 20:03:15,"Mesir sukses menjejak perempatfinal Piala Afrika 2021. Berimbang 0-0 dengan Pantai Gading selama 120 menit, Mohamed Salah dkk menang adu penalti 5-4. https://t.co/nVeFs6LzGp",4,0,0,0,2022-01-26,20,Wednesday,3,4,0
1486426928294903809,2022-01-26 19:52:50,Lyon marah besar setelah dikabarkan sepakat melepas Bruno Guimaraes ke Newcastle United. Klub sampai harus mengeluarkan rilis. https://t.co/GMMwmqTgxB,8,0,0,0,2022-01-26,19,Wednesday,3,8,0
1486423665357041666,2022-01-26 19:39:52,"Polda Sumut bersama Komnas HAM mengecek langsung lokasi kerangkeng di rumah Bupati Langkat nonaktif, Terbit Rencana Perangin Angin. https://t.co/7yIvPtR71u",4,1,0,0,2022-01-26,19,Wednesday,3,4,1
1486420518806994945,2022-01-26 19:27:22,EmojiMix tengah viral di TikTok. Apa itu EmojiMix dan bagaimana cara membuatnya di handphone? Simak di sini:  https://t.co/LyZggUrqdB,2,0,0,0,2022-01-26,19,Wednesday,3,2,0
1486418584939159558,2022-01-26 19:19:41,Roberto Mancini memanggil lagi Mario Balotelli ke Timnas Italia. Pelatih Gli Azzurri itu penasaran dengan kualitas Super Mario saat ini. https://t.co/thoXiZQugw,11,0,1,0,2022-01-26,19,Wednesday,3,12,0
1486416348062306307,2022-01-26 19:10:48,Mitos populer seputar seks kerap beredar akibat minim informasi. Salah satunya anggapan masturbasi bisa mempengaruhi kualitas sperma. Benarkah hal tersebut? https://t.co/2tUeYTCtq0,4,0,1,0,2022-01-26,19,Wednesday,3,5,0
1486413512192757764,2022-01-26 18:59:32,"Ada tujuh satwa dilindungi yang disita BKSDA dari rumah Bupati Langkat nonaktif, Terbit Rencana Perangin Angin. Terbit terancam 5 tahun penjara https://t.co/02QztpJWxI",26,4,7,4,2022-01-26,18,Wednesday,3,33,8
1486411518006673415,2022-01-26 18:51:36,"Tanggul tengah jalan perumahan ini memang sudah dibongkar. Semula, tanggul didirikan untuk mengatasi banjir luapan got. Kini usai tanggul digempur, got dikeruk. https://t.co/Pf4LHKutoy",0,0,2,0,2022-01-26,18,Wednesday,3,2,0
1486408274358513665,2022-01-26 18:38:43,"Ketua DPRD DKI Jakarta Prasetio Edi Marsudi menyoroti sumur resapan di Menteng. Dia menyebut, Menteng bukanlah daerah rawan banjir. https://t.co/GjJFwhbb7s",26,37,5,3,2022-01-26,18,Wednesday,3,31,40
1486391877532327947,2022-01-26 17:33:34,"Pencarian 2 warga Amerika, penumpang pesawat kecil yang jatuh di Samudra Pasifik terus dilakukan. Pencarian dilakukan dengan kapal dan pesawat menyisir daerah Punta Chame Panama https://t.co/4xW2IT9cMm",13,0,4,0,2022-01-26,17,Wednesday,3,17,0
1486387728862351363,2022-01-26 17:17:04,"20Detik merangkum kejadian heboh dan menarik dalam sepekan ini. Apa saja, ya? Simak dalam video berikut ini!  https://t.co/9ZYPtcepyY",8,0,1,0,2022-01-26,17,Wednesday,3,9,0
1486383585955356681,2022-01-26 17:00:37,"Perlintasan sebidang di dekat Stasiun Kemayoran akan ditutup mulai pekan depan. Sayangnya, pembangunan JPO harus menunggu sampai tahun depan. #detikcomdoyourmagic https://t.co/LtMJJqzane",6,1,2,0,2022-01-26,17,Wednesday,3,8,1
1486381450047938561,2022-01-26 16:52:07,"Pedagang kaki lima kawasan wisata jalan Malioboro menjajakan dagangannya, Yogyakarta, Rabu (26/1). Mereka tetap beraktivitas seperti biasa jelang relokasi.  https://t.co/vdDVw4U2eZ",11,0,2,1,2022-01-26,16,Wednesday,3,13,1
1486380186002198528,2022-01-26 16:47:06,"Pekerja dan warga miskin mencari rezeki di jalanan. Potret bersahaja pencari nafkah meski harus memanggul beban berat di kepala, mengandalkan otot dan kesabaran.  https://t.co/G6oH76TAAg",44,3,14,1,2022-01-26,16,Wednesday,3,58,4
1486378941438902275,2022-01-26 16:42:09,Badan Keamanan Kesehatan Inggris (UKHSA) saat ini sedang menyelidiki BA.2 yang merupakan turunan atau mutasi dari varian Omicron. Seperti apa gejalanya? https://t.co/7aog9bQysy,8,16,6,6,2022-01-26,16,Wednesday,3,14,22
1486377886978387975,2022-01-26 16:37:58,"Kak Seto lagi-lagi bikin warganet takjub. Kali ini bukan karena parkour, tapi karena lari-lari sembari ceria. Usia 70 tahun masih bugar, ini lho jurus Kak Seto. https://t.co/raWaNySOeF",107,13,17,2,2022-01-26,16,Wednesday,3,124,15
1486376787546456065,2022-01-26 16:33:36,"Bagi yang belum mengerti bagaimana cara mendapatkan tiket vaksin ketiga, sini merapat. Nih, ada informasinya di sini, mari disimak! https://t.co/onvfzSBFfg",25,2,7,2,2022-01-26,16,Wednesday,3,32,4
1486375200459526149,2022-01-26 16:27:17,"Kasus COVID-19 varian Omicron di Indonesia 'ngegas' terus. Sosok dr Tirta yang biasanya juga ngegas, kali ini menyampaikan pesan bijak. https://t.co/QPvOH6UBre",41,8,5,1,2022-01-26,16,Wednesday,3,46,9
1486374183978385417,2022-01-26 16:23:15,Pemain Timnas Timor-Leste Filomeno Junior da Costa ingin bermain di Liga Indonesia khususnya Persija Jakarta. https://t.co/LBjeNLVU0N,4,1,0,0,2022-01-26,16,Wednesday,3,4,1
1486373211247947785,2022-01-26 16:19:23,"Artis muda Rey Mbayang ungkap rahasianya jaga keromantisan dengan pasangannya, Dinda Hauw. Menurut Rey ada beberapa cara yang biasa dilakukannya, agar hubungan pernikahannya tetap berjalan harmonis serta romantis. https://t.co/7iVRcyVg1Y",6,1,2,0,2022-01-26,16,Wednesday,3,8,1
1486371604275814407,2022-01-26 16:13:00,"Warga RT 08, RW 09, Jalan Babakan Hantap, Kelurahan Babakan Surabaya, Kecamatan Kiaracondong, Kota Bandung mengeluhkan keberadaan tumpukan sampah di aliran Sungai Cicadas. Ini penampakannya: https://t.co/nxPbQ7H25w",2,0,0,0,2022-01-26,16,Wednesday,3,2,0
1486370796658376715,2022-01-26 16:09:48,Bupati nonaktif Langkat Terbit Rencana Perangin Angin membangun kerangkeng manusia di rumahnya. Kerangkeng itu disebut oleh Terbit untuk tempat pembinaan pecandu narkoba. https://t.co/Z2CgcFYdXU,8,0,0,3,2022-01-26,16,Wednesday,3,8,3
1486368512302063620,2022-01-26 16:00:43,"COVID-19 RI naik kembali gegara varian Omicron. Mengandalkan cakupan vaksinasi hingga kini, cukup kuatkah warga RI hadang imbas lonjakan kasus? Ini kata pakar: https://t.co/LjQyxhVuQO",4,7,0,5,2022-01-26,16,Wednesday,3,4,12
1486367047873355779,2022-01-26 15:54:54,Senegal terus membiarkan Sadio Mane main meski kepalanya sempat mengalami benturan di laga melawan Cape Verde. https://t.co/3EcuTyk1wJ,4,0,2,0,2022-01-26,15,Wednesday,3,6,0
1486366015655186435,2022-01-26 15:50:48,Tidak ada Gerard Pique dalam reuni Lionel Messi dengan pemain-pemain senior Barcelona dan ada kabar bahwa Messi dan Pique kini tidak berhubungan baik. https://t.co/enJcPgLkwK,9,1,1,0,2022-01-26,15,Wednesday,3,10,1
1486365116174155779,2022-01-26 15:47:13,Departemen kepolisian San Francisco melaporkan pada Selasa (25/1) bahwa kejahatan rasial terhadap warga Asia-Amerika dan Kepulauan Pasifik meningkat. Otoritas menduga jumlah sebenarnya jauh lebih tinggi karena orang enggan melapor kasusnya ke polisi. https://t.co/4ZgJL3xmCI,6,0,1,0,2022-01-26,15,Wednesday,3,7,0
1486363685937373185,2022-01-26 15:41:32,"Bandara Halim Perdanakusuma, Jakarta Timur, resmi ditutup sementara mulai hari ini. Penutupan bandara ini pun menyisakan sederet kisah pilu. https://t.co/z5THlmHIa0",9,1,4,2,2022-01-26,15,Wednesday,3,13,3
1486362954505367554,2022-01-26 15:38:38,Ilmuwan bioakustik bernama Prof. Nicolas Mathevon menceritakan soal risetnya tentang suara pada kuda nil. Riset Prof. Nicolas cs ini mengulik tentang cara mamalia tersebut berkomunikasi. Seperti apa ya? https://t.co/hHEqkMpUzU,8,0,6,0,2022-01-26,15,Wednesday,3,14,0
1486362933378830337,2022-01-26 15:38:33,"Ini dia 5 Tips aman berkendara pakai taksi online versi 
@GrabID
#PercayaAman
https://t.co/9nCz6XRa36 https://t.co/R5QBSCQIWl",25,0,16,7,2022-01-26,15,Wednesday,3,41,7
1486361700269965318,2022-01-26 15:33:39,"COVID-19 RI melonjak kembali akibat varian Omicron. Perlindungan 2 dosis vaksin COVID-19 bisa menurun sampai sisa 2 persen, ini kata pakar soal urgensi booster: https://t.co/Qgvx5OY6df",8,1,3,1,2022-01-26,15,Wednesday,3,11,2
1486359986896875525,2022-01-26 15:26:50,Manchester United melepas Anthony Martial ke Sevilla dengan status pinjaman. Gelandang Bruno Fernandes berharap temannya itu bisa bersinar di tanah Spanyol. https://t.co/fXZE4nmzko,7,0,1,0,2022-01-26,15,Wednesday,3,8,0
1486358281115344896,2022-01-26 15:20:04,Persoalan kerangkeng manusia di rumah Bupati Langkat non aktif Langkat Terbit Perangin Angin masih terus bergulir. Berikut informasi terbarunya. https://t.co/rYVw92Mroo,7,0,2,0,2022-01-26,15,Wednesday,3,9,0
1486357573075075080,2022-01-26 15:17:15,"Indra Sjafri Beri Coaching Clinic Calon Atlet Esport LEAD by IndiHome
https://t.co/V0DRvlngfG",27,3,5,0,2022-01-26,15,Wednesday,3,32,3
1486356871044870145,2022-01-26 15:14:27,Melanie Putria dan Aldico Sapardan semakin dekat dengan hari pernikahannya. Mereka melakukan berbagai persiapan. https://t.co/PCmerLnOrL,4,0,2,0,2022-01-26,15,Wednesday,3,6,0
1486356075779608588,2022-01-26 15:11:18,#FOTO Wanna One dikonfirmasi akan merilis single digital B-Side yang diberi judul Beautiful (Part III). Mereka pun merilis teaser foto resmi. Ini potretnya:  https://t.co/uQrRWEF01s,5,0,1,0,2022-01-26,15,Wednesday,3,6,0
1486355810422865921,2022-01-26 15:10:15,"Pangdam XVI/Pattimura Mayjen TNI Richard TH Tampubolon mempertemukan sejumlah tokoh lintas agama terkait bentrokan maut di Pulau Haruku, Maluku. https://t.co/oFijqfhCpU",6,0,2,0,2022-01-26,15,Wednesday,3,8,0
1486355318372241420,2022-01-26 15:08:17,"The Batman, yang direncanakan rilis Maret 2022, merilis video pendek yang mengungkap motif dari sang villain utama yakni Riddler. #TheBatman  https://t.co/zimbW2vs0G",7,0,3,0,2022-01-26,15,Wednesday,3,10,0
1486354434531766277,2022-01-26 15:04:46,Taeyeon SNSD bakal merlis album penuh ketiga berjudul INVU. Album tersebut bisa mulai didengarkan pada 14 Februari 2022. #TaeyeonSNSD  https://t.co/QQzJkFY5OT,3,0,1,1,2022-01-26,15,Wednesday,3,4,1
1486353666034573313,2022-01-26 15:01:43,Metaverse ternyata mulai menarik perhatian para bank. Perusahaan sudah mulai menunjukkan niatnya untuk membuka cabang virtual di Metaverse.  https://t.co/9mqD11uTUo,25,0,11,4,2022-01-26,15,Wednesday,3,36,4
1486352781409759235,2022-01-26 14:58:12,"Kamis (27/1/2022), laga uji coba Timnas Indonesia melawan Timor Leste digelar di Stadion Kapten I Wayan Dipta di Kabupaten Gianyar, Bali. Evan Dimas meminta para pemain timnas tidak meremehkan Timor Leste. https://t.co/WsZ1HF2MfT",7,0,2,0,2022-01-26,14,Wednesday,3,9,0
1486352223990861828,2022-01-26 14:55:59,Sebanyak Rp 750 miliar pendanaan digelontorkan untuk para pelaku UMKM. Pendanaan itu bukan berasal dari pemerintah melainkan dari salah satu platform fintech.  https://t.co/LOv0OBRdka,10,4,4,1,2022-01-26,14,Wednesday,3,14,5
1486351966209032195,2022-01-26 14:54:58,Seolhyun AOA belum lama ini mencuri perhatian lewat foto baru yang diunggah di media sosial. Ia tampil seksi mengenakan gaun hitam. Ini potretnya: https://t.co/TEDe45HLFw,15,1,3,1,2022-01-26,14,Wednesday,3,18,2
1486351232679698432,2022-01-26 14:52:03,Tahun Baru Imlek segera datang. Perayaan ini biasanya diisi dengan penyajian banyak makanan enak yang merupakan lambang keberuntungan. Ada apa saja ya?  https://t.co/qCZOmDs6FA,9,0,1,0,2022-01-26,14,Wednesday,3,10,0
1486350985333288969,2022-01-26 14:51:04,"Kadin Indonesia akan menggelar pertemuan pendahuluan atau B20 Inception Meeting dengan semua delegasi anggota G20 di Jakarta, 27-28 Januari 2022.  https://t.co/1ERV0pdjlr",6,1,3,2,2022-01-26,14,Wednesday,3,9,3
1486350471816265731,2022-01-26 14:49:02,Stok pohon kopi di Bandung kian bertambah. Pohon kopi diharapkan mampu mengangkat perekonomian warga Bandung. https://t.co/GmUpTyoHk0,13,0,1,0,2022-01-26,14,Wednesday,3,14,0
1486350226394857472,2022-01-26 14:48:03,"Mau jadi streamer game handal? Yuk ikutan Esports Talent Hunt (ETH) 2022, di mana pendaftaran gelombang kedua telah dibuka mulai dari 22 - 30 Januari 2022. https://t.co/3WEXmXUH3j",3,0,0,0,2022-01-26,14,Wednesday,3,3,0
1486349595164786696,2022-01-26 14:45:33,"Banyaknya uang yang diberikan PT Pertamina Rosneft Pengolahan dan Petrokimia (PRPP) ternyata tidak berakhir baik untuk kehidupan warga desa di Tuban. Ini kisah sedih mereka, dari kaya hingga merana!  https://t.co/qKqQQDqHpL",49,30,7,3,2022-01-26,14,Wednesday,3,56,33
1486349569978159107,2022-01-26 14:45:27,Salah satu restoran cepat saji ternama di Amerika kabarnya akan menganti nama. Hal ini dikarenakan Jungkook BTS salah menyebutkan nama!  https://t.co/t1jfHCeI11,432,5,103,6,2022-01-26,14,Wednesday,3,535,11
1486348320478011392,2022-01-26 14:40:29,Kemampuan berakting Reza Rahardian tentunya sudah tidak diragukan lagi. Ini beberapa momen dirinya saat berperan menjadi seorang suami di dalam sinetron:  https://t.co/fEZQ549wwf,3,2,0,1,2022-01-26,14,Wednesday,3,3,3
1486347082537619461,2022-01-26 14:35:34,"Steam menyelenggarakan event, di mana menawarkan judul-judul berkualitas dengan harga sangat murah. Bertajuk Steam Lunar Sale, akan digelar pada 27 Februari. https://t.co/CdVCuMRWpX",13,0,7,2,2022-01-26,14,Wednesday,3,20,2
1486345985932636168,2022-01-26 14:31:12,Bintang reality show ini dipecat karena rasis dan antivaksin. Sosialita kontroversial ini juga mempercayai teori konspirasi antara Joe Biden dan Donald Trump. https://t.co/qaKCUGV3Ec,6,0,1,1,2022-01-26,14,Wednesday,3,7,1
1486344968100888580,2022-01-26 14:27:10,Tips kecantikan ini bisa kamu coba untuk menyambut Hari Raya Imlek dengan tampilan mempesona:   https://t.co/RaFicyXTh5,1,0,1,0,2022-01-26,14,Wednesday,3,2,0
1486342994622038016,2022-01-26 14:19:19,"PT PLN (Persero) melakukan sejumlah langkah efisiensi untuk memperbaiki kinerja. Salah satunya, dengan renegosiasi dengan swasta.  https://t.co/TCtpmDw4go",5,1,5,0,2022-01-26,14,Wednesday,3,10,1
1486341880749203460,2022-01-26 14:14:53,"Seorang mantan guru honorer asal Garut, MA, diamankan polisi lantaran nekat membakar sekolah tempat mengajarnya dulu. Polisi menyebut MA sakit hati lantaran honornya selama dua tahun mengajar dulu tak kunjung dibayar. https://t.co/joyjyMDd3P",20,1,3,0,2022-01-26,14,Wednesday,3,23,1
1486340577587257350,2022-01-26 14:09:43,Korlantas Polri sebut truk yang kelebihan muatan atau overdimension dan overloading (ODOL) merupakan kejahatan lalu lintas (lalin). Kendaraan ODOL dinilai sangat berpotensi terjadi kecelakaan lalin. https://t.co/uv0mFioFtI,18,7,4,0,2022-01-26,14,Wednesday,3,22,7
1486339566583877634,2022-01-26 14:05:42,Di tahun 2021 kemarin ekspor daging sapi ke Indonesia justru mengalami penurunan. Apa krisis sapi di Australia jadi penyebabnya?  https://t.co/i00AKaB4jL,7,0,5,0,2022-01-26,14,Wednesday,3,12,0
1486338282581643269,2022-01-26 14:00:36,"Pasangan crazy rich Bali, Kadek Maharani Kemala dan Dewa Gede telah menjadi pebisnis sukses. Namun, mereka ternyata pernah diremehkan, lho. Simak, yuk! #detikNetwork  https://t.co/0Lkcryiz4s",17,1,6,1,2022-01-26,14,Wednesday,3,23,2
1486338239845867525,2022-01-26 14:00:25,Sebelumnya Jerinx memperlihatkan foto pria yang disebut berinisial 'AD' mengacungkan jari tengah sembari memegang foto Presiden Jokowi. https://t.co/qVMCyzMbig,8,0,3,0,2022-01-26,14,Wednesday,3,11,0
1486338237752819721,2022-01-26 14:00:25,"23 orang petani asal Desa Gunung Kramat, Kecamatan Cisolok, Kabupaten Sukabumi melakukan aksi jalan kaki menuju Istana Presiden di Jakarta. https://t.co/l4oCAMrfRm",15,0,5,0,2022-01-26,14,Wednesday,3,20,0
1486337408245321733,2022-01-26 13:57:07,"Tangis haru pecah saat berlangsungnya pemakaman jurnalis asal Pakistan, Husnain Shah. Husnain diketahui tewas ditembak orang tak dikenal di timur Kota Lahore, Pakistan. https://t.co/yXRzFjv3Ak",1,0,3,0,2022-01-26,13,Wednesday,3,4,0
1486336894585778180,2022-01-26 13:55:05,Mantan pegawai pajak di Ditjen Pajak Wawan Ridwan mengalirkan uang korupsinya ke sejumlah orang. Tercatat ada nama mantan pramugari Garuda Siwi Widi. https://t.co/NTmXFlYM8y,310,117,111,120,2022-01-26,13,Wednesday,3,421,237
1486336393303449607,2022-01-26 13:53:05,Presenter Diana Wardhani ngaku membatasi penerimaan endorsement. Hal itu ia dilakukan demi fokus kuliah dan kerja. https://t.co/1r43m9zP3s,11,0,2,0,2022-01-26,13,Wednesday,3,13,0
1486335587430932485,2022-01-26 13:49:53,Jamie Dornan cerita dirinya pernah ikut audisi buat film Thor. Tapi dia gagal buat dapat peran dalam film tersebut. #JamieDornan  https://t.co/qqGpfsS3Yi,5,1,1,0,2022-01-26,13,Wednesday,3,6,1
1486334985594458118,2022-01-26 13:47:29,Komnas KIPI menyebut efek samping vaksin COVID-19 pada anak cenderung lebih rendah dibanding dewasa. KIPI serius paling banyak ditemukan pada usia 31-45 tahun. https://t.co/KgQA7eITdG,6,0,2,1,2022-01-26,13,Wednesday,3,8,1
1486334387092393992,2022-01-26 13:45:07,Anindita Hidayat ngaku jika dirinya sempat ditawari untuk menjadi pelakor di dalam sebuah film. Begini tanggapan Anindita Hidayat:  https://t.co/GoqeDOZ4ye,8,1,3,0,2022-01-26,13,Wednesday,3,11,1
1486333596596068357,2022-01-26 13:41:58,"Di persidangan Munarman, JPU bertanya kepada saksi soal keanggotaan FPI pelaku bom bunuh diri di Filipina. Bagaimana keterangan saksi? https://t.co/QwrqfqhMXG",10,1,2,0,2022-01-26,13,Wednesday,3,12,1
1486332839473913856,2022-01-26 13:38:58,Kim Kardashian akhirnya buka suara dan membantah pernyataan Kanye West soal video seks kedua antara dirinya dan Ray J. Ini keterangan resminya:  https://t.co/84XYwurjQ1,8,0,2,0,2022-01-26,13,Wednesday,3,10,0
1486332583344582657,2022-01-26 13:37:57,Sebelumnya Jerinx memperlihatkan foto pria yang disebut berinisial 'AD' mengacungkan jari tengah sembari memegang foto Presiden Jokowi. https://t.co/tZIBj3BYNA,18,3,3,1,2022-01-26,13,Wednesday,3,21,4
1486332355895832576,2022-01-26 13:37:03,"Kampung halaman mangaka sekaligus pencipta manga One Piece, Eiichiro Oda jadi rumah bagi sejumlah karakter yang diciptakan. https://t.co/C91k6FoSvL",46,2,13,2,2022-01-26,13,Wednesday,3,59,4
1486331371824062467,2022-01-26 13:33:08,"Tokopedia, konsisten membantu masyarakat mendapat akses pendanaan untuk memenuhi kebutuhan harian hingga menjaga kelangsungan usaha. https://t.co/p2ftkIi3Nu",8,0,0,1,2022-01-26,13,Wednesday,3,8,1
1486330653612335112,2022-01-26 13:30:17,LPPOM MUI menggelar tasyakur ulang tahun ke-33 kemarin dan meresmikan laboratorium kimia dan mikrobiologi untuk menganalisis produk.  https://t.co/YY1BaoG9UJ,11,2,0,1,2022-01-26,13,Wednesday,3,11,3
1486329943717986311,2022-01-26 13:27:27,Ekonomi hingga sistem keuangan Indonesia mendapatkan pujian dari Dana Moneter Internasional (International Monetary Fund/IMF).  https://t.co/pdssKGOh6d,18,4,2,1,2022-01-26,13,Wednesday,3,20,5
1486328985474764802,2022-01-26 13:23:39,"Pemerintah Peru meminta perusahaan minyak asal Spanyol, Repsol bertanggung jawab atas tragedi tumpahan minyak di sepanjang pantai Ibu Kota Peru.  https://t.co/EQ3vbFKOpz",13,0,1,1,2022-01-26,13,Wednesday,3,14,1
1486328200556945411,2022-01-26 13:20:32,Rookie Cops mempersatukan Kang Daniel dan Chae Soo Bin. Tim K-Talk pun diberi kesempatan untuk mengobrol dengan keduanya. Simak di sini: #KTalk  https://t.co/HjPz7Hc3dR,400,2,229,2,2022-01-26,13,Wednesday,3,629,4
1486327380230692867,2022-01-26 13:17:16,"Revitalisasi bandara Halim Pedanakusuma, Jakarta Timur dilakukan selama kurang lebih 3,5 bulan. Berikut 5 kabar terbarunya. https://t.co/y8zZRJBSif",5,0,1,2,2022-01-26,13,Wednesday,3,6,2
1486326526568194054,2022-01-26 13:13:53,"Bentrokan maut antara kelompok pemuda Pelauw dan Kei terjadi di Sorong, Papua Barat, Selasa (25/1/2022) dini hari. Selain merenggut belasan nyawa orang, dua mobil dan satu tempat karaoke ikut dibakar massa. https://t.co/bRr0Vy5W75",7,0,0,0,2022-01-26,13,Wednesday,3,7,0
1486325968402796547,2022-01-26 13:11:40,Coba temukan dompet yang beda. Bisa? https://t.co/zuBMvr7G1Y,164,89,12,3,2022-01-26,13,Wednesday,3,176,92
1486324631611088904,2022-01-26 13:06:21,"Berbeda dengan film 'Virgin' yang mengangkat realitas tersembunyi pergaulan remaja tahun 2000-an, serial 'Virgin The Series' mengambil latar era media sosial. https://t.co/TTE9PIIS3K",10,0,0,1,2022-01-26,13,Wednesday,3,10,1
1486324603697999876,2022-01-26 13:06:14,"Aksi kawanan geng motor d=menyerang tempat rental playstation di Kota Kendari, Sultra viral di media sosial. https://t.co/9XcpwaGzTa",15,2,1,1,2022-01-26,13,Wednesday,3,16,3
1486324124066717700,2022-01-26 13:04:20,Thailand menjadi negara pertama di Asia Tenggara yang melegalkan ganja. Negara ini bahkan memperbolehkan warga menanamnya di rumah untuk keperluan medis. https://t.co/doPFQdw8Xx,144,18,39,14,2022-01-26,13,Wednesday,3,183,32
1486323589909565444,2022-01-26 13:02:13,Wanita ini viral karena mengaplikasikan makeup sebanyak 10 layer ke wajahnya. Begini hasilnya:  https://t.co/8B2nQ53ZM2,6,0,1,3,2022-01-26,13,Wednesday,3,7,3
1486322744119734275,2022-01-26 12:58:51,"Kode Redeem Genshin Impact kembali tersaji untuk para penggemarnya. Bisa memperoleh beragam hadiah menarik, mulai dari Primogems, Adventure Exp hingga Mora. https://t.co/BwW5VHo67h",8,1,0,0,2022-01-26,12,Wednesday,3,8,1
1486321988259962880,2022-01-26 12:55:51,"Fuji dan Fadly sering disebut sebagai sibling goals karena kekompakan mereka. Inilah foto terbaru yang curi atensi netizen, bahkan disebut seperti vibe pacaran. https://t.co/chUl5jW9QJ",18,2,2,5,2022-01-26,12,Wednesday,3,20,7
1486321427791888388,2022-01-26 12:53:37,"Ello baru saja melangsungkan pernikahan di Bali. Digelar outdoor, Ello, sang istri, dan para tamu undangan kompak pakai kacamata hitam. Ini potretnya:  https://t.co/8vCqq7ZVGJ",25,1,0,0,2022-01-26,12,Wednesday,3,25,1
1486321406170533893,2022-01-26 12:53:32,Rencana KPK tidak menggunakan istilah OTT dianggap bukan sebagai sesuatu yang penting. Hal yang penting adalah KPK menangkap koruptor kelas kakap. https://t.co/cJArkA2HJW,20,5,4,0,2022-01-26,12,Wednesday,3,24,5
1486320516860420102,2022-01-26 12:50:00,Rihanna merilis lingerie pria untuk menyambut Hari Valentine. Kolaborasi Savage x Fenty kali ini menghadirkan koleksi pakaian dalam pria berwarna merah. https://t.co/sYylhQwPiC,4,0,1,0,2022-01-26,12,Wednesday,3,5,0
1486319780990795786,2022-01-26 12:47:04,"Warga Kelurahan Cilenggang, Serpong, Kota Tangsel, meminta pejabat terkait membangun jembatan penyeberangan orang (JPO) untuk melintasi tol. https://t.co/ENS8vokAK6",8,0,2,1,2022-01-26,12,Wednesday,3,10,1
1486319228563173383,2022-01-26 12:44:53,"Persija Jakarta meluncurkan 'Persija DNA', sebuah panduan mengenai pengembangan pemain muda, yang diharapkan bisa melahirkan pemain-pemain yang kompetitif. https://t.co/gHtwwh7pZE",9,0,2,1,2022-01-26,12,Wednesday,3,11,1
1486318314976645120,2022-01-26 12:41:15,Jamie Brown seorang manajer produksi di Hollywood meninggalkan kehidupan glamournya untuk memperdalam ilmu agama Islam. Ini kisahnya:  https://t.co/PuybnoVi41,85,3,11,2,2022-01-26,12,Wednesday,3,96,5
1486317561436377101,2022-01-26 12:38:15,Raphael Varane mengungkap kesan bermain di musim pertama di Liga Inggris dan menilai Liga Inggris adalah liga terbaik di dunia dengan intensitas yang tinggi. https://t.co/bnqEN1aEFI,8,0,1,1,2022-01-26,12,Wednesday,3,9,1
1486317045981532161,2022-01-26 12:36:12,Menyambut Tahun Baru China 2022 sejumlah brand kecantikan telah merilis produk-produk ikonik bertema Imlek. Ini lima diantarannya:  https://t.co/29QSE45M69,5,0,1,0,2022-01-26,12,Wednesday,3,6,0
1486316010928021512,2022-01-26 12:32:06,"Bagi kamu wanita berhijab yang ingin mengadakan acara pernikahan, ini inspirasi rias pengantin hijab untuk tampil cantik dan pangling:  https://t.co/aYoBt2B9e2",9,0,1,0,2022-01-26,12,Wednesday,3,10,0
1486315899841921026,2022-01-26 12:31:39,"Makan malam di tempat langganannya, pria ini temukan hal mengejutkan. Ia yang memesan semangkuk bubur mendapatkan 'kejutan' kecoa di dalamnya!  https://t.co/MwuWgYvF3r",5,0,1,0,2022-01-26,12,Wednesday,3,6,0
1486315426166546432,2022-01-26 12:29:46,"Perayaan hari kasih sayang, Valentine masih 3 pekan lagi. Namun kesibukan sudah terlihat di pertanian bunga di Kolombia. Siap diekspor ke AS!  https://t.co/w9PYEBDsGL",7,1,0,2,2022-01-26,12,Wednesday,3,7,3
1486315406692339713,2022-01-26 12:29:42,"Indonesia telah mengambil alih pelayanan ruang udara dari Singapura, yaitu ruang udara di atas wilayah Kepulauan Riau dan Natuna.  https://t.co/mlGqV6XvNp",31,8,9,1,2022-01-26,12,Wednesday,3,40,9
1486314865899851784,2022-01-26 12:27:33,Selebgram Marissya Icha mengungkapkan bukti baru terkait dugaan laporan palsu dengan terlapor Medina Zein. https://t.co/wqPpRt9t3g,6,0,0,0,2022-01-26,12,Wednesday,3,6,0
1486314343813853185,2022-01-26 12:25:28,"Bandara Internasional Jawa Barat (BIJB) Kertajati, Majalengka menjadi 1 dari 5 bandara yang menerima perpindahan operasional penerbangan dari Bandara Halim.  https://t.co/sUuFeqc6mb",3,0,0,0,2022-01-26,12,Wednesday,3,3,0
1486314106734919682,2022-01-26 12:24:32,"Indonesia Vs Timor Leste sempat direncanakan main di depan penonton di stadion, bikin Shin Tae-yong antusias.Tetapi rencana itu batal! https://t.co/QlO5oJORt7",5,0,0,0,2022-01-26,12,Wednesday,3,5,0
1486313532014698498,2022-01-26 12:22:15,Prakiraan cuaca besok untuk seluruh wilayah Indonesia sudah dirilis oleh BMKG. Simak informasinya berikut ini. https://t.co/FG7WJKQX4g,1,0,0,0,2022-01-26,12,Wednesday,3,1,0
1486313288392744963,2022-01-26 12:21:16,Sejak 2021 kemarin Toyota Indonesia sudah memastikan akan memproduksi kendaraan elektrifikasi di Indonesia. https://t.co/8euVMXAzLb,8,1,1,0,2022-01-26,12,Wednesday,3,9,1
1486313027041439746,2022-01-26 12:20:14,"Di pemakaman, Nurul Arifin mengungkapkan penyesalannya. Ia baru sadar ternyata waktu bersama keluarga lebih penting ketimbang pekerjaan...  https://t.co/DJj3wBt9pB",20,0,2,2,2022-01-26,12,Wednesday,3,22,2
1486313007756025858,2022-01-26 12:20:10,Polisi menangkap pelaku tabrak lari yang menewaskan dua orang di Tol Madiun Jawa Timur. Berikut identitas pelaku. https://t.co/pcZk6qg9XA,11,1,1,0,2022-01-26,12,Wednesday,3,12,1
1486312435837546500,2022-01-26 12:17:53,"Si kecil rewel terus gegara sakit gigi yang tak kunjung sembuh? Tak perlu khawatir, ini ada 6 obat sakit gigi anak tradisional yang bisa dicoba di rumah. https://t.co/2tluXgQX1H",6,0,4,0,2022-01-26,12,Wednesday,3,10,0
1486312416682119168,2022-01-26 12:17:49,"Rano Karno turut berduka atas kepergian putri Nurul Arifin, Maura Magnalia. Rano Karno ingatkan kesehatan jantung.  https://t.co/YvQsAEvnRa",14,0,0,0,2022-01-26,12,Wednesday,3,14,0
1486310601869733890,2022-01-26 12:10:36,"Token kripto milik Anang Hermansyah, ASIX mendapatkan respons positif dari masyarakat. Setelah sebelumnya dilakukan private sale dan ludes dalam waktu 1 menit!  https://t.co/s6bwnfdMOE",23,22,5,12,2022-01-26,12,Wednesday,3,28,34
1486310511511810059,2022-01-26 12:10:14,"Ada berbagai jenis tes dalam tahap seleksi calon taruna sekolah kedinasan. Berikut jenis tes sekolah kedinasan yang bisa kamu persiapkan dari sekarang.

via: detikedu  https://t.co/kLh6Ofc8yw",4,0,0,0,2022-01-26,12,Wednesday,3,4,0
1486310146875838469,2022-01-26 12:08:47,"Sekretaris Jenderal DPP Partai Golkar, Lodewijk F. Paulus mengapresiasi kesepakatan jadwal pemilihan Umum (Pemilu) antara KPU, DPR, dan pemerintah. https://t.co/iHb8y6Kfk0",3,0,0,0,2022-01-26,12,Wednesday,3,3,0
1486309559144783874,2022-01-26 12:06:27,"Konsumsi vitamin diperlukan untuk meningkatkan imunitas tubuh. Namun, hal ini tetap harus diperhatikan menurut pakar.  https://t.co/fu5USoP5KS",9,0,1,0,2022-01-26,12,Wednesday,3,10,0
1486309321981972482,2022-01-26 12:05:31,NPC Indonesia bakal menyambangi Kemenpora pada Kamis (27/1/2022). Pertemuan guna membahas anggaran ASEAN Para Games. https://t.co/a1sYLUvFPH,5,0,1,0,2022-01-26,12,Wednesday,3,6,0
1486308683927719940,2022-01-26 12:02:59,"KPK tetapkan mantan Bupati Buru Selatan, Tagop Sudarsono Soulisa, sebagai tersangka kasus suap proyek infrastruktur, gratifikasi, serta TPPU. https://t.co/rGSeoV5Yl0",11,0,3,0,2022-01-26,12,Wednesday,3,14,0
1486308658849931266,2022-01-26 12:02:53,Driver ojol yang eksis dengan nama Babeh Ojol membuat video parodi yang mengundang tawa. Ia membuat parodi video klip Noah dengan judul 'Menghapus Laparmu'.  https://t.co/p4mkxG7tzo,33,2,5,1,2022-01-26,12,Wednesday,3,38,3
1486308103549292550,2022-01-26 12:00:40,Warga Thailand kini lebih memilih mengkonsumsi daging buaya dibandingkan daging babi. Apa penyebabnya? Baca selengkapnya di #CNNIndonesia. #detikNetwork  https://t.co/VtblsNeC02,31,7,3,6,2022-01-26,12,Wednesday,3,34,13
1486308082602979335,2022-01-26 12:00:35,"International Monetary Fund (IMF) memotong proyeksi pertumbuhan ekonomi Indonesia tahun 2022 menjadi 5,6% dari sebelumnya 5,9%.  https://t.co/af1NSxfZET",5,0,1,0,2022-01-26,12,Wednesday,3,6,0
1486307572244119556,2022-01-26 11:58:34,"Selama 2020-2021, gandum asal Australia diekspor sebesar AU$ 1,2 miliar atau sekitar Rp 12,2 triliun (kurs Rp 10.200) ke Indonesia dan ada yang dipakai untuk membuat indomie!  https://t.co/qN0P2xhXlK",21,2,5,1,2022-01-26,11,Wednesday,3,26,3
1486307553936121860,2022-01-26 11:58:29,"#terpopuler Tahun lalu, muncul fenomena warga satu desa di Tuban, mendadak jadi miliarder setelah mendapat ganti rugi pembebasan lahan proyek kilang di kawasan tersebut, namun kini...  https://t.co/XyTs4IuS7U",10,1,1,0,2022-01-26,11,Wednesday,3,11,1
1486307074116100098,2022-01-26 11:56:35,"Wakil Ketua Komisi IX DPR dari Fraksi Partai Keadilan Sejahtera (PKS), Ansori Siregar, menemui massa buruh di Depan Gedung DPR, Rabu (26/1). Ansori menegaskan sejak awal PKS menolak UU Cipta Kerja. https://t.co/P6ewdb5vKF",15,1,1,2,2022-01-26,11,Wednesday,3,16,3
1486306819794522112,2022-01-26 11:55:34,Kasus ujaran kebencian Edy Mulyadi kini telah dinaikkan ke tahap penyidikan. Polisi akan memanggil Edy Mulyadi untuk hadir ke Bareskrim sebagai saksi pada Jumat (28/1) mendatang. https://t.co/1ibh1KunYM,20,12,3,0,2022-01-26,11,Wednesday,3,23,12
1486306306260672521,2022-01-26 11:53:32,Uji coba Timnas Indonesia melawan Timor Leste menjadi ajang pemilihan pemain buat Piala AFF U-23 2022. Shin Tae-yong akan menyaring pemain dalam dua uji coba. https://t.co/xTwB5vjoLS,12,0,0,0,2022-01-26,11,Wednesday,3,12,0
1486306284106362880,2022-01-26 11:53:27,"Bandara Halim Perdanakusuma, Jakarta Timur direvitalisasi selama 3,5 bulan. Penerbangan pun pindah ke lima bandara, berikut daftarnya: https://t.co/G9cx2ALQfs",10,0,0,0,2022-01-26,11,Wednesday,3,10,0
1486305784791244801,2022-01-26 11:51:27,"Nurul Arifin tak kuasa menahan air mata saat mengantar langsung jenazah putrinya, Maura Magnalia Madyaratri ke tempat peristirahatan terakhir di San Diego Hills. https://t.co/NMiJ7p0y4l",9,0,0,0,2022-01-26,11,Wednesday,3,9,0
1486305565156552704,2022-01-26 11:50:35,"Meski belum pulih total, kondisi Tukul Arwana membaik sejak fisioterapi. Keluarga juga menyebut tubuh sang artis semakin kurus. #TukulArwana  https://t.co/uj7to2YzxB",33,2,5,0,2022-01-26,11,Wednesday,3,38,2
1486305543832616961,2022-01-26 11:50:30,"Hidangan China punya banyak penggemar. Terbukti dengan ramainya restoran China klasik hingga modern, bahkan yang legendaris pun tak pernah sepi pengunjung.  https://t.co/2pGFW4mIk5",7,0,0,0,2022-01-26,11,Wednesday,3,7,0
1486304309566447619,2022-01-26 11:45:36,Seorang pria menunjukkan cara mengolah soto menjadi puding. Ia lantas melahapnya dengan sambal dan aneka sate. Netizen menyebut cara makan ini sekte baru!  https://t.co/esjTdIjzn8,11,2,3,4,2022-01-26,11,Wednesday,3,14,6
1486303982570160138,2022-01-26 11:44:18,"Berdasarkan data LTMPT, prodi favorit SNMPTN ITB bisa dilihat dari daya tampung 2021 dan peminat 2020 untuk masing-masing fakultas. Berikut daftarnya.

via: detikedu  https://t.co/nNi5wsjOsK",6,0,1,1,2022-01-26,11,Wednesday,3,7,1
1486303960793296896,2022-01-26 11:44:13,Kadang hal yang tampak sederhana bisa jadi jebakan yang mengecoh logika. Buktikan kecerdasan kamu dengan menjawab teka-teki ini. https://t.co/PdK289EsE7,328,373,34,18,2022-01-26,11,Wednesday,3,362,391
1486302428383358978,2022-01-26 11:38:07,"Eks Bupati Buru Selatan, Tagop Sudarsono Soulisa, ditetapkan KPK sebagai tersangka suap, gratifikasi, serta TPPU. Harta kekayaan Tagop senilai Rp 15,8 miliar. https://t.co/ENXkpk0id6",15,0,5,5,2022-01-26,11,Wednesday,3,20,5
1486302183213645825,2022-01-26 11:37:09,JPU menghadirkan saksi berinisial B di sidang lanjutan kasus dugaan terorisme eks Sekretaris FPI Munarman.  https://t.co/SVfhETU4GR,4,0,2,1,2022-01-26,11,Wednesday,3,6,1
1486301934034300937,2022-01-26 11:36:09,Fashion show Chanel terbaru dibuka dengan penampilan Putri Monaco yang menunggang kuda. Kehadiran seekor kuda dinilai netizen bentuk eksploitasi hewan. https://t.co/5ZYKdFg6l2,4,0,0,0,2022-01-26,11,Wednesday,3,4,0
1486301716077232135,2022-01-26 11:35:17,Hari ini pemerintah mencatat kasus harian positif Corona sebanyak 7.010 kasus. Kasus Corona tampak terus mengalami kenaikan dalam dua pekan terakhir. https://t.co/8CBKAuieGb,14,1,3,5,2022-01-26,11,Wednesday,3,17,6
1486301693151260672,2022-01-26 11:35:12,"Sedang mempertimbangkan beasiswa luar negeri dengan syarat bahasa Inggris yang tidak terlalu berat? Yuk, cek dulu beasiswa dengan syarat IELTS di bawah 6,5 ini.

via: detikedu  https://t.co/uwV1dWUFHo",12,0,2,0,2022-01-26,11,Wednesday,3,14,0
1486301192070344705,2022-01-26 11:33:12,Squid Game dan BTS masuk dalam nominasi 2022 Art Directors Guild Awards. Ajang penghargaan akan digelar 5 Maret 2022.  https://t.co/Fj8ou2Wv83,12,1,2,1,2022-01-26,11,Wednesday,3,14,2
1486300129330094085,2022-01-26 11:28:59,Martin Braithwaite telah kembali bermain setelah cedera parah di awal musim ini. Dia menceritakan bagaimana perjuangan untuk memotivasi diri sendiri. https://t.co/Q3Bw8Gze0E,12,1,0,0,2022-01-26,11,Wednesday,3,12,1
1486299801914335238,2022-01-26 11:27:41,"Indonesia semakin dekat untuk pemindahan Ibu Kota Negara. Ditandai oleh dukungan politik DPR, PKS menjadi fraksi yang menolak. Simak pembahasan selengkapnya dalam 'Adu Persepktif'. Tayang secara langsung malam ini pukul 20.00 WIB. Jangan ketinggalan ya! https://t.co/Vs0XGLPJfc https://t.co/zFbVNkYnzc",23,7,4,4,2022-01-26,11,Wednesday,3,27,11
1486299653234647041,2022-01-26 11:27:06,"Gelak tawa warga Surabaya bermain air di kolam renang Plaza Marina kini hanya tinggal kenangan. Akibat pandemi, kolam favorit pelajar Surabaya ini tutup! https://t.co/g2avjoIqQU",3,0,3,3,2022-01-26,11,Wednesday,3,6,3
1486299400892825602,2022-01-26 11:26:05,Es teh manis di plastik jadi minuman kegemaran orang Indonesia. Ternyata ada cara minum es teh manis sesuai etiket agar terlihat lebih elegan. Begini caranya!  https://t.co/oJHCVXRj7H,5,3,0,1,2022-01-26,11,Wednesday,3,5,4
1486299387030556676,2022-01-26 11:26:02,"Jerome Polin adalah YouTuber terkenal asal Indonesia. Ia memiliki sejumlah fakta kuliner menarik, termasuk jejaknya melebarkan sayap ke bisnis kuliner.  https://t.co/wxVrFGsmMr",9,0,0,0,2022-01-26,11,Wednesday,3,9,0
1486299035245977600,2022-01-26 11:24:38,"Ada seorang hamba Allah SWT, Uzair, yang pernah ditakdirkan meninggal selama 100 tahun dan dihidupkan kembali. Kisah ini dinukil dari surat Al Baqarah ayat 259.

via; detikedu  https://t.co/nbJ0epbKku",37,0,5,0,2022-01-26,11,Wednesday,3,42,0
1486298263842078721,2022-01-26 11:21:34,Rio Ferdinand merasa klausul Ballon d'Or dalam kontrak Anthony Martial di Manchester United membebani sang pemain! https://t.co/qLCGxSJzSi,5,0,0,1,2022-01-26,11,Wednesday,3,5,1
1486297416005476352,2022-01-26 11:18:12,"Maura Magnalia meninggal dalam usia belum genap 28 tahun dan punya banyak latar cerita kehidupan. Sebagai orang tua, Nurul Arifin mendapat pelajaran dan pesan.  https://t.co/7pQlVmYF0N",15,0,6,1,2022-01-26,11,Wednesday,3,21,1
1486297398003576845,2022-01-26 11:18:08,"Tentara bernama Angga ini punya hobi unik. Ia selalu makan menggunakan banyak sambal, kini ia pun populer di medsos termasuk TikTok!  https://t.co/yyvK6J5OkA",6,1,1,1,2022-01-26,11,Wednesday,3,7,2
1486296820426981379,2022-01-26 11:15:50,Jokowi memberikan pembebasan bea materai untuk sejumlah dokumen. Hal itu diatur dalam Peraturan Pemerintah (PP) Nomor 3 Tahun 2022.  https://t.co/t7KjfAlkWD,8,0,1,0,2022-01-26,11,Wednesday,3,9,0
1486296525990944770,2022-01-26 11:14:40,"Utang dana talangan penanganan masalah lumpur Lapindo Sidoarjo, Jawa Timur yang dilakukan PT Lapindo Minarak Jaya (LMJ) milik keluarga Bakrie belum juga selesai. Ini yang akan dilakukan apabila tak kunjung dibayar utangnya.  https://t.co/vV82rUP2mw",20,1,3,2,2022-01-26,11,Wednesday,3,23,3
1486296516142764034,2022-01-26 11:14:38,"Kelulusan 9 calon pegawai negeri sipil (PNS) di Badan Kepegawaian Negara (BKN) dibatalkan, bagaimana bisa terjadi?  https://t.co/qFBBtPDFPL",4,5,4,0,2022-01-26,11,Wednesday,3,8,5
1486295468799893506,2022-01-26 11:10:28,Presiden Konfederasi Serikat Pekerja Indonesia (KSPI) Said Iqbal menyentil kenaikan upah minimum provinsi (UMP) hanya setengah dari harga toilet umum!  https://t.co/5F8X0IEKxq,11,6,1,2,2022-01-26,11,Wednesday,3,12,8
1486294964082466821,2022-01-26 11:08:28,Wakil Ketua KPK Alexander Marwata sempat mengungkap laporan harta kekayaan penyelenggara negara (LHKPN) saat rapat kerja bersama Komisi III DPR RI. https://t.co/mnv4L5wKbF,9,2,0,0,2022-01-26,11,Wednesday,3,9,2
1486294366742368256,2022-01-26 11:06:05,"Maura Magnalia meninggal karena henti jantung. Ternyata, ini bukan pertama kali keluarga Nurul Arifin mengalami kejadian meninggal seperti Maura. https://t.co/bQxcG30VCJ",14,0,0,0,2022-01-26,11,Wednesday,3,14,0
1486294344881651721,2022-01-26 11:06:00,"Pria asal Inggris, Michael Leigh-Mallory mendadak jadi miliarder setelah secara kebetulan menemukan sekeping koin emas Raja Henry III dan menjualnya seharga Rp 12,5 M!  https://t.co/8W3Yu0rzQc",16,1,1,0,2022-01-26,11,Wednesday,3,17,1
1486293844475924482,2022-01-26 11:04:01,Demam non-fungible token (NFT) masih berlanjut. Kali ini seorang pria menjual motornya di OpenSea sebesar Rp 712 juta. Ada yang minat?  https://t.co/jcAv3tsuz9,15,2,0,0,2022-01-26,11,Wednesday,3,15,2
1486293843070881794,2022-01-26 11:04:00,"Anji resmi merilis single barunya pascarehabilitasi. Single itu bertajuk, Disiksa Rindu. Ini Anji ajak kolaborasi Nissa Sabyan:  https://t.co/N8dKnsxs7R",10,0,0,1,2022-01-26,11,Wednesday,3,10,1
1486293234888364036,2022-01-26 11:01:35,"Bandara Halim Perdanakusuma, Jakarta, resmi ditutup sementara selama 3,5 bulan. Penutupan dilakukan mulai hari ini dalam rangka revitalisasi.  https://t.co/617KjQzVn8",6,0,5,2,2022-01-26,11,Wednesday,3,11,2
1486292910639394821,2022-01-26 11:00:18,"Lawan Timor Leste, Timnas Indonesia akan tanpa Witan, Asnawi, Egy, dan Elkan Baggott. Bagaimana pengaruhnya ke kekuatan Skuad Garuda? https://t.co/FL7UArJQom",5,0,1,3,2022-01-26,11,Wednesday,3,6,3
1486292891261710339,2022-01-26 11:00:13,PT PLN (Persero) tengah memproses pembubaran anak usahanya PT PLN Batubara. Anak usaha ini jadi sorotan ketika PLN kesulitan mendapat pasokan batu bara.  https://t.co/KBYnyS8zal,3,0,2,0,2022-01-26,11,Wednesday,3,5,0
1486292876518645763,2022-01-26 11:00:10,"Cari info lokasi vaksin booster Surabaya? Cek syarat, jadwal, lokasi, dan cara daftarnya di sini. Buruan amankan slot, sebelum kehabisan. https://t.co/sZwupXc877",2,0,0,0,2022-01-26,11,Wednesday,3,2,0
1486292498087661572,2022-01-26 10:58:40,Yamaha RNF menyertakan nama Darryn Binder untuk line-up MotoGP 2022. Rider Afrika Selatan itu dikenal sebagai pebalap yang agresif. https://t.co/9AEWlKtuIE,4,0,0,0,2022-01-26,10,Wednesday,3,4,0
1486292288120791046,2022-01-26 10:57:50,"Kepada awak media, Andi Mulya Siregar menyebutkan jika Agustin yang merupakan pihak pelapor jadi oknum yang tak bertanggung jawab. https://t.co/Tl74CTYCRS",1,0,0,0,2022-01-26,10,Wednesday,3,1,0
1486292268529168386,2022-01-26 10:57:45,Pasar mobil bekas diprediksi akan tumbuh tahun 2022 ini. Hal itu berdasarkan survei yang dilakukan OLX Autos. https://t.co/90Ovk9AuWN,4,0,0,0,2022-01-26,10,Wednesday,3,4,0
1486291753879707650,2022-01-26 10:55:42,"Anang Hermansyah tertarik menekuni investasi digital NFT. Namun, masih ada bayang-bayang fatwa haram MUI terkait kripto.  https://t.co/dwXWkfjTXw",10,10,1,1,2022-01-26,10,Wednesday,3,11,11
1486291752705212419,2022-01-26 10:55:42,"Holding-subholding PT PLN akan segera dibentuk. Dalam pembentukan ini, manajemen PLN akan belajar dari sejumlah perusahaan global untuk mencari bentuk yang pas.  https://t.co/QB3Kmd9fcV",3,0,1,0,2022-01-26,10,Wednesday,3,4,0
1486291727161991172,2022-01-26 10:55:36,Sekitar 300 pengusaha kecil dan menengah (UKM) di Korea Selatan mencukur kepalanya hingga nyaris gundul. Hal ini sebagai bentuk protes terhadap pembatasan Covid-19!  https://t.co/UHxyBTSHfY,2,0,0,0,2022-01-26,10,Wednesday,3,2,0
1486291519170658308,2022-01-26 10:54:46,Pengadilan Negeri Jakarta Selatan menggelar sidang perdana kasus penipuan rekrutmen CPNS yang melibatkan Olivia Nathania. Tapi sayangnya tidak ada ucapan maaf. https://t.co/Ph4jT61EB7,5,0,0,0,2022-01-26,10,Wednesday,3,5,0
1486291514724659202,2022-01-26 10:54:45,Katrina Kaif membagikan foto liburan ke Maldives. Potret seksi sang aktris Bollywood diganjar lebih dari dua juta likes. Ini potretnya:  https://t.co/xiqeO9Plft,6,0,0,1,2022-01-26,10,Wednesday,3,6,1
1486290991078420486,2022-01-26 10:52:40,"Anak Nia Daniaty, Olivia Nathania didakwa kasus penipuan terkait rekrutmen CPNS fiktif. Olivia terancam hukuman 4-6 tahun penjara. https://t.co/tCvFHi2dRo",6,0,1,0,2022-01-26,10,Wednesday,3,7,0
1486290487787069446,2022-01-26 10:50:40,Sarung tangan yang dipakai Jokowi saat menggunakan motor kustom berasal dari merek Bellissimo Apparel. Berikut cerita di balik sarung tangan motor Jokowi! https://t.co/8gvAjqLEk5,5,0,0,0,2022-01-26,10,Wednesday,3,5,0
1486289980754378752,2022-01-26 10:48:40,Film KKN Di Desa Penari akhirnya akan segera tayang di bioskop Indonesia. Ini Cerita Calvin Jeremy rasakan beban berat bintangi film KKN Di Desa Penari:  https://t.co/ZxamcT8Qug,10,2,1,1,2022-01-26,10,Wednesday,3,11,3
1486289965646548992,2022-01-26 10:48:36,Peter Dinklage tak suka dengan rencana Disney membuat live action Snow White and the Seven Dwarfs. Ini alasannya:  https://t.co/aYyastt3Ih,2,0,1,0,2022-01-26,10,Wednesday,3,3,0
1486289188131684352,2022-01-26 10:45:31,PT Bank Negara Indonesia Tbk (BNI) akan melakukan aksi korporasi dengan mencaplok PT Bank Mayora. Nantinya Bank Mayora akan dijadikan bank digital.  https://t.co/1rsphZv2OS,18,0,1,0,2022-01-26,10,Wednesday,3,19,0
1486289181273903105,2022-01-26 10:45:29,Komisi VII DPR dan Direktur Utama PT PLN Darmawan Prasodjo menggelar rapat membahas program prioritas PLN 2022 hingga pasokan energi primer termasuk batu bara.  https://t.co/uhIstZpxJJ,9,0,1,1,2022-01-26,10,Wednesday,3,10,1
1486289157119176704,2022-01-26 10:45:23,"Dalam rangka menyambut Hari Gizi dan Makanan Nasional, Tokopedia bersama Celebrity Chef, Norman Ismail ingin membagikan tips memasak makanan sehat. Setidaknya ada 5 tips yang perlu diperhatikan saat memasak makanan sehat.
https://t.co/IPGZuRwzv4",2,1,3,0,2022-01-26,10,Wednesday,3,5,1
1486288656742633474,2022-01-26 10:43:24,"Marc Marquez akan kembali ke lintasan balap, ia akan mengikuti tes pramusim MotoGP 2022 di Sepang dan Mandalika. https://t.co/lOsXzzu618",11,0,1,0,2022-01-26,10,Wednesday,3,12,0
1486288100519198724,2022-01-26 10:41:11,Pembangunan jalan lingkar utara Tasikmalaya yang dimulai sejak 2016 hingga kini belum selesai. Masyarakat berharap pembangunan jalan ini dapat segera rampung.  https://t.co/Gz81WzHcO7,7,0,4,0,2022-01-26,10,Wednesday,3,11,0
1486287943543271428,2022-01-26 10:40:34,"Kasus aktif Corona di Indonesia melonjak, menembus hampir 30 ribu orang. Hampir setengahnya disumbang DKI Jakarta, ini sebaran kasus aktif Corona terbaru. https://t.co/AJewvRsuYD",24,12,9,1,2022-01-26,10,Wednesday,3,33,13
1486287707378798593,2022-01-26 10:39:37,Kenapa penggunaan kripto masih populer meski sudah muncul fatwa haram dari MUI. Gus Miftah memberikan sedikat pandangan.  https://t.co/GEkO3maI0e,24,12,4,3,2022-01-26,10,Wednesday,3,28,15
1486287683014045701,2022-01-26 10:39:32,"Terus meroket, penambahan kasus harian COVID-19 di Indonesia menembus angka 7 ribu kasus. Dengan tambahan 7.010 kasus, total kasus menjadi 4.301.193 kasus. https://t.co/7n0vgCrnDQ",7,3,3,0,2022-01-26,10,Wednesday,3,10,3
1486287586901610499,2022-01-26 10:39:09,"Direktur Jenderal Kekayaan Negara Kemenkeu Rionald Silaban mengatakan saat ini aset negara yang ada di Jakarta berkisar Rp 1.400 triliun dan kalau ibu kota pindah, maka aset yang menganggur bisa Rp 300 T!  https://t.co/30ADn3dqgr",12,5,7,0,2022-01-26,10,Wednesday,3,19,5
1486287334186405891,2022-01-26 10:38:09,"Indonesia mencatat sebanyak 7.010 kasus baru COVID-19, Rabu (26/1/2022). DKI menyumbang kasus terbanyak dengan jumlah 3.509 kasus. https://t.co/EBkMGTF8nI",19,5,5,6,2022-01-26,10,Wednesday,3,24,11
1486287094469337091,2022-01-26 10:37:11,"Sebuah ruko vape di Jalan Boulevard Raya, Kelapa Gading, Jakarta Utara terbakar. Kerugian ditaksir mencapai Rp 30 juta. https://t.co/Bn4VLRx4fI",5,0,0,1,2022-01-26,10,Wednesday,3,5,1
1486286866810818561,2022-01-26 10:36:17,Chansung 2PM berencana akan menikah pada awal 2022. Identitas sang tunangan kini jadi pembicaraan. #Chansung  https://t.co/FAulgKL749,3,0,0,1,2022-01-26,10,Wednesday,3,3,1
1486286621842550789,2022-01-26 10:35:19,"Warga kampung miliarder di Tuban kini nasibnya tak seberuntung dahulu. Terbaru, warga kampung tersebut malah harus menjual sapi. Kenapa? Baca di sini. #detikNetwork  https://t.co/rQvOWrJrgd",9,4,3,6,2022-01-26,10,Wednesday,3,12,10
1486286606420127750,2022-01-26 10:35:15,Polisi mengungkap pembunuhan pemuda inisial AY (19) yang tewas dengan kaki-tangan terikat dan mulut tertutup lakban. https://t.co/3a9y8mCOTx,1,2,0,0,2022-01-26,10,Wednesday,3,1,2
1486286037248843777,2022-01-26 10:32:59,"Kasus COVID-19 di Korsel mengganas. Negara itu melaporkan 13 ribu kasus dalam sehari, terbanyak selama pandemi COVID-19. https://t.co/iLlDNcRdTY",7,1,1,0,2022-01-26,10,Wednesday,3,8,1
1486285543877099528,2022-01-26 10:31:02,Waketum Demokrat Benny Harman curiga masih ada kasus korupsi yang disembunyikan oleh KPK. Benny meminta Ketua KPK membuka saja kasus tersebut. https://t.co/VWh8IhGkZe,24,19,3,2,2022-01-26,10,Wednesday,3,27,21
1486285523870265344,2022-01-26 10:30:57,Duel tim papan bawah BRI Liga 1 2021 antara Persiraja Banda Aceh melawan Persela Lamongan berakhir dengan skor imbang 2-2. https://t.co/PfQbJorUSZ,1,0,0,0,2022-01-26,10,Wednesday,3,1,0
1486285008662843392,2022-01-26 10:28:54,"Karena bisnis menjual kentut dalam stoples, Stephanie pernah mengalami gejala serangan jantung dan mendapat ancaman kematian. Ini kisahnya:  https://t.co/F4XMmw9K5j",9,5,2,3,2022-01-26,10,Wednesday,3,11,8
1486284511335878658,2022-01-26 10:26:55,"Tim juru kunci di Serie A Liga Italia, Salernitana, dikabarkan sedang memburu Diego Costa! https://t.co/ePV1xKsQEV",4,0,1,0,2022-01-26,10,Wednesday,3,5,0
1486284014222819330,2022-01-26 10:24:57,"Bandara Halim Perdanakusuma ditutup sementara mulai Rabu, 26 Januari 2022. Nantinya, Bandara Halim akan dilakukan revitalisasi. https://t.co/hiGThEy8JU",10,2,1,0,2022-01-26,10,Wednesday,3,11,2
1486284000977211393,2022-01-26 10:24:54,"Adik mendiang Maura Magnalia Madyaratri, Melkior Mirari Manusaktri, anak kedua Nurul Arifin memberikan pesan mendalam atas kepergian sang kakak. Begini pesannya dengan nada suara bergetar. https://t.co/K6GdXWugft",4,0,0,0,2022-01-26,10,Wednesday,3,4,0
1486283706843246597,2022-01-26 10:23:44,"Bentrokan antara warga Desa Kariu dan Desa Ori terjadi hari ini Rabu (26/1) di Maluku Tengah, Maluku. Bentrokan tersebut mengakibatkan 2 orang warga tewas dan 1 polisi luka-luka. https://t.co/Pz0UzeoXli",4,0,1,0,2022-01-26,10,Wednesday,3,5,0
1486283687935287297,2022-01-26 10:23:39,Duel tim papan bawah BRI Liga 1 2021 antara Persiraja Banda Aceh melawan Persela Lamongan berakhir dengan skor imbang 2-2. https://t.co/iej4H0NwdI,5,0,0,0,2022-01-26,10,Wednesday,3,5,0
1486283444942524419,2022-01-26 10:22:41,"Situs Marc Jacobs dikabarkan mengalami glitch atau gangguan sementara. Akibatnya, produk tas terkorting sampai 100 persen. https://t.co/WaIY1b6NyB",3,0,3,1,2022-01-26,10,Wednesday,3,6,1
1486283421752168453,2022-01-26 10:22:36,"Alur vaksin Covid perlu diketahui bagi masyarakat yang hendak melakukan vaksinasi booster. Simak ya, ini prosesnya mulai cek tiket hingga penyuntikan. https://t.co/Z41Q4yOPTX",3,0,3,0,2022-01-26,10,Wednesday,3,6,0
1486282862559125512,2022-01-26 10:20:22,"Kabar bahagia datang dari Marcello Tahitoe. Diam-diam, Ello telah menikahi sang kekasih, Cindy Maria. Pernikahan tersebut digelar pada Selasa (25/1) di Ulu Cliffhouse, Bali. https://t.co/1cvgv713sJ",4,0,1,0,2022-01-26,10,Wednesday,3,5,0
1486282842397102081,2022-01-26 10:20:18,Bupati Bogor Ade Yasin menyoroti pencemaran di Situ Citongtut. DLH Bogor menduga ada 4 perusahaan yang diduga membuang limbah ke Situ Citongtut. https://t.co/ciBzpyqlcJ,2,0,0,0,2022-01-26,10,Wednesday,3,2,0
1486282617343385600,2022-01-26 10:19:24,"Tulisan 'Selamat Datang' di Gerbang Geopark Ciletuh Palabuhanratu, Kabupaten Sukabumidikeluhkan traveler. Tulisannya kecil banget! https://t.co/99J0OqNkJI",10,0,2,0,2022-01-26,10,Wednesday,3,12,0
1486281280740368390,2022-01-26 10:14:05,Firli Bahuri menepis tudingan Benny K Harman bahwa KPK menyembunyikan perkara. Firli memastikan penanganan perkara di KPK dilakukan dengan transparan. https://t.co/RPnQGqcLbg,12,0,0,0,2022-01-26,10,Wednesday,3,12,0
1486279753107750916,2022-01-26 10:08:01,Lowongan kerja sedang dibuka BUMN PT Virama Karya untuk lulusan S1. Cek persyaratan lengkapnya di sini. https://t.co/PH6zUwhIvB,14,0,2,1,2022-01-26,10,Wednesday,3,16,1
1486279751727788035,2022-01-26 10:08:01,"Jumlah kasus positif COVID-19 di Indonesia bertambah 7.010, Rabu (26/1/2022). Total kasus positif menjadi 4.301.193, sembuh 4.127.662, dan meninggal 144.254. https://t.co/9q92UhPWFG",7,2,4,3,2022-01-26,10,Wednesday,3,11,5
1486279520336416772,2022-01-26 10:07:06,Jadwal KRL Cikarang-Jakarta dan sebaliknya perlu diperhatikan agar pengguna tak ketinggalan kereta. Cek di sini. https://t.co/iMviXcbAKw,6,0,3,0,2022-01-26,10,Wednesday,3,9,0
1486278785779519488,2022-01-26 10:04:10,Bareskrim telah menaikkan kasus ujaran kebencian Edy Mulyadi ke penyidikan. Edy dan sejumlah saksi akan menjalani pemeriksaan sebagai saksi Jumat mendatang. https://t.co/JHJTcqPhrW,85,26,15,5,2022-01-26,10,Wednesday,3,100,31
1486277280200540161,2022-01-26 09:58:11,"Setahun yang lalu, warga di sebuah desa di Tuban menjadi miliarder berkat uang ganti rugi hasil pembebasan tanah untuk pembangunan proyek kilang pertamina, tetapi kini...  https://t.co/g324BJqgDK",51,32,8,8,2022-01-26,9,Wednesday,3,59,40
1486276704524029955,2022-01-26 09:55:54,"Syukurlah, Kementerian Kesehatan RI membawa kabar melegakan bagi masyarakat soal kondisi klinis pasien Omicron di Indonesia, meski jumlah kasus mencapai 1.766. https://t.co/4z2CrFAe9i",5,0,0,0,2022-01-26,9,Wednesday,3,5,0
1486276187454328836,2022-01-26 09:53:51,Toyota Motor Corp akan memangkas produksi mereka di Jepang hingga 65.000 unit akibat kurangnya suplai semikonduktor. Gimana nasibnya di Indoensia? https://t.co/8M3DEvqxHR,5,0,0,0,2022-01-26,9,Wednesday,3,5,0
1486275619637927938,2022-01-26 09:51:36,"Di Jawa Timur ternyata masih ada wilayah yang menerapkan PPKM level 3. Wilayah tersebut yakni Pamekasan, Madura. Simak informasi terbarunya: https://t.co/JdliKhMlIR",9,0,0,0,2022-01-26,9,Wednesday,3,9,0
1486275365228224517,2022-01-26 09:50:35,"""Tim IMF mendukung komitmen pihak berwenang untuk keluar dari pembiayaan anggaran pada akhir 2022,"" kata IMF.  https://t.co/y1He20MeJX",3,1,1,0,2022-01-26,9,Wednesday,3,4,1
1486275360694099969,2022-01-26 09:50:34,Menteri Perhubungan (Menhub) Budi Karya Sumadi buka-bukaan soal wacana tarif KRL Jabodetabek naik!  https://t.co/ETUNb3maHw,10,2,1,2,2022-01-26,9,Wednesday,3,11,4
1486275075586375681,2022-01-26 09:49:26,"Pertandingan sepak bola di Muara Angke, Jakarta Utara, diwarnai kericuhan. Kericuhan melibatkan para pemain bola dengan warga di dekat lapangan. https://t.co/yBpQUIG7Bg",5,0,0,0,2022-01-26,9,Wednesday,3,5,0
1486274588946407426,2022-01-26 09:47:30,Ketua KPK ungkap pihaknya tidak akan lagi menggunakan istilah OTT. Firli mengatakan pihaknya kini akan menggunakan istilah tangkap tangan. https://t.co/4VuPVMYUcT,4,2,2,0,2022-01-26,9,Wednesday,3,6,2
1486274069867679744,2022-01-26 09:45:26,"Punya gejala mirip, bagaimana membedakan infeksi varian Omicron dan flu biasa? Begini penjelasan ahli: https://t.co/b30Hja07df",8,0,3,0,2022-01-26,9,Wednesday,3,11,0
1486274054566854658,2022-01-26 09:45:22,Perjanjian ekstradisi itu akan membuat Satgas BLBI lebih mudah mencari dan mengejar warga negara Indonesia yang terlibat kucuran dana BLBI di masa lalu.  https://t.co/xkSaRHhE0p,6,0,5,0,2022-01-26,9,Wednesday,3,11,0
1486273816795959298,2022-01-26 09:44:26,"Calon mahasiswa yang sudah diterima SNMPTN namun tidak segera melakukan daftar ulang, bisa berdampak buruk kepada sekolah. Begini penjelasannya.

via: detikedu  https://t.co/dAalFGQLQf",2,0,0,0,2022-01-26,9,Wednesday,3,2,0
1486272964567912451,2022-01-26 09:41:03,Pertanda Honda HR-V generasi terbaru mau meluncur di Indonesia semakin menguat. Berapa harganya? https://t.co/KHSIXeQw0W,7,0,3,1,2022-01-26,9,Wednesday,3,10,1
1486272729758248963,2022-01-26 09:40:07,KPK menyebut NFT berpotensi digunakan untuk pencucian uang. Lili Pintauli memastikan KPK bisa menelusuri dugaan pencucian uang menggunakan NFT. https://t.co/Wv3TRBuj5k,33,11,3,3,2022-01-26,9,Wednesday,3,36,14
1486272712083394566,2022-01-26 09:40:02,Timnas Indonesia bakal menghadapi Timor Leste dalam uji coba dan tidak boleh meremehkan Timor Leste! https://t.co/bDoqUjulnV,4,1,1,0,2022-01-26,9,Wednesday,3,5,1
1486271965920956420,2022-01-26 09:37:04,Indonesia akhirnya mengambil alih pelayanan ruang udara atau Flight Information Region (FIR) yang selama ini dilayani oleh Singapura.  https://t.co/LoWG9BIhWX,43,3,4,2,2022-01-26,9,Wednesday,3,47,5
1486271473614573569,2022-01-26 09:35:07,"PT Net Visi Media Tbk (NETV), resmi mencatatkan sahamnya di Bursa Efek Indonesia. Dari aksi ini, perusahaan mengantongi dana segar Rp 149 miliar! https://t.co/yOg0OrdJek",19,3,3,2,2022-01-26,9,Wednesday,3,22,5
1486271457940365314,2022-01-26 09:35:03,"Takoyaki Ichi telah dapat ditemukan di berbagai tempat seperti Blok M Plaza, Cinere Mall, Kemang, Cipete, Limo, Depok, Burtong, Sawangan dan Margonda, Depok.  https://t.co/rUFd0nwd5V",11,2,2,0,2022-01-26,9,Wednesday,3,13,2
1486271222321135622,2022-01-26 09:34:07,"Laga uji coba antara Timnas Indonesia Vs Timor Leste batal digelar dengan penonton, PSSI mengatakan ini langkah terbaik. https://t.co/kQ1aBDgXGT",9,0,0,0,2022-01-26,9,Wednesday,3,9,0
1486270371720486913,2022-01-26 09:30:44,Pendapatan Indonesia akan meningkat dari biaya Pelayanan Jasa Navigasi Penerbangan (PJNP) pasca mengambil alih pelayanan ruang udara dari Singapura.  https://t.co/r7xCPnPZzx,11,0,1,1,2022-01-26,9,Wednesday,3,12,1
1486270093059313664,2022-01-26 09:29:38,"Andrea Dovizioso mengaku terus beradaptasi dengan Yamaha. Italiano itu sudah amat melekat dengan motor Ducati, mesti mengubah gaya membalap. https://t.co/ZVuQP0cgvN",8,0,0,0,2022-01-26,9,Wednesday,3,8,0
1486269433437990913,2022-01-26 09:27:01,Warga menagih janji dari pihak Pertamina yang disebut menjanjikan warga yang telah menjual tanahnya akan mendapat pekerjaan di proyek!  https://t.co/vytJtM9Uka,12,2,2,2,2022-01-26,9,Wednesday,3,14,4
1486269351179259905,2022-01-26 09:26:41,"Ada ritual khusus yang digelar di TITD Liong Hok Bio Magelang, tiap menjelang Imlek. Kegiatan itu dinamakan ritual Kimsin, yaitu membersihkan patung dewa-dewi. https://t.co/nID5DA0Qgh",9,1,3,1,2022-01-26,9,Wednesday,3,12,2
1486269085369479169,2022-01-26 09:25:38,Suku bunga acuan Bank Indonesia (BI) diprediksi akan naik tahun ini. Hal ini karena sejalan dengan dampak tapering yang terjadi di Amerika Serikat (AS).  https://t.co/gdYi4TrnVf,3,0,1,0,2022-01-26,9,Wednesday,3,4,0
1486268849221775366,2022-01-26 09:24:41,Kemenpora akan menerapkan formula baru dalam menentukan jumlah atlet pada satu cabor yang akan dikirim ke SEA Games Hanoi 2022. Seperti apa caranya? https://t.co/gtgjD0YMC5,2,0,0,1,2022-01-26,9,Wednesday,3,2,1
1486268300493524994,2022-01-26 09:22:31,"Leonardo Bonucci dan Giorgio Chiellini bicara mengenai masa-masa Cristiano Ronaldo di Juventus, saat dulu tiba dengan status kebintangannya. https://t.co/DjaBI626fL",7,0,0,0,2022-01-26,9,Wednesday,3,7,0
1486268038689312770,2022-01-26 09:21:28,"UNESCO Institute for Statistics melaporkan daftar negara yang menutup sekolah terlama akibat pandemi. Data ini diperoleh dari Maret 2020 hingga November 2021.

via: detikedu  https://t.co/D2DAF3z9x9",3,0,0,0,2022-01-26,9,Wednesday,3,3,0
1486267764436205568,2022-01-26 09:20:23,"Dalam penerbangan, tak jarang traveler bertemu anak-anak yang rewel. Kondisi ini kerap membuat jengkel. Berikut tipsnya! https://t.co/oOQnTD4ZgK",13,3,4,0,2022-01-26,9,Wednesday,3,17,3
1486266982504742912,2022-01-26 09:17:16,"Sejak diambil alih oleh PT TWC Juli lalu, restorasi dan revitalisasi TMII terus dikebut oleh Pemerintah dan nantinya jadi etalase megah Indonesia! https://t.co/7PUPvs6qnP",5,2,1,1,2022-01-26,9,Wednesday,3,6,3
1486266963844337664,2022-01-26 09:17:12,Pak Ogah akhirnya diperbolekan pulang dari rumah sakit. Ia masih harus memakai alat bantu pernapasan. Lekas pulih Pak Ogah...  https://t.co/W2MjVpXUhm,60,3,6,2,2022-01-26,9,Wednesday,3,66,5
1486266498574336001,2022-01-26 09:15:21,Metaverse diproyeksi akan menjadi teknologi yang dilirik oleh kalangan perbankan. Apalagi dengan pengalaman imersif yang ditawarkan metaverse ini.  https://t.co/b8L3k7hQg3,4,0,0,0,2022-01-26,9,Wednesday,3,4,0
1486266475795124225,2022-01-26 09:15:15,"Salah satu pemilik tempat makan mengeluhkan penutupan itu. Sebab, dia dan pemilik tempat makan lainnya tetap harus membayar uang sewa ke PT Angkasa Pura II.  https://t.co/SbKCGKICeS",2,2,0,1,2022-01-26,9,Wednesday,3,2,3
1486265953465819139,2022-01-26 09:13:11,"Meskipun saat ini, Metaverse masih menjadi barang baru. Tapi ke depan, Metaverse ini juga bisa membantu perbankan untuk membuat kantor cabang secara virtual.  https://t.co/QDo8QvT1Qe",18,2,8,3,2022-01-26,9,Wednesday,3,26,5
1486265445317591043,2022-01-26 09:11:10,P2G mendesak Anies Baswedan dan kepala daerah sekitar untuk ganti PTM 100 persen jadi 50 persen demi keselamatan dan kesehatan warga sekolah. https://t.co/0VO2gg0kNs,11,2,3,0,2022-01-26,9,Wednesday,3,14,2
1486264701302583304,2022-01-26 09:08:12,DJKN Kemenkeu Rionald Silaban bakal meminta anggaran operasional untuk Satuan Tugas Bantuan Likuiditas Bank Indonesia (Satgas BLBI) pada tahun 2022.  https://t.co/jMblYTE9DQ,6,2,1,0,2022-01-26,9,Wednesday,3,7,2
1486264520607772675,2022-01-26 09:07:29,"""Mulai hari ini Halim ditutup dan pergerakan pesawat dipindah ke Soekarno-Hatta,"" ungkap Budi Karya dalam rapat kerja dengan Komisi V, Rabu (26/1/2022).  https://t.co/tTHEiykT3J",10,0,3,2,2022-01-26,9,Wednesday,3,13,2
1486263959430877187,2022-01-26 09:05:16,Ramalan zodiak cinta Aquarius situasi kurang bersahabat maka mau tidak mau anda harus bisa menjaga perasaannya. Simak ramalan zodiak cinta hari ini: https://t.co/42yWG77Cdz,6,0,0,0,2022-01-26,9,Wednesday,3,6,0
1486263940065734659,2022-01-26 09:05:11,"Soto dari Boyolali, Jawa Tengah ini terkenal gurih segar karena pakai kaldu bening. Yang ini memakai daging sapi dengan isian tauge segar. Enak dimakan hangat.  https://t.co/XGQuQW67d2",19,0,5,2,2022-01-26,9,Wednesday,3,24,2
1486263209896165379,2022-01-26 09:02:17,"Gaga Muhammad mengajukan banding ke Pengadilan Tinggi DKI Jakarta. Setelah itu, beredar petisi menuntut Gaga di hukum berat dan sudah ditandatangani lebih dari 50 ribu orang. https://t.co/x7Lyuqk7R6",12,4,1,1,2022-01-26,9,Wednesday,3,13,5
1486263188442259462,2022-01-26 09:02:12,"Turunnya wisata saat pandemi membuat banyak sektor usaha terdampak, termasuk pramuwisata. Bagaimana nasib pramuwisata di masa depan? https://t.co/vtPDnPOBNz",1,0,0,0,2022-01-26,9,Wednesday,3,1,0
1486262589168525316,2022-01-26 08:59:49,"UniRank baru-baru ini merilis top 200 universitas se-Asia tahun 2021. Sebanyak 23 di antaranya berasal dari Indonesia. Mana saja?

via: detikedu  https://t.co/uJPT4sLOjw",11,2,3,5,2022-01-26,8,Wednesday,3,14,7
1486262096736268288,2022-01-26 08:57:51,"Direktur Utama PT PLN (Persero) Darmawan Prasodjo berjanji, krisis pasokan batu bara yang terjadi beberapa waktu lalu tak terulang.  https://t.co/BOrPvfS7kL",6,3,2,0,2022-01-26,8,Wednesday,3,8,3
1486261355795603457,2022-01-26 08:54:55,"Dispar Lombok Tengah, NTB menggeber persiapan tidak cuma menyambut pebalap dunia di MotoGP 2022 Mandalika. Lombok juga siaga menyambut 100 ribu penonton! https://t.co/t7BwFKOR6W",7,1,1,1,2022-01-26,8,Wednesday,3,8,2
1486260856350466050,2022-01-26 08:52:56,Kota ini memanfaatkan tenaga mikrohidro untuk mensuplai sumber listrik di wilayahnya.  https://t.co/Tr0AHmumVN,12,1,0,1,2022-01-26,8,Wednesday,3,12,2
1486260649764081666,2022-01-26 08:52:06,Kanye West buat pengakuan jika dirinya mencegah penyebaran video seks kedua antara Kim Kardashian dan Ray J. #KanyeWest  https://t.co/pi5ZfKXJp3,4,0,0,0,2022-01-26,8,Wednesday,3,4,0
1486259807338258433,2022-01-26 08:48:46,"Rambu penunjuk jalan di Jalan Gatot Subroto, Senayan, Jakarta, jadi sasaran aksi vandalisme. Akibatnya, rambu penunjuk jalan itu pun tampak kumuh. Terlalu! https://t.co/Fp33gnGxjy",3,1,1,0,2022-01-26,8,Wednesday,3,4,1
1486259023280287746,2022-01-26 08:45:39,"Sebelum melakukan perjalanan, ada baiknya melakukan pengecekan dulu terhadap beberapa komponen mesin dan juga kelistrikan. Dengan begitu mencegah mogok di jalan! https://t.co/bnO8cMbUAH",5,0,2,0,2022-01-26,8,Wednesday,3,7,0
1486258774776193024,2022-01-26 08:44:39,Dosen UNJ Ubedillah Badrun diklarifikasi KPK soal pelaporannya terhadap Gibran dan Kaesang. Ia juga membawa dokumen tambahan saat klarifikasi itu. https://t.co/sgwGfOg13E,7,1,3,0,2022-01-26,8,Wednesday,3,10,1
1486257992035094531,2022-01-26 08:41:33,Hyolyn dinyatakan positif COVID-19. Hal tersebut disampaikan oleh manajemen. #Hyolyn  https://t.co/2qc21DY51z,7,0,2,0,2022-01-26,8,Wednesday,3,9,0
1486257406887837697,2022-01-26 08:39:13,Indonesia secara resmi menjadi tuan rumah Davis Cup 2022 seiring disetujuinya sistem bubble untuk karantina atlet. https://t.co/VBbQiMcSQY,10,0,2,0,2022-01-26,8,Wednesday,3,12,0
1486256898542383107,2022-01-26 08:37:12,"""Tapi kali ini entah, Maura memilih jalannya sendiri dan Tuhan mendahului kami semua pada usia 27 tahun 5 bulan,"" kata Mayong. https://t.co/9r6K4xLWtv",8,0,2,0,2022-01-26,8,Wednesday,3,10,0
1486256375177039872,2022-01-26 08:35:07,"Wiper merupakan komponen tergolong murah. Tapi wiper mobil ini cukup menyita perhatian lantaran harganya yang relatif mahal, Rp 3 jutaan. https://t.co/cN5igostMy",4,0,1,0,2022-01-26,8,Wednesday,3,5,0
1486255880928743425,2022-01-26 08:33:09,"Laga Indonesia vs Timor Leste sempat direncanakan bisa dihadiri penonton. Namun, tidak terjadi setelah kepastian didapat dalam konferensi jelang laga. https://t.co/ywc4xWPWXH",9,0,3,0,2022-01-26,8,Wednesday,3,12,0
1486254712462749699,2022-01-26 08:28:31,"Sejumlah perguruan tinggi di Amerika Serikat menyediakan program kuliah online dengan skema biaya beragam. Berikut 10 kampus yang paling terjangkau.

via: detikedu  https://t.co/ZlkyHxo0oU",14,0,4,0,2022-01-26,8,Wednesday,3,18,0
1486254208076681216,2022-01-26 08:26:31,"Dalam agenda sidang dakwaan, Olivia Nathania terancam hukuman pidana 4 tahun penjara. #OliviaNathania  https://t.co/qrxnkmUEdD",8,0,1,0,2022-01-26,8,Wednesday,3,9,0
1486253715313016832,2022-01-26 08:24:33,"Ada sejumlah orang yang tidak boleh divaksinasi, sampai kondisinya kembali sehat. Ini bergantung pada keadaan tubuh orang tersebut, ini kategorinya: https://t.co/01yOBU1vIx",7,0,4,0,2022-01-26,8,Wednesday,3,11,0
1486253218069893120,2022-01-26 08:22:35,Maskapai Citilink akan mengalihkan sementara operasional penerbangan dari dan menuju Bandara Halim Perdanakusuma ke Bandara Internasional Soekarno-Hatta. https://t.co/xbsanIsZX5,6,1,1,0,2022-01-26,8,Wednesday,3,7,1
1486252186090811393,2022-01-26 08:18:29,Presiden Jokowi menjalin beberapa kesepakatan dengan Perdana Menteri Singapura Lee Hsien Loong. Ada 15 dokumen kerja sama strategis yang ditandatangani. Apa saja? https://t.co/qpGq4BqMWA,5,0,1,0,2022-01-26,8,Wednesday,3,6,0
1486251921300238337,2022-01-26 08:17:25,"Sadio Mane mengalami cedera kepala di laga menghadapi Cape Verde, masih sempat bermain dan mencetak gol sebelum diganti untuk perawatan. https://t.co/jOBZYnCpLG",12,1,0,1,2022-01-26,8,Wednesday,3,12,2
1486251631817678850,2022-01-26 08:16:16,"Maura Magnalia dimakamkan di Sandiego Hills, Karawang, Jawa Barat. Nurul Arifin dan suami merasa ironis harus menguburkan anak pertama mereka. https://t.co/OVB1iSJxfr",1,0,2,0,2022-01-26,8,Wednesday,3,3,0
1486251101355745282,2022-01-26 08:14:10,Maura Magnalia Madyaratri meninggalkan sebuah buku yang terkendala pendistribusiannya. Buku tersebut dinilai kontroversial. https://t.co/VWQCiKmoMu,5,0,2,0,2022-01-26,8,Wednesday,3,7,0
1486250597825273864,2022-01-26 08:12:10,"Biasanya 'ngegas', dr Tirta muncul menyampaikan saran yang menenangkan soal Omicron. Ia berpesan untuk tidak panik jika sewaktu-waktu terpapar Omicron. https://t.co/oaRHJdVvJV",13,0,4,0,2022-01-26,8,Wednesday,3,17,0
1486250013567115268,2022-01-26 08:09:51,"Kripto mulai dilirik banyak kalangan mulai dari pengusaha hingga selebritis. Namun dibalik kehebohan itu justru muncul fatwa haram dari MUI. Menurut pandangan Gus Miftah, kripto merupakan alat tukar yang halal. Berikut penuturannya! https://t.co/HKnypQJs7i",45,33,9,10,2022-01-26,8,Wednesday,3,54,43
1486249522871291905,2022-01-26 08:07:54,Harry Maguire sedang berusaha kembali ke tim inti Manchester United dan dinasihati agar meniru David de Gea. https://t.co/oJnrMXUjkQ,7,3,1,2,2022-01-26,8,Wednesday,3,8,5
1486249278867746819,2022-01-26 08:06:55,"BRI Liga 1 2021/2022 sudah bergulir lagi. Pada jadwal Liga 1 hari ini, ada dua laga yang digelar. Persita Tangerang vs Persija Jakarta salah satunya. https://t.co/gjF1Y287Pc",5,0,0,0,2022-01-26,8,Wednesday,3,5,0
1486249020347588609,2022-01-26 08:05:54,"Liburan ke Jepang di tengah pandemi ini memang susah-susah gampang. Namun, mal di bilangan Jakarta Barat ini bisa mengobati kerinduan akan Negeri Sakura. https://t.co/RC3rvgqFnc",12,1,3,0,2022-01-26,8,Wednesday,3,15,1
1486248539839729667,2022-01-26 08:03:59,#Foto Penemuan kerangkeng yang berisi sejumlah warga di rumah Bupati Langkat gegerkan publik. Ini penampakannya. https://t.co/iYRCUTvDnn,10,0,1,0,2022-01-26,8,Wednesday,3,11,0
1486248518864015362,2022-01-26 08:03:54,"PT PLN (Persero) masih memiliki utang yang sangat besar. Kendati begitu, utang tersebut telah berhasil dipangkas.  https://t.co/4ELzMdXd0k",14,3,4,1,2022-01-26,8,Wednesday,3,18,4
1486248062880305152,2022-01-26 08:02:06,Marsda Eris Widodo Yuliastono dirotasi dari jabatan Dankorpaskhas jadi Dankopasgat. Terdapat keterangan selanjutnya rotasi ini bersifat validasi organisasi. https://t.co/hrUwSBnQKd,16,1,2,0,2022-01-26,8,Wednesday,3,18,1
1486247720193036291,2022-01-26 08:00:44,Seorang kakek di Iran bikin peneliti bingung karena tetap sehat dan fit meski sehari-hari mengonsumsi bangkai hewan dan air yang kotor. Begini ceritanya.  https://t.co/t3XQKabaa6,20,9,7,1,2022-01-26,8,Wednesday,3,27,10
1486247466626334723,2022-01-26 07:59:43,Rio Ferdinand menilai Anthony Martial bikin keputusan tepat meninggalkan Manchester United. Langkah sama diharapkan dibuat Donny van de Beek dan Jesse Lingard. https://t.co/QBadcDzDsg,9,0,0,0,2022-01-26,7,Wednesday,3,9,0
1486247450667098112,2022-01-26 07:59:40,"#FOTO Seperti apa gaya Sonya Fatmala hingga Arumi Bachsin, artis yang kini jadi istri pejabat saat belanja ke pasar? Inilah gaya tujuh istri pejabat Indonesia:  https://t.co/cOG6F4NyEN",11,0,1,1,2022-01-26,7,Wednesday,3,12,1
1486246948734738434,2022-01-26 07:57:40,"Penulis novel Percy Jackson and the Olympians, Rick Riordan, akan terlibat langsung dalam produksi serialnya! https://t.co/YEpYkaGQlB",12,0,3,6,2022-01-26,7,Wednesday,3,15,6
1486246424677429257,2022-01-26 07:55:35,"DJKN Kemenkeu Rionnald Silaban menegaskan pegawainya yang memalsukan aset tanah Bantuan Likuiditas Bank Indonesia (BLBI) berjumlah 1 orang, bukan 11 orang.  https://t.co/4nBCZvGRbS",5,0,2,0,2022-01-26,7,Wednesday,3,7,0
1486246166325047298,2022-01-26 07:54:33,"Ultras Inter Milan mengancam bakal memboikot laga Derby Milan,  akibat mereka tak puas dengan alokasi tiket untuk laga tersebut. https://t.co/4OPNLESWDn",8,2,0,1,2022-01-26,7,Wednesday,3,8,3
1486245926972936196,2022-01-26 07:53:36,"Ada beberapa fakta menarik pada SNMPTN 2022 yang harus diperhatikan siswa. Simak penjelasannya di bawah ini.

via: detikedu  https://t.co/8m91c1woS0",6,0,2,0,2022-01-26,7,Wednesday,3,8,0
1486245422892994562,2022-01-26 07:51:36,Eks Pemain Paris Saint-Germain tersinggung dengan pembelaan Karim Benzema terhadap Lionel Messi. Benzema diyakini tidak mengikuti laga-laga PSG. https://t.co/a95b5iD10c,2,0,0,0,2022-01-26,7,Wednesday,3,2,0
1486244601023406082,2022-01-26 07:48:20,"Belanda mulai melonggarkan pembatasan Covid-19 dan mulai hari ini, bar, restoran dan teater kembali dibuka. https://t.co/QyvJcTxwJE",20,0,3,0,2022-01-26,7,Wednesday,3,23,0
1486244580500647940,2022-01-26 07:48:15,Toyota Motor Corp mengumumkan akan memangkas produksi mereka di Jepang hingga 65.000 unit. https://t.co/zecnhI5Fd9,4,0,0,0,2022-01-26,7,Wednesday,3,4,0
1486244004186537991,2022-01-26 07:45:58,"Anang Hermansyah merasakan keuntungan bermain NFT. Akan tetapi, ada keresahan yang dirasakan Anang Hermansyah. https://t.co/onCGMn8aYh",7,0,1,0,2022-01-26,7,Wednesday,3,8,0
1486243510198194177,2022-01-26 07:44:00,Aplikasi media sosial TikTok diduga menggunakan tiga lagu yang dipopulerkan Virgoun tanpa izin. TikTok digugat dengan dugaan melanggar UU tentang Hak Cipta. https://t.co/3snhXs8Bts,49,5,5,5,2022-01-26,7,Wednesday,3,54,10
1486243006063722496,2022-01-26 07:42:00,Maura diketahui meninggal dunia karena henti jantung. Ini kenangan Nurul Arifin soal sosok Maura semasa hidupnya. https://t.co/HMIp5e30kS,10,0,2,0,2022-01-26,7,Wednesday,3,12,0
1486241525239619584,2022-01-26 07:36:07,Ketua Migrant Care Anis Hidayah kemudian melaporkan dugaan perbudakan modern di rumah Bupati Langkat kepada Komnas HAM pada Senin (24/1). #CNNIndonesia #detiknetwork  https://t.co/MZ4AKCQ8EF,10,0,2,0,2022-01-26,7,Wednesday,3,12,0
1486241516800643073,2022-01-26 07:36:05,Malware Android ini bisa menghapus data di ponsel setelah membobol rekening korban untuk menutupi jejaknya. Malware ini sudah menyerang di beberapa negara. https://t.co/nNfYcMKxal,8,0,5,2,2022-01-26,7,Wednesday,3,13,2
1486241045763477506,2022-01-26 07:34:12,Wakil Ketua KPK Alexander Marwata menjawab pertanyaan tentang masalah dan kabar simpang siur terkait kebijakan rotasi pegawai itu. Berikut perbincangan lengkapnya: #detikX https://t.co/OTFPWudqDL,3,0,2,0,2022-01-26,7,Wednesday,3,5,0
1486241025844731905,2022-01-26 07:34:08,Beredar video aksi maling motor yang bukannya untung malah buntung. Aksi curanmor itu terjadi di Kabupaten Pasuruan. Bagaimana kejadiannya? https://t.co/ozZR5qkrUa,9,0,2,0,2022-01-26,7,Wednesday,3,11,0
1486240528748457984,2022-01-26 07:32:09,Polisi siap tindak tegas pengendara berknalpot bising di Bandung. Selama ini polisi menerima banyak keluhan masyarakat soal kendaraan berknalpot bising itu. https://t.co/PEvt9nCr2x,17,11,3,4,2022-01-26,7,Wednesday,3,20,15
1486239731713294337,2022-01-26 07:28:59,"Perampokan diotaki oleh sopir angkot berinisial IS (22). IS juga memperkosa korban, lalu membuangnya ke Sungai Ciujung, Tangerang. https://t.co/GHh7WaL14G",8,5,3,1,2022-01-26,7,Wednesday,3,11,6
1486238324436389888,2022-01-26 07:23:24,"Rasa lega bisa dirasakan oleh Kakek Sunardi. Kini Ia bisa tinggal di rumah yang layak untuk ditempati. Terima kasih kepada #sahabatbaik yang telah ikut berdonasi untuk Kakek Sunardi. 

Jika #sahabatbaik lainnya ingin ikut berdonasi bisa melalui platform @berbuatbaik_id. https://t.co/rDtnVY86pd",62,0,7,0,2022-01-26,7,Wednesday,3,69,0
1486237935947194368,2022-01-26 07:21:51,"Biaya kuliah merupakan hal penting yang harus diperhatikan oleh calon mahasiswa. Berikut ini adalah jenis biaya kuliah di universitas swasta.

via: detikedu  https://t.co/TJX7Of8yAE",7,0,1,0,2022-01-26,7,Wednesday,3,8,0
1486237424179109890,2022-01-26 07:19:49,"Dunia kembali dikejutkan dengan kemunculan varian baru BA.2 yang juga disebut sebagai 'Son of Omicron'. Lalu, seberapa berbahayanya varian BA.2 ini? https://t.co/KJOZSCDcbm",238,251,81,122,2022-01-26,7,Wednesday,3,319,373
1486237112282329089,2022-01-26 07:18:35,Lini tengah disebut sebagai salah satu yang wajib dibenahi Manchester United. Berikut dua pemain pun muncul dan dinilai bisa bikin MU langsung juara. https://t.co/LjVWyZ8cFh,5,0,1,0,2022-01-26,7,Wednesday,3,6,0
1486236856756940800,2022-01-26 07:17:34,Mantan Wali Kota Tangsel Airin Rachmi Diany hingga Tantowi Yahya turut berduka cita atas meninggalnya putri Nurul Arifin. Keduanya menyebut jika Nurul dan sang suami tampak tegar. https://t.co/wkMheIhyhx,5,0,0,0,2022-01-26,7,Wednesday,3,5,0
1486236136683053056,2022-01-26 07:14:42,Saat ini para ilmuwan dunia melakukan pemantauan atas varian BA.2 yang dijuluki 'son of Omicron'. Apa lagi sih itu? https://t.co/pzLJMTRhmE,37,40,12,18,2022-01-26,7,Wednesday,3,49,58
1486235396409556993,2022-01-26 07:11:46,"Solihin (52) penjual lukisan di Braga, Kota Bandung tak menyangka lukisan kaligrafinya bisa terjual empat kali lipat di platform NFT dari harga normal. https://t.co/qALNXYjbww",24,1,4,0,2022-01-26,7,Wednesday,3,28,1
1486234394633330688,2022-01-26 07:07:47,Ruang udara udara Kepri-Natuna dikuasai oleh Singapura sejak 1946. Pengelolaan didelegasikan ke Singapura lantaran saat itu Indonesia belum memiliki perlengkapan dan alat yang memadai untuk mengelola FIR. https://t.co/08OdOhXg5t,6,1,3,2,2022-01-26,7,Wednesday,3,9,3
1486234152978497540,2022-01-26 07:06:49,Kanye West dan Julia Fox eksis di Paris Fashion Week. Ini adalah kali pertama mereka tampil di tengah publik sebagai sepasang kekasih. Ini potretnya: https://t.co/w8DlbF3wMO,4,0,1,0,2022-01-26,7,Wednesday,3,5,0
1486233656716898306,2022-01-26 07:04:51,"Setelah sempat bikin heboh dengan pengumuman akuisisi Arm senilai Rp 573 triliun, kini Nvidia tampaknya sudah pasrah jika akuisisi tersebut tak bisa berlanjut. https://t.co/VyxIGscbTP",8,0,0,0,2022-01-26,7,Wednesday,3,8,0
1486232939709018119,2022-01-26 07:02:00,"Snack untuk diet tidak harus selalu berupa sayuran potong, buah-buahan atau protein bar. Ini snack untuk diet yang disukai para selebriti dunia, bisa kamu tiru! https://t.co/OTDOroLK0B",6,0,2,0,2022-01-26,7,Wednesday,3,8,0
1486232914710913028,2022-01-26 07:01:54,"Kini, Indonesia tengah menguji coba bahan bakar bensin dari kelapa sawit! https://t.co/qflwobcL7p",23,5,2,1,2022-01-26,7,Wednesday,3,25,6
1486232313264545794,2022-01-26 06:59:31,"Jelang laga uji coba kedua tim, Timnas Indonesia punya rekor bagus atas Timor Leste. Akankah skuad Garuda pesta gol? https://t.co/suqbsa5xy8",9,1,0,0,2022-01-26,6,Wednesday,3,9,1
1486232312169865217,2022-01-26 06:59:30,"Menurut Ice Universe, Dimensity 9000 lebih kencang dibanding Snapdragon 8 Gen 1 dan Exynos 2200.  https://t.co/XHlv7v7503",5,0,0,0,2022-01-26,6,Wednesday,3,5,0
1486232083638935552,2022-01-26 06:58:36,Maura Magnalia Madyaratri meninggalkan sebuah buku yang terkendala pendistribusiannya. Buku tersebut dinilai kontroversial. https://t.co/JbM4pp7Mjn,8,2,0,0,2022-01-26,6,Wednesday,3,8,2
1486232070359851011,2022-01-26 06:58:33,"Sebanyak 90 sekolah di Jakarta tutup PTM imbas kasus COVID-19 pada siswa hingga guru. Berikut daftar sekolah yang ditutup sementara di wilayah DKI Jakarta.

via: detikedu  https://t.co/FGiH01DvpP",7,0,0,0,2022-01-26,6,Wednesday,3,7,0
1486231468460359683,2022-01-26 06:56:09,Tak bisa dipungkiri Paris St. Germain punya skuad terbaik di Liga Champions. Real Madrid diyakini memiliki peluang lolos jika bermain secara kolektif. https://t.co/tszaciskly,15,0,1,0,2022-01-26,6,Wednesday,3,16,0
1486230931337891844,2022-01-26 06:54:01,Apa itu blackhole atau lubang hitam? Apakah benar blackhole bisa menyedot benda-benda yang berada di sekitarnya? Ini penjelasannya:  https://t.co/4CMlm89f4b,9,0,3,0,2022-01-26,6,Wednesday,3,12,0
1486230391614808066,2022-01-26 06:51:52,Anang Hermasnyah menjelaskan alasan ia membuat game tradisional Indonesia di NFT. Ini kata Anang Hermansyah:  https://t.co/1CrmBdSYk7,5,0,0,0,2022-01-26,6,Wednesday,3,5,0
1486229903552954369,2022-01-26 06:49:56,"Truk over dimension over loading (ODOL) sering menjadi pemicu kecelakaan. Bahkan, polisi menyebut truk ODOL termasuk tindak kejahatan. https://t.co/KtFS2J7dA0",5,2,1,0,2022-01-26,6,Wednesday,3,6,2
1486229400064507907,2022-01-26 06:47:56,"Son Dam Bi mengumumkan rencana pernikahan dengan sang kekasih. Jika tak ada perubahan, keduanya akan menikah pada Mei 2022. #SonDamBi  https://t.co/dFB3isWA87",7,0,0,1,2022-01-26,6,Wednesday,3,7,1
1486228904100646912,2022-01-26 06:45:58,"Anak Nia Daniaty, Olivia Nathania bersama dua tersangka lain mengikuti sidang perdana kasus penipuan rekrutmen CPNS.  https://t.co/AdebwLOxAO",8,0,1,0,2022-01-26,6,Wednesday,3,9,0
1486228902888579073,2022-01-26 06:45:57,"Upaya Indonesia mengambil alih pelayanan ruang udara atau Flight Information Region di atas wilayah Kepulauan Riau dan Natuna dari Singapura berjalan alot, tapi akhirnya...  https://t.co/9EKYuqhHCI",4,1,2,0,2022-01-26,6,Wednesday,3,6,1
1486228423160774659,2022-01-26 06:44:03,"Jajanan murah meriah bisa ditemukan di area belakang Mall Grand Indonesia. Ada bakwan Pontianak, cilor sampai roti maryam. Harganya kurang dari Rp 10 ribu!  https://t.co/lpFJqUSjhS",85,6,5,3,2022-01-26,6,Wednesday,3,90,9
1486228398414389256,2022-01-26 06:43:57,Pratama Arhan disebut masih mengalami radang di bagian otot. Pelatih fisik Timnas Indonesia Shin Sang-gyu membeberkan kondisinya. https://t.co/gXqyBBtG79,4,0,0,0,2022-01-26,6,Wednesday,3,4,0
1486227874608824324,2022-01-26 06:41:52,"Kompolnas menanggapi hebohnya penggunaan pelat nomor RF. Menurut Komisioner Kompolnas Irjen (Purn) Pudji Hartanto, mobil dengan pelat RF tidak ada bedanya dengan kendaraan pelat hitam lainnya. https://t.co/kNBrSq8jwt",24,13,14,0,2022-01-26,6,Wednesday,3,38,13
1486227598740971520,2022-01-26 06:40:46,"""...waktu di atas kendali kita semua dan ingatlah itu untuk selalu menyediakan waktu untuk orang-orang yang terdekat,"" kata adik Maura, Dimel. https://t.co/ZlxhMeaWs3",5,2,0,2,2022-01-26,6,Wednesday,3,5,4
1486227581473107968,2022-01-26 06:40:42,Jerome Polin ramai diperbincangkan karena dianggap meremehkan pebalap Indonesia. Jerome Polin juga ditegur Sean Gelael!  https://t.co/Ihy9ZmD5wk,6,5,2,4,2022-01-26,6,Wednesday,3,8,9
1486227332507570177,2022-01-26 06:39:43,"Walaupun sudah lama pensiun, Xavi Hernandez tetap lihai mengolah bola! https://t.co/Tg3N408FcB",7,0,0,1,2022-01-26,6,Wednesday,3,7,1
1486226847817949186,2022-01-26 06:37:47,Samsung konfirmasi akan adakan Galaxy Unpacked meski belum sebut tanggalnya. Bocoran mengungkap peluncuran Galaxy S22 &amp; Tab S8 pada 9 Februari. https://t.co/bdQQMQjQGq,9,2,2,2,2022-01-26,6,Wednesday,3,11,4
1486226299572170752,2022-01-26 06:35:37,"Pengalaman kencan unik seorang wanita jadi viral. Awalnya tidak terkesan dengan pria yang dijodohkan, kelanjutan kisah wanita ini tak terduga:  https://t.co/yPdCXOBGY5",4,0,0,0,2022-01-26,6,Wednesday,3,4,0
1486226282564173825,2022-01-26 06:35:33,Pakar etiket yang eksis di TikTok ini membagikan 5 etiket makan simpel yang perlu kamu tahu. Mulai dari cara makan pizza hingga memegang cangkir teh.  https://t.co/s9DaxtIOHS,5,0,1,0,2022-01-26,6,Wednesday,3,6,0
1486225778517884929,2022-01-26 06:33:32,"Kembangkan kemampuannya, seorang mantan teknisi SpaceX uji coba robot pizza. Tak disangka percobaan pertamanya justru ciptakan 'hujan keju'.  https://t.co/HjPJCoFOLD",5,0,1,0,2022-01-26,6,Wednesday,3,6,0
1486225547420180480,2022-01-26 06:32:37,Banyak cara yang dilakukan salah satunya adalah dengan melakukan kerja sama antara sektor akademis dengan industri langsung.  https://t.co/8LXqWxIllU,1,0,0,0,2022-01-26,6,Wednesday,3,1,0
1486225318142689283,2022-01-26 06:31:43,Seorang ibu di Inggris memicu perdebatan setelah mengatakan bayinya akan diberi makanan vegan. Netizen ramai berkomentar karena khawatir bayi ini kurang gizi.  https://t.co/mTca73AUmW,11,2,0,2,2022-01-26,6,Wednesday,3,11,4
1486224726360043520,2022-01-26 06:29:22,Penyanyi Marcello Tahitoe atau Ello resmi menikahi Cindy Maria di Bali. Ini potret pernikahan mereka:  https://t.co/Bx7j9skFZx,19,1,0,0,2022-01-26,6,Wednesday,3,19,1
1486224486689132544,2022-01-26 06:28:24,Badai salju hebat melanda Yunani dan Turki yang menyebabkan lalu lintas terganggu. Mobil-mobil terdampar di jalan dalam kondisi beku! https://t.co/vLp8co3MrD,10,1,5,0,2022-01-26,6,Wednesday,3,15,1
1486224233873215489,2022-01-26 06:27:24,Acha Septriasa belum lama ini bertamu ke kediaman Irwansyah dan Zaskia Sungkar. Pertemuan ketiganya jadi sorotan. https://t.co/JDZtrhoc7S,9,0,0,1,2022-01-26,6,Wednesday,3,9,1
1486223973625049093,2022-01-26 06:26:22,Tumis genjer terlihat sederhana. tetapi jika dipadu dengan oncom dan cabe bisa jadi lauk yang pedas sekaligus sedap rasanya. Cocok dimakan dengan nasi hangat.  https://t.co/g6Ljk4SNY5,6,1,1,0,2022-01-26,6,Wednesday,3,7,1
1486223955556016133,2022-01-26 06:26:18,"Wagub Ahmad Riza Patria mengatakan, kapasitas ruangan selama PTM baru bisa dikurangi jika status PPKM Jakarta meningkat ke level 3. https://t.co/dQJsvNjwxf",5,0,2,0,2022-01-26,6,Wednesday,3,7,0
1486223452289867776,2022-01-26 06:24:18,Thailand resmi hapus ganja dari daftar obat-obatan terlarang. Thailand juga jadi negara pertama di Asia Tenggara yang legalkan ganja untuk medis dan penelitian. https://t.co/y992lq7opc,2418,185,705,239,2022-01-26,6,Wednesday,3,3123,424
1486223196529508355,2022-01-26 06:23:17,Bank Indonesia (BI) mewaspadai lonjakan inflasi dan tekanan pada nilai tukar rupiah terhadap dolar Amerika Serikat (AS) di tahun ini.  https://t.co/p0lperU92c,4,0,5,0,2022-01-26,6,Wednesday,3,9,0
1486222683968782339,2022-01-26 06:21:15,Setiap personel BLACKPINK punya kesibukan masing-masing yang mempengaruhi pendapatan mereka meski. Ini urutan member BLACKPINK terkaya:  https://t.co/sXj4wWZgp3,8,1,2,1,2022-01-26,6,Wednesday,3,10,2
1486222656609431555,2022-01-26 06:21:08,Direktur Utama PT PLN (Persero) Darmawan Prasodjo memberi penjelasan terkait kabar mengenai kenaikan tarif listrik.  https://t.co/NTcY3XV4dW,5,3,4,0,2022-01-26,6,Wednesday,3,9,3
1486222395534884865,2022-01-26 06:20:06,Mulai hari ini renovasi besar-besaran bakal dilakukan di Bandara Halim Perdanakusuma. Menteri Perhubungan Budi Karya Sumadi menjelaskan hal itu dalam rapat DPR. https://t.co/wfMsJUW053,7,1,2,0,2022-01-26,6,Wednesday,3,9,1
1486222376132038656,2022-01-26 06:20:01,Komisi VII DPR RI menggelar rapat dengar pendapat dengan Direktur Utama PT PLN (Persero) Darmawan Prasodjo siang ini.  https://t.co/1ZF4rTQObG,6,0,2,0,2022-01-26,6,Wednesday,3,8,0
1486222145508290561,2022-01-26 06:19:06,Kisah getok harga di warung seafood begitu menarik perhatian pembaca. Ada juga Kopi Klotok yang buka di Cisarua hingga bakmi terenak versi netizen Twitter.  https://t.co/BicUp1hgam,5,0,0,3,2022-01-26,6,Wednesday,3,5,3
1486222125174251527,2022-01-26 06:19:01,"Bandara Halim Perdanakusuma ditutup sementara dalam rangka revitalisasi mulai hari ini, 26 Januari 2022. Salah satu 'limpahannya' ialah di bandara Pondok Cabe. Inilah suasananya di hari pertama.  https://t.co/gLzRsVExgA",1,0,1,1,2022-01-26,6,Wednesday,3,2,1
1486221901835948034,2022-01-26 06:18:08,"Setelah lebih dari dua tahun sejak pertama kali diumumkan, proyek yang disponsori Facebook dalam membuat mata uang kripto kemungkinan akan segera berakhir. Apa penyebabnya?  https://t.co/nMAPecG7M7",3,0,0,0,2022-01-26,6,Wednesday,3,3,0
1486221884563857409,2022-01-26 06:18:04,"Pemilik WithU Yamaha RNF, Razlan Razali, optimis timnya bisa menjadi tim independen terbaik di MotoGP 2022 kendati diperkuat pebalap bengal, Darryn Binder. https://t.co/oE2JYmVKvF",2,0,0,0,2022-01-26,6,Wednesday,3,2,0
1486221647870898178,2022-01-26 06:17:08,BNN Sumut menyebut tidak semua penghuni kerangkeng di rumah Bupati Langkat  merupakan pecandu narkoba. https://t.co/3hlNVVFhC9,8,2,2,1,2022-01-26,6,Wednesday,3,10,3
1486221634193272835,2022-01-26 06:17:04,"UMKM asal Semaran dan Surakarta memiliki kepedulian terhadap lingkungan. Tak hanya kerja cuan, mereka pun punya cara tersendiri dalam menjaga kelestarian alam.  https://t.co/L68JtiVZqW",3,0,1,0,2022-01-26,6,Wednesday,3,4,0
1486221383000633346,2022-01-26 06:16:05,Fenomena rumah 'kandang' menjadi sisi lain gemerlapnya kota Hong Kong. Rumah itu jadi tempat tinggal warga yang sulit dapat tempat tinggal imbas lahan terbatas.  https://t.co/Ii7evxMmDg,7,1,1,1,2022-01-26,6,Wednesday,3,8,2
1486221381830332423,2022-01-26 06:16:04,"Bank Indonesia (BI) memproyeksikan pertumbuhan ekonomi Indonesia dapat menyentuh 4,7% sampai 5,4% di 2022.  https://t.co/FYOCVzWy69",4,0,0,0,2022-01-26,6,Wednesday,3,4,0
1486220648217202689,2022-01-26 06:13:09,"Di masa pandemi, konsumsi suplemen jadi hal yang penting untuk menjaga imunitas tubuh. Lakukan hal ini untuk mengimbanginya:  https://t.co/1Auyci7hYq",5,0,1,0,2022-01-26,6,Wednesday,3,6,0
1486220401743171585,2022-01-26 06:12:11,Kinerja BNI 2021 tercatat sangat menggembirakan di mana laba bersih tersebut mampu melampaui ekspektasi pasar.  https://t.co/YA87f18BY1,6,0,4,1,2022-01-26,6,Wednesday,3,10,1
1486220244632969224,2022-01-26 06:11:33,"Thailand memperbolehkan warganya menanam ganja di rumah dengan izin pemerintah setempat. Namun, ganja tidak dapat digunakan untuk komersial tanpa izin!  https://t.co/5cVaKCpG53",26,0,11,5,2022-01-26,6,Wednesday,3,37,5
1486219261114785796,2022-01-26 06:07:39,Persediaan minyak goreng di sejumlah toko ritel mulai langka usai pemerintah menetapkan harganya di Rp 14.000 per liter. detikers temukan penimbunan minyak goreng? Lapor polisi!  https://t.co/K7u5AGfx0z,19,4,6,1,2022-01-26,6,Wednesday,3,25,5
1486218927495602176,2022-01-26 06:06:19,Rodrygo begitu gembira setelah dipanggil lagi ke timnas Brasil dan memiliki hasrat memenangi Piala Dunia 2022. https://t.co/g0hu3gDbB1,5,0,0,0,2022-01-26,6,Wednesday,3,5,0
1486218910252810241,2022-01-26 06:06:15,Dana Moneter Internasional (International Monetary Fund/IMF) mendesak El Salvador untuk menghapus Bitcoin sebagai alat pembayaran yang sah.  https://t.co/P04LZj7YBF,5,5,2,2,2022-01-26,6,Wednesday,3,7,7
1486218363080790017,2022-01-26 06:04:05,"Xiaomi bakal merilis jajaran ponsel Redmi terbarunya di Eropa pada 26 Januari, yang sudah dikonfirmasi oleh Xiaomi. Ini spesifikasinya:  https://t.co/266gtuiVdo",5,0,0,0,2022-01-26,6,Wednesday,3,5,0
1486217881356492803,2022-01-26 06:02:10,"Bentrokan maut terjadi di Kabupaten Maluku Tengah, Maluku. Seorang polisi menjadi korban dan mengalami luka di bagian pipi. https://t.co/x4GOh7qyZU",4,0,0,0,2022-01-26,6,Wednesday,3,4,0
1486217546898546689,2022-01-26 06:00:50,Kericuhan terjadi di lapangan Ingub Muara Angke. Satu orang warga dilaporkan terluka akibat dilempari benda-benda oleh pemain bola. Begini kejadiannya. https://t.co/YcZ3uAvHwI,3,0,0,1,2022-01-26,6,Wednesday,3,3,1
1486217523326500868,2022-01-26 06:00:44,"Putra John Lennon, Julian Lennon akan melelang beberapa memorabilia The Beatles dan ayahnya sebagai non-fungible token (NFT).  https://t.co/q5YiCTkXxO",19,1,2,2,2022-01-26,6,Wednesday,3,21,3
1486217322096467968,2022-01-26 05:59:56,Dosen UI buka-bukaan di balik kegagalan ia meraih gelar profesor. Artikelnya terbit di berbagai jurnal internasional dan sudah lolos reviewer dari AS-Jepang. Ini ceritanya. https://t.co/rzsBAnVBPa,19,3,10,0,2022-01-26,5,Wednesday,3,29,3
1486217303469473792,2022-01-26 05:59:52,"WhatsApp untuk platform iOS baru saja diperbarui, banyak fitur baru yang sebelumnya telah lama berada di versi beta kini sudah tersedia secara resmi. #WhatsApp  https://t.co/Cu2dIYVmAH",1,1,1,1,2022-01-26,5,Wednesday,3,2,2
1486217044840398852,2022-01-26 05:58:50,"Forbes telah merilis daftar orang terkaya di seluruh benua Afrika. Uniknya, ada salah satu nama di daftar tersebut memiliki usia yang sudah sangat tua!  https://t.co/hrmQA8TJwg",5,0,1,0,2022-01-26,5,Wednesday,3,6,0
1486216774676893698,2022-01-26 05:57:46,Younghoon THE BOYZ dinyatakan positif COVID-19. Hal itu disampaikan langsung oleh manajemen. Lekas pulih Younghoon...  https://t.co/KIAylTptSx,6,0,0,1,2022-01-26,5,Wednesday,3,6,1
1486215979965296640,2022-01-26 05:54:36,"PT Unilever Indonesia Tbk merupakan salah satu perusahaan besar di Tanah Air. Tak heran, banyak orang yang ingin bergabung alias bekerja di perusahaan tersebut. Mau tahu berapa gajinya? Cek disini.  https://t.co/qlbDcDsOlN",6,2,1,4,2022-01-26,5,Wednesday,3,7,6
1486215785307648001,2022-01-26 05:53:50,"Pemerintah melalui KemenPAN-RB akan menghapus pegawai honorer pada 2023 mendatang. Namun, honorer dimungkinkan menjadi PNS dengan syarat berikut ini.

via: detikedu  https://t.co/nBxJl8vqXb",9,0,7,1,2022-01-26,5,Wednesday,3,16,1
1486215060754214912,2022-01-26 05:50:57,"Jenazah putri sulung Nurul Arifin sudah diberangkatkan dari rumah ke pemakaman San Diego Hills, Jawa Barat, untuk dikebumikan hari ini. Keberangkatan juga diiringi sanak keluarga dan kerabat. https://t.co/gu9YaLWepj",2,1,1,0,2022-01-26,5,Wednesday,3,3,1
1486215037748457473,2022-01-26 05:50:52,"Achraf Hakimi pamer kemampuan tendangan bebas dengan Maroko di Piala Afrika 2021. Tetapi di PSG, ia tak mendapat jatah mengeksekusi bola mati. https://t.co/fHtgwtk9Fi",7,0,0,0,2022-01-26,5,Wednesday,3,7,0
1486214540098510848,2022-01-26 05:48:53,"Inilah potret Evan Rachel Wood, aktris yang jadi sorotan setelah ngaku pernah diperkosa oleh Marilyn Manson:  https://t.co/S7hnhgpoBT",2,0,1,0,2022-01-26,5,Wednesday,3,3,0
1486213804400730117,2022-01-26 05:45:58,Google dikabarkan tengah mengembangkan perangkat headset AR yang dinamai 'Project Iris' direncanakan akan dirilis pada tahun 2024. #Google  https://t.co/iJ9BePv767,3,1,0,0,2022-01-26,5,Wednesday,3,3,1
1486212778713137154,2022-01-26 05:41:53,Kawasan Malioboro di Yogyakarta sempat viral karena getok harga oleh warung tenda dan pecel lele. Ternyata pekan ini pedagang PKL Malioboro akan digusur Sultan!  https://t.co/hNMdP0Wv9D,23,2,2,0,2022-01-26,5,Wednesday,3,25,2
1486212054918782979,2022-01-26 05:39:01,Kita sering mendengar perihal lapisan langit hingga langit ke-7. Bagaimana hal ini menurut sains? Begini penjelasannya:  https://t.co/ZuUpYmE4de,10,0,2,1,2022-01-26,5,Wednesday,3,12,1
1486211834571018245,2022-01-26 05:38:08,"Bikin foto bagus nggak melulu harus susah dan mahal lho. Trik ini memungkinkan bisa dicoba dengan apa yang ada di sekitar kita, bahkan dengan ponsel. Begini triknya:  https://t.co/jM6LD0wIFI",10,1,3,1,2022-01-26,5,Wednesday,3,13,2
1486211806133690373,2022-01-26 05:38:01,Juventus kesal karena Aaron Ramsey terus menolak tawaran klub peminatnya dan berencana mengasingkan Ramsey di sisa musim ini. https://t.co/AE8hCpIB7l,6,0,0,0,2022-01-26,5,Wednesday,3,6,0
1486210968128528386,2022-01-26 05:34:41,"""Menurut saya, pertama, dari sisi aturan tidak ada UU atau Peraturan KPU yang mengatur atau melarang. Jadi peluang tetap terbuka,"" kata Komisioner KPU. https://t.co/0Syxv0GNbr",4,3,3,1,2022-01-26,5,Wednesday,3,7,4
1486210284243066881,2022-01-26 05:31:58,Meta tengah membangun sebuah komputer super kecerdasan buatan yang bakal paling kencang di dunia. #Meta  https://t.co/eqDUCqGPZi,3,0,3,0,2022-01-26,5,Wednesday,3,6,0
1486209736727044098,2022-01-26 05:29:48,"Nah, kalau di Moms Potato kamu bisa nyicipin potato wedges homemade dengan saus enak yang tidak biasa. Yakni garlic mayo dan spicy sweet mayo.  https://t.co/CHVefJ4foQ",3,0,0,0,2022-01-26,5,Wednesday,3,3,0
1486209702044348418,2022-01-26 05:29:40,"Putri Nurul Arifin, Maura Magnalia, diduga mengalami stres sebelum meninggal akibat henti jantung. Dokter menyebut stres bisa memicu 'Broken Heart Syndrome'. https://t.co/hhtFcpBcz5",19,0,12,2,2022-01-26,5,Wednesday,3,31,2
1486209207527428099,2022-01-26 05:27:42,"Saat meminjam uang, kadang orang mengiba setengah mati. Tapi saat ditagih, bisa lebih galak dari yang memberi pinjaman. Apakah kita bisa pidanakan pengemplang?
#detiksAdvocate https://t.co/kyuh3CHSt8",184,30,69,8,2022-01-26,5,Wednesday,3,253,38
1486208721458016262,2022-01-26 05:25:46,Robin Gosens tak tertarik merumput di Liga Inggris bersama Newcastle United. Gosens pun malah menerima tawaran dari Inter Milan. https://t.co/wP1ihSrdWS,10,0,0,2,2022-01-26,5,Wednesday,3,10,2
1486208694589263877,2022-01-26 05:25:39,"Tangis Nurul Arifin pecah di depan jenazah putrinya saat ibadah tutup peti. Sang suami, Mayong Suryo pun tampak menguatkan Nurul. https://t.co/3mHTCIoZqt",4,0,1,0,2022-01-26,5,Wednesday,3,5,0
1486208164013953029,2022-01-26 05:23:33,"Pendiri Facebook Mark Zuckerberg benar-benar setia dengan Priscilla Chan, istrinya. Mereka sudah bersama sekitar 19 tahun dan tak pernah tertimpa gosip apapun. https://t.co/BJlaqjvBf0",20,0,3,0,2022-01-26,5,Wednesday,3,23,0
1486208146037215239,2022-01-26 05:23:29,"Aprilio Manganang menggelar acara lamaran dengan wanita pilihannya Claudya di Manado, Sulawesi Utara. Ini potret kemesraan mereka:  https://t.co/g0dw0yCF6U",4,0,0,0,2022-01-26,5,Wednesday,3,4,0
1486207558037778433,2022-01-26 05:21:08,"Sedang nyaman di tempat tidur, ilmuwan Inggris ini menemui nasib malang. Sebuah peluru nyasar menembus tembok apartemen mengenai kepalanya. https://t.co/Q6QW15NUs4",6,1,1,0,2022-01-26,5,Wednesday,3,7,1
1486206817348825094,2022-01-26 05:18:12,"Sean Gelael memberikan teguran kepada Jerome Polin. Teguran itu ditulis oleh Sean usai Jerome menuliskan cuitan di Twitter terkait pembalap Indonesia. Setelah tahu terkait teguran itu, Jerome langsung menghubungi dan meminta maaf kepada Sean.  https://t.co/eFfJqbIJB4",8,1,2,1,2022-01-26,5,Wednesday,3,10,2
1486206554395361282,2022-01-26 05:17:09,"Dua hari sebelum meninggal, Maura Magnalia dikatakan Nurul Arifin sempat curhat. Sang putri mengutarakan kekecewaan terhadap dirinya sendiri.  https://t.co/XngLS8zFXS",7,0,0,1,2022-01-26,5,Wednesday,3,7,1
1486206090085863429,2022-01-26 05:15:18,Putri Fadzilah dari Brunei Darussalam tengah menggelar perayaan pernikahan mewah selama 10 hari. Ini potret cantik wanita 36 tahun itu ketika jadi pengantin:  https://t.co/rz61wi2nZw,9,0,0,1,2022-01-26,5,Wednesday,3,9,1
1486206074285965312,2022-01-26 05:15:15,Perut ikan merupakan bahan makanan istimewa yang cocok disajikan untuk tamu atau kerabat saat imlek. Kali ini dimasak dengan berbagai sayuran. Segar dan enak!  https://t.co/ToUgtDpGu9,0,0,0,0,2022-01-26,5,Wednesday,3,0,0
1486205819888836608,2022-01-26 05:14:14,Dunia maya dihebohkan dengan video aktor Steven Seagal ke Indonesia. Ia disebut mendatangi Kalimantan. #StevenSeagal  https://t.co/geVpYtWWZS,65,5,10,2,2022-01-26,5,Wednesday,3,75,7
1486205087693381632,2022-01-26 05:11:19,"Gejala Omicron mirip flu biasa. Jadi, masyarakat boleh sedikit santai soal Omicron? Tunggu dulu, ini yang bikin Omicron berbeda dari flu biasa menurut pakar. https://t.co/DVIkhgHGbJ",4,0,0,0,2022-01-26,5,Wednesday,3,4,0
1486205076125401088,2022-01-26 05:11:17,"Kamu seorang yang berzodiak Pisces, atau mengenal orang dengan zodiak Pisces? Yuk! Simak sifat zodiak Pisces yang menarik dan perlu diketahui ini:  https://t.co/2SlWkJzen2",11,1,0,2,2022-01-26,5,Wednesday,3,11,3
1486204073401622528,2022-01-26 05:07:18,"Direktur Utama Telkomsel mengungkapkan dibandingkan dengan teknologi seluler lainnya, jaringan 3G umurnya memang sebentar. Ini penjelasannya:  https://t.co/zEE8vPmV5g",7,1,2,0,2022-01-26,5,Wednesday,3,9,1
1486203580046618625,2022-01-26 05:05:20,Nurul Arifin tak kuasa menahan tangis saat berpisah dengan Maura Magnalia. Kejadian itu terjadi sebelum jenazah Maura Magnalia diberangkatkan ke pemakanan. https://t.co/NE7H46UUDj,5,1,1,0,2022-01-26,5,Wednesday,3,6,1
1486203323787227139,2022-01-26 05:04:19,Anang Hermansyah bertemu Gus Miftah untuk bicara soal NFT. Anang melihat ada peluang keuntungan dari NFT untuk pelaku industri kreatif. https://t.co/CdpVYdZsFq,6,4,0,1,2022-01-26,5,Wednesday,3,6,5
1486201832250748929,2022-01-26 04:58:23,"Tangis Nurul Arifin pecah saat misa penutupan peti jenazah sang anak, Maura Magnalia. Nurul Arifin menangis sambil memeluk jenazah putri sulungnya itu. https://t.co/WF1ggq3mzR",43,6,10,2,2022-01-26,4,Wednesday,3,53,8
1486201674872070148,2022-01-26 04:57:46,"Bukan sekadar makan sayur, vegetarian ternyata terbagi dalam banyak jenis. Enam jenis vegetarian ini perlu kamu ketahui sebelum memutuskan jadi vegetarian.  https://t.co/3cHOeLm0WX",5,0,1,1,2022-01-26,4,Wednesday,3,6,1
1486201167294173189,2022-01-26 04:55:45,"Meski sudah ada 2 kasus meninggal, gejala ringan seperti batuk pilek masih mendominasi kasus Omicron di Indonesia. Banyak yang menyamakannya dengan flu biasa. https://t.co/noVxqEFliq",11,3,3,1,2022-01-26,4,Wednesday,3,14,4
1486200694927462402,2022-01-26 04:53:52,AS dan China sudah terang-terangan meneliti Mars dengan misi mereka tersendiri. Apakah Indonesia juga melakukan penelitian Planet Mars? Simak di sini jawabannya: #Eureka  https://t.co/f2XWX0m6Au,6,4,1,3,2022-01-26,4,Wednesday,3,7,7
1486200680046071810,2022-01-26 04:53:49,Dibangunnya Observatorium Nasional Gunung Timau di NTT jadi pembuka jalan Indonesia ikut dalam pencarian exoplanet. Ini alasan teleskop pemburu exoplanet di Gunung Timau:  https://t.co/fKeImQbNwL,8,0,1,0,2022-01-26,4,Wednesday,3,9,0
1486199936966402050,2022-01-26 04:50:51,XL Axiata mengungkapkan peralihan dari layanan 3G ke 4G akan berlangsung dalam satu tahun. Sudah siapkah masyarakat beralih dari 3G ke 4G? https://t.co/TfppBf5PT1,8,1,0,2,2022-01-26,4,Wednesday,3,8,3
1486199917605527552,2022-01-26 04:50:47,"Kesibukan kita di dunia jangan sampai membuat kita lupa salat. Kenapa sih muslim dan muslimah harus salat, ada yang tahu alasannya?

via: detikedu  https://t.co/irib7xzNZv",23,2,2,3,2022-01-26,4,Wednesday,3,25,5
1486199426305695744,2022-01-26 04:48:50,"Advan kembali merilis tablet murah di Indonesia. Kali ini bernama Advan Sketsa 2, tablet harga Rp 2 jutaan ini didukung stylus untuk corat-coret di layar.  https://t.co/Y3o2l9ZfXO",7,1,0,0,2022-01-26,4,Wednesday,3,7,1
1486198860485734400,2022-01-26 04:46:35,Hasil lelang OPPO Find N dan donasi tambahan yang totalnya Rp 118 juta akan diserahkan ke Yayasan Happy Hearts Indonesia. https://t.co/37nF1C45xu,4,1,1,0,2022-01-26,4,Wednesday,3,5,1
1486198096073797632,2022-01-26 04:43:32,Mata gatal dan kemerahan disebut sebagai tanda COVID-19 varian Omicron. Benarkah demikian? Simak penjelasan ahli: https://t.co/sdLWuIUatr,5,4,1,2,2022-01-26,4,Wednesday,3,6,6
1486197852024061958,2022-01-26 04:42:34,"90 Sekolah di Jakarta ditutup dan Wapres Ma'ruf Amin menilai kebijakan PTM diperhatian khusus terhadap penyebaran Omicron. Berikut respons Kemendikbudristek.

via: detikedu  https://t.co/tXdmWctS76",16,1,1,2,2022-01-26,4,Wednesday,3,17,3
1486196861744656384,2022-01-26 04:38:38,"Kenapa bisa muncul teori Bumi datar? Bentuk Bumi sebenarnya bulat atau datar? Pertanyaan detikers ini dijawab pakar dengan bukti kuat, no debat!  https://t.co/y4GpDX4JOq",13,4,4,1,2022-01-26,4,Wednesday,3,17,5
1486196310705332225,2022-01-26 04:36:27,Petenis top Novak Djokovic sempat terlibat dalam polemik Australian Open 2022 lantaran belum vaksin lengkap. Berikut komentar dari Zlatan Ibrahimovic! https://t.co/xix2vWXUfa,2,1,1,1,2022-01-26,4,Wednesday,3,3,2
1486196018957987840,2022-01-26 04:35:17,Jembatan Penyebrangan Orang (JPO) hingga halte TransJ masih menjadi andalan pemotor di Ibu Kota kala hujan turun untuk berteduh. https://t.co/MlnJerOPrO,3,0,0,0,2022-01-26,4,Wednesday,3,3,0
1486195276981407751,2022-01-26 04:32:20,"Sebagai klub kaya dan pemain bintang, PSG belum juga bisa Liga Champions. Apa kata Zlatan Ibrahimovic yang pernah main di PSG? https://t.co/nGBXO0XzTE",7,1,0,0,2022-01-26,4,Wednesday,3,7,1
1486194795420831745,2022-01-26 04:30:26,Bintan menjadi lokasi pertemuan Presiden RI Joko Widodo dengan Perdana Menteri Singapura Lee Hsien Loong. Pulau ini punya destinasi wisata yang menarik. https://t.co/2WlPmzjTRZ,11,1,1,0,2022-01-26,4,Wednesday,3,12,1
1486194779985743875,2022-01-26 04:30:22,Arnold Putra dicibir setelah memakai baju mirip seragam Pemuda Pancasila di Paris Fashion Week. Ini beberapa potret gayanya:  https://t.co/RhEfaqayeW,2,1,0,0,2022-01-26,4,Wednesday,3,2,1
1486194299427438593,2022-01-26 04:28:27,"Viral unggahan di media sosial seekor kucing diduga dianiaya dengan cara disiram air panas di Cijeruk, Bogor. https://t.co/8D4q8HB6nq",7,0,1,0,2022-01-26,4,Wednesday,3,8,0
1486194272432967681,2022-01-26 04:28:21,Aktor Wu Fung baru saja merayakan ulang tahunnya ke-90 bersama dengan sahabat-sahabatnya. Ini sosoknya:  https://t.co/c8smvyD2CR,14,0,0,0,2022-01-26,4,Wednesday,3,14,0
1486193520570425344,2022-01-26 04:25:22,"Kim Dong Han, Yoo Yong Ha, dan Kang Seok Hwa WEi dinyatakan positif COVID-19. Jadwal kegiatan mereka langsung dihentikan. #WEi  https://t.co/hIlSTUbRdV",9,0,1,0,2022-01-26,4,Wednesday,3,10,0
1486192938862399493,2022-01-26 04:23:03,"Anggota Komisi IX DPR RI, Irma Suryani menegur Menkes Budi Gunadi saat rapat kerja antara DPR dan Kemenkes, Selasa (25/1/2022). Irma merasa tak dihargai karena wajahnya tak dilihat Budi saat sedang berbicara. https://t.co/vANE2uMuJ0",71,134,9,17,2022-01-26,4,Wednesday,3,80,151
1486192717231239169,2022-01-26 04:22:10,Virgin the series jadi salah satu tayangan terbaru yang mengundang perhatian. Yuk kenalan dengan para karakter. Ini sosoknya:  https://t.co/oLHGzS9THY,5,0,0,0,2022-01-26,4,Wednesday,3,5,0
1486192698214297603,2022-01-26 04:22:06,Bupati Langkat membangun kerangkeng manusia di rumahnya. Ini motif Terbit bikin 'penjara' dirumahnya. https://t.co/wLrQT8xDnd,16,4,3,2,2022-01-26,4,Wednesday,3,19,6
1486191919310979072,2022-01-26 04:19:00,"Penggelaran layanan 5G di Indonesia sudah dilakukan sejak Mei 2021. Sayangnya, kehadiran teknologi tersebut, ponsel 5G masih terbilang minim keberadaannya. https://t.co/YqOdKrV8MM",5,1,0,0,2022-01-26,4,Wednesday,3,5,1
1486191632039002114,2022-01-26 04:17:51,"Maura Magnalia Madyaratri akan dimakamkan hari ini, Rabu (26/1) di San Diego Hills Karawang. Tampak beberapa karangan bunga berjejer di sekitaran pemakaman. Mulai dari AHY hingga Prabowo Subianto. https://t.co/2w5c7zXFZ1",2,1,0,0,2022-01-26,4,Wednesday,3,2,1
1486191364899540992,2022-01-26 04:16:48,"Mantan Wali Kota Tangsel, Airin Rachmi Diany, melayat ke rumah duka putri sulung Nurul Arifin. Sejak pagi hari ini, Rabu (26/1), pelayat dari kerabat dan sanak keluarga pun masih berdatangan. https://t.co/RGCdqepSgU",8,0,1,0,2022-01-26,4,Wednesday,3,9,0
1486191123538366465,2022-01-26 04:15:50,Anindita Hidayat mengungkapkan niatnya untuk menikah dan memiliki anak yang banyak. Agar hal itu terwujud ia punya cara tersendiri ini:  https://t.co/Jr72juzs1S,10,3,0,2,2022-01-26,4,Wednesday,3,10,5
1486190544187498503,2022-01-26 04:13:32,Della Dartyan menuntaskan janjinya untuk menerbitkan sebuah buku yang menjadi cerita pengalamannya sembuh dari proses healing. https://t.co/rMpUFB2sox,4,0,0,1,2022-01-26,4,Wednesday,3,4,1
1486190056763179014,2022-01-26 04:11:36,"Dear Taurus, hindari sikap egois yang akan menuntun anda ke arah kehancuran sedikit demi sedikit. Simak ramalan zodiak hari ini: https://t.co/0V89K5Dseh",7,1,1,0,2022-01-26,4,Wednesday,3,8,1
1486189729653698560,2022-01-26 04:10:18,Wijaya Saputra berulang tahun ke-37. Perayaan ulang tahun itu terlihat berbeda dari tahun sebelumnya tanpa Gisel...  https://t.co/OpCh8FjOlw,4,0,0,1,2022-01-26,4,Wednesday,3,4,1
1486189491845017606,2022-01-26 04:09:21,"Vicky Prasetyo makin dipandang buruk karena pengakuan 24 kali nikah. Mengaku itu hanya candaan, kini Vicky Prasetyo susah kembalikan citra baik. https://t.co/mQXTSWchm0",7,7,0,0,2022-01-26,4,Wednesday,3,7,7
1486188932832370691,2022-01-26 04:07:08,"Omicron di Indonesia nanjak terus, kini totalnya mencapai 1.766 orang. Ingat! entry point gejala COVID-19 Omicron berbeda dengan Delta. https://t.co/D3TnChgnaE",24,8,13,2,2022-01-26,4,Wednesday,3,37,10
1486188919779692550,2022-01-26 04:07:05,Vaksin Merah Putih buatan Unair mulai uji klinis manusia pada 7 Februari 2022. Berikut fakta-faktanya. https://t.co/ZHpuuCMHrT,5,1,2,0,2022-01-26,4,Wednesday,3,7,1
1486187878745092097,2022-01-26 04:02:56,Laudya Cynthia Bella belum lama ini bertemu dengan Zaskia Sungkar. Keduanya menyempatkan diri berfoto bersama. https://t.co/4n1aQAvwPY,18,2,1,0,2022-01-26,4,Wednesday,3,19,2
1486187329542832130,2022-01-26 04:00:46,"Nur Afifah Balqis ditetapkan sebagai tersangka kasus suap Bupati Penajam Paser Utara Abdul Gafur Mas'ud. Masih 24 tahun, foto dan gaya hidupnya jadi sorotan. #detiknetwork  https://t.co/PqyJCmljrN",80,37,15,10,2022-01-26,4,Wednesday,3,95,47
1486186797197668356,2022-01-26 03:58:39,"Dear Cancer, jangan biarkan keuangan hancur lebur hanya karena perilaku diri sendiri. Simak ramalan zodiak hari ini:  https://t.co/dbCH8gIhd9",3,0,1,0,2022-01-26,3,Wednesday,3,4,0
1486186328949768195,2022-01-26 03:56:47,"Elton John umumkan pemunduran jadwal konsernya di Dallas, Texas setelah di diagnosa COVID-19. Lekas pulih Elton John...  https://t.co/e4fIDq6kQ7",2,0,0,0,2022-01-26,3,Wednesday,3,2,0
1486186309974646784,2022-01-26 03:56:42,Ariel NOAH beberkan cara ia menulis lagu-lagu dengan lirik puitisnya. Ariel NOAH hanya menyisipkan 20 persen kisah hidupnya. https://t.co/fsDbBLRdjG,12,4,0,0,2022-01-26,3,Wednesday,3,12,4
1486185813931143169,2022-01-26 03:54:44,Italia menjalani Euro 2020 lalu dengan mengesankan hingga akhirnya jadi juara. Ada satu 'tradisi' yang dipertahankan Italia sejak awal turnamen. https://t.co/7UObc72izB,1,0,0,0,2022-01-26,3,Wednesday,3,1,0
1486185303140450304,2022-01-26 03:52:42,Cuitan Jerome Polin dapat kritik dari Sean Gelael dianggap meremehkan pebalap Indonesia. Jerome langsung klarifikasi ke Sean Gelael.  https://t.co/UOtI37N8Ld,30,4,3,2,2022-01-26,3,Wednesday,3,33,6
1486185286296088577,2022-01-26 03:52:38,"Dikenal lewat perannya sebagai pria jahat dan pemerkosa, Wong Wai Tong ternyata sosok yang begitu sayang pada keluarganya dan menghormati wanita. https://t.co/xisG2lVtbg",1,0,0,1,2022-01-26,3,Wednesday,3,1,1
1486184540674666496,2022-01-26 03:49:41,"Dengan angle foto yang pas, foto-foto ini bisa mengelabui mata kamu, dan melihatnya pun tak cukup sekali saja. Ini potretnya:  https://t.co/QovD5vAF8V",8,0,0,0,2022-01-26,3,Wednesday,3,8,0
1486184052780675077,2022-01-26 03:47:44,"Kasus tabrak lari di Tol Madiun menewaskan 2 orang, yakni sopir dan kernet truk. Polisi sudah menangkap pelaku di Sidoarjo. https://t.co/Umj8Kkco2I",3,0,0,0,2022-01-26,3,Wednesday,3,3,0
1486183471269748738,2022-01-26 03:45:26,Anthony Martial resmi dipinjamkan ke Sevilla. Marcus Rashford mendoakan yang terbaik untuk Martial. https://t.co/QVMQNt1arB,7,0,0,0,2022-01-26,3,Wednesday,3,7,0
1486183207250898948,2022-01-26 03:44:23,"Sean Gelael jadi perbincangan gara-gara ribut dengan influencer Jerome Polin. Sean menuding Polin meremehkan pebalap Indonesia. Lo, kok bisa? https://t.co/nNTw2lZM3t",4,1,0,0,2022-01-26,3,Wednesday,3,4,1
1486182731801317378,2022-01-26 03:42:29,Once Mekel ikut kolaborasi dengan musisi dunia untuk kampanye soal perubahan iklim. #OnceMekel  https://t.co/wpbz2FIyq9,17,0,2,2,2022-01-26,3,Wednesday,3,19,2
1486182228132601859,2022-01-26 03:40:29,Penyanyi Marcello Tahitoe atau Ello resmi menikah. Pernikahan Ello dengan Cindy Maria dielar di Bali. Selamat!  https://t.co/40q9qyOL9w,7,0,2,1,2022-01-26,3,Wednesday,3,9,1
1486182226928803843,2022-01-26 03:40:29,Malawi memang sudah tersingkir dari Piala Afrika (AFCON). Tapi paling tidak ada gol cantik Gabadinho Mhango yang lahir di laga pamungkas Malawi di ajang itu. https://t.co/vyXWnF8q3Q,2,0,0,0,2022-01-26,3,Wednesday,3,2,0
1486181258686341124,2022-01-26 03:36:38,Polisi mendalami kasus kerangkeng manusia di rumah Bupati Langkat. Dugaan perbudakan mulai diusut. https://t.co/bxWHtYCHPv,18,1,3,1,2022-01-26,3,Wednesday,3,21,2
1486181242349531136,2022-01-26 03:36:34,"Merasa tak puas dengan musiknya dulu, Ariel NOAH pernah ingin hengkang dari Peterpan dan ciptakan musik yang lebih bagus. #ArielNOAH  https://t.co/k0aaUkJzJY",9,1,0,1,2022-01-26,3,Wednesday,3,9,2
1486180722230673415,2022-01-26 03:34:30,"Ridwan Kamil menyesalkan soal masih ada pihak yang mencoreng kebinekaan, mulai dari Arteria Dahlan hingga Edy Mulyadi. Ini katanya. https://t.co/k1aasVP5mF",19,12,0,4,2022-01-26,3,Wednesday,3,19,16
1486180206624886784,2022-01-26 03:32:27,"Bandara Halim Perdanakusuma ditutup sementara selama 3,5 bulan mulai 26 Januari 2022. Perpindahan operasional penerbangan pun dilakukan ke 5 bandara penerima.  https://t.co/TgnHge0AGH",7,0,4,0,2022-01-26,3,Wednesday,3,11,0
1486179447774482436,2022-01-26 03:29:26,"Christian Eriksen sudah berlatih lagi dengan Ajax Amsterdam, setelah menganggur akibat sempat terkena serangan jantung.  https://t.co/T8Fsd1NQNt",9,2,0,0,2022-01-26,3,Wednesday,3,9,2
1486179130685247493,2022-01-26 03:28:11,Queendom akan kembali dengan musim kedua. Taeyeon SNSD dikonfirmasi jadi host di program ini. #TaeyeonSNSD  https://t.co/4dHZDretKg,8,0,1,0,2022-01-26,3,Wednesday,3,9,0
1486178680300879874,2022-01-26 03:26:23,Sejumlah negara Timur Tengah masuk daftar berbahaya COVID-19. Negara apa saja? https://t.co/WgTl6SK8rW,4,2,0,0,2022-01-26,3,Wednesday,3,4,2
1486178101826662400,2022-01-26 03:24:05,Ansu Fati menolak dioperasi untuk memulihkan cedera hamstringnya. Membuat kepulihan pemain depan Barcelona itu jadi sulit diprediksi. https://t.co/soUjLdDE1y,5,0,0,0,2022-01-26,3,Wednesday,3,5,0
1486177603471953923,2022-01-26 03:22:07,Kondisi kesehatan terdakwa kasus dugaan penistaan agama M Kace sudah membaik. Ia sudah keluar dari RSUD Ciamis dan dibawa petugas penegak hukum. https://t.co/TGthpkarlN,10,2,0,0,2022-01-26,3,Wednesday,3,10,2
1486177344788250631,2022-01-26 03:21:05,Evergrande masih berusaha menenangkan para krediturnya yang mengancam akan mengambil tindakan hukum terhadap raksasa real estate China ini!  https://t.co/xgxb0c4UZ7,6,1,0,0,2022-01-26,3,Wednesday,3,6,1
1486176837000732679,2022-01-26 03:19:04,Mario Balotelli kembali dipanggil untuk memperkuat Timnas Italia dan akan ikut bersama skuad tim nasional dalam kamp pelatihan di Coverciano. https://t.co/FfJXRkq9jf,7,0,0,0,2022-01-26,3,Wednesday,3,7,0
1486176578035986439,2022-01-26 03:18:02,Berikut ini lokasi perpanjangan SIM keliling di DKI Jakarta! https://t.co/9zY9ZdIkUI,5,0,0,0,2022-01-26,3,Wednesday,3,5,0
1486176560893902848,2022-01-26 03:17:58,Harga emas hari ini kembali mengalami kenaikan. Harga emas Antam 24 karat hari ini tercatat naik Rp 3.000 per gram menjadi Rp 950.000 per gram.  https://t.co/riyb9cnYNv,9,0,0,0,2022-01-26,3,Wednesday,3,9,0
1486176312956006400,2022-01-26 03:16:59,"Lagi-lagi pentingnya peralatan safety riding menjadi penentu keselamatan dalam berkendara, terutama untuk pengendara sepeda motor. https://t.co/8EHlqMRXbH",4,0,2,0,2022-01-26,3,Wednesday,3,6,0
1486175570367070210,2022-01-26 03:14:02,"Pria ini mencari orangtua kandungnya setelah ayah dan ibu yang mengadopsinya meninggal. Saat bertemu orangtua kandung, ia malah menutut mereka secara hukum. https://t.co/c6JfSfrrM4",14,1,1,2,2022-01-26,3,Wednesday,3,15,3
1486175569096187908,2022-01-26 03:14:02,Di Kampoeng Seafood bisa menikmati berbagai olahan seafood. Salah satunya restoran ini yang menawarkan ikan masak gulai hingga tumis genjer.  https://t.co/uyyMvXmTOy,3,1,0,0,2022-01-26,3,Wednesday,3,3,1
1486174813421031428,2022-01-26 03:11:01,Vlahovic sangat ingin gabung Juventus sampai-sampai tidak menanggapi tawaran dari klub Premier League. https://t.co/xlicMHK08k,9,5,0,1,2022-01-26,3,Wednesday,3,9,6
1486174318165995520,2022-01-26 03:09:03,Liverpool menyudahi Januari tanpa terkalahkan dan menjadi bukti The Reds bisa tetap melaju kencang tanpa Mohamed Salah dan Sadio Mane. https://t.co/Hjakihkjzu,18,2,2,2,2022-01-26,3,Wednesday,3,20,4
1486173812404150276,2022-01-26 03:07:03,"Sebanyak 7.907 lokasi di wilayah Terdepan, Terluar, dan Tertinggal (3T) di Indonesia kini mulai tersedia jaringan 4G.  https://t.co/U19zx7daQ9",3,1,1,0,2022-01-26,3,Wednesday,3,4,1
1486173308949258243,2022-01-26 03:05:03,Hujan salju masih mengguyur sejumlah wilayah di Turki sejak pekan lalu dan berakibat ratusan penumpang terdampar di Bandara Istanbul pada selasa (25/1). https://t.co/OLtL6T70jo,4,0,0,0,2022-01-26,3,Wednesday,3,4,0
1486173292583174148,2022-01-26 03:04:59,KontraS mengecam keras kerangkeng manusia Rumah Bupati Langkat. KontraS curiga ada banyak pihak yang terlibat terkait kerangkeng tersebut. https://t.co/lzQzKL0coD,35,0,5,1,2022-01-26,3,Wednesday,3,40,1
1486173016241414147,2022-01-26 03:03:53,Investasi bukan hanya soal modal uang yang ditanam untuk nanti dituai. Setidaknya itu yang diyakini seorang Adri Martowardojo. Simak di sini #HotQuestions  https://t.co/u9EAiAsm1P,3,1,0,1,2022-01-26,3,Wednesday,3,3,2
1486172451985895425,2022-01-26 03:01:38,"Epic Games Store, kembali membagikan game gratis. Ini memang kerap dilakukan mereka setiap minggu. Hanya saja, tersedia dalam kurun waktu terbatas. https://t.co/n4eA4bG7Du",4,0,0,0,2022-01-26,3,Wednesday,3,4,0
1486172133860466691,2022-01-26 03:00:23,"Proyek Pinocchio sudah lama dinantikan. Akan tayang di Netflix, film ini diberi judul resmi Guillermo del Toro's Pinocchio. https://t.co/8BB3lnHFDf",4,1,1,0,2022-01-26,3,Wednesday,3,5,1
1486172118517747722,2022-01-26 03:00:19,Lagi cari tiket pesawat ke destinasi menarik di Indonesia? Serbu nih tiket Garuda Indonesia diskon 50 persen! https://t.co/vbg5HTtHcS,11,0,3,1,2022-01-26,3,Wednesday,3,14,1
1486171614941229056,2022-01-26 02:58:19,Ririe Fairus akhirnya buka-bukaan soal perselingkuhan Ayus Sabyan. Begini cerita Ririe Fairus:  https://t.co/vPsprwLvus,4,1,1,0,2022-01-26,2,Wednesday,3,5,1
1486171102497935360,2022-01-26 02:56:17,Beberapa driver Gojek kini dibekali motor listrik. Maka jangan heran kalau kamu pesan ojek online tapi motornya nggak ada knalpotnya. https://t.co/XmfUtnzpjC,18,0,0,0,2022-01-26,2,Wednesday,3,18,0
1486170606445940738,2022-01-26 02:54:18,"Sinyal kehadiran Honda HR-V generasi terbaru semakin menguat, di media sosial beredar foto mobil yang diduga Honda HR-V sedang syuting! https://t.co/XWGBouE7tx",5,0,0,1,2022-01-26,2,Wednesday,3,5,1
1486169816100655106,2022-01-26 02:51:10,Kuasa hukum dosen UI ungkap Kemendikbud pernah luluskan profesor hanya dalam waktu 12 hari. Sedangkan Sri yang telah diakui banyak negara malah tidak lulus. https://t.co/WOadsffhDW,24,3,4,2,2022-01-26,2,Wednesday,3,28,5
1486169281624748032,2022-01-26 02:49:03,Menkominfo Johnny G Plate mengungkapkan alasan dimatikan layanan 3G dibanding 2G yang teknologinya jelas-jelas lebih jadul. #Kominfo  https://t.co/lAFceA7AlH,14,3,1,3,2022-01-26,2,Wednesday,3,15,6
1486169028448112641,2022-01-26 02:48:02,Nathalie Holscher dan Sule baru saja dikaruniai seorang anak bernama Adzam. Begini tanggapan Sule soal anaknya yang di cap sultan:  https://t.co/93oAa1IZ9s,9,0,0,0,2022-01-26,2,Wednesday,3,9,0
1486168515497414662,2022-01-26 02:46:00,"Dihimpun detikJateng, berikut jadwal dan syarat lengkap vasinasi booster untuk lansia di 6 puskesmas, Stadion Mandala Krida, dan JEC. https://t.co/CzmOesp8S3",3,0,1,0,2022-01-26,2,Wednesday,3,4,0
1486167940865175558,2022-01-26 02:43:43,"Bayern Munich ingin Robert Lewandowski dan Manuel Neuer bertahan selama mungkin, hingga mereka pensiun. https://t.co/re3cUPXV74",9,1,1,1,2022-01-26,2,Wednesday,3,10,2
1486167689508835331,2022-01-26 02:42:43,"Juergen Klopp takjub melihat performa timnya sepanjang Januari ini. Karena, The Reds biasanya suka keteteran. https://t.co/EikhdfO81e",7,0,0,0,2022-01-26,2,Wednesday,3,7,0
1486167145230872578,2022-01-26 02:40:33,Ada pertandingan Timnas Indonesia Vs Timor Leste pada pekan ini dan berlangsung dua kali. Simak jadwalnya! https://t.co/CHn4rJt94R,6,0,0,0,2022-01-26,2,Wednesday,3,6,0
1486166625053286412,2022-01-26 02:38:29,Bandara Istanbul terpaksa ditutup karena lebatnya hujan salju dan memaksa pemadamanan dan terjadi kekacauan lalu lintas. https://t.co/ibA6S8w8Z0,7,1,0,0,2022-01-26,2,Wednesday,3,7,1
1486166139432542208,2022-01-26 02:36:33,"Indonesia menandatangani perjanjian ekstradisi dengan Singapura. Indonesia bisa menuntaskan kejahatan masa lalu, termasuk soal BLBI.  https://t.co/tmLVuWH7Ci",123,41,15,6,2022-01-26,2,Wednesday,3,138,47
1486165852571512833,2022-01-26 02:35:25,Indeks Harga Saham Gabungan (IHSG) pada pagi ini menguat. IHSG akhirnya menguat setelah dua hari di pekan ini berada di zona merah.  https://t.co/tR6EnhWDRQ,0,0,0,0,2022-01-26,2,Wednesday,3,0,0
1486165851447382021,2022-01-26 02:35:25,"Hong Kong masih menjadi destinasi yang melakukan aturan ketat terkait karantina wajib. Walaupun negatif Covid, Anda masih harus mengurung diri selama 21 hari! https://t.co/Km4TA2G7yo",1,0,1,0,2022-01-26,2,Wednesday,3,2,0
1486165354791456779,2022-01-26 02:33:26,Sekolah yang ditutup akibat kasus COVID-19 kian bertambah. Setidaknya ada 120 siswa positif COVID-19 sehingga 90 sekolah ditutup sementara. Ini daftarnya: https://t.co/fXvRrNlygJ,23,4,9,5,2022-01-26,2,Wednesday,3,32,9
1486164612408033280,2022-01-26 02:30:29,Para pelayat terlihat masih nampak berdatangan ke rumah duka Maura Magnalia.  https://t.co/odWt1s05YO,3,1,0,0,2022-01-26,2,Wednesday,3,3,1
1486164598004891648,2022-01-26 02:30:26,"Kripto difatwa haram oleh MUI. Akan tetapi, kripto semakin jadi primadona dan semakin banyak muncul aset digital, salah satunya NFT. Ini kata ustaz:  https://t.co/kcedCvSy5W",10,5,2,3,2022-01-26,2,Wednesday,3,12,8
1486164103626465284,2022-01-26 02:28:28,"Penemuan kerangkeng manusia di rumah Bupati Langkat, jadi pergunjingan masyarakat. Jika benar itu praktik perbudakan, sungguh keterlaluan!   https://t.co/Fyyylm7sg8",14,1,6,3,2022-01-26,2,Wednesday,3,20,4
1486163358420189187,2022-01-26 02:25:30,"Usai menjalani sidang saksi ahli, Jerinx tunjukkan foto yang diduga adalah Adam Deni yang sedang melecehkan foto Presiden Joko Widodo. Jerinx berharap, Adam Deni juga diadili apabila memang terbukti orang yang ada di foto tersebut benar Adam Deni. https://t.co/KGlC0LAe6j",15,3,5,0,2022-01-26,2,Wednesday,3,20,3
1486163340888006657,2022-01-26 02:25:26,"Jenazah putri Nurul Arifin, Maura Magnalia, akan dimakamkan hari ini (26/1) di San Diego Hills, Karawang, Jawa Barat. Maura meninggal di usia 27 tahun karena penyakit jantung. https://t.co/OkWXsYSC9v",8,1,2,1,2022-01-26,2,Wednesday,3,10,2
1486162873546162179,2022-01-26 02:23:35,"Gol dari Hakimi menentukan kemenangan Maroko, dan lolos ke perempatfinal Piala Afrika 2021 usai menyingkirkan Malawi. https://t.co/Uk40jAjjbR",9,0,1,0,2022-01-26,2,Wednesday,3,10,0
1486162322515279872,2022-01-26 02:21:23,Upaya memperbaiki kinerja PT Garuda Indonesia (Persero) Tbk menunjukkan tanda-tanda yang positif.  https://t.co/GdWUa9a1YF,3,0,1,0,2022-01-26,2,Wednesday,3,4,0
1486161834335997952,2022-01-26 02:19:27,Banyak cara memotong buah dan sayuran yang praktis dan mudah untuk dipraktekkan. Kamu bisa meniru agar lebih cepat saat mengolah makanan di dapur.  https://t.co/fMlbARaYyz,10,1,2,0,2022-01-26,2,Wednesday,3,12,1
1486161325759901696,2022-01-26 02:17:26,"Putri Nurul Arifin, Maura Magnalia meninggal dunia di usia 28 tahun karena serangan jantung. Nurul Arifin mengungkap kondisi terakhir sang putri:  https://t.co/LX0oecMPUQ",10,1,0,0,2022-01-26,2,Wednesday,3,10,1
1486161085904437262,2022-01-26 02:16:29,"Sultan Brunei Darusalam, kembali menjadi sorotan, kali tentang koleksi mobil miliknya yang lebih mahal dari klub Manchester United! https://t.co/4b7Dr7HuD0",36,14,7,0,2022-01-26,2,Wednesday,3,43,14
1486160548781830153,2022-01-26 02:14:21,"Meningkat signifikan, DKI Jakarta melaporkan total kasus aktif COVID-19 sebanyak 12.196, Selasa (25/1/2022). Sementara, Omicron naik menjadi 1.697 kasus. https://t.co/MpKAU3A6IY",4,1,3,0,2022-01-26,2,Wednesday,3,7,1
1486160081339228160,2022-01-26 02:12:29,Sejumlah nama mencuat calon kuat jadi Kepala Otorita IKN Nusantara. Ini kata Ali Mochtar Ngabalin. https://t.co/PvBBsp9Nlf,5,3,1,0,2022-01-26,2,Wednesday,3,6,3
1486160063496658944,2022-01-26 02:12:25,"Lagi ramai di media sosial, Stasiun Pengisian Bahan Bakar Umum (SPBU) hanya menyediakan jalur 'Honda'. https://t.co/9RbVbKWri3",152,130,31,31,2022-01-26,2,Wednesday,3,183,161
1486159553741864961,2022-01-26 02:10:23,"#Foto Ini loh kapal dagang Viking dari abad ke-11 masuk ke dalam daftar ""Warisan Budaya Takbenda"" UNESCO. https://t.co/bJXNA0iRSQ",5,0,1,0,2022-01-26,2,Wednesday,3,6,0
1486159306944827393,2022-01-26 02:09:24,Pisang plenet merupakan salah satu camilan khas Semarang yang rasanya enak. Pisang bakar yang dipipihkan ini ditambahkan topping selai nanas hingga keju.  https://t.co/iBh939HRDF,5,2,4,0,2022-01-26,2,Wednesday,3,9,2
1486158559863783437,2022-01-26 02:06:26,Sebuah gunung es yang sempat jadi gunung es terbesar di Bumi bernama A68a terus mencair dan melelehkan air sebanyak 152 miliar ton ke pulau di sekitarnya. https://t.co/IPgFJeiwRX,17,0,6,5,2022-01-26,2,Wednesday,3,23,5
1486158291684282372,2022-01-26 02:05:22,"Memiliki penasaran yang tinggi, seorang bocah memasukkan petai ke penampung air dispenser. Hasilnya satu rumah geger karena bau petai yang tak kunjung hilang!  https://t.co/BuZiTrITzq",19,7,9,9,2022-01-26,2,Wednesday,3,28,16
1486158079444066309,2022-01-26 02:04:32,"BMKG mencermati bibit siklon tropis masih pengaruhi kondisi cuaca di Indonesia. Simak prakiraan cuaca selengkapnya yang berlaku untuk hari Rabu, 26 Januari 2022. https://t.co/h6qW90oLpc",2,0,1,0,2022-01-26,2,Wednesday,3,3,0
1486158056291512322,2022-01-26 02:04:26,Ririe Fairus akhinya berani berbagi cerita. Ingat lagi ketika dugaan perselingkuhan Ayus dan Nissa Sabyan terungkap:  https://t.co/jQnJRYsynl,1,0,1,0,2022-01-26,2,Wednesday,3,2,0
1486157804104781825,2022-01-26 02:03:26,Acha Septriasa menjadi sorotan setelah memenuhi undangan Irwansyah dan Zaskia Sungkar untuk membuat konten bersama. Netizen jadi heboh sendiri!  https://t.co/eKgEsp0319,2,4,2,0,2022-01-26,2,Wednesday,3,4,4
1486157787633795077,2022-01-26 02:03:22,"Masa depan Paulo Dybala masih belum jelas, yang terbaru menyebut Dybala hampir pasti gabung Inter Milan musim depan! https://t.co/SfJDmphdEt",15,0,2,1,2022-01-26,2,Wednesday,3,17,1
1486157535694540803,2022-01-26 02:02:22,Ririe Fairus kembali menjadi sorotan setelah curhat dengan Maia Estianty tentang perjalanan cintanya. Ibu 2 anak ini ternyata juga sering ngopi cantik di kafe.  https://t.co/4sXr7iNsT9,6,0,1,0,2022-01-26,2,Wednesday,3,7,0
1486157511363379206,2022-01-26 02:02:16,Viral yang menyebut permen Yupi haram itu menandakan bahwa masyarakat kita sangat peduli soal halal atau haram sebuah produk. Ini klarifikasi dari BPJH Kemenag.  https://t.co/XUR4764Nr2,3,1,2,1,2022-01-26,2,Wednesday,3,5,2
1486157310732951555,2022-01-26 02:01:29,Minum kopi bisa menambah energi dan membantu daya fokus. Selain itu minum kopi juga bisa bantu turunkan berat badan. Asalkan dilakukan dengan tepat.  https://t.co/5RyyLNsnW3,4,0,4,1,2022-01-26,2,Wednesday,3,8,1
1486157307570532355,2022-01-26 02:01:28,"Bertema Kundalini Chakra, kostum rancangan Eggie Jasmin asal Surabaya berhasil menang sebagai Kostum Nasional Terbaik Mrs. World 2022. https://t.co/HeN7CGl3Dy",21,2,5,1,2022-01-26,2,Wednesday,3,26,3
1486157047410397185,2022-01-26 02:00:26,"#detiknetwork  Artis cilik pemeran film Danur 2 dan 3, Matthew White meninggal dunia di usia 12 tahun karena menderita penyakit diabetes. Diabetes yang dialami anak berbeda dengan yang dialami pada orang dewasa. Baca cirinya di #CNNIndonesia! https://t.co/flOCNfHuQe",7,0,4,1,2022-01-26,2,Wednesday,3,11,1
1486156769424461824,2022-01-26 01:59:19,"Nurul Arifin kehilangan putri sulungnya, Maura Magnalia, untuk selamanya. Ia mengungkap percakapan terakhir dengan sang mendiang:  https://t.co/AmP5OqWcoj",3,0,1,0,2022-01-26,1,Wednesday,3,4,0
1486156006564503554,2022-01-26 01:56:18,"Wanita Jepang memiliki kulit sehat dan glowing. Selain memakai produk kecantikan, hal tersebut didapat dari konsumsi dan penggunaan bahan makanan berikut.  https://t.co/JE5cKzMtHV",8,0,3,0,2022-01-26,1,Wednesday,3,11,0
1486154823745605637,2022-01-26 01:51:36,Unilever akan segera memangkas 1.500 pegawai di seluruh dunia. Ada apa nih?  https://t.co/IT090bRDKn,53,8,14,4,2022-01-26,1,Wednesday,3,67,12
1486154741549834242,2022-01-26 01:51:16,Badan Pengatur Jalan Tol (BPJT) membuka prakualifikasi pelelangan pengusahaan jalan tol Sentul Selatan-Karawang Barat.  https://t.co/K8s1FqEe15,3,0,1,0,2022-01-26,1,Wednesday,3,4,0
1486154740346105857,2022-01-26 01:51:16,Kasus Aliff Alli dan Aska Ongi soal dugaan pemalsuan dokumen masih berlanjut. Aliff diperiksa oleh penyidik dan dicecar 15 pertanyaan.  https://t.co/qsJ6Obmrbx,2,0,1,0,2022-01-26,1,Wednesday,3,3,0
1486154739544997889,2022-01-26 01:51:15,Manchester United melepas Anthony Martial ke Sevilla dengan status pinjaman sampai akhir musim. https://t.co/ZK5fndwcN6,3,0,1,0,2022-01-26,1,Wednesday,3,4,0
1486153442662010882,2022-01-26 01:46:06,Perbaikan breasting dolphin di Dermaga Terminal Manggis ditargetkan selesai pada April 2022. Ini progresnya.  https://t.co/oYTF6zyUe9,2,0,1,0,2022-01-26,1,Wednesday,3,3,0
1486153429617676288,2022-01-26 01:46:03,Pemindahan IKN ke Kalimantan Timur dikhawatirkan berdampak pada sisi beban utang.  https://t.co/i2UT2K82Pg,107,60,18,7,2022-01-26,1,Wednesday,3,125,67
1486152662395539456,2022-01-26 01:43:00,Della Dartyan tak hanya melawan fobia akan berbagai hal. Tapi sekarang dia punya hobi bertualang ke berbagai daerah di Indonesia. Ini potretnya:  https://t.co/2Yc1BeYRQ3,7,0,1,0,2022-01-26,1,Wednesday,3,8,0
1486151808905097216,2022-01-26 01:39:37,Kalina Oktarani tak terima ibunya dijadikan konten oleh Vicky Prasetyo. Ia pun murka saat megentahui hal tersebut. Begini tanggapan santai Vicky:  https://t.co/wqKBTB5fNX,11,2,4,0,2022-01-26,1,Wednesday,3,15,2
1486151083454050306,2022-01-26 01:36:44,Gubernur DIY Sri Sultan Hamengku Buwono tidak memberi toleransi lagi kepada PKL di Jalan Malioboro dan ingin segera digusur.  https://t.co/swQQMFS1Zo,73,11,12,3,2022-01-26,1,Wednesday,3,85,14
1486150747041546243,2022-01-26 01:35:24,"Beredar postingan di media sosial ada anak berusia 10 tahun yang meninggal dunia usai divaksin. Dinkes Tanjungbalai, Sumut membantah informasi tersebut. https://t.co/Sd96pwMRgN",22,1,5,1,2022-01-26,1,Wednesday,3,27,2
1486150222636007428,2022-01-26 01:33:19,"Usai mengalami kecelakaan mobil beruntun, Arnold Schwarzenegger memilih untuk gowes dengan sepedanya di jalanan Los Angeles.  https://t.co/AtGcDRq3Tm",15,1,3,1,2022-01-26,1,Wednesday,3,18,2
1486148448986480640,2022-01-26 01:26:16,Mendengarkan musik saat tidur sering dilakukan banyak orang karena dianggap membuat suasana istirahat jadi lebih nyaman. Ini kekurangan dan kelebihannya:  https://t.co/Po4t2jpAlk,4,0,3,1,2022-01-26,1,Wednesday,3,7,1
1486147264506699779,2022-01-26 01:21:33,Pelayanan ruang udara atau Flight Information Region (FIR) di atas wilayah Kepulauan Riau dan Natuna akhirnya diambil alih Indonesia.  https://t.co/klzz7BykDW,24,3,4,0,2022-01-26,1,Wednesday,3,28,3
1486146025727397892,2022-01-26 01:16:38,Persediaan minyak goreng Rp 14.000 per liter mulai sulit didapatkan. Hal ini tercermin dari penampakan rak minyak goreng kosong di berbagai minimarket!  https://t.co/oQRpD1P0CO https://t.co/iSVdXpuJ9E,24,33,6,6,2022-01-26,1,Wednesday,3,30,39
1486145025994072066,2022-01-26 01:12:40,Gelaran The Modest Heritage of Indonesia akhirnya digelar oleh Pelangi Wastra Indonesia. Ada 10 desainer yang ikut dalam gelaran lestarikan Wastra Indonesia. https://t.co/FmtiT0b6j4,6,0,2,0,2022-01-26,1,Wednesday,3,8,0
1486144033630179330,2022-01-26 01:08:43,Perbaikan besar-besaran bakal dilakukan pada struktur Jalan Tol Trans Sumatera. Begini rinciannya.   https://t.co/sPtV6FZhWu,3,0,0,0,2022-01-26,1,Wednesday,3,3,0
1486143533576855552,2022-01-26 01:06:44,Anggita Sari meluapkan emosinya di media sosial. Diduga ia sedang berseteru dengan Marissya icha. https://t.co/gIvJybmqM7,2,1,0,0,2022-01-26,1,Wednesday,3,2,1
1486141309257666563,2022-01-26 00:57:53,Maura Magnalia sempat minta maaf ke Nurul Arifin karena tak bisa memenuhi harapan sang ibu. https://t.co/AE7WHGsX44,38,2,0,2,2022-01-26,0,Wednesday,3,38,4
1486140573333528577,2022-01-26 00:54:58,Asisten pelatih ganda putri Chafidz Yusuf juga keluar dari Pelatnas PBSI. Chafidz tidak diperpanjang oleh induk organisasi bulutangkis nasional tersebut. https://t.co/JCGvJwJHmN,5,0,0,0,2022-01-26,0,Wednesday,3,5,0
1486139826424459267,2022-01-26 00:52:00,Indonesia dan Singapura menjalin kesepakatan (deal) mengenai sejumlah hal. Berikut adalah enam hal yang telah diketahui sejauh ini soal deal itu. https://t.co/N44bpOHUpK,16,2,5,1,2022-01-26,0,Wednesday,3,21,3
1486138982857596930,2022-01-26 00:48:39,Diogo Jota bertransformasi dengan baik menjadi penyerang andalan Liverpool. Kemampuan adaptasi yang sangat baik jadi kunci ketajamannya. https://t.co/IbwE7kMcDQ,8,0,0,0,2022-01-26,0,Wednesday,3,8,0
1486138182634778626,2022-01-26 00:45:28,"Belanda akan mencabut sejumlah pembatasan COVID-19. PM Belanda, Mark Rutte, mengatakan bar, restoran, dan museum diizinkan untuk buka kembali. https://t.co/sv4PhLO9S3",16,0,6,0,2022-01-26,0,Wednesday,3,22,0
1486137188710551556,2022-01-26 00:41:31,Gubernur Jateng Ganjar Pranowo membuat postingan 'halu' video call dengan Lisa Blackpink. Konten itu disebut jurus Ganjar memikat segmen milenial. https://t.co/XD485BBBN9,546,41,185,4,2022-01-26,0,Wednesday,3,731,45
1486136446121656324,2022-01-26 00:38:34,"Presiden Prancis, Emmanuel Macron, memperingatkan Rusia akan menghadapi konsekuensi berat jika menyerang Ukraina. https://t.co/OEVv0dq3hP",10,1,2,0,2022-01-26,0,Wednesday,3,12,1
1486135321729376262,2022-01-26 00:34:06,"Seorang remaja berusia 17 tahun di Nagan Raya, Aceh divonis 66 bulan penjara karena terbukti memperkosa anak berusia 15 tahun. https://t.co/o3PHd7LPsD",4,0,2,0,2022-01-26,0,Wednesday,3,6,0
1486134589630337040,2022-01-26 00:31:11,"Jaksa Agung ST Burhanuddin menyambangi kantor Kejati Jabar. Dalam kesempatan tersebut, Burhanuddin menyoroti Plt Bupati Bandung Barat Hengky Kurniawan. https://t.co/zjO2csGNhJ",7,0,2,0,2022-01-26,0,Wednesday,3,9,0
1486133594565357568,2022-01-26 00:27:14,"Kapal dagang Viking dari abad ke-11 masuk ke dalam daftar ""Warisan Budaya Takbenda"" UNESCO. Perahu layar kayu ini paling terkenal digunakan selama era Viking. https://t.co/ncHIlAusHc",5,0,0,0,2022-01-26,0,Wednesday,3,5,0
1486133034298621954,2022-01-26 00:25:01,Robin Gosens tak tertarik merumput di Liga Inggris bersama Newcastle United. Gosens pun malah menerima tawaran dari Inter Milan. https://t.co/6SM8VRYvV5,6,0,0,0,2022-01-26,0,Wednesday,3,6,0
1486132050927173639,2022-01-26 00:21:06,"Penyakit jantung bisa menyerang siapa saja, namun banyak yang meyakini wanita muda lebih terlindungi dari penyakit mematikan ini. Faktanya, nggak juga. https://t.co/DlJvhJ9q5C",7,0,3,0,2022-01-26,0,Wednesday,3,10,0
1486131309051326464,2022-01-26 00:18:09,Pelaku pembakar mobil dinas Lapas Gobah Pekanbaru seorang napi bernama Riko Silalahi. Aksi kriminal itu dilakukan lantaran Riko dendam pernah dirazia HP. https://t.co/oTcm61tkRp,7,0,1,1,2022-01-26,0,Wednesday,3,8,1
1486130461701283841,2022-01-26 00:14:47,"Inilah empat striker Liga Inggris yang paling hobi jebol gawang Arsenal. Dua masih aktif main dan duanya lagi sudah pensiun, bisa tebak siapa saja? https://t.co/giSKVzlEf7",0,0,0,0,2022-01-26,0,Wednesday,3,0,0
1486129544964841474,2022-01-26 00:11:09,Kapolri menunjuk Kapolrestabes Medan baru untuk menggantikan Kombes Riko yang dicopot. Siapa? https://t.co/UyKHQbQBAM,6,0,1,0,2022-01-26,0,Wednesday,3,7,0
1486128779873472515,2022-01-26 00:08:06,"Georgina Rodriguez sempat kesulitan mengikuti gaya hidup mewah kekasihnya, Cristiano Ronaldo. Georgina bahkan sempat nyasar di rumah Ronaldo. https://t.co/raz5eZvmaX",21,4,2,4,2022-01-26,0,Wednesday,3,23,8
1486128035338362881,2022-01-26 00:05:09,Seorang pria di Bali melakukan aksi nekat dengan menabrakkan dirinya ke pelaku jambret. Pria itu menabrakkan diri ke pelaku demi merebut tas milik korban. https://t.co/wOGaanXmdE,22,6,1,3,2022-01-26,0,Wednesday,3,23,9
1486127454448193537,2022-01-26 00:02:50,"Belum genap satu musim berseragam Paris Saint-Germain, Georginio Wijnaldum dikabarkan ingin hengkang. Wijnaldum disebut tertarik kembali ke Inggris. https://t.co/Eqmu0q5BhL",5,1,0,0,2022-01-26,0,Wednesday,3,5,1
1486127028487217154,2022-01-26 00:01:09,10 Negara Dunia yang Pekerjanya Paling Sejahtera. https://t.co/VkVNsmcoa9,23,1,1,0,2022-01-26,0,Wednesday,3,24,1
1486125873656963072,2022-01-25 23:56:33,"MAKI mengadukan pungutan liar (pungli) yang dilakukan oleh oknum Bea Cukai Bandara Soekarno-Hatta. Usai laporan itu, pejabat Bea Cukai diberhentikan. https://t.co/Mhn4xONu6e",16,0,3,1,2022-01-25,23,Tuesday,2,19,1
1486125110411022338,2022-01-25 23:53:31,Akun Instagram Ketua Umum (Ketum) PSI Giring Ganesha sempat mendadak hilang. PSI sempat menduga akun sang ketum hilang karena serangan. https://t.co/zEjUR6qU8l,25,56,3,11,2022-01-25,23,Tuesday,2,28,67
1486123326632251392,2022-01-25 23:46:26,Pemerintah melaporkan kasus harian positif Corona hari ini sebanyak 4.878 kasus. Provinsi dengan kasus tertinggi dalam 24 jam terakhir adalah DKI Jakarta. https://t.co/0fJytwoCto,7,0,3,2,2022-01-25,23,Tuesday,2,10,2
1486122582873186305,2022-01-25 23:43:29,"Kasus positif COVID-19 varian Omicron di DKI Jakarta kembali bertambah. Kini, kasus Omicron DKI bertambah 113 orang, sehingga totalnya jadi 1.697 orang. https://t.co/P8skDM1XEQ",6,0,2,0,2022-01-25,23,Tuesday,2,8,0
1486121452726280193,2022-01-25 23:38:59,"Paris Saint-Germain akan menghadapi Real Madrid di Liga Champions. Namun, PSG masih belum tahu apakah Neymar bisa pulih tepat waktu untuk laga itu. https://t.co/FzSAiADfcc",13,0,1,0,2022-01-25,23,Tuesday,2,14,0
1486120161178533893,2022-01-25 23:33:51,"Polisi kini menetapkan 5 tersangka pengeroyokan yang menewaskan kakek diteriaki maling di Cakung, Jakut. Pelaku lain masih dikear. https://t.co/8TX79G5EY6",12,4,0,0,2022-01-25,23,Tuesday,2,12,4
1486119432451723267,2022-01-25 23:30:58,Riko Silalahi menjadi otak pelaku pembakaran mobil dinas Kepala Keamanan Lapas Pekanbaru. Napi narkoba itu dipastikan akan dipindahkan ke Lapas Nusakambangan. https://t.co/FJepoITN4r,8,1,0,0,2022-01-25,23,Tuesday,2,8,1
1486118201901600772,2022-01-25 23:26:04,"Seorang warga yang berada di dalam kerangkeng Rumah Bupati Langkat, menceritakan saat dia berada di dalam kerangkeng. Fredi mengaku makin gemuk. https://t.co/X9TnkxWipI",41,14,11,7,2022-01-25,23,Tuesday,2,52,21
1486116951944531971,2022-01-25 23:21:06,"Komnas KIPI pastikan laporan efek samping serius pada anak jauh lebih sedikit ketimbang usia dewasa. Artinya, anak aman diberikan vaksin COVID-19. https://t.co/LZumFISzwi",2,0,0,1,2022-01-25,23,Tuesday,2,2,1
1486115954752991233,2022-01-25 23:17:08,Tim gabungan dari Ditpolair Baharkam Polri dan Ditpolaair Polda Kaltim mengamankan 1.000 batang kayu jenis meranti dan berbagai jenis lainnya tanpa dokumen. https://t.co/8CRizwdR1A,8,1,1,1,2022-01-25,23,Tuesday,2,9,2
1486114950858907649,2022-01-25 23:13:09,"Salat tahajud memiliki keutamaan yang banyak. Dilaksanakan setelah bangun tidur, kapan sih waktu yang mustajab untuk melaksanakannya? https://t.co/HnDTbcjdPO",96,2,17,0,2022-01-25,23,Tuesday,2,113,2
1486112514085732359,2022-01-25 23:03:28,"Kisah Firaun memberi hikah, hidayah Allah SWT yang bisa datang pada siapa saja. Salah satunya pada Asiyah, istri sang raja zalim yang menganggap dirinya Tuhan. https://t.co/DQa13vUNCk",16,0,2,1,2022-01-25,23,Tuesday,2,18,1
1486112303217094656,2022-01-25 23:02:38,Bisnis jasa curhat online kian marak. Pernah menggagalkan upaya bunuh diri pasien yang sedang galau. Simak selengkapnya di https://t.co/KkN5F67WzG https://t.co/onEz8IJhJp,13,1,2,3,2022-01-25,23,Tuesday,2,15,4
1486109582162370569,2022-01-25 22:51:49,Perbaikan besar-besaran bakal dilakukan pada struktur Jalan Tol Trans Sumatera. Begini rinciannya.  https://t.co/DpJD1hbDBN,11,2,1,0,2022-01-25,22,Tuesday,2,12,2
1486109571412279296,2022-01-25 22:51:47,"Bandara Internasional Bintan Baru atau New Internasional Airport Bintan disambut baik Menhub Budi Karya. Yuk, intip progres terkininya!  https://t.co/Y9uAv5h2DC",17,1,2,0,2022-01-25,22,Tuesday,2,19,1
1486109216976912387,2022-01-25 22:50:22,#terpopuler Seiring meningkatnya COVID-19 varian Omicron mengharuskan kita untuk tetap menjaga sistem kekebalan tubuh. Hal ini bisa didapatkan dengan minuman sehat ini.  https://t.co/GmUOLf8QVn,4,1,2,2,2022-01-25,22,Tuesday,2,6,3
1486109200275095558,2022-01-25 22:50:18,"Seorang ibu, LF (45), di Tangsel menyeret anaknya, pemuda berinisial S (24) ke meja hijau karena menjual kulkas. LF mengungkap alasannya melaporkan sang anak. https://t.co/YpuvX7pVrW",50,18,11,10,2022-01-25,22,Tuesday,2,61,28
1486108930665291789,2022-01-25 22:49:14,Proyek kebanggaan Anies bernama Jakarta International Stadium (JIS) berdiri megah di utara Jakarta. Dibalik kemegahannya masih terdapat ketimpangan disekitarnya https://t.co/3ARCrAwowQ,34,20,4,2,2022-01-25,22,Tuesday,2,38,22
1486108913045061637,2022-01-25 22:49:10,Korlantas Polri menegaskan bahwa truk yang kelebihan muatan atau ODOL merupakan kejahatan lalu lintas. Polisi akan melakukan penilangan. https://t.co/RZffIrcfmB,9,3,3,1,2022-01-25,22,Tuesday,2,12,4
1486100343591260170,2022-01-25 22:15:06,"Indonesia mencatat sebanyak 4.878 kasus baru COVID-19, Selasa (25/1/2022). DKI menyumbang kasus terbanyak dengan jumlah 2.190 kasus. https://t.co/1pcQJEQueY",12,2,4,2,2022-01-25,22,Tuesday,2,16,4
1486098924444262406,2022-01-25 22:09:28,Manchester United melepas Anthony Martial ke Sevilla. Martial gabung Sevilla dengan status pinjaman sampai akhir musim. https://t.co/Jj4TqEgfCM,10,0,4,0,2022-01-25,22,Tuesday,2,14,0
1486098573863399426,2022-01-25 22:08:05,Hari ini dilaporkan ada tambahan 4.878 kasus positif COVID-19 di Indonesia. Sedangkan kasus sembuh bertambah 869 dan meninggal akibat Corona 20 orang. https://t.co/zBRxHj1kJl,7,0,0,1,2022-01-25,22,Tuesday,2,7,1
1486097394467061775,2022-01-25 22:03:23,"""Apabila itu tidak dilakukan, maka Jakarta akan penuh dan akan dilakukan penjemputan paksa oleh kami,"" kata Hebby Nurlan Arafat. https://t.co/BCL7nVCeAA",1387,403,207,85,2022-01-25,22,Tuesday,2,1594,488
1486095472792121344,2022-01-25 21:55:45,"Shin Ji Yeon, kontestan acara perjodohan Netflix 'Single's Inferno' membantah tuduhan memakai bantalan pinggul. Ini potret dan sederet faktanya:  https://t.co/5ZQb8oJbXn",6,0,0,0,2022-01-25,21,Tuesday,2,6,0
1486093576148762626,2022-01-25 21:48:13,BMKG mengeluarkan prakiraan cuaca untuk wilayah DKI Jakarta. BMKG memprediksi sejumlah wilayah Jakarta diguyur hujan disertai angin kencang. https://t.co/NIAQLX2rN1,18,0,7,0,2022-01-25,21,Tuesday,2,25,0
1486091587809595397,2022-01-25 21:40:19,Maroko lolos ke perempatfinal Piala Afrika 2021 usai menyingkirkan Malawi. Achraf Hakimi mencetak gol penentu kemenangan Maroko. https://t.co/ZHc5dJxhgG,5,0,0,0,2022-01-25,21,Tuesday,2,5,0
1486090615590903811,2022-01-25 21:36:27,"MA, seorang mantan guru honorer asal Garut, diamankan polisi lantaran nekat membakar sekolah tempat mengajarnya dulu lantaran gajinya tak dibayar. https://t.co/gjsJCiv7R5",68,23,8,12,2022-01-25,21,Tuesday,2,76,35
1486089398370320384,2022-01-25 21:31:37,"Langit selepas petang memberi pesan. Hari selesai, bersiap menuju malam. Transisi ini beri keajaiban visual yang sedap diilihat. Cocok buat para pencari senja. https://t.co/qw4OypxyeS",21,2,2,0,2022-01-25,21,Tuesday,2,23,2
1486086909273288707,2022-01-25 21:21:43,"Satu dekade terakhir ada empat rumor besar di Liga Inggris. Di antaranya Neymar sempat dilirik Chelsea, Mbappe didekati Liverpool, tapi tidak kejadian. https://t.co/QryRg3SjE6",5,0,0,0,2022-01-25,21,Tuesday,2,5,0
1486084853145735171,2022-01-25 21:13:33,"Perlintasan sebidang di Gunung Sahari Selatan, Kemayoran, akan ditutup. Pemkot Jakpus berharap agar JPO sebagai akses warga menuju pasar segera dibangun. https://t.co/wxUQxYYXxe",4,1,0,0,2022-01-25,21,Tuesday,2,4,1
1486083732876500996,2022-01-25 21:09:06,"Mak Unah, warga Palembang yang tinggal di rumah reyot menyatu dengan kandang ayam, mendapat bantuan pembangunan rumah dari Presiden Joko Widodo. Bagaimana Mak Unah menanggapi bantuan tersebut? https://t.co/bb7rhxcmQY",9,1,0,0,2022-01-25,21,Tuesday,2,9,1
1486082635130671111,2022-01-25 21:04:44,"Waspada faktor pemicu serangan jantung yang jarang disadari dan bisa menyerang usia muda. Hati-hati, bisa menyebabkan kematian guys. https://t.co/nJvrRlsLpa",5,0,1,0,2022-01-25,21,Tuesday,2,6,0
1486080772872314883,2022-01-25 20:57:20,"Ketua DPP Nasdem Saan Mustopa menyebut kewenangan memilih kepala badan otorita IKN Nusantara ada di tangan presiden, meski Ridwan Kamil diisukan jadi pilihan https://t.co/7tYNJwiFSD",7,5,1,0,2022-01-25,20,Tuesday,2,8,5
1486079399887884295,2022-01-25 20:51:53,"""Kunjungan keluarga nggak sembarangan,"" kata Fredi setelah dibawa dari kerangkeng ke Kantor Camat Kuala, Langkat. https://t.co/oXBpTgdnzi",8,1,2,0,2022-01-25,20,Tuesday,2,10,1
1486078283368189952,2022-01-25 20:47:27,"Polisi berhasil menangkap dua laki-laki berinisial N (24) dan ZA (34) pelaku pembegalan menggunakan airsoft gun di Demak, Jawa Tengah. Dalam aksinya, kedua pria tersebut tak segan menembak korban incarannya. https://t.co/QTxIuv6EB7",7,1,0,0,2022-01-25,20,Tuesday,2,7,1
1486075790106234880,2022-01-25 20:37:32,Perjalanan Della Dartyan ke berbagai tempat di Indonesia itulah yang membuatnya menuangkan tulisan ke dalam buku berjudul Biru Kelana. https://t.co/QMt4RtI1gm,7,0,0,0,2022-01-25,20,Tuesday,2,7,0
1486074492849958915,2022-01-25 20:32:23,"Menurut Psikolog Klinis Dewasa dan Founder Anastasia &amp; Associate, Anastasia Sari Dewi, hubungan yang sehat adalah hubungan yang 'saling'. Ini maksudnya: https://t.co/xx9zNg92Nb",14,0,0,1,2022-01-25,20,Tuesday,2,14,1
1486073242393710594,2022-01-25 20:27:25,"PT Pertamina (Persero) memastikan kesiapannya dalam proyek hilirisasi batu bara menjadi Dimethyl Ether (DME) di Tanjung Enim, Sumatera Selatan (Sumsel).  https://t.co/7rTLm9mbnp",6,0,3,0,2022-01-25,20,Tuesday,2,9,0
1486070463646285831,2022-01-25 20:16:23,"Perjanjian ekstradisi RI-Singapura benar-benar terealisasi. Menkumham Yasonna menggemborkan, kini koruptor tak bisa sembunyi lagi. https://t.co/chTlTjn4VJ",39,11,4,2,2022-01-25,20,Tuesday,2,43,13
1486062913030967298,2022-01-25 19:46:22,70 persen sel imunitas ada pada usus. Sehingga kondisi tubuh secara keseluruhan sangat bergantung pada sistem pencernaan. https://t.co/TkZRJKP6rT,15,1,7,1,2022-01-25,19,Tuesday,2,22,2
1486060577814364160,2022-01-25 19:37:06,Peristiwa tersebut terjadi sekitar pukul 14.00 WIB siang tadi. Saat ini kebakaran telah dipadamkan. https://t.co/NnQJZmPKvC,10,2,0,0,2022-01-25,19,Tuesday,2,10,2
1486058965775667200,2022-01-25 19:30:41,Senegal melaju ke perempatfinal Piala Afrika 2021 setelah menyingkirkan Cape Verde. Singa Teranga susah payah menang 2-0 atas 9 pemain lawan. https://t.co/DJ0Emuborr,8,0,0,1,2022-01-25,19,Tuesday,2,8,1
1486057005785747458,2022-01-25 19:22:54,"BNN akan melakukan asesmen terhadap puluhan warga yang dikurung di krangkeng rumah Bupati Langkat, apakah positif narkoba atau tidak sebelum dipindahkan. https://t.co/F5PXbf1X1H",5,0,1,1,2022-01-25,19,Tuesday,2,6,1
1486055966001045509,2022-01-25 19:18:46,"Ahli hukum pidana dari Universitas Trisakti, Effendi Saragih, menilai percakapan telepon Jerinx 'SID' dengan Adam Deni masuk dalam kategori ancaman. https://t.co/KMuWpA0RbA",5,0,0,1,2022-01-25,19,Tuesday,2,5,1
1486053274931372033,2022-01-25 19:08:04,Polda Sumut terus menyelidiki soal puluhan orang yang ditemukan dikerangkeng di rumah Bupati Langkat. Polisi mengungkap mereka dipekerjakan tanpa digaji. https://t.co/k16kefSbUb,9,1,5,1,2022-01-25,19,Tuesday,2,14,2
1486050989744476167,2022-01-25 18:59:00,"Sebelumnya, korban ditemukan dalam kondisi tangan dan kaki terikat serta mulut ditutup lakban. Keluarga curiga korban dibunuh. https://t.co/jGisjpt9ER",6,0,1,0,2022-01-25,18,Tuesday,2,7,0
1486048517806297097,2022-01-25 18:49:10,Ada sejumlah PTN yang menerima mahasiswa pemegang KIP-Kuliah paling banyak. PTN mana yang terbanyak itu? https://t.co/UofRiKHAag,10,0,0,0,2022-01-25,18,Tuesday,2,10,0
1486045940070948867,2022-01-25 18:38:56,Tammy Abraham sudah menunjukkan diri pantas menjadi andalan lini depan AS Roma. Pemain Inggris itu dituntut agar lebih kalem supaya bisa terus tajam. https://t.co/pynOmIQ1Nx,14,0,1,0,2022-01-25,18,Tuesday,2,15,0
1486042674956226565,2022-01-25 18:25:57,"Kecewa dengan pelayanan Disnakertrans Provinsi Bengkulu, seorang warga nyaris adu jotos dengan pegawai Disnakertrans. Warga kemudian ngadu ke Gubernur Bengkulu. https://t.co/0O0R3Jmq8V",19,0,3,0,2022-01-25,18,Tuesday,2,22,0
1486041639994941440,2022-01-25 18:21:50,Kapan pandemi COVID-19 yang sudah berjalan dua tahun lebih ini berakhir? Pakar menyebut 2022 akan menjadi tahun penentu nasib dunia. https://t.co/UfN5awpYmo,9,1,0,0,2022-01-25,18,Tuesday,2,9,1
1486040356286259203,2022-01-25 18:16:44,"Manchester United yang sekarang, begitu berbeda di mata Rio Ferdinand. Baginya, para pemain Setan Merah kini tak lagi panas di sesi latihan. Apa maksudnya? https://t.co/ToyqG2u1ON",4,0,0,0,2022-01-25,18,Tuesday,2,4,0
1486038392345354245,2022-01-25 18:08:56,Andrea Dovizioso akan membalap di MotoGP 2022 bersama tim RNF Yamaha. Italiano itu tak mau senasib seperti Valentino Rossi di tim satelit pabrikan Jepang itu. https://t.co/afutn9ltAd,2,0,1,1,2022-01-25,18,Tuesday,2,3,1
1486036814171447297,2022-01-25 18:02:40,"Angin kencang menerjang Tasikmalaya dan Ciamis mengakibatkan sejumlah kendaraan tertimpa. Selain itu, ada seorang guru yang nekat membakar sekolah di Garut. https://t.co/gsjDY8YBCA",3,1,2,1,2022-01-25,18,Tuesday,2,5,2
1486032447661875200,2022-01-25 17:45:19,Booster vaksin Sinovac bisa menggunakan vaksin dengan jenis heterolog (berbeda) ataupun homolog (sejenis). Ini kombinasinya yang perlu diketahui guys. https://t.co/EDQmdAFS8Y,7,0,2,1,2022-01-25,17,Tuesday,2,9,1
1486031436343873543,2022-01-25 17:41:18,"Bagi kalian yang ingin bekerja berbeda dengan jurusan kuliah, jangan khawatir! Berikut ini daftar jurusan kuliah para artis Indonesia yang berbeda dengan profesinya. 

via: detikedu https://t.co/j1OYRx8UX3",4,0,0,1,2022-01-25,17,Tuesday,2,4,1
1486029874422812681,2022-01-25 17:35:05,Della Dartyan menjajal dunia baru dengan menulis sebuah buku berjudul Biru Kelana. Della menyebut buku tersebut menceritakan proses perjalanan self healing. https://t.co/8dTuoW0ylc,8,0,0,1,2022-01-25,17,Tuesday,2,8,1
1486028212991934467,2022-01-25 17:28:29,Negara di dunia perlahan mulai mengakui mata uang kripto (cryptocurrency) sebagai perkembangan digital sehingga sah digunakan sebagai alat pembayaran.  https://t.co/kHCijLsrKs,9,0,3,0,2022-01-25,17,Tuesday,2,12,0
1486026675586486280,2022-01-25 17:22:23,"Tahun lalu, muncul fenomena warga satu desa di Tuban, mendadak jadi miliarder setelah mendapat ganti rugi pembebasan lahan proyek kilang di kawasan tersebut, namun kini...  https://t.co/T9iBqvCFJE",122,48,40,24,2022-01-25,17,Tuesday,2,162,72
1486025116454735873,2022-01-25 17:16:11,Ketua Umum Partai Golkar Airlangga Hartarto menyambangi rumah duka Maura Magnalia Madyaratri. Diketahui Airlangga baru saja terbang dari Bintan ke Jakarta. https://t.co/PxECDR0fLC,6,0,2,0,2022-01-25,17,Tuesday,2,8,0
1486024284879347716,2022-01-25 17:12:53,"Foxconn, perusahaan perakit handphone iPhone asal Taiwan bakal investasi gede-gedean di sektor kendaraan listrik Indonesia.  https://t.co/F0oKeSbCb3",14,0,0,2,2022-01-25,17,Tuesday,2,14,2
1486022894526345222,2022-01-25 17:07:21,Berikut ini kata-kata penyemangat hidup untuk diri sendiri hingga teman yang bisa jadi referensi dan sumber inspirasi kamu:  https://t.co/AjTm8r43sy,13,1,6,1,2022-01-25,17,Tuesday,2,19,2
1486021581356814337,2022-01-25 17:02:08,Tidak semua pasangan dikaruniai kemudahan untuk mendapat keturunan. Sebagian harus mengatur strategi dengan cermat agar pembuahan bisa terjadi dengan sukses. https://t.co/UthupSE8rC,5,0,1,1,2022-01-25,17,Tuesday,2,6,1
1486020656579948544,2022-01-25 16:58:28,"Menggaruk kemaluan memang bisa meredakan gatal, tetapi ini hanya bersifat sementara. Malahan, bisa lecet. Sebaiknya gunakan obat alami berikut ini: https://t.co/Hnrhul0yIC",9,0,1,0,2022-01-25,16,Tuesday,2,10,0
1486019465900929026,2022-01-25 16:53:44,Ingin mendapatkan wajah glowing saat bangun tidur? Lakukan urutan skincare routine malam hari berikut ini: https://t.co/fi8WkeuN42,8,0,3,0,2022-01-25,16,Tuesday,2,11,0
1486018405215973380,2022-01-25 16:49:31,"Bentrok antara warga di Kota Sorong, Papua Barat menewaskan 19 orang. Kini, Polri tengah melakukan upaya antisipasi dengan merangkul tokoh agama, adat dan masyarakat guna mencegah terjadinya bentrokan susulan. https://t.co/w9YXsbuuFV",16,0,2,1,2022-01-25,16,Tuesday,2,18,1
1486017320426299392,2022-01-25 16:45:12,Raffi Ahmad dijuluki sebagai Sultan Andara karena kekayaan dan bisnisnya. Dari mana saja sumber kekayaannya?  https://t.co/X0U9LcfuX9,12,1,0,0,2022-01-25,16,Tuesday,2,12,1
1486015624858021889,2022-01-25 16:38:28,Efek vaksin ke-3 atau efek usai divaksin booster yang dirasakan setiap orang bisa berbeda-beda. Berikut beberapa efek samping vaksin booster Sinovac-Moderna. https://t.co/S2GyawNQmL,14,3,6,1,2022-01-25,16,Tuesday,2,20,4
1486014462628974605,2022-01-25 16:33:51,"Dibanding varian Delta, varian Omicron relatif lebih 'jinak' gejalanya. Keluhan yang paling dominan ditemukan pada pasien pun tidak sama. https://t.co/okzpn07Gxy",7,0,2,1,2022-01-25,16,Tuesday,2,9,1
1486013233689464844,2022-01-25 16:28:58,"Ketua DPD PDIP Provinsi Kalimantan Barat, Lasarus, meminta pihak kepolisian segera menangkap dan memproses Edy Mulyadi. Lasarus menilai pernyataan Edy terkait Kalimantan tempat jin buang anak telah melukai hati masyarakat. https://t.co/imtGLwUEck",25,5,4,0,2022-01-25,16,Tuesday,2,29,5
1486012349257588741,2022-01-25 16:25:27,Lumpur Lapindo atau lumpur yang menyembur di Sidoarjo ini ternyata menyimpan potensi 'harta karun'. Apa itu?  https://t.co/eWZ4wdJpIC,16,6,3,4,2022-01-25,16,Tuesday,2,19,10
1486011015120760847,2022-01-25 16:20:09,Efek samping vaksin Sinovac pada anak disebut lebih ringan daripada dewasa. Komnas KIPI membeberkan datanya. https://t.co/5i3uKFqSjh,4,0,0,0,2022-01-25,16,Tuesday,2,4,0
1486009527040413702,2022-01-25 16:14:14,"Sekjen Majelis Adat Dayak Nasional, Yakobus Kumis meminta Edy Mulyadi diberi hukum adat. Selain itu mendorong aparat kepolisian untuk memproses hukum bagi Edy Mulyadi. https://t.co/3SqFQnxHWy",29,15,3,1,2022-01-25,16,Tuesday,2,32,16
1486008425523855374,2022-01-25 16:09:52,"Berdasarkan zodiak China, tahun 2022 ini adalah tahun macan air. Ini ramalan shio macan air di tahun 2022:  https://t.co/DqMPJm2djk",4,0,2,3,2022-01-25,16,Tuesday,2,6,3
1486007305569243138,2022-01-25 16:05:24,Sindiran tersebut terkait momen ketika salah satu anggota Demokrat melakukan interupsi saat rapat paripurna pengesahan RUU Cipta Kerja tahun 2020. https://t.co/nKv4kYs5Qr,3,0,1,0,2022-01-25,16,Tuesday,2,4,0
1486006333828648965,2022-01-25 16:01:33,Ada aja kalo lagi cuti. Pernah ngerasain kayak gini? https://t.co/WORjndempY,24,4,10,6,2022-01-25,16,Tuesday,2,34,10
1486004531934765058,2022-01-25 15:54:23,Janet Jackson membuka ke publik tentang trauma yang dirasakannya karena sikap Michael Jackson saat mereka muda. Ini pengakuan Janet Jackson:  https://t.co/ZfsICJefNT,6,0,0,2,2022-01-25,15,Tuesday,2,6,2
1486003560806559755,2022-01-25 15:50:32,"Alih-alih mendukung lahirnya tim satelit, Joan Mir malah memberi pesan menohok kepada Suzuki. https://t.co/V2CQmNrsnZ",8,0,0,0,2022-01-25,15,Tuesday,2,8,0
1486001880081780751,2022-01-25 15:43:51,"Partai Golkar akan menyelenggarakan Perayaan Natal Nasional 2021 di Kota Salatiga, Jawa Tengah, di akhir Januari 2022. https://t.co/5r4Foe6EbN",7,1,1,0,2022-01-25,15,Tuesday,2,8,1
1486001613823221773,2022-01-25 15:42:47,Peneliti memperkirakan masa inkubasi varian Omicron jauh lebih cepat dari varian Corona lainnya. Kira-kira seberapa lama akan gejalanya muncul usai terinfeksi? https://t.co/919KGWfjsD,12,0,5,0,2022-01-25,15,Tuesday,2,17,0
1486000227660316676,2022-01-25 15:37:17,"Duka mendalam dirasakan keluarga Nurul Arifin setelah buah hati tercinta, Maura Magnalia Madyaratri, meninggal dunia. Nurul berharap putrinya menemukan surga. https://t.co/FTdal3TBMP",14,2,2,0,2022-01-25,15,Tuesday,2,16,2
1485999322441338883,2022-01-25 15:33:41,Penerima vaksin primer AstraZeneca sudah bisa disuntik vaksin COVID-19 booster. Studi ungkap pilihan booster bagi penerima AstraZeneca. https://t.co/K5RgMtE6rL,40,4,12,3,2022-01-25,15,Tuesday,2,52,7
1485998209466089476,2022-01-25 15:29:16,Tim ilmuwan dari Tiongkok mengusung konsep pembuatan es berkelas di arena olahraga Winter Olympic Beijing 2022 menggunakan sistem Transcritical CO2 Refrigeration. Teknologi tersebut diklaim lebih ramah lingkungan dan efisien. Begini proses pembuatannya: https://t.co/AoW8PzIYF2,5,0,1,0,2022-01-25,15,Tuesday,2,6,0
1485997356382404608,2022-01-25 15:25:52,MenPAN-RB Tjahjo Kumolo meminta Kementerian/Lembaga hingga Pemda tidak lagi merekrut tenaga honorer.  https://t.co/XnxHd28yy4,18,1,9,1,2022-01-25,15,Tuesday,2,27,2
1485997347398209547,2022-01-25 15:25:50,"Beras 'anti stunting' baru saja diluncukan Anies Baswedan, produk beras fortifikasi itu dinamai FS Nutri Rice.   https://t.co/UFsjXtwiNc",40,16,3,0,2022-01-25,15,Tuesday,2,43,16
1485996702121316354,2022-01-25 15:23:16,"Presiden Jokowi mengumumkan pengambilalihan ruang kendali udara di Kepulauan Riau termasuk Natuna dari Singapura melalui perjanjian kesepakatan bersama. Setelah diambil alih ini, ruang kendali udara sepenuhnya dikelola Jakarta. https://t.co/ds1Nplix2n",24,4,5,2,2022-01-25,15,Tuesday,2,29,6
1485996129233874952,2022-01-25 15:21:00,Jokowi melepas ekspor perdana tahun 2022 dari smelting grade alumina di Kabupaten Bintan. Tetapi...  https://t.co/UjU0id6qCD,31,9,4,3,2022-01-25,15,Tuesday,2,35,12
1485996094001664002,2022-01-25 15:20:51,Bandara Halim akan ditutup untuk kegiatan revitalisasi. Sejumlah maskapai mulai memindahkan pesawatnya ke bandara pengganti salah satunya Bandara Pondok Cabe.  https://t.co/dIHmIS8giD,17,1,5,3,2022-01-25,15,Tuesday,2,22,4
1485995581424164871,2022-01-25 15:18:49,Pembangunan Kantor Presiden hingga Gedung DPR di Ibu Kota Negara (IKN) baru membutuhkan Rp 46 triliun. Ini sederet faktanya.  https://t.co/pTbccz9yD2,16,7,2,1,2022-01-25,15,Tuesday,2,18,8
1485995569508143106,2022-01-25 15:18:46,RI mau keluar dari dominasi China. Luhut Pandjaitan mengatakan dominasi itu terjadi di sektor industri kesehatan dan farmasi.  https://t.co/nOYR3tW9H9,5,1,2,1,2022-01-25,15,Tuesday,2,7,2
1485994946108837900,2022-01-25 15:16:18,"Beras 'anti stunting' baru saja diluncukan Anies Baswedan, produk beras fortifikasi itu dinamai FS Nutri Rice.  https://t.co/q9blpcC5gi",23,9,3,0,2022-01-25,15,Tuesday,2,26,9
1485994943520907273,2022-01-25 15:16:17,Direktur Utama PT Asabri (Persero) Wahyu Suparyono membongkar bobroknya keuangan perusahaan sebelum dia menjabat.  https://t.co/CA42jPbIhK,13,0,6,0,2022-01-25,15,Tuesday,2,19,0
1485994566348161028,2022-01-25 15:14:47,"KPK limpahkan berkas perkara I Ketut Suarbawa-Petrus Edy Susanto ke Pengadilan Tipikor Pekanbaru. Hal ini terkait dugaan korupsi proyek jalan di Bengkalis, Riau https://t.co/ipXnn2holW",6,0,3,0,2022-01-25,15,Tuesday,2,9,0
1485994294158794764,2022-01-25 15:13:42,Warga Burkina Faso berpesta pora di jalanan merayakan suksesnya kudeta terhadap Presiden Roch Marc Christian Kabore. Saat ini kepemimpinan di Burkina Faso dipegang oleh Letnan Kolonel Paul Henri Sandaogo Damiba sebagai junta. https://t.co/aVCQjPM40n,11,1,1,0,2022-01-25,15,Tuesday,2,12,1
1485993743085969419,2022-01-25 15:11:31,Menteri Investasi/Kepala BKPM Bahlil Lahadalia buka suara mengenai pernyataannya mengenai pengusaha minta Pemilu diundur.  https://t.co/2rjiUfz4QT,5,0,1,0,2022-01-25,15,Tuesday,2,6,0
1485993741626359813,2022-01-25 15:11:31,Suporter Fiorentina membentangkan spanduk kecaman untuk Dusan Vlahovic. Hal itu menyusul soal kabar kemungkinan pindah ke Juventus. https://t.co/fGhdiOBY9U,7,0,1,0,2022-01-25,15,Tuesday,2,8,0
1485992322923909131,2022-01-25 15:05:52,PT Angkasa Pura II selaku pengelola bandara mulai menjalankan skenario perpindahan operasional penerbangan ke 5 bandara penerima (recipient).  https://t.co/5nMNAohvgP,6,0,2,0,2022-01-25,15,Tuesday,2,8,0
1485991363426627592,2022-01-25 15:02:04,Direktur Utama PT Asabri (Persero) Wahyu Suparyono menegaskan bahwa dirinya akan mengawasi seluruh manajemen perusahaan jika berani berbuat korupsi.  https://t.co/oYIAjMyrxp,11,1,1,0,2022-01-25,15,Tuesday,2,12,1
1485991361753059337,2022-01-25 15:02:03,Direktur Utama PT Asabri (Persero) Wahyu Suparyono menegaskan bahwa dirinya dan manajemen anti terhadap window dressing. https://t.co/0rCsqNHUSR,4,0,1,0,2022-01-25,15,Tuesday,2,5,0
1485990986576809989,2022-01-25 15:00:34,Masyarakat Indonesia semakin suka memamerkan kemewahan di media sosial. Banyak dari mereka dijuluki 'crazy rich'. Pertanda apakah itu? Berikut 3 faktanya:  https://t.co/QmQWFmJopN,15,0,5,4,2022-01-25,15,Tuesday,2,20,4
1485990975218626574,2022-01-25 15:00:31,"Viral video di media sosial yang memperlihatkan kerumunan saat gelaran anime di Mall Of Indonesia (MOI), Jakarta Utara. Ini penjelasan MOI.  https://t.co/HnP5Nr0xrq",13,0,2,0,2022-01-25,15,Tuesday,2,15,0
1485990748520648705,2022-01-25 14:59:37,Menteri Investasi/Kepala BKPM Bahlil Lahadalia mengatakan Indonesia akan sulit untuk menjadi negara maju bila penghasilan masyarakat masih rendah!  https://t.co/MbRj3XpIdB,42,25,9,4,2022-01-25,14,Tuesday,2,51,29
1485990357078888449,2022-01-25 14:58:04,Direktur Utama PT Asabri (Persero) Wahyu Suparyono berjanji akan mengawasi seluruh manajemen perusahaan yang berniat menggerogoti keuangan.  https://t.co/2pDZNCLjle,8,0,6,0,2022-01-25,14,Tuesday,2,14,0
1485990008519639043,2022-01-25 14:56:41,"""Tentu Nurul Arifin akan tetap aktif dalam kegiatan-kegiatan organisasi khususnya Partai Golkar,"" kata Akbar Tandjung. https://t.co/ekFLFJhTGO",10,0,0,0,2022-01-25,14,Tuesday,2,10,0
1485989262172594187,2022-01-25 14:53:43,Sebuah mobil misterius tertangkap kamera sedang syuting di jalanan Jakarta. Mobil itu diduga adalah Honda HR-V generasi terbaru. https://t.co/gjukWGPblj,20,1,4,1,2022-01-25,14,Tuesday,2,24,2
1485988686047158275,2022-01-25 14:51:25,PT Garuda Indonesia (Persero) Tbk menggelar diskon tiket hingga 50% lewat gelaran Garuda Indonesia 73rd Anniversary.  https://t.co/uerDVvjx0N,26,1,14,4,2022-01-25,14,Tuesday,2,40,5
1485988362435670026,2022-01-25 14:50:08,"Beberapa sekolah kedinasan ini bisa dijajal para siswa jurusan IPA atau SMK. Setelah lulus pun dapat ikatan dinas.

via: detikedu  https://t.co/YrufGfN5r3",20,1,4,0,2022-01-25,14,Tuesday,2,24,1
1485986670134583308,2022-01-25 14:43:25,"Seorang wanita membagikan kisah miris hubungan percintaannya. Wanita bernama Colleen Le telah mendonorkan ginjalnya, namun berakhir diselingkuhi. https://t.co/AMOTIcwyEl",231,67,41,46,2022-01-25,14,Tuesday,2,272,113
1485986017945563136,2022-01-25 14:40:49,"Supaya kemampuan berpikir bisa tetap tajam, otak harus sering dilatih memecahkan masalah. Teka-teki ini bisa jadi 'suplemen' otak. https://t.co/SpwkqWJt8Q",6,2,4,2,2022-01-25,14,Tuesday,2,10,4
1485984992580800514,2022-01-25 14:36:45,Beredar video di media sosial sahabat yang memberikan hadiah buket uang Rp100 juta sebagai kado ulang tahun. Ini kisah selengkapnya:  https://t.co/i0h6GUh95V,11,1,2,4,2022-01-25,14,Tuesday,2,13,5
1485984252789415938,2022-01-25 14:33:48,"Memiliki harta yang berlimpah, para artis ini memilih barang-barang seserahan lamaran mewah yang harganya fantastis. Ini potretnya:  https://t.co/BsLeE7TAr6",11,0,4,0,2022-01-25,14,Tuesday,2,15,0
1485983571311480841,2022-01-25 14:31:06,"Greysia Polii tak kuasa menahan haru karena harus ditinggal salah satu pelatihnya, Chafidz Yusuf. Apalagi, Chafidz berperan penting dalam kariernya. https://t.co/tpBkpTmc7F",20,0,1,0,2022-01-25,14,Tuesday,2,21,0
1485983265156734981,2022-01-25 14:29:53,Vogue British menerbitkan edisi Februari 2022 dengan menampilkan 9 model kulit hitam. Netizen menilai Vogue British keliru menginterpretasikan warna kulit. https://t.co/n8OG1tA6zf,13,1,2,0,2022-01-25,14,Tuesday,2,15,1
1485981842411032584,2022-01-25 14:24:14,"Pria yang juga keponakan mantan Presiden KH. Abdurrahman Wahid itu pun menambahkan, bahwa PKB saat ini fokus pada target merebut kemenangan Pemilu 2024. https://t.co/UamiyKfxwL",9,0,2,0,2022-01-25,14,Tuesday,2,11,0
1485980626419339268,2022-01-25 14:19:24,Persib Bandung akan melawan Tira Persikabo di lanjutan BRI Liga 1 2021/2022. Maung Bandung mengasah taktik demi meraih hasil baik. https://t.co/kSdIvnNGaE,5,0,1,1,2022-01-25,14,Tuesday,2,6,1
1485980135459368965,2022-01-25 14:17:27,"Idul Fitri 2022/1443 H kembali dirayakan para muslim di Indonesia dan dunia. Jika dihitung mundur, berapa hari lagi ya perayaan Lebaran dan puasa Ramadhan?  https://t.co/husrA1RX8y",29,6,7,3,2022-01-25,14,Tuesday,2,36,9
1485978968281030659,2022-01-25 14:12:48,Desainer Arnold Putra bukan kali pertama membuat kontroversi karena aksinya. Ini deretan kontroversi Arnold Putra:  https://t.co/0qKPxzVGaK,7,0,2,0,2022-01-25,14,Tuesday,2,9,0
1485978091163947016,2022-01-25 14:09:19,"Untuk yang berencana pergi ke mal, patut memperhatikan aturan ke mal terbaru di Jabodetabek. Kini, anak di bawah usia 12 tahun tidak diperbolehkan masuk. https://t.co/NRjahfTL95",13,0,1,3,2022-01-25,14,Tuesday,2,14,3
1485977353440436227,2022-01-25 14:06:23,"NFT mulai populer di kalangan masyarakat global. Bintang Paris Saint-Germain, Neymar, sampai ikut-ikutan tren NFT dengan membeli gambar monyet. https://t.co/qf4VF8Rdn5",17,1,6,1,2022-01-25,14,Tuesday,2,23,2
1485976294961696783,2022-01-25 14:02:11,Suasana haru menyelimuti misa requiem putri sulung Nurul Arifin dan Mayong Suryolaksono. Keluarga tak kuasa menahan tangis saat lagu rohani mulai dilantunkan. https://t.co/1NGNEIlHTU,17,1,2,2,2022-01-25,14,Tuesday,2,19,3
1485976262158041089,2022-01-25 14:02:03,Bagaimana caranya agar anak semangat belajar dan semakin berprestasi tahun ini? Berikut tips yang bisa dilakukan dengan menata rumah sesuai feng shui. #detikNetwork  https://t.co/aGpJ2BCljF,6,0,1,0,2022-01-25,14,Tuesday,2,7,0
1485976086336966666,2022-01-25 14:01:21,Lelang tender pembangunan sirkuit Formula E tertulis gagal di situs resmi JakPro. Sindiran pun mengemuka. https://t.co/wunk7UUPJb,16,9,4,1,2022-01-25,14,Tuesday,2,20,10
1485976030582120451,2022-01-25 14:01:08,"Vaksin Pfizer adalah salah satu vaksin yang dijadikan sebagai booster. Nah, sebelum mendapatkannya, kenali dulu fakta dan efek samping vaksin Pfizer di sini. https://t.co/CPsJ05xXJp",22,0,6,0,2022-01-25,14,Tuesday,2,28,0
1485974307192905741,2022-01-25 13:54:17,Double O Sorong merupakan tempat hiburan malam (THM) yang dibakar massa imbas bentrokan dua kelompok pemuda. Ini fakta-faktanya. https://t.co/Gls7v8OKGm,11,0,2,1,2022-01-25,13,Tuesday,2,13,1
1485973540058935300,2022-01-25 13:51:14,"Berbeda dari tali masker pada umumnya, tali masker milik ibunda Ayu Ting Ting, Umi Kalsum terbuat dari emas asli. Ini penampakannya:  https://t.co/yg8FxNL9VF",26,53,2,10,2022-01-25,13,Tuesday,2,28,63
1485972778314518532,2022-01-25 13:48:13,"Sebanyak 26 rumah semipermanen di Jalan Tanah Sereal, Tambora, Jakarta Barat (Jakbar), terbakar. Dugaan awal kebakaran tersebut adalah korsleting listrik. https://t.co/Zb6n5O683t",11,0,0,0,2022-01-25,13,Tuesday,2,11,0
1485972588992266240,2022-01-25 13:47:27,"Berdasarkan ilmu perbintangan Cina, Tanggal 1 Februari 2022 mendatang akan memasuki tahun macan dengan elemen air. Masyarakat budaya Cina mempercayai bahwa beberapa warna dinilai membawa keberuntungan.
https://t.co/BRUJdU8shT",9,0,2,0,2022-01-25,13,Tuesday,2,11,0
1485972452614479872,2022-01-25 13:46:55,"Perhiasan emas hanya dipakai oleh orang tua, kata siapa? Nyatanya perhiasan emas seperti gelang, kalung dan cincin juga cocok untuk anak muda.
https://t.co/OxzB0BYg3q",6,0,1,0,2022-01-25,13,Tuesday,2,7,0
1485971724818599939,2022-01-25 13:44:01,Gubernur Jawa Barat Ridwan Kamil langsung menjajal jalan Tol Cisumdawu usai peresmian. RK menargetkan Tol Cisumdawu bisa beroperasi penuh Juni 2022 https://t.co/OHv1eIcjhi,10,1,1,0,2022-01-25,13,Tuesday,2,11,1
1485970668592189445,2022-01-25 13:39:50,"WHO menegaskan merebaknya varian Omicron bukan akhir pandemi COVID-19. Justru khawatir varian-varian Corona baru berpotensi bermunculan, begini pesan WHO: https://t.co/fHJGJAjtyE",38,46,11,4,2022-01-25,13,Tuesday,2,49,50
1485969844549963777,2022-01-25 13:36:33,"Hubungan beracun atau toxic bisa meninggalkan luka batin yang dalam bagi seseorang. Bahkan, hal ini juga bisa menyebabkan trauma memulai hubungan baru. https://t.co/zJBnWO9QzH",43,4,17,6,2022-01-25,13,Tuesday,2,60,10
1485969104611725313,2022-01-25 13:33:37,Agar momen istimewa pernikahan berjalan dengan baik dan lancar perlu adanya susunan acara pernikahan. Apa saja susunan acara pernikahan? Simak di sini:  https://t.co/fSlYS9ZU31,42,4,16,5,2022-01-25,13,Tuesday,2,58,9
1485967759859195909,2022-01-25 13:28:16,Na In Woo siap bergabung dengan member acara televisi 2 Days &amp; 1 Night. Ia menggantikan posisi Kim Seon Ho yang mengundurkan diri dari acara tersebut. https://t.co/sQKevgir4a,15,1,0,2,2022-01-25,13,Tuesday,2,15,3
1485967513422860297,2022-01-25 13:27:17,"Pria asal Colorado, AS ini jadi viral setelah memamerkan potret kehidupannya sehari-hari di media sosialnya. Dia mengenakan popok setiap harinya. Ini potretnya:  https://t.co/Zy8jXiOE4u",4,0,1,0,2022-01-25,13,Tuesday,2,5,0
1485966780753498116,2022-01-25 13:24:23,Evan Rachel Wood ngaku pernah diperkosa oleh musisi metal Marilyn Manson saat pembuatan video klip. Sang musisi memperkosa Wood di depan kamera. https://t.co/TCRM49KBEU,37,2,12,4,2022-01-25,13,Tuesday,2,49,6
1485966274010169350,2022-01-25 13:22:22,"Kisah 25 nabi dan rasul memiliki banyak hikmah bagi muslim. Salah satunya mukjizat yang menjadi tanda kebesaran dan keagungan Allah SWT.

via: detikedu  https://t.co/B0gjkgsJZr",51,2,11,1,2022-01-25,13,Tuesday,2,62,3
1485965739723046917,2022-01-25 13:20:14,Seorang pria melayangkan perceraian kepada istri yang baru saja dinikahinya. Sang pengantin wanita ditalak saat acara resepsi pernikahan. https://t.co/uoSvy0Sh5E,15,3,2,1,2022-01-25,13,Tuesday,2,17,4
1485965217452417025,2022-01-25 13:18:10,"Tumpukan sampah yang diperkirakan mencapai 50 meter kubik atau setara 25 truk menyumbat aliran Sungai Wonggo di Desa Jurangjero, Kecamatan Karanganom, Klaten, Jawa Tengah, Senin (24/1/2022). Sampah-sampah tersebut merupakan campuran kayu hingga sedimen. https://t.co/34lTGapkfI",16,4,2,3,2022-01-25,13,Tuesday,2,18,7
1485964630602260487,2022-01-25 13:15:50,Tya Ariestya mantap memakai hijab pada awal Januari 2022 ini. Keputusan Tya ini jadi sorotan publik. Ini tanggapan Tya Ariestya soal komentar warganet:  https://t.co/keBjynyXSc,19,3,1,1,2022-01-25,13,Tuesday,2,20,4
1485963263573639168,2022-01-25 13:10:24,"Di hari ulang tahunnya, Lucas NCT masih hiatus imbas tuduhan berselingkuh dari mantan pacar. #LucasNCT  https://t.co/x24EOX4PmQ",7,0,2,2,2022-01-25,13,Tuesday,2,9,2
1485963247609999361,2022-01-25 13:10:20,"Pelni menyiapkan dua Kapal Motor (KM), yaitu KM Sinabung dan KM Kelud yang bisa digunakan sebagai hotel terapung bagi para wisatawan MotoGP Mandalika.  https://t.co/0Vfj5uDDxF",44,0,2,6,2022-01-25,13,Tuesday,2,46,6
1485963217855778821,2022-01-25 13:10:13,"Bentrokan antara kelompok pemuda Pelauw dan Key pecah di Sorong, Papua Barat. Bentrokan itu telah merenggut belasan nyawa orang. https://t.co/EKkFx8kIwY",63,1,16,5,2022-01-25,13,Tuesday,2,79,6
1485962202809044996,2022-01-25 13:06:11,"Nama Eunice Tjoa jadi sorotan netizen, ia jadi salah satu TikTokers yang naik daun saat ini.cKenalin nih Eunice Tjoa. TikTokers berpenghasilan Rp 300 juta sebulan:  https://t.co/YW1tDqLGJ3",20,6,3,3,2022-01-25,13,Tuesday,2,23,9
1485962183569776646,2022-01-25 13:06:07,Nama Arnold Putra ramai diperbincangkan setelah kemunculannya di Paris Fashion Week. Ia memakai seragam Pemuda Pancasila. https://t.co/fe4EDOHgLL,15,0,4,0,2022-01-25,13,Tuesday,2,19,0
1485961117541314564,2022-01-25 13:01:52,"Kejujuran harus dibiasakan sejak dini. Ada beberapa cara yang dapat dilakukan orang tua untuk mengajarkan kejujuran pada anak.

via: detikedu  https://t.co/fbwlrGycr4",25,2,3,0,2022-01-25,13,Tuesday,2,28,2
1485960195901730820,2022-01-25 12:58:13,"Beasiswa S2 - S3 fully funded di CMU Thailand dibuka hingga 25 April 2022 loh! Yuk Cek syarat dan jadwal beasiswa kuliah di Thailand selengkapnya berikut.

via: detikedu  https://t.co/AUnmqmv96j",27,0,6,0,2022-01-25,12,Tuesday,2,33,0
1485960177966882820,2022-01-25 12:58:08,Ulah kepepet netizen ini ada-ada saja. Manfaatkan peralatan bangunan sebagai alat makan bikin siapapun yang melihatnya bisa ngakak!  https://t.co/bWptPccbz9,10,0,1,0,2022-01-25,12,Tuesday,2,11,0
1485959592626511874,2022-01-25 12:55:49,"Untuk tahun 2022, IPB membuka jalur masuk penerimaan mahasiswa baru program sarjana melalui jalur tes dan rapor. Ini daftar jalur selengkapnya. 

via: detikedu https://t.co/JKKI6fdqZj",13,2,2,0,2022-01-25,12,Tuesday,2,15,2
1485958951082549248,2022-01-25 12:53:16,Dikenal dengan julukan 'Sultan Andara' Nagita Slavina kepergok membalikkan botol saus yang sudah mau habis. Cara ini juga pernah diterapkan oleh Jokowi.  https://t.co/ve9ievZAfO,116,64,8,22,2022-01-25,12,Tuesday,2,124,86
1485958706055548928,2022-01-25 12:52:17,Robert Pattinson menjanjikan sesuatu yang berbeda lewat perannya Bruce Wayne atau Batman dalam film The Batman arahan Matt Reeves.  https://t.co/4nze6xY5mQ,14,2,4,1,2022-01-25,12,Tuesday,2,18,3
1485957867282866180,2022-01-25 12:48:57,Hujan deras disertai angin kencang menerjang wilayah perkotaan Ciamis. Ada belasan pohon tumbang di beberapa ruas jalan. https://t.co/RpHaOBOUtj,7,0,2,0,2022-01-25,12,Tuesday,2,9,0
1485957382337347586,2022-01-25 12:47:02,Polda Sumut menarik proses pemeriksaan dugaan vaksin kosong yang disuntikkan ke siswa di Medan. Sejauh ini sudah dua anak yang diduga terima vaksin kosong. https://t.co/f2u0NbdxNK,7,1,4,2,2022-01-25,12,Tuesday,2,11,3
1485957364654252035,2022-01-25 12:46:58,Kapolri melakukan rotasi terhadap sejumlah pati dan pamen di lingkungan Polri. Kabid Humas Polda Jatim Kombes Gatot Repli Handoko jadi Kabag Penum Humas Polri. https://t.co/l3FUuc97aQ,5,0,1,0,2022-01-25,12,Tuesday,2,6,0
1485956924969558021,2022-01-25 12:45:13,"Bentrokan maut terjadi antara kelompok pemuda Pelauw dan Key di Kota Sorong, Papua Barat. Sebanyak 19 orang meninggal akibat insiden tersebut. https://t.co/O4wLY4I0RC",20,3,2,3,2022-01-25,12,Tuesday,2,22,6
1485956903696052229,2022-01-25 12:45:08,Mario Balotelli dipanggil lagi ke timnas Italia. Roberto Mancini saat ini memang kesulitan menemukan penyerang tajam yang bisa diandalkan. https://t.co/82dBKsjfMq,17,1,1,1,2022-01-25,12,Tuesday,2,18,2
1485955795170828288,2022-01-25 12:40:43,Prakiraan cuaca besok pagi 26 Januari 2022 perlu diketahui sebelum memulai aktivitas di luar rumah. Ini prakiraan BMKG di Jabodetabek. https://t.co/RcFi2DOr3z,6,0,0,1,2022-01-25,12,Tuesday,2,6,1
1485955792662675456,2022-01-25 12:40:43,Kota Cimahi dan Kabupaten Bandung Barat bersiap menghadapi peningkatan kasus COVID-19 di awal tahun 2022 https://t.co/WqLCH6DZuN,12,0,2,0,2022-01-25,12,Tuesday,2,14,0
1485955555126558724,2022-01-25 12:39:46,"Maura Magnalia, putri sulung Nurul Arifin meninggal dunia dan ditemukan di meja makan. Ini momen kenangan Maura semasa hidupnya:  https://t.co/hKSDC5h6eq",17,0,0,1,2022-01-25,12,Tuesday,2,17,1
1485955284430471174,2022-01-25 12:38:42,"26 rumah semipermanen di Jalan Tanah Sereal, Tambora, Jakbar, terbakar. Dari 26 rumah semipermanen tersebut, sebanyak 276 jiwa terdampak. https://t.co/jWSq8CJKib",6,0,2,1,2022-01-25,12,Tuesday,2,8,1
1485954779830493188,2022-01-25 12:36:41,"Wilayah pesisir selatan Kabupaten Pandeglang, Banten, tepatnya di Kecamatan Sumur, masih minim alat-alat canggih yang bisa mendeteksi gempa dan tsunami. https://t.co/Kwf8AjK0zV",11,0,1,1,2022-01-25,12,Tuesday,2,12,1
1485954312849264646,2022-01-25 12:34:50,Taylor Swift marah karena dituding tak membuat lagunya sendiri oleh Damon Albarn Blur. #TaylorSwift  https://t.co/GKBPegguvc,10,0,4,1,2022-01-25,12,Tuesday,2,14,1
1485953256627052544,2022-01-25 12:30:38,"Warung kopi yang kondang dengan kopi tubruk dan pisang goreng di Pakem kini ada di Cisarua, Bogor. Dalam 6 bulan warung kopi khas Jawa itu disiapkan.  https://t.co/T9U4VtCxrm",30,8,4,4,2022-01-25,12,Tuesday,2,34,12
1485952481255477252,2022-01-25 12:27:33,"""CPI ini merupakan gambaran kondisi korupsi di Indonesia yang masih harus terus dibenahi,"" kata Plt Juru Bicara KPK, Ipi Maryati Kuding. https://t.co/d2kM6d7Nwk",13,0,1,0,2022-01-25,12,Tuesday,2,14,0
1485952163398438912,2022-01-25 12:26:18,Mencegah obesitas dalam rangka Hari Gizi Nasional 2022 ini bisa dilakukan dengan menjalani pola makan sehat. Beberapa pola makan sehat ini bisa jadi panduan.  https://t.co/8nETcA4hHB,17,0,1,0,2022-01-25,12,Tuesday,2,18,0
1485952100228022275,2022-01-25 12:26:03,Kasus aktif hingga penambahan kematian COVID-19 di Indonesia per hari ini meningkat. Berikut catatannya sepekan terakhir. https://t.co/flw6IHtijh,10,0,0,1,2022-01-25,12,Tuesday,2,10,1
1485951595506503681,2022-01-25 12:24:02,"Indonesia mencatatkan 4.878 kasus baru COVID-19, Selasa (25/1/2022). Tren penambahan kasus secara konsisten cenderung meningkat dalam sepekan terakhir. https://t.co/CX7F4oBRjq",16,6,3,2,2022-01-25,12,Tuesday,2,19,8
1485951328702676993,2022-01-25 12:22:59,"Puluhan pelari termasuk olahragawan mengikuti lari maraton di dekat Oymyakon, Rusia. Tak biasa, mereka lari saat suhu turun hingga di bawah -50 derajat Celsius. Berikut potretnya: https://t.co/E3fhlHGlDM",12,1,3,0,2022-01-25,12,Tuesday,2,15,1
1485949650968399878,2022-01-25 12:16:19,"Tak tanggung-tanggung, Pemkab Mojokerto bekerja sama dengan KPK untuk mewujudkan pemerintahan yang berintegritas. https://t.co/KjeyUf28n0",14,4,2,1,2022-01-25,12,Tuesday,2,16,5
1485949443543289858,2022-01-25 12:15:29,Kapolri Jenderal Listyo Sigit Prabowo melakukan mutasi terhadap sejumlah perwira tinggi (pati). Pergantian jabatan terjadi di Polda Kalimantan Utara. https://t.co/9jSNbuPO4S,11,0,4,0,2022-01-25,12,Tuesday,2,15,0
1485949438082306054,2022-01-25 12:15:28,Indonesia dan Singapura menyepakati perjanjian mengenai FIR. Jokowi mengatakan ruang lingkup Jakarta kini melingkupi seluruh wilayah udara di Kepri- Natuna. https://t.co/k5jXpByqgu,18,1,7,1,2022-01-25,12,Tuesday,2,25,2
1485947667956084738,2022-01-25 12:08:26,"Di balik buku Biru Kelana yang jadi debut Della Dartyan sebagai seorang penulis, ada andil sang kekasih yakni Nino Kayam. #BiruKelana  https://t.co/NuWmWIIzgk",7,0,1,0,2022-01-25,12,Tuesday,2,8,0
1485946877648461829,2022-01-25 12:05:17,Indonesia mengambil alih pelayanan ruang udara atau Flight Information Region (FIR) yang sebelumnya dilayani oleh Otoritas Navigasi Penerbangan Singapura.  https://t.co/y3F9tJnV5P,28,0,12,1,2022-01-25,12,Tuesday,2,40,1
1485946623482122243,2022-01-25 12:04:17,"Selama menempuh pendidikan di London, Anindita Hidayat sempat bekerja sebagai pramusaji. Ia sempat dimaki-maki oleh pelanggan di restoran itu. https://t.co/SdYzY4dsS5",38,7,2,2,2022-01-25,12,Tuesday,2,40,9
1485946377855188992,2022-01-25 12:03:18,"Masyarakat Medan merapat kuy, ini ada info lokasi vaksin booster COVID-19. Lengkap dengan syarat, jadwal, dan cara daftar. Segera amankan slot! https://t.co/axciGJZowY",8,1,1,1,2022-01-25,12,Tuesday,2,9,2
1485945760810217474,2022-01-25 12:00:51,1.400 karyawan KB Bukopin kompak mengajukan resign berjamaah. Pengamat mengatakan hal tersebut harus menjadi pelajaran bahwa digitalisasi perbankan bisa berdampak pada lapangan kerja. #Analisis #CNNIndonesia #detikNetwork https://t.co/gn6eaqT3U0,17,8,10,5,2022-01-25,12,Tuesday,2,27,13
1485945447520911366,2022-01-25 11:59:36,"Maura Magnalia Madyaratri, putri Nurul Arifin meninggal dunia pada Selasa (25/1). Suami Nurul, Mayong Suryo menjelaskan putrinya itu meninggal karena gagal jantung. https://t.co/g7kq3TDsE4",11,1,2,0,2022-01-25,11,Tuesday,2,13,1
1485944952710471682,2022-01-25 11:57:38,"Ada 10 negara terbaik untuk melanjutkan studi. Kira-kira di negara mana saja ya? 

via: detikedu https://t.co/OKNIiNGGez",12,1,2,0,2022-01-25,11,Tuesday,2,14,1
1485944650406010883,2022-01-25 11:56:26,WithU Yamaha RNF MotoGP Team telah meluncurkan livery motor yang akan mengarungi MotoGP 2022. Berikut tampilan kuda besi tim asal Malaysia tersebut. https://t.co/YFDQ95D5A1,7,0,1,0,2022-01-25,11,Tuesday,2,8,0
1485943637464825863,2022-01-25 11:52:25,Francis Ngannou sukses pertahankan sabuk juara kelas berat UFC. Dirinya ditantang Tyson Fury untuk bertinju dan dapatkan cuan lebih banyak. https://t.co/945RiBmmZm,6,2,0,0,2022-01-25,11,Tuesday,2,6,2
1485943374926467074,2022-01-25 11:51:22,"Berikut ini informasi lengkap mengenai UTBK-SBMPTN 2022 mulai dari jadwal, materi yang diujikan, syarat, sampai biaya pendaftarannya. 

via: detikedu https://t.co/nAvfZttUxl",12,0,1,0,2022-01-25,11,Tuesday,2,13,0
1485943349567983619,2022-01-25 11:51:16,"Pemkot Jakbar bakal membuka posko bagi warga terdampak banjir di Tegal Alur, Kalideres, Jakarta Barat, yang hendak memperbaiki dokumen kependudukan. https://t.co/jhFXwb2ik0",4,0,1,0,2022-01-25,11,Tuesday,2,5,0
1485942579069923331,2022-01-25 11:48:12,"Jalan berlubang di kawasan Jalan Bhayangkara, Solo, tepatnya di simpang tiga SMA Negeri 7 membuat sejumlah pengendara motor sering terjatuh. https://t.co/GaCLrfRlrY",10,6,0,0,2022-01-25,11,Tuesday,2,10,6
1485942346428534785,2022-01-25 11:47:17,"Jenderal TNI Dudung Abdurachman menjawab adanya poster acara Haikal Hassan dan video pengusiran yang disebut-sebut terjadi di Yonif Para Rider, Malang. Dudung menegaskan acara tersebut tak digelar di Yonif Para Rider. https://t.co/ztzUaUmNIM",13,5,4,1,2022-01-25,11,Tuesday,2,17,6
1485941240856203266,2022-01-25 11:42:53,"Sekilas deretan benda pada gambar ini terlihat sama, namun ternyata ada satu yang janggal. Coba temukan sekaligus cek kejelian mata kamu. https://t.co/YzNf972xkW",4,3,1,0,2022-01-25,11,Tuesday,2,5,3
1485940993115533312,2022-01-25 11:41:54,"Diana Di Meo, wasit wanita dari Italia ini lagi bernasib buruk. Video syur miliknya tersebar, diyakini jadi korban 'revange porn'. https://t.co/vDyynEO8qu",14,3,1,1,2022-01-25,11,Tuesday,2,15,4
1485940770796412938,2022-01-25 11:41:01,"Kenali ciri-ciri penyakit jantung di usia muda. Putri Nurul Arifin, Maura Magnalia, mengalami masalah dengan jantung ketika meninggal di usia 27 tahun. https://t.co/RzZCvHD3S4",22,3,4,5,2022-01-25,11,Tuesday,2,26,8
1485940010746589186,2022-01-25 11:38:00,Jerinx SID tiba-tiba menunjukkan foto seseorang yang menunjukkan jari tengah sembari memegang foto Presiden Joko Widodo (Jokowi). Apa maksudnya? https://t.co/Uij717gSYN,32,12,10,5,2022-01-25,11,Tuesday,2,42,17
1485939803212460041,2022-01-25 11:37:11,Menteri Pekerjaan Umum dan Perumahan Rakyat (PUPR) Basuki Hadimuljono memaparkan rencana program 2022. Tak ada program yang berkaitan dengan IKN.  https://t.co/maUZJCUQ20,8,0,1,0,2022-01-25,11,Tuesday,2,9,0
1485939775022510083,2022-01-25 11:37:04,"Selain Telkomsel dan XL Axiata, Indosat Ooredoo Hutchison juga akan mematikan layanan 3G mereka. Siap-siap pelanggan 3G untuk beralih ke 4G! https://t.co/DuCraHKfWn",10,0,3,1,2022-01-25,11,Tuesday,2,13,1
1485939256585510913,2022-01-25 11:35:00,"Kebanyakan restoran McDonald's memiliki desain bangunan yang sama. Namun ada beberapa restoran super unik, bahkan ada yang menggunakan body pesawat terbang!  https://t.co/hbvVJ90mVR",9,0,2,0,2022-01-25,11,Tuesday,2,11,0
1485939085407666183,2022-01-25 11:34:20,"Twitter mengembangkan fitur baru bernama Flock untuk membantu pengguna membatasi jangkauan cuitannya, mirip seperti fitur Close Friends di Instagram. https://t.co/FdjfZNQazj",24,3,8,8,2022-01-25,11,Tuesday,2,32,11
1485938920223350789,2022-01-25 11:33:40,"Beredar postingan di media sosial ada anak berusia 10 tahun yang meninggal dunia usai divaksin. Dinkes Tanjungbalai, Sumut membantah informasi tersebut. https://t.co/KvWUvduDnN",3,0,0,1,2022-01-25,11,Tuesday,2,3,1
1485938918134632450,2022-01-25 11:33:40,KPK lakukan proses penyidikan di kasus dugaan suap Rahmat Effendi. Kini KPK akan mengusut soal dugaan aliran dana yang diterima Pepen ke ranah keluarga. https://t.co/Csg929PwKv,12,0,2,0,2022-01-25,11,Tuesday,2,14,0
1485938451753189385,2022-01-25 11:31:48,"Dunia antariksa Indonesia sedang menantikan teleskop 3,8m di Observatorium Nasional Timau di NTT. Untuk apa teleskop canggih ini?  https://t.co/1J05R2feuX",9,1,2,0,2022-01-25,11,Tuesday,2,11,1
1485938422606880768,2022-01-25 11:31:42,"Putri Nurul Arifin, Maura Magnalia, diduga sempat stres sebelum mengalami henti jantung dan meninggal di usia 27 tahun. Apa kaitan stres dengan jantung? https://t.co/SWKVfjDfAY",10,2,2,0,2022-01-25,11,Tuesday,2,12,2
1485938110684934148,2022-01-25 11:30:27,"Mulai besok, 26 Januari 2022, Bandara Halim Perdanakusuma akan mulai menjalankan skenario perpindahan operasional penerbangan ke 5 bandara penerima (recipient).  https://t.co/1S6Tf5v5Y0",12,0,3,0,2022-01-25,11,Tuesday,2,15,0
1485938109476974594,2022-01-25 11:30:27,Elon Musk geram melihat Twitter mengenalkan fitur yang memungkinkan pengguna memasang NFT sebagai foto profil. Ia menyebut fitur baru itu menyebalkan. https://t.co/nBv31GsVbC,7,0,2,0,2022-01-25,11,Tuesday,2,9,0
1485937321006579714,2022-01-25 11:27:19,"Beda dengan pesta pernikahan lainnya. Pesta pernikahan di India ini, menggunakan penggaris untuk menuliskan menu makanan dan minuman yang disajikan di sana.  https://t.co/lm5ENVb0xo",7,0,1,0,2022-01-25,11,Tuesday,2,8,0
1485937028160233478,2022-01-25 11:26:09,"Kemenangan 2-0 di akhir pekan, menegaskan bahwa Chelsea begitu superior atas Tottenham Hotspur di musim 2021/2022. https://t.co/SlSysMCKgj",11,0,1,0,2022-01-25,11,Tuesday,2,12,0
1485937007864000512,2022-01-25 11:26:04,"Perjanjian ekstradisi Indonesia-Singapura resmi ditandatangani. KPK memaksimalkan upaya untuk memeriksa tersangka korupsi e-KTP, Paulus Tannos. https://t.co/EhcEOmqtjH",18,1,0,0,2022-01-25,11,Tuesday,2,18,1
1485936778179760128,2022-01-25 11:25:09,Kabar kehadiran Realme 9 Pro dan 9 Pro+ diungkap pekan lalu. Begini tampilan keduanya:  https://t.co/93yAvE3Bjh,3,1,0,0,2022-01-25,11,Tuesday,2,3,1
1485935530038734849,2022-01-25 11:20:12,"Banyak orang yang belum pernah mencicipi Indomie goreng, seperti netizen asal Singapura ini. Baru pertama kali buat, netizen ini mencampurkan kuah!  https://t.co/0pBxPbCZat",12,18,2,8,2022-01-25,11,Tuesday,2,14,26
1485935267596967936,2022-01-25 11:19:09,"""Evaluasi kita salah satunya kebobolan di menit akhir, makanya waktu kita latihan ini kan sampai 26 Januari mendatang, jadi kita sekarang lebih banyak berlatih..."" kata pelatih Persebaya. https://t.co/RdmkY65nAT",6,0,0,0,2022-01-25,11,Tuesday,2,6,0
1485934990852562947,2022-01-25 11:18:03,"Putri sulung Nurul Arifin dan Mayong Suryolaksono, Maura Magnalia Madyaratri meninggal dunia. Mayong menjelaskan kondisi terakhir putrinya sebelum tutup usia. https://t.co/OmvAhnHN0d",12,1,3,1,2022-01-25,11,Tuesday,2,15,2
1485934437015736320,2022-01-25 11:15:51,Turki akan segera mengganti nama resmi negara. Presiden Reccep Tayyip Erdogan mengatakan nama negeri itu akan berubah dari Turkey menjadi 'Turkiye'. https://t.co/es1XrCbyjy,163,72,32,30,2022-01-25,11,Tuesday,2,195,102
1485934431210811394,2022-01-25 11:15:50,"Nurul Arifin mengenang momen dia memeluk mendiang sang putri, Maura Magnalia. Nurul berpesan pada orangtua agar banyak-banyak memeluk anak masing-masing. https://t.co/ndS6DZI3Sk",21,1,4,1,2022-01-25,11,Tuesday,2,25,2
1485933986773970944,2022-01-25 11:14:04,Permintaan lampion di Solo jelang perayaan tahun baru Imlek meningkat. Pesanan naik hingga 60 persen dan datang dari sejumlah daerah di Indonesia.  https://t.co/j4bgLy4noK,4,0,2,0,2022-01-25,11,Tuesday,2,6,0
1485933709987622916,2022-01-25 11:12:58,Seluruh konfederasi yang ada dalam representasi LKS Tripartit Nasional terlibat dalam pembahasan undang-undang ini  https://t.co/7ytgtckUAq,5,1,1,1,2022-01-25,11,Tuesday,2,6,2
1485933157559980039,2022-01-25 11:10:46,"Baru-baru ini terungkap bahwa crazy rich yang suka membagikan kegiatan tradingnya berperan sebagai affiliator, bukan trader. Apa bedanya dengan influencer?  https://t.co/fQ61Jn3C3L",18,4,11,1,2022-01-25,11,Tuesday,2,29,5
1485932604935360513,2022-01-25 11:08:34,Empat orang mantan petugas Lapas Klas IA Kota Tangerang didakwa lalai sehingga menyebabkan kebakaran yang mengakibatkan 49 orang meninggal dunia. https://t.co/gGGAoqNjfY,6,0,1,0,2022-01-25,11,Tuesday,2,7,0
1485932091451842562,2022-01-25 11:06:32,Nurul Arifin mengungkapkan mendiang Maura Magnalia bercita-cita ingin menjadi dosen. https://t.co/nviuVBVOp4,10,1,1,0,2022-01-25,11,Tuesday,2,11,1
1485931307981058048,2022-01-25 11:03:25,Kini Twitter jadi tempat orang-orang berbagi rekomendasi kuliner yang enak dan murah meriah. Seperti thread tentang mie ayam dan bakmie terenak di Jakarta ini.  https://t.co/6ATaPwv1HR,20,0,7,1,2022-01-25,11,Tuesday,2,27,1
1485931181208129541,2022-01-25 11:02:55,"Gaji 2 tahun tak dibayar, mantan guru honorer asal Garut diamankan polisi lantaran nekat membakar sekolah tempat mengajarnya dulu. https://t.co/CZwVCEcMOw",695,132,151,94,2022-01-25,11,Tuesday,2,846,226
1485931115105898499,2022-01-25 11:02:39,"Video viral memperlihatkan aksi pengejaran terhadap mobil Toyota Rush yang diteriaki maling dikejar-kejar oleh sejumlah kendaraan motor termasuk mobil patroli polisi. Kabid Humas Polda Metro Jaya, Kombes Endra Zulpan memberikan penjelasannya: https://t.co/fpkzP5xaiQ",1,0,0,2,2022-01-25,11,Tuesday,2,1,2
1485929481181216770,2022-01-25 10:56:10,"Sebuah gudang di Jalan Tanah Sereal, Tambora, Jakarta Barat, terbakar. Sebanyak 19 unit mobil damkar dikerahkan. https://t.co/J0AMl24Ief",6,0,0,0,2022-01-25,10,Tuesday,2,6,0
1485928933946277899,2022-01-25 10:53:59,"Sergio Ramos mengaku sedang berada dalam performa terbaiknya di PSG dan tidak sabar hadapi sang mantan, Real Madrid di Liga Champions! https://t.co/nnInPffKrl",17,0,2,0,2022-01-25,10,Tuesday,2,19,0
1485927543345668098,2022-01-25 10:48:28,"Presiden Jokowi menerima kunjungan PM Singapura Lee Hsien Loong di Kabupaten Bintan, Kepulauan Riau. Pertemuan tersebut membahas upaya penguatan kerja sama. https://t.co/Z6ayWlx6sO",23,0,2,0,2022-01-25,10,Tuesday,2,25,0
1485927313929916420,2022-01-25 10:47:33,Waketum NasDem Ahmad Ali angkat bicara terkait Gubernur DKI Jakarta Anies Baswedan didampingi petinggi DPD NasDem Sulsel saat berkunjung ke Makassar. https://t.co/9TSrcAUEkp,9,1,2,1,2022-01-25,10,Tuesday,2,11,2
1485927047327358978,2022-01-25 10:46:29,"Sejumlah wilayah di Indonesia mengalami fenomena astronomi ekuiluks. Tapi ada juga wilayah yang tidak mengalaminya, termasuk Ibu Kota Negara Baru. https://t.co/nhU11foC4S",13,0,4,0,2022-01-25,10,Tuesday,2,17,0
1485927043606929420,2022-01-25 10:46:29,"Polisi menangkap 8 pelaku pembakaran mobil dinas Kepala Keamanan Lapas Pekanbaru, Riau Effendi Purba. Salah satunya otak pembakaran, Riko Silalahi. https://t.co/GJ12Frcjeg",10,3,1,1,2022-01-25,10,Tuesday,2,11,4
1485926555100536833,2022-01-25 10:44:32,Vaksinasi booster untuk COVID-19 sudah tersedia di berbagai tempat. Inilah cara mudah mencarinya di Google Maps:  https://t.co/qT7aLm1Whu,4,0,2,0,2022-01-25,10,Tuesday,2,6,0
1485926534816935940,2022-01-25 10:44:27,#FOTO Ini adalah sosok YouTuber yang paling banyak menghasilkan uang pada tahun 2021 kemarin menurut perhitungan dari Forbes:  https://t.co/cziRLCwO0N,5,1,1,0,2022-01-25,10,Tuesday,2,6,1
1485925796682285059,2022-01-25 10:41:31,"Kabar bahagia datang dari Derby Romero. Istrinya, Claudia Adinda melahirkan anak pertama. Selamat! https://t.co/srHdFe04CA",10,0,1,1,2022-01-25,10,Tuesday,2,11,1
1485925207126822913,2022-01-25 10:39:11,"Kehidupannya setelah menikah mewajibkan sejumlah penyesuaian. Khususnya soal waktu yang mengharuskan Adri menentukan prioritasnya, pekerjaan dan keluarga. #HotQuestions  https://t.co/8BrcnqRFKm",6,0,1,0,2022-01-25,10,Tuesday,2,7,0
1485924643190026245,2022-01-25 10:36:56,Mayong Suryo Laksono menjelaskan kondisi terakhir putrinya sebelum wafat. https://t.co/3OqK1OB16e,12,1,0,1,2022-01-25,10,Tuesday,2,12,2
1485924363572584449,2022-01-25 10:35:50,"Jumlah kasus positif COVID-19 di Indonesia bertambah 4.878, Selasa (25/1/2022). Total kasus positif menjadi 4.294.183, sembuh 4.125.080, dan meninggal 144.247. https://t.co/HB32fykQG1",6,3,2,3,2022-01-25,10,Tuesday,2,8,6
1485923874625761280,2022-01-25 10:33:53,"Dosen Universitas Indonesia menggugat UU Nomor 14 Tahun 2005 ke MK setelah tidak diangkat sebagai profesor. Berikut syarat pengajuan profesor di Indonesia.

via: detikedu  https://t.co/RVEK3oseRd",11,0,4,0,2022-01-25,10,Tuesday,2,15,0
1485923859459104773,2022-01-25 10:33:49,"SNMPTN merupakan salah satu jalur penerimaan mahasiswa baru yang diselenggarakan oleh LTMPT. 10 PTN ini menjadi favorit peserta SNMPTN. 

via: detikedu https://t.co/AOeToql0Av",13,1,0,0,2022-01-25,10,Tuesday,2,13,1
1485923302182985734,2022-01-25 10:31:37,"#Foto Jorok! Penumpukan sampah kembali terjadi di Bandung. Kali ini di sungai, tepat depan gapura kampung boneka, Sayati Hilir, Desa Sayati, Kabupaten Bandung. https://t.co/ZYxfchwATm",10,5,3,1,2022-01-25,10,Tuesday,2,13,6
1485922457542602756,2022-01-25 10:28:15,"Mak Unah, warga yang rumahnya reyot menyatu dengan kandang ayam ini bertemu dengan Presiden Jokowi di Bandara Internasional Sultan Mahmud Badaruddin Palembang. Presiden Jokowi menjanjikan akan membangunkan rumah baru yang layak untuk Mak Unah.

Terima kasih kepada #sahabatbaik https://t.co/KG3GWETyNB",21,2,0,0,2022-01-25,10,Tuesday,2,21,2
1485922382833410050,2022-01-25 10:27:57,"Baru berusia 40 hari, baby Adzam sudah dapat predikat Sultan oleh para netizen. Begini reaksi Sule:  https://t.co/JHmHmRQlsb",6,0,0,0,2022-01-25,10,Tuesday,2,6,0
1485922357642473472,2022-01-25 10:27:51,KPK angkat bicara soal desakan dari para pegiat antikorupsi soal alasan jaksa KPK hanya menuntut Azis Syamsuddin selama 4 tahun 2 bulan di kasus dugaan suap. https://t.co/9Ouruj2v4Q,5,0,1,0,2022-01-25,10,Tuesday,2,6,0
1485922099382398977,2022-01-25 10:26:50,"Jack Grealish cekcok dengan Oriol Romeu, ia kesal gegara dicubit terus selama pertandingan. https://t.co/jZMI5P9HYC",2,0,0,2,2022-01-25,10,Tuesday,2,2,2
1485921807555346432,2022-01-25 10:25:40,Evan Rachel Wood ngaku diperkosa oleh Marilyn Manson saat syuting video klip. Ini awal mula pertemuan keduanya:  https://t.co/Hx6c8chcT6,9,0,1,0,2022-01-25,10,Tuesday,2,10,0
1485921557105025024,2022-01-25 10:24:40,"#FOTO Anak Nurul Arifin, Maura Magnalia, meninggal dunia karena serangan jantung pada Selasa (25/1/2022). Kini jenazah disemayamkan di rumah duka. https://t.co/Px4AgzM7JD",16,1,2,0,2022-01-25,10,Tuesday,2,18,1
1485921555662221317,2022-01-25 10:24:40,"Pernyataan Menaker Ida Fauziyah terkait upah minimum Indonesia ketinggian diungkit oleh Wakil Ketua Komisi IX DPR RI, Ansory Siregar. Sambil terbata-bata, Ida pun mengaku dilema karena harus ada di tengah-tengah antara pengusaha dan pekerja. https://t.co/K5ZfAtIvnR",8,0,1,1,2022-01-25,10,Tuesday,2,9,1
1485921276799725575,2022-01-25 10:23:34,Rafael Nadal melenggang ke semifinal Australian Open 2022 setelah mengalahkan Denis Shapovalov dalam duel lima set. https://t.co/1caLcNxa7X,6,0,0,0,2022-01-25,10,Tuesday,2,6,0
1485921261305872390,2022-01-25 10:23:30,Della Dartyan menulis jurnal perjalanan tentang proses healing pada 2016 sampai 2017 yang kini dituangkan ke dalam Biru Kelana. Bukunya segera rilis Februari. https://t.co/OAcVJ2wfkX,11,0,0,1,2022-01-25,10,Tuesday,2,11,1
1485920770773688322,2022-01-25 10:21:33,"Gejala Omicron amat mirip flu biasa, pertanda COVID-19 bakal menjadi seperti flu musiman? Singgung dua kasus kematian pasien Omicron RI, begini penegasan pakar: https://t.co/LsMKuLo5dv",11,5,5,1,2022-01-25,10,Tuesday,2,16,6
1485920545900318720,2022-01-25 10:20:39,"Timnas Indonesia akan menjamu Timnas Timor Leste pada laga persahabatan, berikut sajian head-to-head antara kedua kesebelasan. https://t.co/SQD9EyMYuu",4,0,0,0,2022-01-25,10,Tuesday,2,4,0
1485920519631290370,2022-01-25 10:20:33,Muncul kekhawatiran di kalangan masyarakat kalau mobil pelat RF tidak diberi jalan bisa timbul 'gesekan' di jalan raya. Ini jawaban Kompolnas. https://t.co/mxMIam4naP,89,51,28,7,2022-01-25,10,Tuesday,2,117,58
1485919478194057219,2022-01-25 10:16:25,Semburan lumpur di Sidoarjo menyimpan potensi 'harta karun' yang disebut-sebut langka. Hal itu terungkap dalam riset yang dilakukan ITS Surabaya.  https://t.co/Ak1zyCsdfA,11,3,2,0,2022-01-25,10,Tuesday,2,13,3
1485919227320143876,2022-01-25 10:15:25,RI-Singapura menyepakati perjanjian soal flight information region. Dua anggota Komisi I DPR mengapresiasi kesepakatan flight information region. https://t.co/yV103MM8QF,19,1,1,1,2022-01-25,10,Tuesday,2,20,2
1485918685957132289,2022-01-25 10:13:16,"KPK melakukan perkembangan penyidikan di kasus suap proyek infrastruktur di Buru Selatan, Maluku, tahun 2011-2016. Kini KPK melakukan penyidikan soal TPPU. https://t.co/xh0fIxRcKU",6,2,0,0,2022-01-25,10,Tuesday,2,6,2
1485918163057487884,2022-01-25 10:11:11,Kondisi keuangan PT Asabri dilaporkan mulai membaik walaupun...  https://t.co/PQIZsuu1Al,4,1,0,1,2022-01-25,10,Tuesday,2,4,2
1485916662146768899,2022-01-25 10:05:13,"Bandara Halim Perdanakusuma (Bandara Halim), Jakarta mulai ditutup pada hari Rabu, 26 Januari 2022 besok sejalan rencana revitalisasi bandara tersebut.  https://t.co/T5ZKIpgnON",5,0,2,1,2022-01-25,10,Tuesday,2,7,1
1485916127456858115,2022-01-25 10:03:06,Chelsea begitu superior atas Tottenham Hotspur di musim 2021/2022. Kemenangan 2-0 di akhir pekan semakin menegaskan dominasi si Biru. https://t.co/wbbXjtY1Qa,1,1,0,0,2022-01-25,10,Tuesday,2,1,1
1485916125934329859,2022-01-25 10:03:06,"KPK telah memeriksa Ketua DPRD Kota Bekasi, sebagai saksi kasus suap Rahmat Effendi. KPK mengkonfirmasi soal pengajuan anggaran untuk proyek di Kota Bekasi. https://t.co/Qm9oO9R4iJ",2,1,0,0,2022-01-25,10,Tuesday,2,2,1
1485915901388115972,2022-01-25 10:02:12,"Vivo akhirnya resmikan ponsel barunya di Indonesia, yaitu Vivo V23 5G, yang baru dirilis secara online dengan harga Rp 6 juta. https://t.co/rg7xQGuPIA",4,0,0,1,2022-01-25,10,Tuesday,2,4,1
1485914995758092289,2022-01-25 09:58:36,Reaksi Irwansyah dan Acha Septriasa mendapatkan sorotan saat poster Heart diperlihatkan Zaskia Sungkar. https://t.co/OVo8aGGS7g,7,2,0,0,2022-01-25,9,Tuesday,2,7,2
1485914971284422660,2022-01-25 09:58:30,"Video wisatawan berkunjung di Candi Borobudur sekitar tahun 1980-an viral di media sosial (medsos). Saat itu, tiket masuk Candi Borobudur sebesar Rp 100! https://t.co/zzrhuVGBMS",6,0,1,0,2022-01-25,9,Tuesday,2,7,0
1485914390465585159,2022-01-25 09:56:12,"Di antara benda-benda langit, ada objek yang disebut mengancam Bumi. Ukurannya pun bermacam-macam. Seberapa berbahaya ancaman objek ini? Begini penjelasannya:  https://t.co/fMhKzf3To4",4,0,0,1,2022-01-25,9,Tuesday,2,4,1
1485914145732059137,2022-01-25 09:55:13,Menteri BUMN Erick Thohir menaruh perhatian pada perkembangan ekonomi digital. https://t.co/CO0xCl1h2K,11,3,2,3,2022-01-25,9,Tuesday,2,13,6
1485913615601438720,2022-01-25 09:53:07,Ditemukan potensi 'harta karun' di lumpur Sidoarjo atau yang lebih dikenal dengan lumpur Lapindo. Apa dan bisa dipakai buat apa?  https://t.co/El7xqGBldV,10,2,1,0,2022-01-25,9,Tuesday,2,11,2
1485913375716651009,2022-01-25 09:52:10,Asosiasi Semen Indonesia (ASI) meminta agar kebijakan angkutan over dimension dan over loading (ODOL) ditunda. Kenapa?  https://t.co/5md45wapo1,10,10,1,1,2022-01-25,9,Tuesday,2,11,11
1485913105192435713,2022-01-25 09:51:05,"Wakil Ketua Umum Golkar, Nurul Arifin tengah berduka. Ia telah kehilangan anak sulungnya, Maura Magnalia. Sang putri meninggal dunia di usia 27 tahun. #detikNetwork https://t.co/NlZaZZE7SQ",9,1,1,0,2022-01-25,9,Tuesday,2,10,1
1485913103678283781,2022-01-25 09:51:05,Hai detikers! Mau coba peruntungan di tahun 2022? Buka aplikasi detikcom sekarang!  https://t.co/n3i3c1opRQ,2,0,0,0,2022-01-25,9,Tuesday,2,2,0
1485912318437376005,2022-01-25 09:47:58,"Tak kunjung selesai soal transfer Dusan Vlahovic, Arsenal kini coba fokus mendatangkan Alexander Isak. https://t.co/T0sXWSG3Re",7,0,0,2,2022-01-25,9,Tuesday,2,7,2
1485911183135760387,2022-01-25 09:43:27,Bahagianya Mario Balotelli mendapat panggilan untuk kembali memperkuat Timnas Italia. https://t.co/LepaRX8mmG,11,0,1,1,2022-01-25,9,Tuesday,2,12,1
1485910592254889984,2022-01-25 09:41:06,"Nurul Arifin sempat memiliki firasat sebelum sang putri, Maura Magnalia meninggal dunia. Begini cerita ketakutan Nurul Arifin sebelum sang buah hati meninggal dunia:  https://t.co/neAmRImp0e",7,1,1,0,2022-01-25,9,Tuesday,2,8,1
1485910570821951489,2022-01-25 09:41:01,Ghozali Everyday mendatangi KPP Pratama Semarang Timur pada Senin (24/1) sekaligus mendaftarkan diri untuk mendapatkan Nomor Pokok Wajib Pajak (NPWP).  https://t.co/5SaPBzHwAo,7,0,0,0,2022-01-25,9,Tuesday,2,7,0
1485910266177064963,2022-01-25 09:39:48,"Pendaftaran beasiswa penelitian NRC Fellowship 2022 dibuka untuk mahasiswa S1 dan S2 hingga 11 Februari 2022. Cek syarat dan ketentuan selengkapnya. 

via: detikedu https://t.co/BlmCGI5uT0",11,0,2,0,2022-01-25,9,Tuesday,2,13,0
1485909528092815361,2022-01-25 09:36:53,Junhoe iKON dan Yoshi TREASURE dinyatakan positif COVID-19. Hal itu disampaikan oleh YG Entertainment. https://t.co/92BXjOkkLR,81,2,11,3,2022-01-25,9,Tuesday,2,92,5
1485908726364221441,2022-01-25 09:33:41,Wafer roll atau populer dengan brand Astor menjadi camilan ringan yang disukai anak-anak. Tetapi netizen ini punya cara unik untuk menikmati sebuah wafer roll.  https://t.co/GkYzuozGlY,2,2,0,0,2022-01-25,9,Tuesday,2,2,2
1485908482893271047,2022-01-25 09:32:43,Perusahaan bernama Hon Hai Precision Industry Co. Ltd. (Foxconn) menyatakan akan ikut menanam investasi besar dalam bidang baterai mobil listrik di Indonesia. https://t.co/uvTNZ5yklD,7,0,1,0,2022-01-25,9,Tuesday,2,8,0
1485908119595241473,2022-01-25 09:31:17,"Nova Esports, tim asal China, berhasil menjadi juara PUBG Mobile Global Championship 2021. Mereka berhak atas hadiah uang senilai Rp 21,4 miliar.  https://t.co/TdtFMnN3yO",12,0,3,0,2022-01-25,9,Tuesday,2,15,0
1485907594518876160,2022-01-25 09:29:12,"Pelat nomor kendaraan bermotor pribadi akan diubah dari dasar hitam tulisan putih menjadi dasar putih tulisan hitam. Disebutkan, pelat nomor putih juga akan ditanamkan chip. Apa tujuannya? https://t.co/NkavxUIo3B",6,1,1,0,2022-01-25,9,Tuesday,2,7,1
1485907356483559431,2022-01-25 09:28:15,Nurul Arifin menceritakan kegalauan dan kejenuhan yang menyelimuti Maura Magnalia sebelum meninggal dunia. Ini kata Nurul Arifin:  https://t.co/qm04h0k0lQ,5,0,1,1,2022-01-25,9,Tuesday,2,6,1
1485907335813992457,2022-01-25 09:28:10,Menteri PUPR Basuki Hadimuljono mengusulkan dana Rp 46 triliun untuk pembangunan Kantor Presiden hingga pembangunan jalan di ibu kota baru.  https://t.co/I67dTmTd8u,26,4,4,2,2022-01-25,9,Tuesday,2,30,6
1485906599965347843,2022-01-25 09:25:14,"Kontingen Indonesia ditunggu dua multievent SEA Games dan Asian Games 2022. Tetapi, sampai sekarang Kemenpora belum menentukan cabor apa saja yang akan dikirim. https://t.co/ODG1RraVQP",5,0,0,0,2022-01-25,9,Tuesday,2,5,0
1485906085693296641,2022-01-25 09:23:12,Marvel Comics sukses membuat sejumlah semesta bagi karakter yang diciptakannya. Salah satunya adalah semesta buat Spider-Man.  https://t.co/5q2luGv11h,16,3,2,3,2022-01-25,9,Tuesday,2,18,6
1485905861897854976,2022-01-25 09:22:18,"Mengubah pola makan sejak pulang dari liburan dari Turki, Anang Hermansyah kini menghindari nasi. Berat badannya sukses turun hingga 7-8 kilogram!  https://t.co/O4baQP56Ir",5,0,0,0,2022-01-25,9,Tuesday,2,5,0
1485905573237374977,2022-01-25 09:21:10,Pemindahan Ibu Kota Negara (IKN) dari Jakarta ke Kalimantan diperkirakan akan menghabiskan biaya Rp 466 triliun.  https://t.co/3CUrDnxtpK,12,4,4,6,2022-01-25,9,Tuesday,2,16,10
1485905009803939841,2022-01-25 09:18:55,"10 Gol dari 12 laga terakhir, Tammy Abraham lagi on fire dan bawa AS Roma terus jaga asa tembus papan atas Liga Italia! https://t.co/Mwgjz7s20n",5,1,1,1,2022-01-25,9,Tuesday,2,6,2
1485904545779785729,2022-01-25 09:17:05,Pemerintah tegas melanjutkan PTM di tengah melonjaknya kasus Omicron. Pakar mengingatkan kasus rawat inap anak di beberapa negara tinggi ketimbang Delta. https://t.co/7j6eEE38Li,9,6,2,3,2022-01-25,9,Tuesday,2,11,9
1485904170062430210,2022-01-25 09:15:35,"Sri Sultan Hamengku Buwono X, curiga Covid-19 varian Omicron sudah masuk ke Yogyakarta. Berawal dari satu sampel pasien Covid-19 yang mendekati ciri Omicron.  https://t.co/ZPp9dnFwBf",4,1,0,0,2022-01-25,9,Tuesday,2,4,1
1485903925995835395,2022-01-25 09:14:37,Kelompok yang berjumlah sekitar 48 mobil itu memicu aksi berbahaya dengan berjejer parkir di jalur darurat untuk mengambil foto. https://t.co/HWrtf3iCir,13,2,3,4,2022-01-25,9,Tuesday,2,16,6
1485903422087995393,2022-01-25 09:12:37,"Ririe Fairus baru berani membagikan kisahnya dengan Ayus Sabyan yang berakhir karena perselingkuhan. Masih ada tangis, Larissa Chou beri semangat.  https://t.co/5R6apJOLzi",10,2,0,0,2022-01-25,9,Tuesday,2,10,2
1485902022318735363,2022-01-25 09:07:03,"Dipanggilnya Mario Balotelli ke timnas Italia memunculkan anggapan dirinya anak emas Roberto Mancini. Tetapi, hubungan keduanya tak selalu manis. https://t.co/ZtWxqA1CIi",3,0,2,0,2022-01-25,9,Tuesday,2,5,0
1485901794983440393,2022-01-25 09:06:09,"Setelah sukses dengan film Spider-Man: No Way Home, Marvel Studios segera merilis Doctor Strange in the Multiverse of Madness. Plot lengkapnya beredar di internet. https://t.co/omjvJEvW2n",55,4,16,8,2022-01-25,9,Tuesday,2,71,12
1485901780143771648,2022-01-25 09:06:05,Google merilis fitur keamanan bagi penggunanya untuk memberikan peringatan jika ada file mencurigakan di layanan Google Drive. https://t.co/eqSbvQk4Oe,5,0,2,0,2022-01-25,9,Tuesday,2,7,0
1485901245965602819,2022-01-25 09:03:58,Putri sulung artis senior Nurul Arifin meninggal dunia karena serangan jantung. Waspadai gejala utama penyakit ini menurut CDC. https://t.co/GE9SslTPHV,10,1,1,1,2022-01-25,9,Tuesday,2,11,2
1485900962661376001,2022-01-25 09:02:50,"Setelah resmi bercerai dengan Ayus Sabyan, Ririe Fairus akhirnya berani bersuara soal isi hatiny. Netizen Sindir Nissa Sabyan: Sudah ke Cappadocia? https://t.co/z3y72LJU0h",16,2,4,1,2022-01-25,9,Tuesday,2,20,3
1485900944739078144,2022-01-25 09:02:46,"Kasus tabrak lari di Tol Madiun menewaskan 2 orang. Terlacak dari CCTV, polisi menangkap pelaku di Krian, Sidoarjo.  https://t.co/Qx9klujbNz",8,1,2,0,2022-01-25,9,Tuesday,2,10,1
1485900345071083526,2022-01-25 09:00:23,"""Dengan adanya kelangkaan batu bara telah berefek negatif yaitu berkurang atau terhentinya ekspor semen dan klinker,"" jelas Direktur Jenderal Industri Kimia, Farmasi, dan Tekstil (IKFT) Kemenperin, Muhammad Khayam  https://t.co/vUFwsJ3lWC",4,0,1,1,2022-01-25,9,Tuesday,2,5,1
1485900331280220162,2022-01-25 09:00:20,"Tata krama menjadi salah satu hal yang perlu kita tanamkan untuk kehidupan sehari-hari. Apa sih sebenarnya itu tata krama?

via: detikedu https://t.co/feTeWUeX5x",11,0,1,0,2022-01-25,9,Tuesday,2,12,0
1485900070398615556,2022-01-25 08:59:18,"Polisi menetapkan 5 orang tersangka dalam kasus pengeroyokan lansia Wiyanto Halim (89) hingga tewas di Cakung, Jakarta Timur. Salah satu tersangka berinisial RYN, berperan menarik paksa korban keluar dari mobil dan melakukan pukulan ke arah kepala. https://t.co/886JlRvAu1",9,7,2,1,2022-01-25,8,Tuesday,2,11,8
1485899609692123139,2022-01-25 08:57:28,"Sejumlah negara berlomba pergi ke Bulan. Wisata luar angkasa malah sudah diadakan. Kapan ya, Indonesia bisa tur ke Bulan?🤔 https://t.co/h3HvveaoRA",67,132,19,19,2022-01-25,8,Tuesday,2,86,151
1485898622596169734,2022-01-25 08:53:32,"Melihat kondisi ini, kata Emil, pihaknya sudah menyiapkan upaya penanganan. Bahkan, dia menyebut saat ini kondisi di Jabar mengindikasikan lampu kuning. https://t.co/u4YkOjNJkf",14,0,5,4,2022-01-25,8,Tuesday,2,19,4
1485897570845134848,2022-01-25 08:49:22,Perempuan ini bagikan minyak goreng di tengah harganya yang Rp 19 ribu per liter di pasar tradisional Ponorogo. Ada 1.200 liter minyak goreng yang dibagikan. https://t.co/8IizB4eunH,18,0,3,0,2022-01-25,8,Tuesday,2,21,0
1485897101246709762,2022-01-25 08:47:30,"Semangat Olimpiade Musim Dingin 2022 di Beijing, membuat tim hoki era 1970-an kembali ke arena. https://t.co/jX4SPd4bu5",3,0,0,0,2022-01-25,8,Tuesday,2,3,0
1485897074927443968,2022-01-25 08:47:23,"Omicron di Indonesia disebut pakar sudah mendominasi, Delta akan tersingkir. Setidaknya ada 18 wilayah yang mencatat laporan kasus ini menurut ahli. https://t.co/fPuxtlYu8z",6,4,1,0,2022-01-25,8,Tuesday,2,7,4
1485896114649845765,2022-01-25 08:43:35,"Jalan Tol Cileunyi Sumedang Dawuan (Cisumdawu) seksi 1 yang menghubungkan wilayah Cileunyi-Pamulihan mulai beroperasi hari ini (25/1). Nantinya, tol ini akan digratiskan selama 2 minggu. https://t.co/YySJ2XsIub",7,2,0,2,2022-01-25,8,Tuesday,2,7,4
1485895337281822722,2022-01-25 08:40:29,Pemindahan ibu kota negara (IKN) dari Jakarta ke Kalimantan Timur tak sedikit menuai kritikan.  https://t.co/mawowi8lJz,12,4,1,1,2022-01-25,8,Tuesday,2,13,5
1485894254555799555,2022-01-25 08:36:11,Nurul Arifin mengungkap kronologi Maura Magnalia meninggal dunia.  https://t.co/2Nryvflz4p,6,0,2,0,2022-01-25,8,Tuesday,2,8,0
1485893991346409472,2022-01-25 08:35:08,Badan Pengatur Jalan Tol (BPJT) membuka prakualifikasi pelelangan pengusahaan jalan tol Sentul Selatan-Karawang Barat. Ada yang minat?   https://t.co/Qn1PqugEjL,4,1,2,0,2022-01-25,8,Tuesday,2,6,1
1485893202695622656,2022-01-25 08:32:00,Video siswi-siswi SD di Lamongan menyisihkan uang jajan untuk membantu sang guru tengah viral. Guru tersebut merasa kaget hingga terharu. https://t.co/Mp1gBDPlZ4,12,0,3,0,2022-01-25,8,Tuesday,2,15,0
1485892552809230339,2022-01-25 08:29:25,Skor Indeks Persepsi Korupsi (IPK) atau Corruption Perceptions Index (CPI) Indonesia mengalami kenaikan dibandingkan tahun sebelumnya. https://t.co/wmlHbTedWQ,11,2,3,0,2022-01-25,8,Tuesday,2,14,2
1485891715483455488,2022-01-25 08:26:06,"Sultan Brunei Darusalam, kembali menjadi sorotan, kali tentang koleksi mobil miliknya yang lebih mahal dari klub Manchester United! https://t.co/tRrojGIOg1",28,4,5,3,2022-01-25,8,Tuesday,2,33,7
1485891208492863490,2022-01-25 08:24:05,"Erling Haaland disebut memiliki rasa lapar dan gairah mencetak gol seperti Robert Lewandowski. Tetapi, Lewandowski masih unggul karena sejumlah hal. https://t.co/u3CGbfCOlK",4,0,1,0,2022-01-25,8,Tuesday,2,5,0
1485890715800543239,2022-01-25 08:22:07,"Sering pura-pura bahagia padahal sedang banyak masalah? Yuk kenali Duck Syndrome yang bisa terjadi kepada siapapun.

via: detikedu https://t.co/WTwKP4e5Jy",130,10,65,13,2022-01-25,8,Tuesday,2,195,23
1485890444630315009,2022-01-25 08:21:03,"Laga uji coba Timnas Indonesia melawan Timor Leste bisa dihadiri penonton, penjualan tiket sudah dibuka! https://t.co/KG1PJI5XjU",10,0,0,0,2022-01-25,8,Tuesday,2,10,0
1485890414192308226,2022-01-25 08:20:55,Makanan Indonesia kerap ditawarkan pada sebuah bazar di Amerika. Hal ini membuat seorang bule Amerika tertarik untuk mencicipi nasi Padang hingga getuk!  https://t.co/TLpW5dYWlF,14,0,1,1,2022-01-25,8,Tuesday,2,15,1
1485890169949626375,2022-01-25 08:19:57,"Michael Oliver Wellerz meyakini timnya bakal tampil maksimal di seri 2 Bandung IBL 2022, setelah hasil sapu bersih di Jakarta. https://t.co/niEHzPE8E5",7,0,0,0,2022-01-25,8,Tuesday,2,7,0
1485889605551411201,2022-01-25 08:17:43,"Jakarta Bogor, Depok, Tangerang dan Bekasi (Jabodetabek) kini masuk ke PPKM level 2. Akibatnya, kunjungan ke mal tidak lagi 100 persen. https://t.co/FKAf9MVP9y",25,3,12,2,2022-01-25,8,Tuesday,2,37,5
1485889241641103364,2022-01-25 08:16:16,Jalan dan jembatan di Bali yang akan dilalui 39 kepala negara dalam agenda KTT G20 tahan beban untuk kendaraan anti peluru.  https://t.co/sXJtDKkcCY,7,3,1,0,2022-01-25,8,Tuesday,2,8,3
1485888747916959744,2022-01-25 08:14:18,Sudah tahu cerita tentang titik nol yang berada di lintasan antara Alun-alun Utara dengan Ngejaman di selatan Malioboro ini? Simak sepenggal kisahnya yuk. https://t.co/Z42jsPSYCK,7,0,3,0,2022-01-25,8,Tuesday,2,10,0
1485888101977313280,2022-01-25 08:11:44,Gilberto Silva menyebut Casemiro gelandang bertahan terbaik di dunia saat ini. https://t.co/n1mrBqqwst,5,0,0,0,2022-01-25,8,Tuesday,2,5,0
1485887461377064962,2022-01-25 08:09:11,Singapura mengucurkan dana sebesar Rp 131 T ke RI yang salah satunya untuk energi terbarukan.  https://t.co/UsGDIaCzKS,25,3,5,1,2022-01-25,8,Tuesday,2,30,4
1485887216857538561,2022-01-25 08:08:13,"Ketum PBNU panggil ketua PCNU Bondowoso, Jawa Timur usai menyebut ""Bukan PKB yang Peralat NU, Tapi NU yang Peralat PKB"" https://t.co/jWSTMWDCHN",5,0,2,0,2022-01-25,8,Tuesday,2,7,0
1485886704871477248,2022-01-25 08:06:11,Beras ini diyakini mampu meningkatkan gizi dan mempercepat upaya penurunan stunting di ibu kota.  https://t.co/RbGxi8oPio,13,7,3,1,2022-01-25,8,Tuesday,2,16,8
1485886688639471617,2022-01-25 08:06:07,Komisi V Dewan Perwakilan Rakyat Daerah (DPR) RI protes ke Kementerian PUPR karena masih banyak infrastruktur daerah yang masih belum memadai.  https://t.co/ssv4bmZKVf,3,0,1,0,2022-01-25,8,Tuesday,2,4,0
1485886456702943238,2022-01-25 08:05:12,"Dua kelompok warga di Sorong, Papua Barat terlibat bentrok. Sebanyak 11 orang dilaporkan tewas. https://t.co/WH1PXv2jvC",5,1,0,0,2022-01-25,8,Tuesday,2,5,1
1485886413174411264,2022-01-25 08:05:01,Persediaan minyak murah yang diinginkan pemerintah seharga Rp 14.000/Liter tampak mulai sulit didapatkan dan akhirnya mulai diganti dengan Ciki!  https://t.co/WImpXtRoyx,7,5,1,2,2022-01-25,8,Tuesday,2,8,7
1485885853285208070,2022-01-25 08:02:48,Nurul Arifin mengatakan bahwa mendiang Maura Magnalia merupakan anak yang sangat cerdas. Dia mengatakan bahwa menjadi anak politisi tidaklah mudah. https://t.co/J1zolrOv5C,3,0,0,0,2022-01-25,8,Tuesday,2,3,0
1485885602247716865,2022-01-25 08:01:48,Ki Joko Bodo dikabarkan sudah sembuh dari sakit yang membuat kakinya bengkak dan susah berjalan. Kini penampilannya mencuri perhatian. https://t.co/Xxh6dv6Yug,8,0,0,0,2022-01-25,8,Tuesday,2,8,0
1485885236990861318,2022-01-25 08:00:21,"Permintaan menu daging buaya naik 70 Persen di Thailand, ternyata ini penyebabnya! https://t.co/Z9ahGQY3iH",4,1,3,1,2022-01-25,8,Tuesday,2,7,2
1485884980999991297,2022-01-25 07:59:20,"Negara Turki begitu populer lewat series Layangan Putus. Kini, mereka punya nama baru. Jadi apa namanya? https://t.co/ObwLHcOmO9",34,24,3,4,2022-01-25,7,Tuesday,2,37,28
1485884466744770562,2022-01-25 07:57:17,Para peneliti China menemukan bunga paling pemalu di dunia yang berada di Dataran Tinggi Qinghai-Tibet. https://t.co/1xol4qUSSY,6,1,0,0,2022-01-25,7,Tuesday,2,6,1
1485884398306459649,2022-01-25 07:57:01,"Transaksi UMKM Jawa Barat di Tokopedia meningkat hingga hampir 2 kali lipat selama 2021 daripada periode tahun 2020. Hal ini karena Inisiatif Hyperlocal yang tengah digencarkan Tokopedia.
https://t.co/Fu5Ux2kr1O",3,0,0,0,2022-01-25,7,Tuesday,2,3,0
1485884182639558664,2022-01-25 07:56:10,"Tokopedia meraih penghargaan di ajang BAZNAS Award 2022, dalam kategori 'Mitra Pengumpulan Zakat Online Terbaik'.

https://t.co/JNVpnkhVnI",9,0,2,0,2022-01-25,7,Tuesday,2,11,0
1485884146786484225,2022-01-25 07:56:01,"Keluarga menyebut, sebelum meninggal dunia, Maura Magnalia sedang mengurus wisudanya bulan depan. #MauraMagnalia   https://t.co/LXyWCVwSfs",14,1,2,0,2022-01-25,7,Tuesday,2,16,1
1485884124137242626,2022-01-25 07:55:56,"Wakil Menteri Keuangan Suahasil Nazara menyatakan utang adalah alat untuk ekspansi. Bahkan, menurutnya pengusaha yang sehat adalah yang punya utang.  https://t.co/1avuVmc9WA",7,5,2,1,2022-01-25,7,Tuesday,2,9,6
1485883870511775746,2022-01-25 07:54:55,Kabar Baik! 4 Lessor Besar Garuda Setuju Restrukturisasi Utang  https://t.co/CHcihhUitq,9,0,0,0,2022-01-25,7,Tuesday,2,9,0
1485883623828074497,2022-01-25 07:53:56,Penelitian terbaru menunjukkan infeksi COVID-19 dapat meningkatkan risiko seseorang terkena diabetes. Virus Corona ternyata dapat menyerang sel lemak tubuh. https://t.co/jjE2qeiUah,15,3,6,7,2022-01-25,7,Tuesday,2,21,10
1485883297112760322,2022-01-25 07:52:39,"Aksi pencurian motor di kawasan Senen, Jakarta Pusat, terekam CCTV. Pelaku sempat melepaskan tembakan ke warga setelah kepergok. https://t.co/1jxRFxotSQ",4,0,1,0,2022-01-25,7,Tuesday,2,5,0
1485883269266685952,2022-01-25 07:52:32,"Hari ini harga ayam di Pasar Santa, Jakarta Selatan mencapai Rp 60 ribu/ekor!  https://t.co/U8NK0ulx7V",4,0,0,1,2022-01-25,7,Tuesday,2,4,1
1485882693208395779,2022-01-25 07:50:15,"Akibat viralnya tarif parkir bus di Yogya, Sandiaga Uno berharap ada penataan. Dia menyebut ada 3 tempat parkir bus resmi di Yogya. Dimana saja? https://t.co/Y3F5WdJuOJ",14,2,2,0,2022-01-25,7,Tuesday,2,16,2
1485881958039265281,2022-01-25 07:47:19,Naiknya kasus COVID-19 di Indonesia karena varian Omicron membuat para pakar kesehatan khawatir dengan kebijakan PTM 100 persen di wilayah PPKM level 1 dan 2. https://t.co/3jEpTzFMOH,12,2,5,0,2022-01-25,7,Tuesday,2,17,2
1485881473030934529,2022-01-25 07:45:24,Begini pengakuan Zaskia Sungkar soal kedatangan Acha Septriasa ke rumahnya:  https://t.co/Xd11qXHgvD,9,0,1,0,2022-01-25,7,Tuesday,2,10,0
1485881189223518210,2022-01-25 07:44:16,"Untung (42) bersama dua anaknya hidup dalam kondisi memprihatinkan. Rumah mereka terbuat dari bambu yang nyaris roboh. Bahkan untuk masuk ke rumahnya, orang-orang harus merunduk. 

#sahabatbaik ayo bantu Untung melalui platform @berbuatbaik_id atau link https://t.co/kwWirH8KeT. https://t.co/VzneRVjE46",13,1,1,0,2022-01-25,7,Tuesday,2,14,1
1485880733084364810,2022-01-25 07:42:27,Gegara tidak habiskan makanan Kepala sekolah ini paksa muridnya untuk makan dari tempat sampah sebagai hukuman. Akhirnya ia dipecat! https://t.co/sgtd1MrML1,12,1,0,3,2022-01-25,7,Tuesday,2,12,4
1485880452808331264,2022-01-25 07:41:20,Pakar kesehatan menyarankan untuk meningkatkan perlindungan terhadap Omicron dengan masker yang lebih kuat dari segi perlindungan terhadap droplet seperti N95. https://t.co/UOg3FxlwGx,8,1,0,0,2022-01-25,7,Tuesday,2,8,1
1485879964885004288,2022-01-25 07:39:24,"Gaga Muhammad mengajukan banding ke Pengadilan Tinggi DKI Jakarta. Ia tidak terima dengan hukuman 4,5 tahun penjara dan minta hukumannya diringankan. https://t.co/aLsXGlPkN8",5,0,0,2,2022-01-25,7,Tuesday,2,5,2
1485879451951026179,2022-01-25 07:37:22,Istilah 'crazy rich' ramai di Indonesia dan disematkan kepada mereka yang suka menunjukkan kemewahan di media sosial.  https://t.co/jRqTomLZXu,15,1,4,0,2022-01-25,7,Tuesday,2,19,1
1485879183070924801,2022-01-25 07:36:18,"""Saya pikir justru ini adalah hal yang harus kita sikapi bersama, tidak bisa serta merta juga kemudian hal itu mengatakan bahwa kecolongan pihak kepolisian,"" kata kepolisian. https://t.co/wUiQNPEOJJ",37,17,10,11,2022-01-25,7,Tuesday,2,47,28
1485878620111392768,2022-01-25 07:34:03,"KSAD Jenderal Dudung menegaskan poster yang memuat informasi Haikal Hassan mengisi acara di Yonif Para Raider 502, Malang adalah berita bohong atau hoax. https://t.co/QoG7Zqizwv",8,0,1,4,2022-01-25,7,Tuesday,2,9,4
1485878124336320512,2022-01-25 07:32:05,Nurul Ghufron menceritakan soal tim penyelidik KPK yang menemukan kerangkeng manusia di rumah Bupati Langkat saat melancarkan OTT. Begini ceritanya. https://t.co/Q3c81j16nh,10,0,2,0,2022-01-25,7,Tuesday,2,12,0
1485877630268289029,2022-01-25 07:30:07,"Presiden Jokowi mengenakan outfit lokal saat menjajal Sirkuit Mandalika. Nah, produk serupa yang dipakai Jokowi, dijual bengkel Vespa di Tangsel. Lihat yuks.. https://t.co/K3mtJi2oUf",3,1,1,1,2022-01-25,7,Tuesday,2,4,2
1485876829303058438,2022-01-25 07:26:57,"Diego Simeone memang begitu identik dengan Atletico Madrid. Tetapi, ia mengungkapkan bahwa dirinya pasti akan pergi pada suatu hari nanti. https://t.co/v58l5ifmdb",6,0,2,0,2022-01-25,7,Tuesday,2,8,0
1485876513102778369,2022-01-25 07:25:41,Warga desa di Swedia resah tiada tara. Nama desa yang mereka tinggali selalu disensor di media sosial. Mereka pun menuntut agar nama desa diganti. https://t.co/2HdtF012iz,6,1,2,0,2022-01-25,7,Tuesday,2,8,1
1485876485701439488,2022-01-25 07:25:35,Jokowi menggelar pertemuan dengan Perdana Menteri (PM) Singapura Lee Hsien Loong. Ini salah satu yang dibahas.  https://t.co/vAuS2JXNC8,1,0,1,0,2022-01-25,7,Tuesday,2,2,0
1485875100490608640,2022-01-25 07:20:04,"WHO mengatakan pandemi Covid-19 kemungkinan dapat berakhir tahun ini. Hal tersebut dapat terjadi, jika negara-negara berusaha lebih keras memastikan program vaksinasi dan pengobatan berjalan sesuai target. #CNNIndonesia  #detiknetwork  https://t.co/TzegMRuDJi",4,2,3,0,2022-01-25,7,Tuesday,2,7,2
1485874988053901315,2022-01-25 07:19:38,Honda Accord mendapatkan penyegaran dari segi fitur dan interior di Indonesia pada Selasa (25/1/2022). Simak ubahan dan harganya yuk! https://t.co/EOF4ZigifF,7,0,1,0,2022-01-25,7,Tuesday,2,8,0
1485874702312783872,2022-01-25 07:18:29,Nathalie Holscher dan Sule telah dikaruniai anak. Ia berbagi cerita rasanya urus bayi. Sule sampai tak menyangka. https://t.co/YU2uA7W04z,6,0,0,1,2022-01-25,7,Tuesday,2,6,1
1485874118536929281,2022-01-25 07:16:10,"Persediaan minyak di sejumlah toko ritel banyak yang kosong hari ini, kok bisa?  https://t.co/QDqSQOFj8e",3,1,2,0,2022-01-25,7,Tuesday,2,5,1
1485873869600735232,2022-01-25 07:15:11,"Kim Hawt dan Emma Waroka lapor soal media sosial meraka yang raib. Senasib dengan Marissya Icha, mereka siap 'nyanyi' saat pelaku ditangkap. https://t.co/hQqcMcWkIW",4,0,0,2,2022-01-25,7,Tuesday,2,4,2
1485873849442967556,2022-01-25 07:15:06,"Beberapa makanan tercatat dalam Al-Qur'an, salah satunya delima. Buah dengan rasa manis asam ini juga mengandung nutrisi yang kaya manfaat untuk kesehatan.  https://t.co/HNNqTlKpx4",16,0,4,0,2022-01-25,7,Tuesday,2,20,0
1485873539269996544,2022-01-25 07:13:52,"Kalahkan Jose Mourinho dan Sir Alex Ferguson, Pep Guardiola bikin rekor lagi di Liga Inggris pelatih tercepat raih 500 poin! https://t.co/Kowtd9ogBV",1,0,0,0,2022-01-25,7,Tuesday,2,1,0
1485873229541646347,2022-01-25 07:12:38,Semburan lumpur di Sidoarjo menyimpan potensi 'harta karun' yang disebut-sebut langka!  https://t.co/dEjGvXb3kn,8,2,0,1,2022-01-25,7,Tuesday,2,8,3
1485872340500197378,2022-01-25 07:09:06,Dua oknum pegawai Ditjen Bea dan Cukai diduga melakukan pungli di Bandara Soekarno-Hatta. Bea Cukai memutuskan mencopot oknum tersebut. https://t.co/cpsuLQotqh,59,11,26,9,2022-01-25,7,Tuesday,2,85,20
1485872028175454214,2022-01-25 07:07:52,Tender lelang pembangunan lintasan Formula E tertulis gagal di situs resmi JakPro. Direktur Utama PT JakPro Widi Amanasto buka suara. Apa katanya? https://t.co/mzF7bul0z2,13,10,2,1,2022-01-25,7,Tuesday,2,15,11
1485871523420422147,2022-01-25 07:05:51,Kehadiran Munarman sewaktu baiat terhadap ISIS di Makassar pada 2015 dikaitkan dengan tindakan pelaku bom bunuh diri di Filipina. Apa hubungannya? https://t.co/SpHMQ5ztQC,6,3,0,0,2022-01-25,7,Tuesday,2,6,3
1485871016446509060,2022-01-25 07:03:51,Nama Ivory Aquino diumumkan ikut gabung ke proyek ini memerankan karakter transgender di DC Comics. https://t.co/K4k9hLoOhe,4,0,2,1,2022-01-25,7,Tuesday,2,6,1
1485870499511083009,2022-01-25 07:01:47,"Indeks Persepsi Korupsi (CPI) Indonesia mengalami kenaikan skor. Tahun 2021, skor CPI Indonesia yakni 38 dan berada di peringkat 96 di dunia. https://t.co/eAdpkHJCgK",8,0,1,0,2022-01-25,7,Tuesday,2,9,0
1485870161307619332,2022-01-25 07:00:27,"PT Pertamina (Persero) memastikan kesiapannya dalam proyek hilirisasi batu bara menjadi Dimethyl Ether (DME) di Tanjung Enim, Sumatera Selatan (Sumsel).  https://t.co/IkLiOgLdma",6,0,0,0,2022-01-25,7,Tuesday,2,6,0
1485869870843629568,2022-01-25 06:59:17,"Toyota Land Cruiser saat ini tengah mencuri perhatian masyarakat, terlebih model terbarunya diluncurkan resmi di Indonesia. https://t.co/UOe631Mcb4",53,0,10,5,2022-01-25,6,Tuesday,2,63,5
1485869115319496706,2022-01-25 06:56:17,"Satgas Penanganan Covid-19 merilis Surat Edaran No. 3 tahun 2022 tentang protokol kesehatan travel bubble di Batam, Bintan, dengan Singapura di masa pandemi. Berikut isinya! https://t.co/TpHk2YB844",1,0,0,0,2022-01-25,6,Tuesday,2,1,0
1485869114149191682,2022-01-25 06:56:17,"Kementerian BUMN telah membentuk holding pangan BUMN. Namun demikian, Perum Bulog tak masuk dalam holding pangan tersebut. Kenapa?  https://t.co/QZ2ivr1Ab7",2,0,0,0,2022-01-25,6,Tuesday,2,2,0
1485868751643885569,2022-01-25 06:54:51,"Bila kamu tertarik, proses pemesanan pembelian ORI021 dapat dilakukan secara online. Ini cara lengkapnya.  https://t.co/w8onAjaDvn",3,1,0,1,2022-01-25,6,Tuesday,2,3,2
1485868265247318016,2022-01-25 06:52:55,Ronaldinho memberi pujian setinggi-tingginya kepada Virgil van Dijk dan menyebutkan seperti seorang maestro. https://t.co/5YbV2EZViE,5,0,0,0,2022-01-25,6,Tuesday,2,5,0
1485867761238740994,2022-01-25 06:50:55,Maura Magnalia Madyaratri tak banyak jadi sorotan. Ia dan adiknya memang tak mengikuti jejak Nurul Arifin sebagai artis atau politikus. Ini sosok Maura Magnalia:  https://t.co/wNrtXfY9q6,8,0,3,0,2022-01-25,6,Tuesday,2,11,0
1485867453196517378,2022-01-25 06:49:41,Pernikahan Perdana Menteri Selandia Baru Jacinda Ardern dan kekasihnya Clarke Gayford terpaksa batal karena Omicron. Ini momen kemesraan:  https://t.co/nB6RW9xzcf,5,0,0,0,2022-01-25,6,Tuesday,2,5,0
1485867210614599681,2022-01-25 06:48:43,"Putri sulung Nurul Arifin, Maura Magnalia Madyaratri meninggal dunia pada usia 28 tahun. Maura keluhkan hal ini sebelum ditemukan meninggal:  https://t.co/V2CVY51wPe",28,14,15,1,2022-01-25,6,Tuesday,2,43,15
1485866676814069763,2022-01-25 06:46:36,"Comoros tampil heroik, mainkan kiper dadakan dan dapat kartu merah, mereka pulang dengan kepala tegak usai kalah tipis 1-2 dari Kamerun. https://t.co/L0v6gWw50x",3,0,1,0,2022-01-25,6,Tuesday,2,4,0
1485866378284388353,2022-01-25 06:45:25,"Persiapan KTT G20 hingga renovasi TMII membutuhkan anggarak Rp 2,7 triliun. Ini rinciannya  https://t.co/CSbYkL0UJ9",3,0,0,0,2022-01-25,6,Tuesday,2,3,0
1485866122226417666,2022-01-25 06:44:24,"Bertema Kundalini Chakra, kostum rancangan Eggie Jasmin asal Surabaya berhasil menang sebagai Kostum Nasional Terbaik Mrs. World 2022. Ini potret kemegahannya. https://t.co/2kTQkdTMNI",14,2,6,0,2022-01-25,6,Tuesday,2,20,2
1485865133888974850,2022-01-25 06:40:28,Pandemi COVID-19 yang tak jua usai telah merubah industri penerbangan. Pesawat yang menganggur akhirnya dijual dan diubah menjadi bar. https://t.co/vu27IzsVUB,10,1,1,2,2022-01-25,6,Tuesday,2,11,3
1485864347524083712,2022-01-25 06:37:21,"Presiden Amerika Serikat (AS), Joe Biden, membuat geger setelah melemparkan umpatan kotor kepada wartawan. Hal itu dilontarkan Biden saat ditanya mengenai inflasi di AS. https://t.co/X8GjwKg68B",5,2,3,0,2022-01-25,6,Tuesday,2,8,2
1485863861190373376,2022-01-25 06:35:25,"Irwansyah mendatangkan mantan kekasihnya, Acha Septriasa, untuk berbincang dengannya dan juga Zaskia Sungkar. Inilah pertemuan mereka:  https://t.co/Co8UwAbHIt",14,0,2,3,2022-01-25,6,Tuesday,2,16,3
1485863110325985284,2022-01-25 06:32:26,"Warga Palembang yang tinggal di rumah reyot menyatu dengan kandang ayam, Mak Unah, bertemu langsung dengan Presiden Joko Widodo. Ini momennya: https://t.co/Tqf7FlzDx4",13,2,0,0,2022-01-25,6,Tuesday,2,13,2
1485862549828640769,2022-01-25 06:30:12,Saat ini pasar saham AS berada di posisi gelembung besar atau superbubble. Situasi saat ini disebut dampaknya akan lebih lama dari sebelumnya.  https://t.co/uCMClImuHz,11,0,2,0,2022-01-25,6,Tuesday,2,13,0
1485862520556601350,2022-01-25 06:30:05,Hewan aneh ini sedang banyak bergerombol di pantai-pantai Australia. Disebut aneh karena wujudnya tidak seperti hewan pada umumnya. https://t.co/gntZMKxz0o,3,0,1,2,2022-01-25,6,Tuesday,2,4,2
1485862005726658562,2022-01-25 06:28:02,Lydia Kandou cerita soal kondisi Kenang Mirdad usai resmi bercerai dari Tyna Kanna. Ia minta doa dan berharap Kenang lebih bahagia.  https://t.co/K30UXrsUQS,15,0,1,0,2022-01-25,6,Tuesday,2,16,0
1485861781725753346,2022-01-25 06:27:09,"Toni Kroos protes keras terhadap wasit dalam kemenangan 1-2 atas Elche, tetapi ia tetap minta maaf meski sesungguhnya tidak bersalah. https://t.co/T9BocL9vyn",12,0,2,0,2022-01-25,6,Tuesday,2,14,0
1485861271706689542,2022-01-25 06:25:07,Musisi sekaligus rocker Marilyn Manson dituding melakukan pelecehan kepada aktris Evan Rachel Wood. Begini cerita Even Rachel Wood:  https://t.co/ATOtZUNVqW,5,0,3,0,2022-01-25,6,Tuesday,2,8,0
1485861251934822402,2022-01-25 06:25:03,"Puluhan pelari mengikuti lari maraton saat suhu turun hingga di bawah -50 derajat Celsius di dekat Oymyakon, Rusia.  https://t.co/fvn3zbpBHw",5,0,1,0,2022-01-25,6,Tuesday,2,6,0
1485861119843606530,2022-01-25 06:24:31,Situs yang digadang-gadang bisa mendapat uang dengan cepat itu menarik perhatian masyarakat karena banyak 'crazy rich' konon dapat kekayaan dari sini.  https://t.co/8jIzbLMFqx,3,1,3,1,2022-01-25,6,Tuesday,2,6,2
1485860490886758407,2022-01-25 06:22:01,"Sebagai suksesor Galaxy S20 FE, sejumlah peningkatan diberikan Samsung. Tapi ada berapa perubahan yang bikin Galaxy S21 FE ini makin menarik. Ini reviewnya:  https://t.co/1NXMm2SnBk",8,0,3,0,2022-01-25,6,Tuesday,2,11,0
1485859842271154177,2022-01-25 06:19:26,"Belum juga iPhone 14 dirilis, sudah ada bocoran soal fitur baru di iPhone 15 Pro. Apple disebut akan menghadirkan kamera periskop dengan zoom optik 5x di iPhone 15 Pro dan iPhone 15 Pro Max. https://t.co/CpY8iW9Ad3",12,0,4,1,2022-01-25,6,Tuesday,2,16,1
1485859048264187904,2022-01-25 06:16:17,Rachel Vennya kembali sampaikan penyesalan telah kabur dari karantina. Ia mengaku mendapat sanksi sosial akibat hal tersebut. Namun netizen tak bisa menerima penyesalan Rachel. https://t.co/rKYdPfWs4P,13,4,3,2,2022-01-25,6,Tuesday,2,16,6
1485858742474354690,2022-01-25 06:15:04,Bos LaLiga angkat suara soal Barcelona yang 'mengusir' Ousmane Dembele. Dia menyebut tidak ada yang salah dengan apa yang dilakukan Blaugrana. https://t.co/yfNoNthcw2,10,0,0,0,2022-01-25,6,Tuesday,2,10,0
1485858470075191297,2022-01-25 06:13:59,"Bilik mandi pemandian sumber mata air panas Desa Kepulungan, Kabupaten Pasuruan, dibongkar. Namun pengunjung tetap masih bisa mandi air panas. https://t.co/ylbuL0cseo",4,0,2,1,2022-01-25,6,Tuesday,2,6,1
1485857925667110913,2022-01-25 06:11:50,Tya Ariestya sudah seminggu memutuskan untuk memakai hijab. Dia meminta untuk prosesnya belajar menutup aurat dihargai. https://t.co/hiZClT7p1z,44,5,2,0,2022-01-25,6,Tuesday,2,46,5
1485857316721278978,2022-01-25 06:09:24,Masyarakat banyak yang penasaran dengan kondisi terkini Tukul Arwana. Sang manajer pun menjelaskan keluarga Tukul menginginkan adanya privasi untuk hal tersebut. Bahkan artis seperti Sule tak diizinkan mengambil gambar Tukul untuk vlog. https://t.co/FhUy3uGOKJ,14,1,3,2,2022-01-25,6,Tuesday,2,17,3
1485856832648273920,2022-01-25 06:07:29,Vaksin Merah Putih buatan Unairakan mulai uji klinis manusia pada 7 Februari 2022 mendatang di RSU dr Soetomo. https://t.co/b1eLjPcxsN,5,0,2,0,2022-01-25,6,Tuesday,2,7,0
1485856336407666692,2022-01-25 06:05:31,Jakarta akan memiliki 5 lapangan bola berstandar FIFA. Anies mengatakan kelima lapangan itu dibangun di seluruh wilayah kota administrasi Jakarta. Ini daftarnya: https://t.co/ZTJX4hRg8T,22,11,7,1,2022-01-25,6,Tuesday,2,29,12
1485855736852799489,2022-01-25 06:03:08,"Studi menganalisis berapa lama varian Omicron bertahan di permukaan plastik hingga kulit, dibandingkan varian Delta dan varian lain. Ternyata begini hasilnya: https://t.co/vbYhuNaSHx",6,1,2,0,2022-01-25,6,Tuesday,2,8,1
1485855160475729921,2022-01-25 06:00:50,"Menko Marves Luhut Binsar Pandjaitan mengatakan bahwa varian Omicron di Indonesia masih terkendali dibandingkan varian Delta. Oleh karena itu, pemerintah disebut belum kepikiran menerapkan PPKM darurat atau lockdown. https://t.co/7gfG5EvY3L",10,6,1,0,2022-01-25,6,Tuesday,2,11,6
1485854678030204928,2022-01-25 05:58:55,Seiring meningkatnya COVID-19 varian Omicron mengharuskan kita untuk tetap menjaga sistem kekebalan tubuh. Hal ini bisa didapatkan dengan minuman sehat ini.  https://t.co/shRSFW1K5F,6,0,2,1,2022-01-25,5,Tuesday,2,8,1
1485854349297344512,2022-01-25 05:57:37,"Arsenal dikabarkan meminati Renato Sanches untuk memperkuat lini tengah,  Gelandang Portugal itu buka suara soal kans menjajal tantangan baru lagi. https://t.co/43q4jf9G55",4,1,0,1,2022-01-25,5,Tuesday,2,4,2
1485854146704125956,2022-01-25 05:56:49,"Tol Cisumdawu resmi beroperasi pukul 06.00 WIB pagi, diharapkan dengan adanya penambahan jalur bebas hambatan ini bisa membantu perekonomian wilayah Jawa Barat. https://t.co/KVKtY9saWQ",10,0,6,1,2022-01-25,5,Tuesday,2,16,1
1485853804247625730,2022-01-25 05:55:27,"Fiorentina membuka pintu untuk klub yang meminati Dusan Vlahovic menyusul tawaran dari Arsenal dan Juventus. Tapi, agen sang pemain susah diajak bicara. https://t.co/YUvGgDwe0H",5,0,0,0,2022-01-25,5,Tuesday,2,5,0
1485853288272732160,2022-01-25 05:53:24,"Sebanyak 76 pegawai yang terkena rotasi secara sepihak seolah ""mati kutu"". Dengan status sebagai ASN dan tanpa Wadah Pegawai KPK, berat melakukan perlawanan. #detikX https://t.co/8soSGo4dpU",6,0,3,1,2022-01-25,5,Tuesday,2,9,1
1485853276910329856,2022-01-25 05:53:21,Siomay ayam termasuk jenis dimsum paling favorit. Bisa dimakan hangat atau digoreng kering. Tentu saja perlu dicocol dengan saus cabe yang gurih dan harum.  https://t.co/mx4AwrPgpu,15,1,0,1,2022-01-25,5,Tuesday,2,15,2
1485851363426947076,2022-01-25 05:45:45,"Emma Waroka dan Kim Hawt membuat laporan ke Polda Metro Jaya, Senin (24/1). Laporan itu dilakukan lantaran dua akun media sosial mereka hilang dan diretas. https://t.co/sN47DM7df4",10,5,0,1,2022-01-25,5,Tuesday,2,10,6
1485851340349841410,2022-01-25 05:45:39,KPK memanggil Ketua DPRD Kota Bekasi. Dia akan diperiksa sebagai saksi di kasus dugaan suap yang menjerat Wakot Bekasi nonaktif Rahmat Effendi. https://t.co/H2sVJ6seTm,2,0,0,0,2022-01-25,5,Tuesday,2,2,0
1485851082165215235,2022-01-25 05:44:38,"Putri Nurul Arifin, Maura Magdalina, meninggal dunia di usia 27 tahun. Disebutkan penyebab meninggalnya adalah serangan jantung. Kenali penyakit mematikan ini. https://t.co/pnnKIjzNpp",50,4,13,2,2022-01-25,5,Tuesday,2,63,6
1485850824131719169,2022-01-25 05:43:36,Emma Waroka dan Kim Hawt baru saja kehilangan media sosial mereka. Baik Emma maupun Kim tak mau menuduh siapa pun. https://t.co/cy4wjavs6l,3,1,0,0,2022-01-25,5,Tuesday,2,3,1
1485850606283763713,2022-01-25 05:42:44,"Putra mantan Gubernur BI Agus Martowardojo, Adri Martowardojo menceritakan soal privilege yang dia dapat selama ini. Serta bagaimana kehidupannya setelah menikah. Penasaran seperti apa? Saksikan video HotQuestions berikut: https://t.co/S4USKG7zrn",4,0,0,0,2022-01-25,5,Tuesday,2,4,0
1485850578299326466,2022-01-25 05:42:38,Dumpling merupakan salah satu makanan wajib yang jadi suguhan imlek. Kali ini pangsit berbentuk kantong lambang melimpahnya rejeki di tahun baru.  https://t.co/66aFOF6ko6,9,1,0,0,2022-01-25,5,Tuesday,2,9,1
1485850050660077570,2022-01-25 05:40:32,"Selain digunakan sebagai bumbu masakan, bawang bombai juga bisa membersihkan hingga menghilangkan bau tak sedap di dapur.  https://t.co/AnNvTVZq9e",5,0,2,0,2022-01-25,5,Tuesday,2,7,0
1485849591757082626,2022-01-25 05:38:43,Ketua DPRD Sumut Baskami Ginting mengomentari kerangkeng manusia di rumah Bupati Langkat. Baskami menilai kepolisian kecolongan. https://t.co/MtCIMx4DWi,43,16,6,5,2022-01-25,5,Tuesday,2,49,21
1485849583154569216,2022-01-25 05:38:41,Tahu goreng isi perkedel ini merupakan makanan khas Malaysia. Isiannya perkedel yang empuk dan bagian luarnya renyah gurih. Makin enak dimakan hangat.  https://t.co/DOQxQMl1Hc,9,0,5,0,2022-01-25,5,Tuesday,2,14,0
1485849243969540097,2022-01-25 05:37:20,Vivian Hsu sempat dituding jadi selingkuhan Wang Leehom oleh mantan istrinya. Kini ia seolah menyerang balik lewat lagunya.  https://t.co/b0es8IfVhd,4,0,0,0,2022-01-25,5,Tuesday,2,4,0
1485847825778987011,2022-01-25 05:31:42,"Makan seafood di warung pinggir jalan, wanita ini merasa harganya digetok. Seporsi ikan bakar kerapu dibanderol seharga Rp 130.000!  https://t.co/WSBb2xIeqW",113,105,26,20,2022-01-25,5,Tuesday,2,139,125
1485847595910107140,2022-01-25 05:30:47,Riset terbaru oleh peneliti Oxford menemukan penerima vaksin COVID-19 Sinovac dapat memiliki peningkatan antibodi signifikan dari tiga jenis vaksin booster. Apa saja? https://t.co/xF8RvwXszX,23,0,4,0,2022-01-25,5,Tuesday,2,27,0
1485847574460440581,2022-01-25 05:30:42,Pengadilan Negeri Tangerang menggelar sidang kasus investasi tabung tanah yang melibatkan Ustaz Yusuf Mansur. Sidang yang beragendakan mediasi itu harus ditunda.  https://t.co/WYIogVSuCM,3,1,2,0,2022-01-25,5,Tuesday,2,5,1
1485847349750550529,2022-01-25 05:29:48,"Di Instagram, ada akun khusus yang mengungga makanan-makanan yang berantakan. Ada taco yang sudah digigit hingga pancake dengan topping permen yang aneh.  https://t.co/XGQ8uOHEFe",5,0,1,1,2022-01-25,5,Tuesday,2,6,1
1485847333090869249,2022-01-25 05:29:44,"Tren makanan plant-based atau nabati semakin digemari. Jamur jadi salah satu menu favorit. Ternyata selain enak, makan jamur juga punya manfaat sehat ini.  https://t.co/9bCIj5MOuU",4,0,1,0,2022-01-25,5,Tuesday,2,5,0
1485846795439718400,2022-01-25 05:27:36,"Jenazah putri Nurul Arifin sudah disemayamkan di rumah duka di kawasan Puri Cinere, Depok, Jawa Barat. Nurul Arifin tampak tegar duduk di samping peti jenazah putrinya tersebut. https://t.co/ERbe3X0pjP",15,1,2,0,2022-01-25,5,Tuesday,2,17,1
1485846539914432514,2022-01-25 05:26:35,"Ada banyak cara untuk merayakan gol. Yang satu ini rasa-rasanya paling syahdu, yakni mencium tangan ibu! https://t.co/WSioOFnX51",9,0,1,0,2022-01-25,5,Tuesday,2,10,0
1485846355503370242,2022-01-25 05:25:51,Tepat di kaki Gunung Ijen terdapat destinasi wisata Sendang Seruni. Kolam ini dialiri 7 sumber mata air yang jernih dan alami. Tertarik mencoba berendam? https://t.co/lm6n6CJAfk,8,0,0,0,2022-01-25,5,Tuesday,2,8,0
1485846322351591426,2022-01-25 05:25:43,"Kini, inovasi tumpeng juga hadir dalam bentuk lebih kecil yang umum dikenal sebagai tumpeng mini.  https://t.co/amyGiqTvxk",6,0,1,0,2022-01-25,5,Tuesday,2,7,0
1485845997351804928,2022-01-25 05:24:26,Yamaha FZS 250 versi 2022 tampilannya jadi lebih keren mirip motor touring dengan aplikasi visor tinggi dan pelindung tangan. https://t.co/1wc11BEZYM,10,0,0,0,2022-01-25,5,Tuesday,2,10,0
1485845974530547714,2022-01-25 05:24:20,"Aprilio Manganang, eks pemain timnas voli putri mengumumkan pertunangannya dengan Claudya. Ini kata Claudya, sang tunangan:  https://t.co/0sfCCOcTeV",14,1,1,0,2022-01-25,5,Tuesday,2,15,1
1485845397977374720,2022-01-25 05:22:03,"Provinsi di China akan memberikan warganya sejumlah uang jelang Tahun Baru Imlek, agar mereka tak bepergian ke luar kota. https://t.co/fm8UO5JOOr",10,1,5,0,2022-01-25,5,Tuesday,2,15,1
1485845091461877762,2022-01-25 05:20:50,"Maura Magnalia Madyaratri, putri Nurul Arifin meninggal dunia. Begini suasana di rumah duka:  https://t.co/apxahXgkU3",6,1,2,0,2022-01-25,5,Tuesday,2,8,1
1485845061753622528,2022-01-25 05:20:43,"Barbeque identik dengan mahal, namun di Bogor ada tempat makan BBQ murah meriah. Cukup Rp 25 ribu sudah bisa menikmati sensasi bakar-bakaran di ruang terbuka. https://t.co/KfHiNx3GJd",5,0,1,0,2022-01-25,5,Tuesday,2,6,0
1485843624034197505,2022-01-25 05:15:00,"Hai detikers, yuk buka aplikasi detikcom sekarang atau kamu menyesal! Ini merupakan hari terakhir detikers bisa mendapatkan Macbook Air, Samsung S20 FE, hingga emas lho.

Buat detikers yang belum mendownload, temukan aplikasi detikcom di Google Play dan App Store https://t.co/UNa8Z7e4Xq",5,1,0,0,2022-01-25,5,Tuesday,2,5,1
1485843322270887938,2022-01-25 05:13:48,"Berikut daftar gunung api purba di Gunungkidul, Yogyakarta bertambah panjang,  saat ini ada lima gunung api purba di sana. https://t.co/6ZB6NiW5xW",31,2,1,1,2022-01-25,5,Tuesday,2,32,3
1485843295590916098,2022-01-25 05:13:41,"Tak hanya dalam hal fashion, untuk menjaga kesehatannya Amanda Manopo tak mau setengah-setengah. Manda pakai masker anti Corona ini:  https://t.co/3S7Wu4a7oW",6,2,1,0,2022-01-25,5,Tuesday,2,7,2
1485843063620710400,2022-01-25 05:12:46,"Maura Magnalia Madyaratri, putri Nurul Arifin meninggal dunia di rumahnya karena jantung. Maura ditemukan sudah tak bernapas di meja makan. https://t.co/Z4HXWYvvux",7,0,0,1,2022-01-25,5,Tuesday,2,7,1
1485842794359009281,2022-01-25 05:11:42,"Gejala Omicron mirip flu biasa. Meski gejala relatif lebih ringan dibanding varian Corona lain, jangan santai dulu. Ini yang dikhawatirkan terjadi di Indonesia. https://t.co/nptwOEtMpG",10,2,2,1,2022-01-25,5,Tuesday,2,12,3
1485842229554036737,2022-01-25 05:09:27,Politisi Golkar Dedi Mulyadi menilai pro dan kontra dari IKN Nusantara hal yang wajar. Begini tanggapannya. https://t.co/i4mqfg8BnO,14,3,3,0,2022-01-25,5,Tuesday,2,17,3
1485841365229608964,2022-01-25 05:06:01,"COVID-19 RI melonjak kembali akibat cepatnya penyebaran varian Omicron. Lantas, masker seperti apa yang paling ampuh melindungi dari paparan Omicron? https://t.co/7VhOZwfvc2",8,1,3,0,2022-01-25,5,Tuesday,2,11,1
1485841343742160896,2022-01-25 05:05:56,Banyuwangi punya kuliner ekstrem yang cocok dikonsumsi pria dan bapak-bapak. Inilah sup tawon yang diyakini membuat pria makin jantan usai mengonsumsinya.  https://t.co/D1dkuzzOtT,5,4,3,1,2022-01-25,5,Tuesday,2,8,5
1485841053383118848,2022-01-25 05:04:47,"Resmi melamar kekasihnya, Aprilio Manganang siap menjalani hubungan yang lebih serius. Begini gayanya saat asyik minum kopi hingga makan pisang.  https://t.co/a8bPHmUR4d",4,1,1,0,2022-01-25,5,Tuesday,2,5,1
1485840770603130883,2022-01-25 05:03:39,"Warga sempat dihebohkan dengan penemuan mayat pria bertato tersangkut di Sungai Ciwulan, Tasikmalaya, Sabtu (22/1). Pihak kepolisian saat ini telah berhasil mengidentifikasi mayat tersebut. https://t.co/0QpmJM9Ul7",2,2,0,0,2022-01-25,5,Tuesday,2,2,2
1485840751384748034,2022-01-25 05:03:35,"Matthew White, aktor cilik pemain film Danur meninggal dunia pada Minggu (23/01/22). Berikut ini kenangannya almarhum bersama keluarga dan rekan sesama artis.  https://t.co/J06LgLC6EK",10,0,1,0,2022-01-25,5,Tuesday,2,11,0
1485840063586045953,2022-01-25 05:00:51,WithU Yamaha RNF menggantikan posisi Petronas SRT yang sebelumnya menjadi sponsor utama tim satelit MotoGP Yamaha. https://t.co/f7UTzhib17,10,0,3,0,2022-01-25,5,Tuesday,2,13,0
1485839741576794112,2022-01-25 04:59:34,Sekolah tatap muka tetap berlanjut dengan status Jakarta PPKM level 2 dan kasus Omicron yang belum surut. Berikut aturan PTM untuk siswa dan guru di Jakarta.  https://t.co/A242maOxcq,5,1,1,0,2022-01-25,4,Tuesday,2,6,1
1485839715123314690,2022-01-25 04:59:28,"Penampakan arca Agung Maha Patih Gajah Mada di Wisata Desa Bumi Mulyo Jati Mojopahit, Mojokerto dikritik menjadi artikel terpopuler kemarin. https://t.co/fNmFN1wDRq",0,0,2,0,2022-01-25,4,Tuesday,2,2,0
1485839177979768833,2022-01-25 04:57:20,Tarif listrik nonsubsidi bakal naik tahun ini. Ini golongan listrik yang tarifnya bisa naik tahun ini.  https://t.co/R4KfGP46dv,4,4,4,3,2022-01-25,4,Tuesday,2,8,7
1485839176973099012,2022-01-25 04:57:20,Berumah tangga jangan hanya mencari pasangan berparas menawan atau harta. Kata Ustaz cinta itu tulus tanpa alasan… https://t.co/lBdQPUUmK5,11,3,1,1,2022-01-25,4,Tuesday,2,12,4
1485838829118439425,2022-01-25 04:55:57,Akun Instagram Ketua Umum PSI Giring Ganesha mendadak hilang. Hilangnya akun instagram Giring dibenarkan Juru bicara PSI Sigit Widodo. https://t.co/9T09N2PGIg,4,3,0,3,2022-01-25,4,Tuesday,2,4,6
1485838560884408320,2022-01-25 04:54:53,"Adri Marto bercerita tentang banyak hal dari hidupnya. Seperti apa dia dibesarkan, merantau ke Australia hingga pandangannya atas privilese. Simak di #HotQuestions  https://t.co/zqwQjraqrn",1,0,0,0,2022-01-25,4,Tuesday,2,1,0
1485838533461950464,2022-01-25 04:54:46,"Lionel Messi terbang ke Barcelona untuk makan malam bersama Xavi Hernandez. Saat diserbu awak media, Messi hanya diam saja. https://t.co/HXJ8sqYbyu",2,0,1,0,2022-01-25,4,Tuesday,2,3,0
1485838254767329284,2022-01-25 04:53:40,Sebagian orang berjerawat usai minum kopi. Ternyata ada alasan di baliknya. Hal ini bisa dihindari dengan melakukan beberapa hal sederhana.  https://t.co/7K0lfar5LG,2,0,1,0,2022-01-25,4,Tuesday,2,3,0
1485837910893076480,2022-01-25 04:52:18,"Emmanuel Adebayor, mengomentari situasi yang dialami Pierre-Emerick Aubameyang dan menilai The Gunners enggan memaafkan striker Gabon itu. https://t.co/tAOqXZu56J",1,0,0,0,2022-01-25,4,Tuesday,2,1,0
1485837895026065411,2022-01-25 04:52:14,Berikut rekomendasi kendaraan yang cocok digunakan untuk dijadikan armada taksi online. https://t.co/gSCD5MyDkD,2,0,0,0,2022-01-25,4,Tuesday,2,2,0
1485837300093358080,2022-01-25 04:49:52,"Sebelum akun Instagram miliknya hilang, Giring diketahui sempat mengunggah postingan menyindir soal Firaun. #GiringGanesha https://t.co/BJwjEXF7Ud",27,7,0,0,2022-01-25,4,Tuesday,2,27,7
1485837275099500551,2022-01-25 04:49:46,Pelatih Timnas Sepakbola Wanita sebut timnas Wanita seperti bayi yang baru lahir. Para pemain tak banyak pengalaman di liga profesional. https://t.co/1h1FQfJThI,6,0,1,0,2022-01-25,4,Tuesday,2,7,0
1485836729500192769,2022-01-25 04:47:36,Leonardo Bonucci membandingkan Serie A dengan Premier League dan menyatakan bahwa ritme di Liga Inggris lebih tinggi. https://t.co/6wBumig0vY,4,1,1,0,2022-01-25,4,Tuesday,2,5,1
1485836703004778503,2022-01-25 04:47:30,Luhut Pandjaitan meminta para investor tidak ragu menyuntikkan uangnya pada proyek-proyek yang ada di Indonesia.  https://t.co/9fYZJUUb3c,5,2,1,4,2022-01-25,4,Tuesday,2,6,6
1485836394073309185,2022-01-25 04:46:16,Apakah resolusi 2022 kamu memiliki badan ideal? Coba jus ini yang cocok diminum pagi hari untuk diet: https://t.co/a4mz5Qg5nA,8,0,2,1,2022-01-25,4,Tuesday,2,10,1
1485836363748491264,2022-01-25 04:46:09,"Menyusul kesuksesan Squid Game, Netflix akan menayangkan sejumlah drama Korea garapannya di tahun 2022. Ini daftarnya:  https://t.co/yCvcR7p23b",5,0,0,0,2022-01-25,4,Tuesday,2,5,0
1485836075775971329,2022-01-25 04:45:00,"Dinas PUPR Kota Depok, Jawa Barat, mengaku sudah mengangkut batang pohon sisa penebangan di Jalan Kalimulya. https://t.co/rpJk3ZwVwP",5,0,0,0,2022-01-25,4,Tuesday,2,5,0
1485836054355660800,2022-01-25 04:44:55,Harga emas hari ini mulai naik. Harga emas Antam 24 karat hari ini turun Rp 3.000 per gram menjadi Rp 947.000 per gram.  https://t.co/4NJVNk4Wfh,2,0,4,0,2022-01-25,4,Tuesday,2,6,0
1485835685517041664,2022-01-25 04:43:27,"Komisi VI DPR RI menggelar rapat kerja bersama dengan Menteri BUMN Erick Thohir hari ini, Selasa (25/1/2022).  https://t.co/2aPT2ktuf8",2,0,2,0,2022-01-25,4,Tuesday,2,4,0
1485835191428030468,2022-01-25 04:41:29,"Tol Cileunyi Sumedang Dawuan seksi 1 ruas Cileunyi-Pamulihan mulai beroperasi hari ini. Namun di hari pertama beroperasi, arus lalu lintas masih cukup lengang.  https://t.co/FPFosXlGvR",5,1,2,0,2022-01-25,4,Tuesday,2,7,1
1485834538576138241,2022-01-25 04:38:54,Dua orang ditemukan tewas mengenaskan di ruas Tol Ngawi Kertosono KM 622.200 A. Keduanya diduga menjadi korban tabrak lari. https://t.co/ZQdv8nVQkr,10,0,2,3,2022-01-25,4,Tuesday,2,12,3
1485834448289607684,2022-01-25 04:38:32,"Putri Nuurul Arifin, Maura Magnalia Madyaratri meninggal dunia. Maura meninggal karena serangan jantung.  https://t.co/i2GLV2or2Y",33,12,16,16,2022-01-25,4,Tuesday,2,49,28
1485834228021530624,2022-01-25 04:37:40,"""Diharapkan nanti dapat dipertimbangkan jadi Jalan Tol Ali Sadikin sebagai tokoh Jawa Barat yang luar biasa, semoga dapat pertimbangan dari bapak Menteri PUPR,"" jelas Ridwan Kamil  https://t.co/KER3CiqwxH",2,13,0,17,2022-01-25,4,Tuesday,2,2,30
1485834226821967873,2022-01-25 04:37:39,"Varian Omicron mulai berpengaruh pada penerbangan di dunia, berbagai maskapai terpaksa menerbangkan pesawat yang sepi penumpang. Bahkan hampir kosong! https://t.co/vmECYruWli",2,0,2,0,2022-01-25,4,Tuesday,2,4,0
1485833686004244481,2022-01-25 04:35:30,"Premier League telah menunda 21 laga musim ini akibat COVID-19. Keputusan tersebut menuai kritikan, karena dianggap menahan kesempatan bagi pemain muda. https://t.co/GJRRUmtIr2",6,0,1,1,2022-01-25,4,Tuesday,2,7,1
1485833672427294723,2022-01-25 04:35:27,Sekitar 1.400 pegawai PT Bank KB Bukopin mengundurkan diri pada akhir 2021 lalu. Apa yang terjadi?  https://t.co/Yrd2i4C63P,8,1,4,0,2022-01-25,4,Tuesday,2,12,1
1485833414876049408,2022-01-25 04:34:26,"Harga Bitcoin melonjak. Kenaikannya mencapai 2,5% menjadi US$ 37.250 atau Rp 533,6 juta (kurs Rp 14.327).  https://t.co/3EdXgQ6bNL",3,0,4,0,2022-01-25,4,Tuesday,2,7,0
1485833104266833920,2022-01-25 04:33:12,Inmendagri PPKM terbaru kembali diterbitkan seiring diperpanjangnya PPKM di Jawa dan Bali. Berikut isi lengkap aturannya.  https://t.co/bApY6cD1E9,2,1,1,1,2022-01-25,4,Tuesday,2,3,2
1485832751777468418,2022-01-25 04:31:48,Kurs dolar Amerika Serikat (AS) terhadap rupiah pagi ini kembali menguat!  https://t.co/VDmEpvfad7,2,0,0,0,2022-01-25,4,Tuesday,2,2,0
1485832426819670017,2022-01-25 04:30:30,Nicolas Tagliafico ingin pindah ke Barcelona dan berharap Ajax Amsterdam mau mengabulkan keinginannya. https://t.co/hdNFXgjzTh,2,1,0,0,2022-01-25,4,Tuesday,2,2,1
1485831925046648834,2022-01-25 04:28:31,"""Dear My Princess Maura, just can't understand, why you gone so soon.. I'll miss you in every second. You are light of my life,"" tulis Nurul Arifin. #MauraMagnalia #NurulArifin https://t.co/j6sd7dGuSc",277,28,35,12,2022-01-25,4,Tuesday,2,312,40
1485831902057668610,2022-01-25 04:28:25,Korlantas Polri memastikan perubahan warna pelat kendaraan menjadi putih yang terpasang chip berupa radio frequency identification (RFID) dimulai pada 2023. https://t.co/LDXrmfKgdN,10,3,2,2,2022-01-25,4,Tuesday,2,12,5
1485831338989166597,2022-01-25 04:26:11,Pertemuan itu untuk menandatangani kesepakatan mengenai penyesuaian flight information region (FIR) atau pengelolaan wilayah udara.  https://t.co/nkqCwipPxl,4,0,3,1,2022-01-25,4,Tuesday,2,7,1
1485831200740683787,2022-01-25 04:25:38,Aksi taruhan short-selling mewarnai bursa efek Amerika Serikat awal tahun ini. Mereka bertaruh pada saham Tesla dan Netflix sampai Rp 50 T!  https://t.co/9xFmPCmCgA,3,1,1,0,2022-01-25,4,Tuesday,2,4,1
1485830655523102720,2022-01-25 04:23:28,"Vespa selalu memiliki tempat tersendiri di masyarakat Indonesia. Seolah tak lekang oleh zaman, eksistensi Vespa masih bertahan hingga saat ini. https://t.co/9bzNCDdOqD",7,2,2,0,2022-01-25,4,Tuesday,2,9,2
1485830633863716867,2022-01-25 04:23:23,"Dear Leo, hilangkan segala beban yang ada di pundak dengan selalu berlaku jujur dan tanggung jawab. Simak ramalan zodiak hari ini: https://t.co/hXKxgUqKbo",5,0,3,1,2022-01-25,4,Tuesday,2,8,1
1485830368137728004,2022-01-25 04:22:19,"Sebuah kerangkeng manusia ditemukan di rumah Bupati Langkat, Terbit Rencana Perangin Angin usai terkena OTT KPK. Hartanya juga jadi sorotan!  https://t.co/2vadBfcExo",41,5,13,6,2022-01-25,4,Tuesday,2,54,11
1485830353898123269,2022-01-25 04:22:16,"OJK dengan tegas telah melarang lembaga jasa keuangan untuk menggunakan, memasarkan, dan/atau memfasilitasi perdagangan aset kripto!  https://t.co/9MT7YEQFeO",2,0,2,1,2022-01-25,4,Tuesday,2,4,1
1485830342120558594,2022-01-25 04:22:13,Robert Lewandowski terus unjuk ketajaman di depan gawang lawan. Akankah Lewandowski melebihi rekornya di musim lalu? https://t.co/thSqmHIfoP,7,0,0,0,2022-01-25,4,Tuesday,2,7,0
1485829963928453128,2022-01-25 04:20:43,"Prestasi Alfiansyah (13), pelajar asal Kota Pasuruan di olahraga renang sangat moncer. Siswa SMPN 8 ini langganan medali kejuaraan tingkat nasional. Keren! https://t.co/XIKC83m4av",12,1,4,0,2022-01-25,4,Tuesday,2,16,1
1485829934362808323,2022-01-25 04:20:36,Indeks Harga Saham Gabungan (IHSG) pada pagi ini belum beranjak dari zona merah. IHSG melemah sama dengan perdagangan kemarin.  https://t.co/p42rFUbKAm,5,0,0,0,2022-01-25,4,Tuesday,2,5,0
1485829315459792899,2022-01-25 04:18:08,Anthony Martial dilaporkan bakal hengkang dari Manchester United ke Sevilla dengan status pinjaman pada bursa transfer musim dingin ini. https://t.co/I12Q7xJu8N,26,0,2,1,2022-01-25,4,Tuesday,2,28,1
1485828481829199879,2022-01-25 04:14:50,"Inilah daftar paspor yang benar-benar sakti. Karena, berkas ini yang mampu membuka semua pintu negara. https://t.co/oATqHpHzDa",12,0,2,0,2022-01-25,4,Tuesday,2,14,0
1485827738615402499,2022-01-25 04:11:52,Donnie Yen mengucapkan doa pada ulangtahun putrinya yang ke-18. Ia ngaku bangga dengan gadisnya yang kini beranjak remaja.  https://t.co/89akRTB7V8,13,1,1,0,2022-01-25,4,Tuesday,2,14,1
1485826966200754176,2022-01-25 04:08:48,TMII sedang berbenah dan segera memperlihatkan wajah barunya Oktober! https://t.co/MTuwgHS48h,8,0,1,1,2022-01-25,4,Tuesday,2,9,1
1485826940036599808,2022-01-25 04:08:42,"Menjelang MotoGP Mandalika, hotel bintang 4 di Lombok menghadirkan ballroom baru nan megah. https://t.co/9mzYTmg9WX",10,0,0,0,2022-01-25,4,Tuesday,2,10,0
1485826343099109382,2022-01-25 04:06:20,Indonesia bakal meneken perjanjian ekstradisi dengan Singapura. Perjanjian ini diyakini bisa bikin koruptor ketar-ketir. https://t.co/LEtaPahRFS,159,42,36,9,2022-01-25,4,Tuesday,2,195,51
1485826327840235520,2022-01-25 04:06:16,Berikut aturan perjalanan selama PPKM Level 2 berlaku di Jabodetabek periode 25-31 Januari 2022. https://t.co/IhyRGamUMD,8,0,1,0,2022-01-25,4,Tuesday,2,9,0
1485826065700466689,2022-01-25 04:05:14,Korps Lalu Lintas Polri akan mengubah model pelat nomor kendaraan bermotor milik sipil di Indonesia menjadi warna putih dan dipasangi chip berteknologi RFID. https://t.co/CTPjanNvJX,16,3,3,2,2022-01-25,4,Tuesday,2,19,5
1485825561842884609,2022-01-25 04:03:13,"Mak Unah yang tinggal di rumah reyot menyatu dengan kandang ayam, bertemu langsung dengan Presiden Jokowi. Begini kisahnya.... https://t.co/ag1xvlokdL",29,4,1,2,2022-01-25,4,Tuesday,2,30,6
1485825161437851652,2022-01-25 04:01:38,"Bendahara umum DPC Partai Demokrat Nur Afifah Balqis menjadi tersangka KPK di usia 24 tahun. Diduga terseret kasus suap, gaya hidupnya mengejutkan publik. #detiknetwork  https://t.co/SxaApTR06F",7,2,5,1,2022-01-25,4,Tuesday,2,12,3
1485824178746011648,2022-01-25 03:57:44,"Rachel Vennya kembali ke media sosial. Akan tetapi, Rachel Vennya justru diingatkan netizen soal perbuatan masa lalunya. #RachelVennya  https://t.co/kxmm7uCjBf",6,0,1,0,2022-01-25,3,Tuesday,2,7,0
1485823452737155076,2022-01-25 03:54:51,"Gaga Muhammad resmi ajukan banding setelah divonis 4,5 tahun penjara dan denda Rp 10 juta atas kecelakaan bersama Laura Anna. #GagaMuhammad  https://t.co/aUtAwrT135",13,2,1,4,2022-01-25,3,Tuesday,2,14,6
1485822701344370691,2022-01-25 03:51:51,"Harry Pantja 3 kali terkena stroke, kini diungkapkan sang istri kondisinya makin baik. Sang istri ikhlas menerima kondisi suaminya meski kadang sedih. https://t.co/FjueZMldyb",13,0,2,0,2022-01-25,3,Tuesday,2,15,0
1485821687299981312,2022-01-25 03:47:50,"Lionel Messi terekam kamera berada di Barcelona dan bertemu dengan Xavi Hernandez. Ada apa, nih? https://t.co/o4ugVKKFed",17,0,2,0,2022-01-25,3,Tuesday,2,19,0
1485820935781371904,2022-01-25 03:44:50,"Putri sulung pasangan aktris dan politisi Nurul Arifin, Maura Magnalia Madyaratri meninggal dunia, Selasa (25/1) pagi. Saat dikonfrimasi, Nurul membenarkan kabar tersebut. https://t.co/Sy3eCbqLki",24,0,6,4,2022-01-25,3,Tuesday,2,30,4
1485820435120144384,2022-01-25 03:42:51,Lydia Kandou tahu penyebab Kenang dan Tyna Kanna cerai. Ia pilih tak umbar ke publik. https://t.co/KPRxRktyzP,5,1,2,0,2022-01-25,3,Tuesday,2,7,1
1485819848777256962,2022-01-25 03:40:31,"Lama tak terlihat di layar kaca, Harry Pantja tengah berjuang menghadapi stroke. Sang istri ceritakan kronologinya:  https://t.co/RCqofSIQL8",24,0,3,1,2022-01-25,3,Tuesday,2,27,1
1485818852252467204,2022-01-25 03:36:34,"Tak hanya Telkomsel, XL Axiata juga berencana mematikan layanan 3G. Siap-siap, pelanggan XL Axiata untuk beralih ke jaringan 4G. https://t.co/7n754rZISP",16,5,7,10,2022-01-25,3,Tuesday,2,23,15
1485818070094565376,2022-01-25 03:33:27,"Presenter acara horor Indonesia, Harry Pantja, dikabarkan sedang berjuang untuk sembuh dari penyakit stroke yang dialaminya. Istri Harry Pantja, Imelda Laksmi bercerita kondisi terkini kesehatan suaminya tersebut. https://t.co/uR2gw2JQMp",18,2,2,0,2022-01-25,3,Tuesday,2,20,2
1485817339035758592,2022-01-25 03:30:33,"UFO di Indonesia, adakah yang pernah melihatnya? Ternyata sejumlah orang di Tanah Air ngaku pernah jadi saksi mata penamapakan UFO. https://t.co/gj7mOCKVUU",17,6,3,2,2022-01-25,3,Tuesday,2,20,8
1485817080813441024,2022-01-25 03:29:31,Juventus belum memperpanjang kontrak Paulo Dybala hingga kini. Alessandro Del Piero merasa hal tersebut akan sulit terwujud. https://t.co/hiv49MlIFH,17,1,1,1,2022-01-25,3,Tuesday,2,18,2
1485816084477403136,2022-01-25 03:25:34,Enam orang tewas akibat desak-desakan jelang laga babak 16 besar Piala Afrika 2021 antara Kamerun vs Comoros. https://t.co/ceUwFoOysA,10,2,1,1,2022-01-25,3,Tuesday,2,11,3
1485815311316172800,2022-01-25 03:22:29,Penampilan terbaru Ki Joko Bodo jadi sorotan di dunia maya setelah diunggah oleh netizen. Ini penampilan Ki Joko Bodo sekarang:  https://t.co/IHWg7e6JMR,31,4,4,2,2022-01-25,3,Tuesday,2,35,6
1485814215147507713,2022-01-25 03:18:08,"Kabar duka datang dari keluarga Wakil Ketua Umum Partai Golkar Nurul Arifin. Putri Nurul, Maura Magnalia, meninggal dunia. #MauraMagnalia https://t.co/9Kh93L0oaw",161,47,45,9,2022-01-25,3,Tuesday,2,206,56
1485813429722046464,2022-01-25 03:15:01,Bahasianya Mario Balotelli mendapat panggilan untuk kembali memperkuat Timnas Italia. https://t.co/o8fI54YNN4,15,2,0,2,2022-01-25,3,Tuesday,2,15,4
1485813231713144834,2022-01-25 03:14:14,"Kemenkes belum lama ini laporkan kematian 2 pasien Omicron. Meski gejala Omicron relatif ringan, pakar jabarkan 3 kelompok paling rentan jika terkena Omicron. https://t.co/WzgRbTzVcc",19,5,4,0,2022-01-25,3,Tuesday,2,23,5
1485811998407462916,2022-01-25 03:09:20,KPK kembali menggeledah Kantor Dinas Pendidikan Buru Selatan dan kediaman pihak terkait kasus dugaan suap proyek infrastruktur tahun 2011-2016. https://t.co/rpIvedgsQg,14,4,5,0,2022-01-25,3,Tuesday,2,19,4
1485811210918543360,2022-01-25 03:06:12,"2 Kelompok warga terlibat bentrok di Kota Sorong, Papua Barat. 11 Orang dilaporkan tewas dalam pertikaian itu. https://t.co/Zb6qccNDW8",15,2,4,0,2022-01-25,3,Tuesday,2,19,2
1485811209718972416,2022-01-25 03:06:12,"Netflix bakal merilis dokumenter tentang Georgina Rodriguez, kekasih Cristiano Ronaldo. Kabarnya dokumenter itu akan tayang bulan ini. https://t.co/3zzjzSMbue",16,1,3,0,2022-01-25,3,Tuesday,2,19,1
1485810239295438852,2022-01-25 03:02:20,Julia Fox membantah kabar yang menyebutkan jika dia memacari Kanye West hanya demi uang. Ini tanggapan Julia Fox:  https://t.co/HPzsaBpQgQ,10,1,1,1,2022-01-25,3,Tuesday,2,11,2
1485809157898964997,2022-01-25 02:58:02,Tim di balik buku Sultan Agung dalam Goresan S Sudjojono mengatakan demi menyelesaikan naskah buku sampai melakukan riset ke Belanda. https://t.co/dNxkA8l3D8,9,0,2,0,2022-01-25,2,Tuesday,2,11,0
1485807908789047296,2022-01-25 02:53:05,Penambahan kasus Covid-19 harian di DKI Jakarta per Senin (24/1/2022) menyentuh angka 1.993. Menko Luhut pun menyoroti kondisi itu dan mengatakan bahwa level PPKM di Jakarta bisa saja berubah. https://t.co/ZLCaYt3XFn,10,1,3,1,2022-01-25,2,Tuesday,2,13,2
1485806880580644864,2022-01-25 02:48:59,Kisah rumah tangga Ririe Fairus dan Ayus Sabyan terjadi seperti serial Layangan Putus. Mereka bercerai setelah Ayus memilih bersama selingkuhannya. https://t.co/8QUGgYX1LM,30,4,4,1,2022-01-25,2,Tuesday,2,34,5
1485805713155051521,2022-01-25 02:44:21,Adele kena protes salah satu penggemarnya karena mengundur jadwal konser kurang dari 24 jam. #Adele  https://t.co/bFNhNfJQza,12,0,0,0,2022-01-25,2,Tuesday,2,12,0
1485803347311534082,2022-01-25 02:34:57,"Aprilio Manganang, mantan atlet voli yang sempat viral diidentifikasi sebagai wanita, bertunangan. Ini fakta-faktanya: https://t.co/Y0TF0shmEx",15,0,2,1,2022-01-25,2,Tuesday,2,17,1
1485802628676304899,2022-01-25 02:32:06,"Di tengah massa pemotor, ada juga mobil patroli polisi yang ikut mengejar kakek diteriaki maling di Jaktim. Ini penjelasan polisi. https://t.co/QFjasxHYIv",9,2,2,1,2022-01-25,2,Tuesday,2,11,3
1485801288713572353,2022-01-25 02:26:46,Pemerintah mengeluarkan instruksi Menteri Dalam Negeri (Inmendagri) terbaru terkait PPKM. Berikut sejumlah aturan terbarunya: https://t.co/Ivr5FhwgeK,44,19,30,5,2022-01-25,2,Tuesday,2,74,24
1485800083362926593,2022-01-25 02:21:59,"Pendiri Fortescue, Andrew Forrest mengakuisisi perusahaan teknologi dan rekayasa Inggris, Williams Advanced Engineering (WAE)  https://t.co/b6Bc4clZjN",8,1,0,0,2022-01-25,2,Tuesday,2,8,1
1485799052834914310,2022-01-25 02:17:53,Pusat gempa berada 114 kilometer arah barat daya Kabupaten Bantul atau berada di laut dengan kedalaman 12 kilometer. https://t.co/9mf4BOaE1D,6,0,4,0,2022-01-25,2,Tuesday,2,10,0
1485797804874338305,2022-01-25 02:12:56,"Berdasarkan polling yang dibuat pada Senin (24/1) sampai hari ini Selasa (25/1) yang ditutup pukul 08.00, mayoritas pembaca menilai PNS siap pindah ke IKN baru!  https://t.co/lQfk2TNXMj",3,2,2,1,2022-01-25,2,Tuesday,2,5,3
1485797240526577668,2022-01-25 02:10:41,Ekonomi Korea Selatan tumbuh cukup baik tahun lalu. Bank of Korea mencatat produk domestik bruto (PDB) negara itu meningkat 4% selama 2021.  https://t.co/nxSE9y05N8,5,0,0,0,2022-01-25,2,Tuesday,2,5,0
1485796990147563524,2022-01-25 02:09:41,"Prakirawan BMKG melaporkan bibit siklon tropis 91W pengaruhi kondisi cuaca di Indonesia. Simak prakiraan cuaca selengkapnya yang berlaku untuk hari Selasa, 25 Januari 2022. https://t.co/pVK6RSeSYx",1,0,0,0,2022-01-25,2,Tuesday,2,1,0
1485796233839001600,2022-01-25 02:06:41,Sudah siap berubah nih ibu-ibu sekalian?  https://t.co/euBiCKyGFr,7,4,4,2,2022-01-25,2,Tuesday,2,11,6
1485795569453137924,2022-01-25 02:04:03,"Menantu Habib Rizieq Shihab, Habib Hanif Alatas, resmi bebas dari penjara pada Senin kemarin. Begini kondisinya. https://t.co/c82lz7Q6Ej",14,0,1,0,2022-01-25,2,Tuesday,2,15,0
1485793448598941696,2022-01-25 01:55:37,Kapolri Jenderal Listyo Sigit Prabowo meminta maaf jika masih banyak ditemukan pelanggaran yang dilakukan anak buahnya. Sigit menambahkan Polri selalu terbuka terhadap kritik dan pengaduan masyarakat. https://t.co/5ollm6ElTf,17,5,3,2,2022-01-25,1,Tuesday,2,20,7
1485792191037456386,2022-01-25 01:50:37,"Pegiat media sosial Edy Mulyadi bikin heboh dengan pernyataannya soal Kalimantan tempat jin buang anak dan sebut Prabowo macan jadi mengeong. Atas pernyataannya itu, Edy dipolisikan di mana-mana. https://t.co/0Z8xUNU8FU",23,4,3,3,2022-01-25,1,Tuesday,2,26,7
1485790960139264006,2022-01-25 01:45:44,Menparekraf Sandiaga Uno menyebut kawasan Lagoi dan Nongsa di Kepulauan Riau sudah sangat siap untuk menyambut wisatawan dari Singapura. https://t.co/Mi9M2eDhap,4,0,0,1,2022-01-25,1,Tuesday,2,4,1
1485788252820934656,2022-01-25 01:34:58,Emma Waroka dan Kim Hwat buat laporan ke polisi usai akun medsosnya di-banned. Hal itu disebabkan oleh ilegal akses yang dilakukan pihak lain. https://t.co/DynLCSPf8c,7,2,0,1,2022-01-25,1,Tuesday,2,7,3
1485786363488354305,2022-01-25 01:27:28,Rekomendasi saham hari ini mesti diperhatikan baik-baik. Sebab hari ini Indeks Harga Saham Gabungan (IHSG) diprediksi melanjutkan pelemahan.  https://t.co/cgZFEr45RJ,3,0,0,0,2022-01-25,1,Tuesday,2,3,0
1485785108468613121,2022-01-25 01:22:29,Perbaikan besar-besaran bakal dilakukan pada struktur Jalan Tol Trans Sumatera.  https://t.co/HBSngYYenf,11,3,4,0,2022-01-25,1,Tuesday,2,15,3
1485783302657220610,2022-01-25 01:15:18,Sistem trading menggunakan binary option saat ini ramai digunakan. Apa itu?  https://t.co/SNgDrdi02j,6,0,1,0,2022-01-25,1,Tuesday,2,7,0
1485782056101679108,2022-01-25 01:10:21,Perbandingan UMP di Jakarta yang tertinggi dengan Jawa Tengah yang terendah memiliki perbedaan yang cukup jauh.  https://t.co/rBKOpeaEcv,12,6,1,1,2022-01-25,1,Tuesday,2,13,7
1485781314221580292,2022-01-25 01:07:24,"Jalan Tol Cileunyi Sumedang Dawuan atau Tol Cisumdawu seksi 1 ruas Cileunyi-Pamulihan mulai beroperasi hari ini, Selasa (25/1) pukul 06.00 WIB  https://t.co/qkjWLVpk5C",14,1,2,2,2022-01-25,1,Tuesday,2,16,3
1485780828294627329,2022-01-25 01:05:28,Pernyataan Menaker Ida Fauziyah terkait upah minimum Indonesia ketinggian diungkit di DPR. Ida mengaku dilema karena harus adil bagi pengusaha dan pekerja.  https://t.co/43x2YC3bgi,12,12,1,1,2022-01-25,1,Tuesday,2,13,13
1485780815845990401,2022-01-25 01:05:25,"Jokowi mengungkap, nilai impor LPG Indonesia bahkan menyentuh angka Rp 80 triliun.  https://t.co/jhw6KJelBA",21,7,6,3,2022-01-25,1,Tuesday,2,27,10
1485779711905222665,2022-01-25 01:01:02,Masyarakat bisa mengganti pelat kendaraanya dari warna hitam menjadi putih tanpa menunggu masa berlaku TNKB habis https://t.co/aRQk6mwcox,17,2,4,1,2022-01-25,1,Tuesday,2,21,3
1485779225869262850,2022-01-25 00:59:06,Ridwan Kamil (RK) mencuit soal IKN Nusantara di tengah namanya masuk dalam bursa kepala otorita. PKS menilai Ridwan Kamil layak memimpin IKN Nusantara. https://t.co/vh4FbLb7l2,38,97,4,25,2022-01-25,0,Tuesday,2,42,122
1485779210832650241,2022-01-25 00:59:02,Panglima TNI Jenderal Andika Perkasa menyampaikan soal proyeksi pertahanan di Ibu Kota Negara. Andika menyebut akan membantu maksimalkan jika sudah ada arahan. https://t.co/N97Zewl8KT,14,0,2,0,2022-01-25,0,Tuesday,2,16,0
1485778714784845826,2022-01-25 00:57:04,Perubahan pelat dasar hitam tulisan putih menjadi pelat dasar putih tulisan hitam tidak dipungut biaya. Ini alasannya https://t.co/3J5kXWkDV5,21,4,5,1,2022-01-25,0,Tuesday,2,26,5
1485778464452055041,2022-01-25 00:56:05,Salah satu film Indonesia yang sukses di era pandemi Corona adalah Makmum 2 yang mendapatkan 1 juta lebih penonton. Sandiaga Uno pertanyakan hal ini:  https://t.co/DjK98S1I9U,6,0,0,1,2022-01-25,0,Tuesday,2,6,1
1485778228111360007,2022-01-25 00:55:08,"Lokasi vaksin booster COVID-19 bisa dilakukan dengan bantuan Google Maps. Dapat atau tidak, itu soal lain. Ini pengalaman cari lokasi dengan bantuan teknologi. https://t.co/sgHkGBdpJM",5,0,1,1,2022-01-25,0,Tuesday,2,6,1
1485777976440537097,2022-01-25 00:54:08,Kapolres Dompu AKBP Iwan Hidayat menonaktifkan oknum polisi yang diduga melakukan pemerasan kepada beberapa keluarga tersangka di Polres Dompu. https://t.co/KjVBvKUNFc,7,0,1,1,2022-01-25,0,Tuesday,2,8,1
1485777480178966536,2022-01-25 00:52:10,"Idul Fitri 2022/1443 H kembali dirayakan para muslim di Indonesia dan dunia. Jika dihitung mundur, berapa hari lagi perayaan Lebaran dan puasa Ramadhan? https://t.co/ln1XZ3rmHe",138,18,29,6,2022-01-25,0,Tuesday,2,167,24
1485777229158232064,2022-01-25 00:51:10,Nicolas Tagliafico ingin pindah ke Barcelona. Bek asal Argentina itu berharap Ajax Amsterdam mau mengabulkan keinginannya. https://t.co/VukApvNWYJ,8,1,1,0,2022-01-25,0,Tuesday,2,9,1
1485776975511887874,2022-01-25 00:50:10,WHO merekomendasikan pengurangan dosis vaksin COVID-19 Pfizer untuk anak. Booster untuk usia 12 tahun ke bawah dinilai masih belum dibutuhkan. https://t.co/dZjIkMoS1v,2,0,2,0,2022-01-25,0,Tuesday,2,4,0
1485776492483297280,2022-01-25 00:48:14,"Varian Omicron di Indonesia disebut masih terkendali. Oleh karena itu, pemerintah belum kepikiran menerapkan PPKM darurat atau lockdown. https://t.co/3jX6umLhTT",15,2,3,3,2022-01-25,0,Tuesday,2,18,5
1485776239654748163,2022-01-25 00:47:14,Sebanyak 12 ribu tenaga honorer Pemkot Makassar bakal beralih status menjadi pegawai pemerintah dengan perjanjian kerja (PPPK). https://t.co/FRkH3aPKP8,18,1,5,0,2022-01-25,0,Tuesday,2,23,1
1485775992937451524,2022-01-25 00:46:15,"Polres Merauke, Papua mengungkap kasus pemerkosaan di bawah umur. Pelaku mengancam korbannya dengan granat agar tak melaporkan tindakan bejatnya tersebut. https://t.co/05lvzKGWMW",2,0,2,1,2022-01-25,0,Tuesday,2,4,1
1485775460659351564,2022-01-25 00:44:08,"Steven Gerrard ditanya, siapa rekan terbaik di Liverpool semasa bermain dulu. Gerrard ternyata, lebih pilih Luis Suarez dibanding Fernando Torres! https://t.co/slxL8mmpe2",2,0,1,0,2022-01-25,0,Tuesday,2,3,0
1485775211949608961,2022-01-25 00:43:09,Komisi II DPR RI menyetujui Pemilu dilaksanakan 14 Februari 2024. Perludem mengatakan memang sudah saatnya tanggal pencoblosan diketok palu. https://t.co/snvApQcQ0T,7,0,5,1,2022-01-25,0,Tuesday,2,12,1
1485774963789418502,2022-01-25 00:42:10,"Bos UFC, Dana White, mengungkapkan kondisi terkini Conor McGregor. Dia menyebut The Notorious mulai pulih dan diharapkan comeback musim panas ini. https://t.co/ItePSo9K9l",5,1,2,0,2022-01-25,0,Tuesday,2,7,1
1485772962963894276,2022-01-25 00:34:13,"Wilayah Jabodetabek berada di level 2 PPKM hingga sepekan ke depan. Sejumlah pembatasan berlaku dalam kegiatan sehari-hari, termasuk untuk bepergian ke mal. https://t.co/hlcfv4kAZg",1,1,2,2,2022-01-25,0,Tuesday,2,3,3
1485772515523940355,2022-01-25 00:32:26,Ada yang berbeda dengan keluhan pasien COVID-19 Omicron ketimbang Delta. Ini gejala COVID-19 nomor satu yang dikeluhkan pasien Omicron di RI. https://t.co/KtlIXQTibE,3,0,0,1,2022-01-25,0,Tuesday,2,3,1
1485772498406891520,2022-01-25 00:32:22,Polda Metro memperketat permohonan penerbitan/perpanjangan pelat 'RF' dan sejenisnya. Pengetatan dilakukan usai temuan banyaknya pelanggaran mobil pelat 'RF'. https://t.co/JsRN9qJVDt,32,22,3,4,2022-01-25,0,Tuesday,2,35,26
1485771999041445889,2022-01-25 00:30:23,"Berbeda dengan varian Delta, demam tidak lagi mendominasi gejala pada varian Omicron. Batuk kering disebut sebagai 'entry point' yang paling sering ditemukan. https://t.co/IojlQyN0MN",25,0,5,1,2022-01-25,0,Tuesday,2,30,1
1485771501051826178,2022-01-25 00:28:24,Paris Saint-Germain masih belum berhasil mengikat Kylian Mbappe dengan kontrak baru. Arsene Wenger ikut khawatir dengan situasi di PSG. https://t.co/zaZmA8f8NO,4,1,0,0,2022-01-25,0,Tuesday,2,4,1
1485770969704767490,2022-01-25 00:26:18,"Pegiat media sosial Edy Mulyadi bikin heboh usai singgung Kalimantan dan Menhan Prabowo Subianto. Atas pernyataannya itu, Edy dipolisikan di mana-mana. https://t.co/bKzWfzZDuv",123,60,17,10,2022-01-25,0,Tuesday,2,140,70
1485770720198242306,2022-01-25 00:25:18,"Tabrakan beruntun yang 5 kendaraan terjadi di Jalan Raya Bandung Garut atau di Kecamatan Cimanggung, Kabupaten Sumedang, Senin (24/1/2022) malam. https://t.co/ZWBp2cUtYS",3,1,1,0,2022-01-25,0,Tuesday,2,4,1
1485770459689984007,2022-01-25 00:24:16,"Pemerintah Inggris menarik beberapa staf dan kerabat mereka dari Kedutaan Besarnya di Ukraina sebagai tanggapan atas ""ancaman yang meningkat dari Rusia"". https://t.co/PKdz7jciNL",7,2,0,1,2022-01-25,0,Tuesday,2,7,3
1485768897240481793,2022-01-25 00:18:04,"Di balik pujian itu, ada sindiran elite Demokrat untuk putri Megawati yang saat ini menjabat Ketua DPR RI Puan Maharani. https://t.co/7NfOmaPcS4",4,0,0,0,2022-01-25,0,Tuesday,2,4,0
1485768419098206214,2022-01-25 00:16:10,Setidaknya enam orang tewas dalam kekacauan jelang laga babak 16 besar Piala Afrika 2021 antara Kamerun vs Comoros. Penonton berjubel memicu desak-desakan. https://t.co/dKxnniN6Vi,4,0,0,0,2022-01-25,0,Tuesday,2,4,0
1485767394060603398,2022-01-25 00:12:05,"Gempa berkekuatan magnitudo (M) 4,6 mengguncang Kabupaten Lombok Barat, Nusa Tenggara Barat. Pusat gempa berada di darat. https://t.co/Ul6mvWZcEZ",10,1,2,0,2022-01-25,0,Tuesday,2,12,1
1485766927662395395,2022-01-25 00:10:14,Berikut ini beberapa jalur penerimaan mahasiswa baru di berbagai perguruan tinggi yang menggunakan nilai rapor. Siswa cek infonya ya! https://t.co/lWRPmotBiU,5,0,2,0,2022-01-25,0,Tuesday,2,7,0
1485766140529938436,2022-01-25 00:07:06,Pemkot Bandung melakukan penelusuran (tracing) 80 kontak erat dari enam warga yang terpapar virus Corona varian Omicron. https://t.co/5EBCkwe7SY,4,0,0,0,2022-01-25,0,Tuesday,2,4,0
1485765645161668611,2022-01-25 00:05:08,"Polisi menangkap pengedar narkotika jenis sabu-sabu bernama Fajar Gilang. Dari penangkapan itu, polisi menyita barang bukti sabu-sabu seberat 1.014,83 gram. https://t.co/bT7rZFFfWx",3,0,0,2,2022-01-25,0,Tuesday,2,3,2
1485763630058590209,2022-01-24 23:57:08,"Wilayah Jabodetabek berada di level 2 daftar wilayah PPKM terbaru. Penentuan level PPKM didasarkan pada sejumlah indikator, termasuk cakupan vaksinasi. https://t.co/vx8Vhnmsvs",2,1,3,0,2022-01-24,23,Monday,1,5,1
1485763406527401988,2022-01-24 23:56:14,"Debat panas antara terdakwa kasus terorisme, Munarman dengan saksi inisial AM terjadi di persidangan. Munarman dan saksi AM saling adu kuat bukti. Seperti apa? https://t.co/Bx3znGfvwd",17,2,2,0,2022-01-24,23,Monday,1,19,2
1485762381167083521,2022-01-24 23:52:10,Mayjen Maruli Simanjuntak buka suara soal jadi Pangkostrad karena kedekatan Istana. Apa katanya? https://t.co/sHieVwAEdW,26,33,3,6,2022-01-24,23,Monday,1,29,39
1485760589658009606,2022-01-24 23:45:03,Koordinator PPKM Jawa-Bali Luhut Binsar Pandjaitan memastikan pembelajaran tatap muka (PTM) tetap dilanjutkan. Sementara pakar menyoroti ancaman varian Omicron. https://t.co/3iCjmNvgOY,3,2,2,0,2022-01-24,23,Monday,1,5,2
1485759851179429891,2022-01-24 23:42:07,Pemerintah resmi memperpanjang PPKM Jawa-Bali hingga 31 Januari 2022. Hal ini untuk mengendalikan penyebaran Covid-19. https://t.co/irRKbZhNr4,42,6,12,5,2022-01-24,23,Monday,1,54,11
1485759075115753473,2022-01-24 23:39:02,"Komisioner Komnas HAM, Choirul Anam, meminta polisi menyelidiki informasi terkait 40 orang yang diduga menjadi korban kerangkeng di rumah Bupati Langkat. https://t.co/nM5Atv3kmz",30,0,6,4,2022-01-24,23,Monday,1,36,4
1485758069833449472,2022-01-24 23:35:02,Menkes memprioritaskan vaksinasi booster di Jabodetabek. Kenaikan kasus Omicron paling tinggi dalam 2-3 pekan ke depan diperkirakan terjadi di wilayah ini. https://t.co/QurhPwYG3R,11,0,4,0,2022-01-24,23,Monday,1,15,0
1485756226608771074,2022-01-24 23:27:43,Rudy Mas'ud meminta Polri menindak tegas dugaan ujaran kebencian terkait perpindahan IKN. Rudy menyebut dugaan ujaran itu bisa merusak persatuan. https://t.co/YPJqE5CsBh,17,3,1,0,2022-01-24,23,Monday,1,18,3
1485755637120262152,2022-01-24 23:25:22,Gambia dan Kamerun melanjutkan langkah ke babak delapan besar Piala Afrika 2021. Keduanya selanjutnya akan saling berhadapan demi tiket semifinal. https://t.co/Mx0HNTfPV5,6,0,0,0,2022-01-24,23,Monday,1,6,0
1485754805842759682,2022-01-24 23:22:04,Penambahan kasus Covid-19 harian di DKI Jakarta per Senin (24/1/2022) menyentuh angka 1.993. Level PPKM DKI bisa saja berubah dengan situasi ini. https://t.co/yKKNLbz7pZ,5,3,7,1,2022-01-24,23,Monday,1,12,4
1485754050457047050,2022-01-24 23:19:04,"Pengemudi mobil, Wiyanto Halim (89) tewas dikeroyok massa setelah diteriaki maling, padahal bukan maling. Empat orang jadi tersangka termasuk si penghasut, https://t.co/oXBnhL4Pcd",24,3,5,2,2022-01-24,23,Monday,1,29,5
1485753564643434496,2022-01-24 23:17:08,"""Ada aturannya di Perkap, namun demikian kita akan perbaiki untuk kita evaluasi,"" tegas Kapolri Jenderal Listyo Sigit Prabowo. https://t.co/ASwf9IKorl",22,4,3,0,2022-01-24,23,Monday,1,25,4
1485752511734685703,2022-01-24 23:12:57,"Perampokan sadis menewaskan seorang mahasiswi, Leli Agustin (20), terjadi di wilayah Way Bungur, Lampung Timur. Pelaku menembak mati korban yang melawan. https://t.co/9z0bNyc01S",10,2,2,2,2022-01-24,23,Monday,1,12,4
1485750249142505472,2022-01-24 23:03:57,Ciri-ciri orang mau meninggal dalam kondisi husnul khotimah telah dijelaskan dalam Al Quran dan hadits. Semoga kita diberi peluang mendapatkannya. https://t.co/NwRgFzwDNO,65,3,8,0,2022-01-24,23,Monday,1,73,3
1485749993705283589,2022-01-24 23:02:57,Tottenham Hotspur diminta tak setengah-setengah dalam mempercayakan proyek tim ke Antonio Conte. Manajemen diharapkan mendukung sang manajer sepenuhnya. https://t.co/y0iHr0yf1S,5,0,0,0,2022-01-24,23,Monday,1,5,0
1485748617155682309,2022-01-24 22:57:28,Sultan Gustaf Al Ghozali akhirnya memenuhi kewajibannya membayar pajak setelah DJP sempat menyindirnya untuk membayar pajak dari penjualan NFT.  https://t.co/T9pkuum6D1,199,46,25,15,2022-01-24,22,Monday,1,224,61
1485747586376118273,2022-01-24 22:53:23,Venna Melinda akan melangsungkan pernikahan dengan Ferry Irawan. Pernikahan itu digelar di Bali. https://t.co/DebfzbRlpY,7,1,0,0,2022-01-24,22,Monday,1,7,1
1485745709647290374,2022-01-24 22:45:55,Anindita Hidayat bercerita tentang dua sosok yang dikaguminya yakni Ariel NOAH dan Ariel Tatum. Ini kata Anindita Hidayat:  https://t.co/yX1WA0IIot,7,0,0,0,2022-01-24,22,Monday,1,7,0
1485744472893894664,2022-01-24 22:41:00,Pemerintah melaporkan kasus positif Corona hari ini sebanyak 2.927 kasus. Provinsi yang melaporkan kasus tertinggi dalam 24 jam terakhir adalah DKI Jakarta. https://t.co/cdN8W8MXHp,15,1,5,1,2022-01-24,22,Monday,1,20,2
1485743348598067200,2022-01-24 22:36:32,"Akses enam rumah di Dusun Karangwaru RT 03/RW 10, Malang, tertutup tembok beton perumahan. Warga pun harus menjebol tembok rumah mereka untuk akses jalan baru. https://t.co/iEMnf5gCXd",8,0,3,0,2022-01-24,22,Monday,1,11,0
1485742122208800778,2022-01-24 22:31:40,"Sudah mulai ikut seleksi masuk perguruan tinggi? Jika kamu sedang memilih jurusan, cek dulu yang lulusannya selalu dibutuhkan dunia industri dan usaha. https://t.co/EitoHsac2z",7,1,2,0,2022-01-24,22,Monday,1,9,1
1485740208230481920,2022-01-24 22:24:04,Kerangkeng berisi orang ditemukan di rumah Bupati Langkat. Anggota Komisi III DPR RI fraksi PPP Arsul Sani meminta kasus itu diusut tuntas. https://t.co/9NWykdzaAw,25,2,5,2,2022-01-24,22,Monday,1,30,4
1485739740678791172,2022-01-24 22:22:12,"Corona Malaysia terus mengalami lonjakan kasus. Per hari ini, kasus Corona di Malaysia tembus 3.214 orang. Bagaimana kondisi COVID-19 di Malaysia saat ini? https://t.co/skYDDv19RE",7,2,2,0,2022-01-24,22,Monday,1,9,2
1485738750646829056,2022-01-24 22:18:16,Romelu Lukaku sedang seret gol belakangan ini. Penyerang Chelsea itu sekarang tak terlihat seperti pemain yang dibeli seharga lebih dari 100 juta euro. https://t.co/rcVcfkqmrm,5,1,1,0,2022-01-24,22,Monday,1,6,1
1485737728994168836,2022-01-24 22:14:12,"Kareena Kapoor bernostalgia dengan mengunggah video dirinya yang dirilis 21 tahun lalu. Dulu dan kini, dia tetap mempesona! https://t.co/uxIVKUslVZ",8,0,1,1,2022-01-24,22,Monday,1,9,1
1485735915477688322,2022-01-24 22:07:00,BMKG mengeluarkan prakiraan cuaca untuk wilayah DKI Jakarta. BMKG memprediksi sejumlah wilayah Jakarta diguyur hujan disertai angin kencang. https://t.co/YofINSkNpW,8,0,2,0,2022-01-24,22,Monday,1,10,0
1485734714006769668,2022-01-24 22:02:14,"Mayjen Maruli Simanjuntak, menantu Luhut, ditunjuk menjadi Pangkostrad TNI. Panglima TNI Jenderal Andika Perkasa buka suara soal penunjukan Maruli. https://t.co/xQ7mFfYafZ",21,7,1,0,2022-01-24,22,Monday,1,22,7
1485733577807511552,2022-01-24 21:57:43,Para pedagang minyak skala kecil di Bandung Barat mengeluhkan kebijakan minyak Rp 14 ribu per liter. Mereka menilai kebijakan itu hanya untungkan pedagang besar https://t.co/MaxwKE7GOI,19,3,2,3,2022-01-24,21,Monday,1,21,6
1485731312954744833,2022-01-24 21:48:43,"Enam rumah warga RT 03 RW 10, Candirenggo, Singosari, Kabupaten Malang, harus kehilangan akses keluar-masuk. Kondisi ini sudah berlangsung 10 hari terakhir. https://t.co/JPxk40t6Cy",19,1,13,2,2022-01-24,21,Monday,1,32,3
1485730285069213698,2022-01-24 21:44:38,"Sudah 13 tahun berlalu, pedangdut Inul Daratista baru berani mengungkapkan foto kehamilannya. #InulDaratista  https://t.co/kQNUBufDRU",3,0,0,0,2022-01-24,21,Monday,1,3,0
1485729292290084867,2022-01-24 21:40:41,"Pemerintah dan KPU telah menyepakati jadwal pemilu yang jatuh pada 14 Februari 2024. Namun, terkait lamanya masa kampanye, pemerintah dan KPU berbeda pendapat. https://t.co/vTFt1sfqbD",9,1,1,2,2022-01-24,21,Monday,1,10,3
1485726463584313345,2022-01-24 21:29:27,"Seorang mahasiswa universitas di Sumsel meninggal saat mengikuti diklatsar pencinta alam. Beberapa jam sebelum dikabarkan tewas, korban sempat mengeluh sakit. https://t.co/zlyGRKitWO",14,3,3,0,2022-01-24,21,Monday,1,17,3
1485724968713441284,2022-01-24 21:23:30,PB SEMMI melaporkan Edy Mulyadi ke Bareskrim Polri kemarin. Laporan tersebut terkait ucapan Edy yang menyebut Kalimantan Timur sebagai 'Tempat Jin Buang Anak'. https://t.co/ecTxWEORoS,16,15,0,4,2022-01-24,21,Monday,1,16,19
1485724074810740738,2022-01-24 21:19:57,Perwakilan komunitas pemobil mewah meminta maaf soal aksi dokumentasi di Tol Andara. Minta maaf karena sudah mengganggu kelancaran lalu lintas. https://t.co/2yu3kzNdIe,10,5,0,0,2022-01-24,21,Monday,1,10,5
1485720844194230277,2022-01-24 21:07:07,"Perancang busana asal Indonesia, Arnold Putra, belakangan menjadi perbincangan di medsos berkat penampilannya yang unik dan nyentrik di Paris Fashion Week 2022. https://t.co/WLqxm0t0le",11,1,1,6,2022-01-24,21,Monday,1,12,7
1485719579930214400,2022-01-24 21:02:05,Lelang tender pembangunan sirkuit Formula E gagal. Wagub DKI Jakarta Ahmad Riza Patria mengklaim secara teknis Formula E tidak ada masalah. https://t.co/X86si9UP7f,29,45,9,9,2022-01-24,21,Monday,1,38,54
1485717976569597960,2022-01-24 20:55:43,"GoFood memperkenalkan penggunaan robot untuk layanan pesan-antar makanan Indonesia. Robot berwarna merah terlihat di Mall Kelapa Gading, Jakarta. Ini potretnya:  https://t.co/esBO0y7RFw",5,0,0,0,2022-01-24,20,Monday,1,5,0
1485716690155491331,2022-01-24 20:50:36,"""Buat kami bukan sekadar pengeroyokan biasa, ini pasti ada dalangnya,"" kata kuasa hukum keluarga korban, Freddy Y Patty. https://t.co/k30yNNLp0p",8,2,3,1,2022-01-24,20,Monday,1,11,3
1485715469621501960,2022-01-24 20:45:45,Yusup Adi (41) kini harus mempertanggungjawabkan perbuatannya. Dia dibui polisi lantaran membunuh dan merampok istrinya sendiri Deti Suminarsih (38). https://t.co/VDHdzPn2kH,6,2,1,0,2022-01-24,20,Monday,1,7,2
1485714299167387650,2022-01-24 20:41:06,Lumpur Lapindo di Sidoarjo disebut memiliki kandungan lithium. Riset kandungan lithium ini ditemukan Institut Teknologi Sepuluh Nopember (ITS) Surabaya. https://t.co/55fldqc8hg,17,5,4,1,2022-01-24,20,Monday,1,21,6
1485711110397378570,2022-01-24 20:28:26,"Pelat putih akan dipasangi chip berupa radio frequency identification (RFID). Namun, pemasangan chip tersebut baru akan dimulai pada 2023. https://t.co/AaCqQsbTDC",7,2,2,3,2022-01-24,20,Monday,1,9,5
1485709558580396035,2022-01-24 20:22:16,Cah Solo merapat. d'Videocaster Hunt 2022 cari host bertalenta!  https://t.co/O8lGzS5wvi,1,0,0,0,2022-01-24,20,Monday,1,1,0
1485707342519980039,2022-01-24 20:13:28,"Dengan presentasi cukup dan pemain yang enak dilihat, The Royal Treatment jadi tontonan yang ditujukan buat kamu yang sudah tidak mau mikir. https://t.co/pgGUAXxXu1",3,0,0,0,2022-01-24,20,Monday,1,3,0
1485705191173369857,2022-01-24 20:04:55,"Menteri Agama, Yaqut Cholil Qoumas menyebut asrama haji bisa dijadikan tempat karantina bagi jamaah umrah. Yaqut mengatakan biaya yang dikeluarkan jika karantina di asrama haji lebih murah dibandingkan di hotel. https://t.co/LwSdEhJNLR",4,2,0,2,2022-01-24,20,Monday,1,4,4
1485703129039613959,2022-01-24 19:56:43,"Maling di Sukabumi melakukan aksi konyol usai mencuri sepeda motor. Diduga karena kesal motor tak bisa menyala, hasil curiannya itu pun langsung dibakar. https://t.co/1xu0fbFFH7",4,0,1,0,2022-01-24,19,Monday,1,5,0
1485700738311499776,2022-01-24 19:47:13,Lima tim kewirausahaan Universitas Tidar lolos pendanaan Kegiatan Berwirausaha Mahasiswa Indonesia (KBMI) 2021. https://t.co/6OYvXuMS0n,12,0,0,0,2022-01-24,19,Monday,1,12,0
1485698380600909828,2022-01-24 19:37:51,"Gempa bermagnitudo (M) 5,3 mengguncang Haiti. 2 orang dilaporkan tewas. https://t.co/697KNLi3fU",132,0,13,3,2022-01-24,19,Monday,1,145,3
1485695713744986116,2022-01-24 19:27:15,Polri menyebut pelat hitam ke putih dilakukan jika stok material lama sudah habis terpakai. https://t.co/dWBtjXsLyJ,5,0,1,0,2022-01-24,19,Monday,1,6,0
1485695467363180545,2022-01-24 19:26:16,"Politikus PKS, Tifatul Sembiring, membela Edy Mulyadi yang dipolisikan sejumlah kelompok buntut pernyataan Kalimantan sebagai tempat jin buang anak. https://t.co/RU1554aMfe",68,80,12,20,2022-01-24,19,Monday,1,80,100
1485693205668638720,2022-01-24 19:17:17,Mayjen Maruli Simanjuntak buka suara soal jadi Pangkostrad karena kedekatan Istana. Apa katanya? https://t.co/BSbSKfsWSt,6,1,0,0,2022-01-24,19,Monday,1,6,1
1485689308942118916,2022-01-24 19:01:48,Claudio Ranieri resmi dipecat Watford. Manajer asal Italia itu dianggap tak mampu mengangkat The Hornets keluar dari zona degradasi. https://t.co/YeVbZrTDjW,2,1,1,0,2022-01-24,19,Monday,1,3,1
1485688971359408128,2022-01-24 19:00:28,Tender lelang pembangunan lintasan Formula E disebut gagal. Pengumuman gagal itu disampaikan melalui situs e-Procurement JakPro. https://t.co/E2qapKNGI4,184,109,44,27,2022-01-24,19,Monday,1,228,136
1485687475196637187,2022-01-24 18:54:31,Chelsea membayangi Liverpool di klasemen Liga Inggris usai menang 2-0 atas Tottenham Hotspur dini hari tadi.  https://t.co/9RxKctAm4G,6,0,1,0,2022-01-24,18,Monday,1,7,0
1485685671918514177,2022-01-24 18:47:21,"Saksi AM mengakui menyamarkan tema acara deklarasi ISIS di Makassar menjadi seminar atau tabligh akbar. Perubahan itu dilakukan atas saran dari Ustaz Basri, guna menghindari sorotan aparat. https://t.co/iVhbjJ7Bzg",7,0,4,0,2022-01-24,18,Monday,1,11,0
1485684351731998725,2022-01-24 18:42:06,Petenis dunia menggunakan kompres es hingga dipijat agar tetap rileks dan prima di ajang Australian Open 2022. Begini potretnya. https://t.co/ntRS7nrSHd,5,0,2,0,2022-01-24,18,Monday,1,7,0
1485682048983609344,2022-01-24 18:32:57,"Bupati Langkat Terbit Rencana Perangin Angin kena OTT KPK. Usai kena OTT, temuan kerangkeng manusia di rumah Bupati Langkat di Sumatera Utara (Sumut) mencuat. https://t.co/LiBIaV7YtW",43,7,9,1,2022-01-24,18,Monday,1,52,8
1485678921664417792,2022-01-24 18:20:32,Seruan sanksi berat hingga pecat Arteria Dahlan mencuat usai pernyataan Arteria terkait Kejati berbahasa Sunda menyinggung masyarakat Sunda. PDIP buka suara. https://t.co/vKcV6T06IG,5,4,2,1,2022-01-24,18,Monday,1,7,5
1485676975050084360,2022-01-24 18:12:48,"Perhimpunan Dokter Paru Indonesia menyorot lonjakan kasus COVID-19 akibat varian Omicron. Khawatir soal risiko faskes bakal kewalahan, begini penegasannya: https://t.co/5chL7QAKcc",5,0,1,1,2022-01-24,18,Monday,1,6,1
1485674383188369409,2022-01-24 18:02:30,Pevita Pearce mengungkapkan saat ini lebih menyukai map baru bertajuk Livik. Dengan durasi bermain yang tidak lama. https://t.co/FIi5aaBKme,8,4,2,1,2022-01-24,18,Monday,1,10,5
1485672513699000323,2022-01-24 17:55:04,"Polisi membentuk tim khusus memburu perampok sadis yang menewaskan mahasiswi, Leli Agustin (20). Identitas pelaku sudah dikantongi polisi. https://t.co/T4LIVuPyvS",11,4,3,0,2022-01-24,17,Monday,1,14,4
1485669430180855808,2022-01-24 17:42:49,Beberapa gaya bercinta ini bisa membuat wanita lebih puas di ranjang hingga orgasme lebih mudah dan cepat. Salah satunya gaya cowgirl bersandar. https://t.co/Z7ErPwu0O0,7,0,2,0,2022-01-24,17,Monday,1,9,0
1485667040446894082,2022-01-24 17:33:19,Hari ini dilaporkan ada tambahan 2.927 kasus positif COVID-19 di Indonesia. https://t.co/CemeC4vgjb,19,1,2,2,2022-01-24,17,Monday,1,21,3
1485665195758338052,2022-01-24 17:25:59,"Seorang pemuda berinisial AY ditemukan tewas di dalam kamar mandi rumahnya di Jatiwaringin, Pondok Gede, Kota Bekasi. Korban diduga menjadi korban pembunuhan. https://t.co/MU4Vug0FlH",9,0,2,0,2022-01-24,17,Monday,1,11,0
1485663251803348998,2022-01-24 17:18:16,Mayjen Maruli Simanjuntak yang ditunjuk menjadi Pangkostrad menyoroti 5 ancaman militer bagi Indonesia. Apa saja? https://t.co/QRq3PDZlRL,11,0,3,0,2022-01-24,17,Monday,1,14,0
1485662113423101954,2022-01-24 17:13:44,Wali Kota Medan Bobby Nasution mengecek aduan masyarakat adanya praktik parkir manual di kawasan parkir elektronik. Ini hasilnya. https://t.co/JBtRFeKFQG,6,0,1,1,2022-01-24,17,Monday,1,7,1
1485661128302731272,2022-01-24 17:09:49,"Video amatir ini memperlihatkan hujan deras disertai angin kencang di Jalan Alternatif Sentul, Kabupaten Bogor, Jawa Barat. Terlihat dahan-dahan pohon di sekitar lokasi tumbang mengenai kabel listrik dan mobil. https://t.co/58K7zuEaZc",8,1,1,0,2022-01-24,17,Monday,1,9,1
1485660002895474698,2022-01-24 17:05:21,"Mengingat gejala Omicron amat mirip flu biasa, Luhut meminta warga langsung melakukan tes COVID-19 jika mengalami sederet gejala. Senada, begini pesan pakar. https://t.co/0zQCybgTp9",10,15,4,1,2022-01-24,17,Monday,1,14,16
1485658901211144202,2022-01-24 17:00:58,"Melihat kasus varian Omicron yang semakin banyak, Kemenkes RI berencana menggunakan PCR-SGTF untuk mendeteksi Omicron. Sementara whole genome sequence akan diarahkan untuk menganalisa pola penyebaran kasus Omicron. https://t.co/gtYnT19Yb6",4,0,1,0,2022-01-24,17,Monday,1,5,0
1485656125190160391,2022-01-24 16:49:57,"Perdana Menteri (PM) Selandia Baru, Jacinda Ardern, menyebut pernikahannya dibatalkan imbas peraturan pembatasan Covid-19. Diketahui, pembatasan tersebut dilakukan untuk mencegah penyebaran varian Omicron. https://t.co/2AOW4B4A01",5,1,0,0,2022-01-24,16,Monday,1,5,1
1485655004782505988,2022-01-24 16:45:29,"Pihak keluarga Wiyanto Halim (89), lansia yang tewas dikeroyok di Jakarta Timur, mengungkap kronologi pengeroyokan yang terjadi. Mereka meyakini ada dalang di balik aksi pengeroyokan tersebut. https://t.co/aWxmtLExxK",2,0,0,0,2022-01-24,16,Monday,1,2,0
1485654080810668033,2022-01-24 16:41:49,"Netizen dihebohkan pertemuan Acha dan Irwansyah yang kini masing-masing sudah berkeluarga. Bisa kok menjalani hubungan baik dengan mantan, ini tips psikolog: https://t.co/NNBVfVMfHT",15,3,6,2,2022-01-24,16,Monday,1,21,5
1485652771969941512,2022-01-24 16:36:37,"#Terpopuler Di mana saja lokasi vaksin booster COVID-19 Jakarta Selatan? Buat yang memenuhi syarat, ini lokasi, jenis vaksin, hingga kuota per harinya. https://t.co/htjWh26cSl",2,0,1,0,2022-01-24,16,Monday,1,3,0
1485651523585650694,2022-01-24 16:31:39,"Khusus Jabodetabek, pasien COVID-19 yang terpapar Omicron bisa mendapat obat gratis termasuk Molnupiravir. Bisa didapat lewat 17 platform, cek di sini. https://t.co/aA9Vt7Udai",13,0,16,0,2022-01-24,16,Monday,1,29,0
1485650420584304646,2022-01-24 16:27:16,"Di era digital seperti sekarang, desa bisa melaju seperti di perkotaan. Telkom punya solusi jitu dalam digitalisasi desa untuk lebih cerdas, cepat, dan tepat. https://t.co/Dwrffu2Ry8",5,0,0,1,2022-01-24,16,Monday,1,5,1
1485649416199585798,2022-01-24 16:23:17,"Disaat Syahrini bikin NFT, Pevita Pearce, membeberkan rahasia soal rencananya membuat tim esports. Menurutnya saat ini untuk ide dan konsep sudah ada. https://t.co/cqhIgFT5Gw",16,0,0,0,2022-01-24,16,Monday,1,16,0
1485648172512911369,2022-01-24 16:18:20,Samsung mulai menjual Galaxy A03 di Indonesia yang harganya Rp 1 jutaan. Ini harga dan spesifikasinya:  https://t.co/3BlYdWHl0P,13,0,1,0,2022-01-24,16,Monday,1,14,0
1485647294057832448,2022-01-24 16:14:51,"Berencana beli atau menggunakan obat Ambroxol? Eits, jangan sembarangan! Kenali dulu manfaat, dosis, dan efek sampingnya di sini: https://t.co/9hib7XWRu1",7,0,1,0,2022-01-24,16,Monday,1,8,0
1485646367028621317,2022-01-24 16:11:10,Tebak-tebakan sederhana ini mengharuskan kamu teliti melihat persoalan. Awas jangan salah jawab karena kurang fokus. https://t.co/cdHqfsqMoC,14,11,5,1,2022-01-24,16,Monday,1,19,12
1485644875412516880,2022-01-24 16:05:14,"Aksi maling motor umbar tembakan ke arah warga di Senen, Jakpus, viral di media sosial. Satu orang pelaku ditangkap polisi. https://t.co/wl2hLS09eP",7,0,1,1,2022-01-24,16,Monday,1,8,1
1485643645780955144,2022-01-24 16:00:21,Berkeinginan untuk membeli HP Xiaomi dengan jenis apapun? Simak beberapa cara atau tips berikut ini:  https://t.co/OCq7efAPzT,8,0,2,0,2022-01-24,16,Monday,1,10,0
1485641757492666372,2022-01-24 15:52:51,"Heboh penemuan kerangkeng yang disebut sebagai tempat rehabilitasi narkoba di rumah Bupati Langkat, Terbit Rencana Perangin Angin. Kapolda Sumut menegaskan tempat rehabilitasi narkoba itu tidak berizin. https://t.co/PrJ5pIfl8a",18,3,9,1,2022-01-24,15,Monday,1,27,4
1485640756744314883,2022-01-24 15:48:52,"Yang biasanya tandus dan diliputi pasir, Gurun Sahara diselimuti salju! Begini penampakannya. https://t.co/C1bWN2ODRl",94,11,32,5,2022-01-24,15,Monday,1,126,16
1485639907347509250,2022-01-24 15:45:30,"Harga daging babi sedang melonjak tinggi di Thailand. Sebagai alternatif, masyarakat justru memilih makan daging buaya yang harganya jauh lebih murah!  https://t.co/hVKw4rCItV",19,2,9,4,2022-01-24,15,Monday,1,28,6
1485638858293264389,2022-01-24 15:41:20,Untuk mencapai gairah perlu diketahui bagian tubuh mana saja yang mudah terangsang. Ini 6 titik sensitif pria yang mudah terangsang dan bisa tingkatkan ereksi. https://t.co/LCefhnf5TU,14,0,1,0,2022-01-24,15,Monday,1,15,0
1485638069650866180,2022-01-24 15:38:12,Imlek atau tahun baru China juga dikenal sebagai perayaan datangnya musim semi. Tradisi Imlek di Indonesia biasanya dirayakan dengan makan bareng keluarga.  https://t.co/3iDLHgFVuZ,11,0,1,0,2022-01-24,15,Monday,1,12,0
1485636344458231813,2022-01-24 15:31:20,Polri telah melakukan pengecekan ketersediaan stok minyak goreng dan gula pasir di wilayah Jabodetabek dan sekitar. Stok dijamin aman https://t.co/nTG5XkiR0J,14,7,2,2,2022-01-24,15,Monday,1,16,9
1485635719968215043,2022-01-24 15:28:52,Potensi ketersediaan Energi Baru Terbarukan (EBT) yang tersedia di Indonesia diperkirakan mencapai 418.000 Megawatt.  https://t.co/9Lsyiudbb8,13,2,1,3,2022-01-24,15,Monday,1,14,5
1485634613980577796,2022-01-24 15:24:28,Jose Mourinho punya tuntutan tinggi terhadap Tammy Abraham dengan mencetak gol di setiap pertandingan. https://t.co/D3EeApb3nm,6,0,0,0,2022-01-24,15,Monday,1,6,0
1485634325265752066,2022-01-24 15:23:19,PT Jakpro menyatakan sampai saat ini belum ada sponsor yang bergabung untuk membiayai penyelenggaraan Formula E yang rencananya berlangsung 4 Juni nanti. https://t.co/A0SpFp38Et,13,19,2,6,2022-01-24,15,Monday,1,15,25
1485633453081206787,2022-01-24 15:19:51,Inovasi kamera smartphone OPPO ini seperti fitur lensa kamera profesional yang membuat efek bokeh menjadi semakin jelas dan jernih. https://t.co/3OCR3stvPB,14,0,1,0,2022-01-24,15,Monday,1,15,0
1485632232333135874,2022-01-24 15:15:00,"Battlefield 2042 awalnya sempat dianggap akan menjadi game yang laris manis. Setelah dirilis, ternyata game ini tak bisa memenuhi ekspektasi para penggemar. https://t.co/fdW4PE8MzN",15,1,4,1,2022-01-24,15,Monday,1,19,2
1485632210015240199,2022-01-24 15:14:55,Wagub DKI Jakarta Ahmad Riza Patria memastikan banjir dan COVID-19 varian Omicron tidak akan mengganggu rangkaian kegiatan G20 di Jakarta. https://t.co/4muyKfv7pM,12,4,0,2,2022-01-24,15,Monday,1,12,6
1485630684710510594,2022-01-24 15:08:51,"Man United menghadapi persaingan ketat dalam perburuan posisi di empat besar klasemen Liga Inggris. MU mewaspadai beberapa tim, bukan cuma dua tim London Utara. https://t.co/05x0HZ7yOO",8,2,2,0,2022-01-24,15,Monday,1,10,2
1485630078868463625,2022-01-24 15:06:27,"#FOTO Kocak banget kumpulan foto hewan yang gagal tampil keren di foto panorama ini, bikin nggak habis pikir dan ngakak karenanya!  https://t.co/eWJTbcq1uq",16,0,0,0,2022-01-24,15,Monday,1,16,0
1485627945477681154,2022-01-24 14:57:58,"Bill Gates telah lama berinvestasi dalam pengembangan vaksin melalui yayasannya, Bill &amp; Melinda Gates Foundation. Apakah Bill Gates untung dari vaksin? Ini faktanya:  https://t.co/kpxM03949v",33,9,12,5,2022-01-24,14,Monday,1,45,14
1485627921033306112,2022-01-24 14:57:52,Viral trik tidur dalam dua menit ala tentara yang diklaim bikin tidur pulas. Penasaran caranya bagaimana? Sini merapat. https://t.co/ou945RMXCd,84,1,28,3,2022-01-24,14,Monday,1,112,4
1485627339211948037,2022-01-24 14:55:33,Telkomsel secara bertahap meng-upgrade seluruh layanan 3G ke 4G di 2022. Ini cara pelanggan pindah dari layanan 3G ke 4G Telkomsel dengan mudah. https://t.co/815zFYDgYZ,17,1,6,1,2022-01-24,14,Monday,1,23,2
1485626293244862466,2022-01-24 14:51:24,"John Legend jadi pria metroseksual yang rajin dalam perawatan kulit. Sadar akan penampilannya, ia terjun ke bisnis kecantikan. https://t.co/avp8zT7Xqg",13,0,1,1,2022-01-24,14,Monday,1,14,1
1485625715760447491,2022-01-24 14:49:06,"#FOTO Mantan pemain timnas voli putri, Aprilio Manganang baru saja bertunangan. Ini momen manis pertunangan Manganang:  https://t.co/uUVRA34V3C",33,1,2,2,2022-01-24,14,Monday,1,35,3
1485625691169300480,2022-01-24 14:49:01,"Beragam peristiwa terjadi di Jawa Barat hari ini, Senin (24/1/2022) dari mulai petani di Karawang dibunuh hingga viral PNS tinju honorer di Kabupaten Cianjur. https://t.co/SXw6JqAWfH",16,1,1,0,2022-01-24,14,Monday,1,17,1
1485625170480017414,2022-01-24 14:46:56,"Claudya, tunangan Aprilia Manganang mengungkapkan dibalik acara lamarannya. Ini penuturannya:  https://t.co/8LKidAaset",13,4,0,0,2022-01-24,14,Monday,1,13,4
1485624417917054976,2022-01-24 14:43:57,Zaskia Sungkar mendapatkan pujian dari netizen karena Irwansyah bertemu dengan Acha Septriasa. https://t.co/ALikiPMwQ9,27,7,5,2,2022-01-24,14,Monday,1,32,9
1485624398447104008,2022-01-24 14:43:52,"Beberapa waktu lalu, seorang wanita berusia 54 tahun sempat viral karena mengandung cucunya sendiri. Sang cucu akhirnya lahir 13 Januari lalu. https://t.co/pSIccNBpjG",42,23,6,2,2022-01-24,14,Monday,1,48,25
1485623800611942407,2022-01-24 14:41:30,"Media sosial punya peran penting untuk menyebarkan informasi, sama halnya seniman. Ini 5 akun Instagram seniman yang wajib di-follow: https://t.co/9PyV9oIkjQ",6,0,1,0,2022-01-24,14,Monday,1,7,0
1485622005294579719,2022-01-24 14:34:22,Rawat inap COVID-19 pasien Omicron ikut meningkat di tengah lonjakan kasus Omicron. Keterisian hampir menyentuh 70 persen. https://t.co/vHfAqDg5uc,51,6,34,4,2022-01-24,14,Monday,1,85,10
1485621491492392964,2022-01-24 14:32:19,"Aksi unjuk rasa tolak vaksinasi dan pembatasan aktivitas akibat Covid-19 di ibu kota Belgia berakhir ricuh. Massa merusak barikade yang dibuat petugas kepolisian, hingga merusak gedung.  https://t.co/neM9YsEo2c",13,1,5,1,2022-01-24,14,Monday,1,18,2
1485620806411509762,2022-01-24 14:29:36,"Diogo Dalot yang sekarang, bersama Ralf Rangnick, bukanlah Diego Dalot di bawah arahan Ole Gunnar Solskjaer dulu.  https://t.co/fPVcCFrqh6",11,0,4,0,2022-01-24,14,Monday,1,15,0
1485620033346756621,2022-01-24 14:26:32,"Repsol Honda diyakini sedang mencari pebalap juara untuk MotoGP 2023. Livio Suppo meyakini, Joan Mir cocok menjadi tandem Marc Marquez. https://t.co/pUJzbXobRA",16,1,1,1,2022-01-24,14,Monday,1,17,2
1485619152811343873,2022-01-24 14:23:02,"Bek Barcelona Jordi Alba tak masalah dengan kritik yang diarahkan kepadanya. Namun, Alba frustrasi karena merasa lebih sering dikritik secara tidak adil. https://t.co/5iSlfQSqZF",6,0,0,0,2022-01-24,14,Monday,1,6,0
1485618907541131267,2022-01-24 14:22:03,Sepandai-pandai tupai melompat akhirnya jatuh juga. Itu menggambarkan Karim Benzema yang akhirnya gagal penalti juga! https://t.co/pQWfJMrpWJ,3,1,0,0,2022-01-24,14,Monday,1,3,1
1485618906165297152,2022-01-24 14:22:03,"Viral maskawin atau mahar pernikahan bak 'sultan' di Purwodadi, Grobogan, Jawa Tengah. Video viral ini dibagikan oleh akun TikTok @_agung.m. https://t.co/ekntJZFKmX",7,0,4,0,2022-01-24,14,Monday,1,11,0
1485618426509148164,2022-01-24 14:20:08,"Kamu kreatif? Jago ngomong di depan kamera? Buktikan di audisi #dVideoCasterHunt2022 dari detikcom. Hadir di 7 kota: Solo, Surabaya, Bandung, Makassar, Medan, Bali, dan Jakarta. Daftar sekarang di https://t.co/fOGyUVLoAA https://t.co/vZJQNx6gNU",5,0,0,1,2022-01-24,14,Monday,1,5,1
1485617994545963012,2022-01-24 14:18:26,Timnas putri Indonesia harus mengakui keunggulan Thailand di Piala Asia Wanita 2022 dengan skor 0-4. https://t.co/hmVf2Uhj4L,26,7,3,1,2022-01-24,14,Monday,1,29,8
1485616745004122121,2022-01-24 14:13:28,"Rasyid Rajasa selain gemar bermain golf, rupanya punya hobi olahraga lain yang aktivitasnya dilakukan di luar ruangan. Apa saja ya? https://t.co/PfhNlj1vzJ",5,4,0,0,2022-01-24,14,Monday,1,5,4
1485616140785176579,2022-01-24 14:11:04,"Sebuah banguan di Jalan Meruya Utara, Jakarta terbakar hebat. Sebanyak 11 unit mobil pemadam dikerahkan. https://t.co/7RJil5k7jm",11,1,3,0,2022-01-24,14,Monday,1,14,1
1485616120946171908,2022-01-24 14:10:59,Munarman tak dapat menahan emosi saat saksi menyebut dirinya tetap menghadiri acara Baiat ISIS. https://t.co/GZATqckKRR,52,27,6,3,2022-01-24,14,Monday,1,58,30
1485615577796337667,2022-01-24 14:08:49,"Menparekraf, Sandiaga Uno, menegaskan persiapan MotoGP Mandalika 2022 sudah final. Sandi justru menyebut akan akan menambah kapasitas tiket untuk penonton. https://t.co/xjSMQEDuzQ",17,3,1,0,2022-01-24,14,Monday,1,18,3
1485615086882504704,2022-01-24 14:06:52,"Hujan deras disertai angin kencang mengakibatkan pohon tumbang di Jalan Dadali Kota Bogor, Senin (24/1/2022). Akibatnya, 2 mobil dan 2 motor yang sedang melintas alami kerusakan. https://t.co/99doEplxgr",9,0,2,0,2022-01-24,14,Monday,1,11,0
1485614503995789312,2022-01-24 14:04:33,"Knaffgallery menyediakan beragam cemilan krispi lainnya seperti aneka risoles, aneka keripik, soes jepang krispi, dan ikan asin. https://t.co/PRdSHasKBs",7,0,2,0,2022-01-24,14,Monday,1,9,0
1485613525728907264,2022-01-24 14:00:40,"Anak tetangga ini baik di depan tapi berbeda di belakang, dia sering kali neriakin anak saya bahkan memukul tangannya dengan batu hingga lecet. Aku harus apa? #detikNetwork  https://t.co/0iTOVDq4du",8,1,2,0,2022-01-24,14,Monday,1,10,1
1485613024220270599,2022-01-24 13:58:40,Bingung kirim anak ke pesantren atau sekolah umum untuk melanjutkan pendidikan? Penjelasan ini mungkin bisa membantu orang tua atau detikers lainnya. Via: detikedu  https://t.co/HY0xL1prKz,19,2,4,2,2022-01-24,13,Monday,1,23,4
1485612437856473089,2022-01-24 13:56:21,Mesir kuno diketahui menjadi peradaban tertua sekaligus mewarisi bahasa pertama di dunia. Bahasa paling kuno tersebut sudah ada sekitar 3200 SM. Via: detikedu  https://t.co/MmJbMujpWz,26,1,3,0,2022-01-24,13,Monday,1,29,1
1485611924465332224,2022-01-24 13:54:18,"Pendidikan tinggi di Indonesia mengenal universitas, institut, sekolah tinggi, politeknik, dan akademi. Apa bedanya? Bagaimana lulusannya? Via: detikedu  https://t.co/va4QeMnU3O",29,1,9,1,2022-01-24,13,Monday,1,38,2
1485611370649464838,2022-01-24 13:52:06,"Terkenal dengan konten tantanganya, TikToker ini punya aksi mulia. Siapapun yang bisa selesaikan tantangannya bisa mendapat hadiah hingga Rp 1 juta! https://t.co/zw1Dnfb84z",14,1,5,0,2022-01-24,13,Monday,1,19,1
1485611340647608322,2022-01-24 13:51:59,Gubsu Edy Rahmayadi kembali mengungkit soal sejumlah warga Karo yang mendatangi Presiden Jokowi. Dia mengaku ditegur usai warga mengadu ke Jokowi. https://t.co/FuqJkgHUom,20,8,3,0,2022-01-24,13,Monday,1,23,8
1485610698335997968,2022-01-24 13:49:26,"Ridwan Kamil muncul sebagai salah satu kandidat calon Kepala Otorita IKN. Direktur Eksekutif Parameter Politik Indonesia Adi Prayitno menyebut, jika Ridwan Kamil memilih menjadi Kepala Otorita IKN, lebih banyak mudaratnya daripada menjadi Gubernur Jawa ... https://t.co/h4t4X4Tpca",14,4,3,1,2022-01-24,13,Monday,1,17,5
1485610043118600194,2022-01-24 13:46:50,Sebagian sumber mengatakan bahwa Suku Tengger adalah keturunan terakhir Kerajaan Majapahit. Faktanya dijelaskan di sini. Via: detikedu https://t.co/O0flOblA2Q,14,0,8,0,2022-01-24,13,Monday,1,22,0
1485610019395719178,2022-01-24 13:46:44,"Kue keranjang selalu hadir dalam perayaan Imlek. Di balik rasanya yang manis dan teksturnya yang lengket, kue keranjang punya makna spesial lho.  https://t.co/w65COEX1sx",8,1,4,0,2022-01-24,13,Monday,1,12,1
1485608219686973440,2022-01-24 13:39:35,"Kasus aktif Corona di Indonesia melonjak, menembus 20 ribu orang. Setengahnya disumbang DKI Jakarta, ini sebaran kasus aktif Corona RI 24 Januari 2022. https://t.co/h0wwbllngF",27,1,9,5,2022-01-24,13,Monday,1,36,6
1485607959044440069,2022-01-24 13:38:33,"Indonesia mencatat sebanyak 2.927 kasus baru COVID-19, Senin (24/1/2022). DKI menyumbang kasus terbanyak dengan jumlah 1.993 kasus. https://t.co/b3IgKUaBnh",12,1,5,2,2022-01-24,13,Monday,1,17,3
1485607605615706112,2022-01-24 13:37:09,"Jumlah kasus positif COVID-19 di Indonesia bertambah 2.927, Senin (24/1/2022). Total kasus positif menjadi 4.289.305, sembuh 4.124.211, dan meninggal 144.227. https://t.co/ptdWXTfs1x",20,1,5,0,2022-01-24,13,Monday,1,25,1
1485606703009783818,2022-01-24 13:33:33,Real Madrid disebut sampai pada periode paling penting di musim ini. Perburuan gelar pada tiga ajang memasuki masa krusial. https://t.co/YVDniacrFZ,8,0,0,0,2022-01-24,13,Monday,1,8,0
1485606075332284419,2022-01-24 13:31:04,Senior PDIP Junimart Girsang membela Ketua DPR Puan Maharani yang disentil elite Demokrat Kamhar Lakumani. Junimart meminta Kamhar untuk santun berkomentar. https://t.co/0EsyyCl2yl,8,4,2,2,2022-01-24,13,Monday,1,10,6
1485605830498172930,2022-01-24 13:30:05,"Seorang lansia berinisial HM (89) tewas dihakimi massa di Pulo Kambing, Cakung lantaran diteriaki maling oleh pemotor. Begini kronologinya.... https://t.co/oqjPfBujuN",21,15,8,2,2022-01-24,13,Monday,1,29,17
1485604441495588872,2022-01-24 13:24:34,Tottenham Hotspur dinilai membutuhkan tambahan pemain baru. Kalau tidak bisa berimbas negatif terkait Antonio Conte. https://t.co/O6QC94QxB8,8,0,0,0,2022-01-24,13,Monday,1,8,0
1485603725947420673,2022-01-24 13:21:44,"Tiga rumah di Kecamatan Cabangbungin, Kabupaten Bekasi terkena longsor tanggul Citarum. Warga berharap mendapatkan ganti rugi dan tanggul diperbaiki. https://t.co/VOK8FwyJIU",6,0,0,0,2022-01-24,13,Monday,1,6,0
1485603492047855616,2022-01-24 13:20:48,"Atta Halilintar beberapa waktu lalu melelang bandana favoritnya. Tidak disangka, bandana tersebut laku sampai Rp 2,2 miliar. #AttaHalilintar  https://t.co/9k9U8LMcq2",14,23,6,12,2022-01-24,13,Monday,1,20,35
1485603490785382405,2022-01-24 13:20:48,Pendidikan nyatanya tidak memandang usia. Empat siswa SMA Ini telah berhasil membuktikannya di usia yang terbilang cukup tua. Via: detikedu  https://t.co/nlEXi0zVV6,24,4,2,0,2022-01-24,13,Monday,1,26,4
1485603156209938437,2022-01-24 13:19:28,"Usai Man City diimbangi Southampton, Jack Grealish rupanya menunggu Oriol Romeu untuk menyelesaikan urusan yang belum tuntas di lapangan. Bagaimana akhirnya? https://t.co/d29ZxtYrIi",11,0,1,2,2022-01-24,13,Monday,1,12,2
1485602781713113088,2022-01-24 13:17:58,Berikut ini daftar beserta harga motor retro termurah di Indonesia. Ada dari Jepang hingga Italia. https://t.co/H6uavwkys3,18,0,0,1,2022-01-24,13,Monday,1,18,1
1485601842990096384,2022-01-24 13:14:15,Sedang viral dan ngetren di media sosial. Banyak makanan di minimarket yang jadi incaran. Mulai dari camilan sampai menu makanan utama.  https://t.co/gha4qwBc7S,11,1,0,0,2022-01-24,13,Monday,1,11,1
1485600986429366274,2022-01-24 13:10:50,"Wiyanto Halim, pengemudi mobil, tewas usai dikeroyok massa. Dia dikeroyok menggunakan batu dan kayu. https://t.co/BCrMrsHwHt",12,5,2,1,2022-01-24,13,Monday,1,14,6
1485599617349828613,2022-01-24 13:05:24,Pelatih AS Roma Jose Mourinho punya tuntutan tinggi terhadap Tammy Abraham. Mourinho mengharapkan gol dari Abraham di setiap pertandingan. https://t.co/z8Jz7BdDSk,11,1,0,0,2022-01-24,13,Monday,1,11,1
1485599393919258626,2022-01-24 13:04:31,"Peugeot 2008 masuk ke Indonesia. Meski belum rilis, keran pemesanan sudah mulai dibuka. https://t.co/JSeS54bz4u",11,1,2,1,2022-01-24,13,Monday,1,13,2
1485598419880136704,2022-01-24 13:00:39,"Sudah mulai kehilangan penggemar, beberapa model motor bebek masih eksis di Tanah Air. Berikut harganya di bulan Januari 2022. https://t.co/DrVOv02C90",17,2,2,0,2022-01-24,13,Monday,1,19,2
1485598087322247173,2022-01-24 12:59:19,Salah satu infrastruktur yang bakal ada di ibu kota negara (IKN) baru Nusantara adalah jalan tol yang berada di bawah laut.   https://t.co/axXpgfJDJD,96,70,11,13,2022-01-24,12,Monday,1,107,83
1485597829506682886,2022-01-24 12:58:18,Jeff Bezos dalam misi menolak penuaan setelah mendanai Altos Lab yang berfokus pada anti penuaan. Apakah manusia bisa menolak penuaan bahkan kematian? https://t.co/P9NDtmGVJJ,11,0,5,3,2022-01-24,12,Monday,1,16,3
1485597273115484164,2022-01-24 12:56:05,"Sulit bikin gol, apakah kini saatnya memberi kepercayaan pada striker Pierre-Emerick Aubameyang lagi? https://t.co/iE6Cbj1hT4",9,1,0,1,2022-01-24,12,Monday,1,9,2
1485597267272863748,2022-01-24 12:56:04,#Foto Pelican crossing Glodok sebagai sarana penyeberangan dan akses sementara menuju halte Transjakarta Glodok. Lihat uji cobanya yuk! https://t.co/vGCPNqsvgD,8,0,0,1,2022-01-24,12,Monday,1,8,1
1485596687737499654,2022-01-24 12:53:46,Porsinya jumbo dan isiannya padat. Banyak sate yang dilirik orang karena porsinya yang royal. Mulai dari sate kulit ayam sampai sate kambing yang enak.  https://t.co/yTnW0gjSdM,11,0,0,0,2022-01-24,12,Monday,1,11,0
1485596302838743044,2022-01-24 12:52:14,Hubungan Vicky Prasetyo dan Kalina Oktarani dikabarkan retak. Hal ini jadi polemik karena akan menjadi perceraian Vicky Prasetyo yang kesekian kalinya. https://t.co/MaaNTKwYyD,72,35,13,15,2022-01-24,12,Monday,1,85,50
1485595750054735872,2022-01-24 12:50:02,Proyek pesawat tempur kolaborasi Korea Selatan dan Indonesia terus digarap supaya bisa melakukan uji terbang pertamanya di tahun ini. https://t.co/d9F7O4cqZf,29,1,2,2,2022-01-24,12,Monday,1,31,3
1485594363556245504,2022-01-24 12:44:31,"Indeks demokrasi berbagai negara dunia, termasuk Indonesia, terus menurun selama dua tahun terakhir akibat pandemi. https://t.co/XD2aNrZpXX",8,1,1,0,2022-01-24,12,Monday,1,9,1
1485594361152917504,2022-01-24 12:44:31,Pelaku pembunuhan pedagang jamu di Garut pada 20 Desember 2020 lalu akhirnya tertangkap. Pelaku ternyata suami korban bernama Yusup Adi (41). https://t.co/TKD8UsxZQZ,14,1,0,0,2022-01-24,12,Monday,1,14,1
1485593616370520065,2022-01-24 12:41:33,"Ssssttt! Kesempatan detikers untuk dapat emas tinggal 1 hari lagi. Yuk buruan buka aplikasi detikcom detik ini juga.⁣
⁣
Buat detikers yang belum mendownload, temukan aplikasinya di Google Play dan App Store https://t.co/6wfo7VlYU5",2,1,0,0,2022-01-24,12,Monday,1,2,1
1485592967054307339,2022-01-24 12:38:58,"Kanye West memboyong pacar barunya, Julia Fox, ke Paris Fashion Week. Keduanya memamerkan kemesraan lewat busana yang serasi. https://t.co/o5jFhB6jo5",5,2,0,1,2022-01-24,12,Monday,1,5,3
1485591697643950089,2022-01-24 12:33:56,Indonesia sebentar lagi punya teleskop canggih. Apakah Indonesia mencari exoplanet dan alien menggunakan teleskop ini? Tonton sekarang! https://t.co/gzvh4trT5C,17,9,0,1,2022-01-24,12,Monday,1,17,10
1485591017525067777,2022-01-24 12:31:14,Wajah anak Anushka Sharma dan Virat Kohli tiba-tiba disorot kamera saat menyaksikan pertandingan cricket. Fans pun bereaksi keras. https://t.co/SalXlSCvia,6,1,0,2,2022-01-24,12,Monday,1,6,3
1485590668181393409,2022-01-24 12:29:50,Ada beberapa pertanyaan yang harus diajukan kepada agen yang menawarkan produk unit link.  https://t.co/uLo0o3iApS,7,2,1,0,2022-01-24,12,Monday,1,8,2
1485590036330471428,2022-01-24 12:27:20,Sedang mencari cara diet rendah gula? Ada sederet cara diet rendah gula yang bisa membantu menurunkan berat badan dan hidup lebih lama. https://t.co/UXBl552EsB,12,1,2,1,2022-01-24,12,Monday,1,14,2
1485589675855200261,2022-01-24 12:25:54,Inul Daratista jadi sorotan usai melontarkan kalimat kontroversi ketika berkunjung ke rumah Lesti Kejora dan Rizky Billar. Ini penjelasan Inul soal Lesti Kejora yang nggak boleh lahiran normal: https://t.co/TOR9dwypET,5,1,0,0,2022-01-24,12,Monday,1,5,1
1485589087704727553,2022-01-24 12:23:34,"COVID-19 kembali menjadi ancaman belakangan ini. Robert Rene Alberts, mengungkap pentingnya vaksin dan booster COVID-19. https://t.co/lTSGDkqD4q",8,1,1,1,2022-01-24,12,Monday,1,9,2
1485588333715668992,2022-01-24 12:20:34,Keterlibatan publik menjadi salah satu yang dipersoalkan dalam pembentukan Undang-Undang Cipta Kerja (UUCK).   https://t.co/PVvfSTLTNp,13,2,4,1,2022-01-24,12,Monday,1,17,3
1485588312337227780,2022-01-24 12:20:29,"Imbang dengan Elche, Real Madrid tetap mensyukuri satu poin ini karena diraih usai tertinggal dua gol. https://t.co/QYAuastDAm",4,1,2,0,2022-01-24,12,Monday,1,6,1
1485587647657566208,2022-01-24 12:17:50,Tottenham Hotspur dinilai membutuhkan tambahan pemain baru. Kalau tidak bisa berimbas negatif terkait Antonio Conte. https://t.co/SPjNQN1HTw,3,1,0,1,2022-01-24,12,Monday,1,3,2
1485587370305011722,2022-01-24 12:16:44,Seorang netizen membagikan temuan gurita cincin biru yang dikenal sebagai hewan paling mematikan. Postingan ini ramai dikomentari dan viral. https://t.co/PxkxrsWCeR,30,1,10,1,2022-01-24,12,Monday,1,40,2
1485587349740441605,2022-01-24 12:16:39,Pernyataan Menteri Ketenagakerjaan Ida Fauziyah soal upah minimum Indonesia ketinggian kembali diungkit dalam rapat kerja bersama Komisi IX DPR RI.  https://t.co/hdR3oiE1uv,68,102,15,12,2022-01-24,12,Monday,1,83,114
1485586518014111748,2022-01-24 12:13:21,AMI Awards telah mengumumkan nama musisi Candra Darusman sebagai ketua umum selanjutnya. https://t.co/oH3v2QBzRK,6,1,2,1,2022-01-24,12,Monday,1,8,2
1485586004719382532,2022-01-24 12:11:19,Kreasi mie instan amat beragam. TikToker ini menunjukkan paduan antara Indomie goreng dengan Samyang yang terkenal pedas nikmat. Begini cara buatnya.  https://t.co/3WBAJ0qZka,15,2,1,1,2022-01-24,12,Monday,1,16,3
1485585495958691840,2022-01-24 12:09:17,Honda Revo 2022 hadir dengan pilihan warna serta grafis baru. Nih pilihannya. https://t.co/JZ2nYQ0pFx,8,3,0,0,2022-01-24,12,Monday,1,8,3
1485585225178566656,2022-01-24 12:08:13,Sebuah laga sepakbola level usia di Brasil sempat terusik. Bukan cuma dikarenakan aksi penyusup lapangan tapi juga lemparan benda tajam alias pisau! https://t.co/XraDWBgtrF,6,1,0,0,2022-01-24,12,Monday,1,6,1
1485584755366273029,2022-01-24 12:06:21,"COVID-19 kembali menjadi ancaman belakangan ini. Pelatih Persib Bandung, Robert Rene Alberts, mengungkap pentingnya vaksin dan booster COVID-19. https://t.co/kShMMtJIVf",10,0,3,0,2022-01-24,12,Monday,1,13,0
1485584242977484803,2022-01-24 12:04:19,"Petugas Jihandak dari Brimob Polda Sumut dan Puslabfor tengah melakukan olah TKP terkait ledakan di Sibolga, Sumut. 4 orang terluka akibat insiden itu. https://t.co/fN7PVVK9IN",1,0,0,0,2022-01-24,12,Monday,1,1,0
1485583995656155143,2022-01-24 12:03:20,Samsung Galaxy S22 Ultra diprediksi akan dijual dengan harga yang sama seperti Galaxy S21 Ultra. Tapi Galaxy S22 Ultra akan punya RAM yang lebih kecil.  https://t.co/ti2a8ZIDup,16,0,1,2,2022-01-24,12,Monday,1,17,2
1485583372827213827,2022-01-24 12:00:51,1.400 karyawan Bank KB Bukopin mengundurkan diri secara berjamaah sejak Desember 2021 lalu. Apa penyebabnya? Baca selengkapnya di #CNNIndonesia. #detikNetwork  https://t.co/l2f6NKjGIv,34,4,20,5,2022-01-24,12,Monday,1,54,9
1485583116383174656,2022-01-24 11:59:50,Desainer Indonesia tuai prestasi di kancah internasional. Karya Eggie Jasmin berhasil meraih gelar Kostum Nasional Terbaik di ajang Mrs. World 2022. https://t.co/hcbpGf5TUE,15,1,3,0,2022-01-24,11,Monday,1,18,1
1485582828117139461,2022-01-24 11:58:41,"Area31, penyedia Tier III Hyperscale Datacenter, saat ini tengah menyelesaikan pembangunan data center yang berkonsep 'military bunker' di Depok.  https://t.co/kFEG3175I7",7,1,4,2,2022-01-24,11,Monday,1,11,3
1485582810148753416,2022-01-24 11:58:37,Indonesia sebentar lagi punya teleskop canggih. Apakah Indonesia mencari exoplanet dan alien menggunakan teleskop ini? Selengkapnya simak di sini:  https://t.co/torz6mJj7B,5,3,0,0,2022-01-24,11,Monday,1,5,3
1485582278688399366,2022-01-24 11:56:30,"Menko Perekonomian, Airlangga Hartarto membantah soal dana PEN 2022 untuk pembangunan Ibu Kota Negara (IKN) baru. Airlangga memastikan dana pembangunan IKN diambil dari dana Kementerian PUPR.  https://t.co/17YagTpqDA",6,0,1,0,2022-01-24,11,Monday,1,7,0
1485582260002770946,2022-01-24 11:56:26,"Kalah dari Chelsea 0-2, Roy Keane cecar para pemain Spurs yang tidak kunjung bagus juga walau sudah diasuh Antonio Conte! https://t.co/pFnpu7S5dO",6,0,1,0,2022-01-24,11,Monday,1,7,0
1485581943798382595,2022-01-24 11:55:10,"Liburan ke Bogor memang tak pernah bikin bosan. Nah, ini rekomendasi 5 tempat wisata di Bogor! https://t.co/NkoDcbnqmo",17,1,2,1,2022-01-24,11,Monday,1,19,2
1485581398799007745,2022-01-24 11:53:00,Ada isu pindah agama dalam perceraian Tyna Kanna dan Kenang Mirdad. Ini kata Lydia Kandou soal hal itu:  https://t.co/qmNDcupLrW,7,0,0,1,2022-01-24,11,Monday,1,7,1
1485581385146540034,2022-01-24 11:52:57,"Ribuan orang menggelar unjuk rasa di Washington DC, Amerika Serikat (AS), untuk memprotes aturan wajib vaksin virus Corona (COVID-19). https://t.co/asueKpNd7O",16,2,3,0,2022-01-24,11,Monday,1,19,2
1485581178384044032,2022-01-24 11:52:08,"Usai kemenangan Liverpool, Jürgen Klopp menyempatkan diri turun dari bus tim cuma untuk memberikan botol-botol bir buat fans yang menunggu. https://t.co/iXruBReu0C",7,0,0,1,2022-01-24,11,Monday,1,7,1
1485581157412610052,2022-01-24 11:52:03,"Pemandangan hijau di taman kota kerap jadi tempat pelarian untuk menghilangkan penat. Sementara ini, semua taman ditutup karena Omicron. https://t.co/GnVTMmtDzM",5,0,2,1,2022-01-24,11,Monday,1,7,1
1485580252860592141,2022-01-24 11:48:27,"Ketua DPRD Kabupaten Bogor, Rudy Susmanto, mengkritik hasil pembangunan trotoar Sentul-Kandang Roda yang menghabiskan anggaran . https://t.co/cico51D20Z",15,0,2,4,2022-01-24,11,Monday,1,17,4
1485580063085109252,2022-01-24 11:47:42,"God of War resmi melebarkan sayapnya ke PC. Sejak rilis pada 14 Januari lalu, petualangan Kratos ini berhasil mengalahkan Monster Rise dalam hal penjualan.  https://t.co/bvwZ0xhSpS",7,0,0,0,2022-01-24,11,Monday,1,7,0
1485580035859824650,2022-01-24 11:47:35,Ian Kasela turut geram atas ucapan politikus PKS Edy Mulyadi soal Kalimantan. Ucapanan yang mengibaratkan seperti tempat jin buang anak dinilai tak pantas. https://t.co/yg6octyUvL,16,1,1,0,2022-01-24,11,Monday,1,17,1
1485579505678888964,2022-01-24 11:45:29,Maskapai Wings Air akan membuka rute baru Pontianak-Palangkaraya di pulau Kalimantan. Rute baru ini akan menghubungkan Kalimantan Barat dan Kalimantan Tengah. https://t.co/rxwKoIA8XT,10,0,1,2,2022-01-24,11,Monday,1,11,2
1485579272689434624,2022-01-24 11:44:33,MotoGP 2022 tahun ini sudah benar-benar ditinggal Valentino Rossi. Maka siapakah yang akan jadi 'brand' utama dan ikon baru setelahnya? https://t.co/HjXkvyoMqZ,9,0,2,1,2022-01-24,11,Monday,1,11,1
1485578433392521216,2022-01-24 11:41:13,"Tidak main-main, Xiaomi sudah menyiapkan 12 HP baru yang akan diluncurkan tahun ini. Mulai dari Redmi K50 sampai Redmi Note 12, intip bocorannya di sini:  https://t.co/oGCprrkyJb",10,1,1,0,2022-01-24,11,Monday,1,11,1
1485577628312653825,2022-01-24 11:38:01,"Seiring perkembangan teknologi, akan ada pekerjaan lama yang hilang, di sisi lain muncul jenis pekerjaan baru. Ini daftar pekerjaan di era teknologi: https://t.co/8tjn6nPSG4",11,0,4,0,2022-01-24,11,Monday,1,15,0
1485577610998566913,2022-01-24 11:37:57,Ditangkapnya geng hacker REvil di Rusia pada pertengahan Januari lalu membuat para dedemit maya ketar-ketir.  https://t.co/l25zmWROLR,17,1,6,0,2022-01-24,11,Monday,1,23,1
1485576521414852609,2022-01-24 11:33:38,ITC Cempaka Mas menjadi tempat belanja favorit banyak orang. Selain itu pusat perbelanjaan ini memiliki 5 tempat makan enak yang bisa disinggahi. Cek daftarnya!  https://t.co/57qquY5rHr,16,1,1,3,2022-01-24,11,Monday,1,17,4
1485575625188466691,2022-01-24 11:30:04,Warga Sumatera Selatan (Sumsel) menangis setelah berfoto dengan Presiden Joko Widodo (Jokowi). Begini momennya. https://t.co/7eOkGBDOLQ,34,7,4,1,2022-01-24,11,Monday,1,38,8
1485575361370984448,2022-01-24 11:29:01,Frenkie de Jong tidak senang dengan reaksi Barcelona usai dibekap Real Madrid 2-3 di Piala Super Spanyol. https://t.co/nc12zPWYU5,3,0,0,0,2022-01-24,11,Monday,1,3,0
1485574817004855300,2022-01-24 11:26:51,Chelsea dinilai memang pantas menang atas Tottenham Hotspur pada lanjutan Liga Inggris. https://t.co/4200eOfIvD,6,0,0,0,2022-01-24,11,Monday,1,6,0
1485574543221608452,2022-01-24 11:25:46,"Ari Lesmana, vokalis Fourtwnty memiliki banyak cerita unik saat manggung. Ini aksi panggung Ari Lesmana di Fourtwnty yang tak pernah ia lupakan:  https://t.co/mWejHUtiMP",6,2,1,0,2022-01-24,11,Monday,1,7,2
1485574519116992514,2022-01-24 11:25:40,"Kakek Sunardi tak lagi tinggal di gubuk reyot. Berkat bantuan #sahabatbaik lewat https://t.co/gJZ8ovBbIQ, Kakek Sunardi kini punya rumah baru yang laik. https://t.co/WJMJErlgpx",17,2,2,0,2022-01-24,11,Monday,1,19,2
1485574158117478400,2022-01-24 11:24:14,"Rumah di di Meruya, Kembangan, Jakbar terbakar. Sebanyak 8 unit mobil pemadam kebakaran dikerahkan untuk memadamkan api. https://t.co/Q8OMhU8Y76",6,1,1,1,2022-01-24,11,Monday,1,7,2
1485573173932437507,2022-01-24 11:20:19,IKN Nusantara dinilai tidak demokratis lantaran pemimpinnya nanti tidak dipilih rakyat serta tidak ada DPRD. Juru bicara IKN menanggapi kritik ini. https://t.co/3pwR0tHfib,24,5,7,1,2022-01-24,11,Monday,1,31,6
1485572914795761668,2022-01-24 11:19:18,Mangaka Kohei Horikoshi mengumumkan manga My Hero Academia bakal hiatus dan tidak terbit sementara waktu karena kondisi kesehatan sang komikus. https://t.co/86bSwTbCu8,12,1,1,2,2022-01-24,11,Monday,1,13,3
1485572068175454210,2022-01-24 11:15:56,"Sejumlah produsen otomotif kini tengah gencar melakukan elektrifikasi, termasuk Lamborghini. https://t.co/8wjW48w88c",8,1,2,1,2022-01-24,11,Monday,1,10,2
1485571539756105729,2022-01-24 11:13:50,"Tak sengaja kelebihan isi saldo e-wallet, wanita ini habiskan dengan cara traktir makan driver ojol. Sejumlah Rp 500.000 dipakai borong bakso!  https://t.co/lhQ3k3xtKP",8,0,3,0,2022-01-24,11,Monday,1,11,0
1485570803982819328,2022-01-24 11:10:54,"Pelican crossing di kawasan Glodok, Jakbar, tengah diujicoba. Pelican crossing sebagai sarana penyeberangan dan akses sementara menuju halte Transjakarta Glodok https://t.co/hJCWZp5bMk",5,0,1,1,2022-01-24,11,Monday,1,6,1
1485570511212007427,2022-01-24 11:09:45,"Keluarga Sumanto (58) tak punya tetangga gegara proyek Tol Jogja-Solo. Seluruh tetangganya di RT 14 RW 5 Dusun Ngentak, Klaten, pindah terdampak proyek tol. https://t.co/AA5DZlyRLt",13,0,4,0,2022-01-24,11,Monday,1,17,0
1485570492916551680,2022-01-24 11:09:40,"Polisi mengamankan 14 orang terkait pengeroyokan lansia pemobil di Cakung, Jaktim. Ke-14 orang itu kini diperiksa polisi. https://t.co/temoYci4Pn",13,1,2,1,2022-01-24,11,Monday,1,15,2
1485570238011875329,2022-01-24 11:08:39,"Polisi mengungkap ihwal lansia pemobil tewas dikeroyok di Jaktim. Semua bermula dari pemotor yang terserempet yang meneriakinya maling, padahal bukan maling. https://t.co/CJJIYzQuFJ",112,55,32,11,2022-01-24,11,Monday,1,144,66
1485570224149651467,2022-01-24 11:08:36,"Kuasa hukum Ferdinand Hutahaean, M Zakir Rasyidin, mengatakan kliennya siap menghadapi proses persidangan. Ia meminta penangguhan penahanannya dikabulkan. https://t.co/ofj3AnSrgJ",5,0,2,1,2022-01-24,11,Monday,1,7,1
1485569987473514497,2022-01-24 11:07:40,"Mantan Sekda Kota Tanjungbalai, Yusmada, divonis 1 tahun 4 bulan penjara. Yusmada terbukti bersalah memberi suap Rp 100 juta ke Walkot nonaktif M Syahrial. https://t.co/BpK3wZWRnr",3,1,0,0,2022-01-24,11,Monday,1,3,1
1485569971384205314,2022-01-24 11:07:36,Pemerintah Indonesia dan Malaysia sepakat mematangkan penyelesaian nota kesepahaman tentang perekrutan Pekerja Migran Indonesia (PMI) sektor domestik https://t.co/wL89ZQ0NFg,9,0,1,0,2022-01-24,11,Monday,1,10,0
1485569859396288512,2022-01-24 11:07:09,"Sore ini Tol Cisumdawu seksi I dibuka. Ruas jalan tol Cileunyi Sumedang Dawuan yang menghubungkan Cileunyi-Pamulihan sepanjang 11,4 KM tarifnya masih gratis.  https://t.co/5BXR1xJsey",3,1,1,0,2022-01-24,11,Monday,1,4,1
1485569693159149572,2022-01-24 11:06:30,Polri akui bahwa pelat dinas Polri yang dipakai Arteria Dahlan dimobilnya merupakan pemberian dalam rangka pengawalan dan pengamanan. https://t.co/97pL6GPa4T,273,341,90,86,2022-01-24,11,Monday,1,363,427
1485569678533607427,2022-01-24 11:06:26,"Seorang pengacara di Medan, Irwansyah Gultom, melaporkan Edy Mulyadi ke Polda Sumut. Edy dilaporkan karena pernyataan yang diduga menghina Kalimantan. https://t.co/9KRZj0CkkY",14,2,3,1,2022-01-24,11,Monday,1,17,3
1485569448748765186,2022-01-24 11:05:31,"Hujan disertai angin kencang terjadi di Kabupaten Bogor. Akibatnya, dahan-dahan pohon di sekitar tumbang mengenai salah satu mobil dan kabel listrik. https://t.co/IOKv1kiGFv",7,0,0,0,2022-01-24,11,Monday,1,7,0
1485569433217245188,2022-01-24 11:05:28,"Polda Sumut akan mengusut tuntas dugaan adanya kerangkeng manusia di rumah Bupati Langkat, Terbit Rencana Perangin Angin. Polisi menggandeng BNN setempat. https://t.co/G7D0dG5EIj",37,4,13,6,2022-01-24,11,Monday,1,50,10
1485569195316322308,2022-01-24 11:04:31,Beragam cara dilakukan pemerintah untuk mempromosikan gelaran MotoGP Mandalika 2022 yang berlangsung bulan Maret nanti. https://t.co/CC7DQTanFc,8,4,2,0,2022-01-24,11,Monday,1,10,4
1485569177427533824,2022-01-24 11:04:27,Sejumlah warga Kaltim mempersoalkan ucapan Edy Mulyadi yang diduga melakukan penghinaan dengan menyebut 'tempat buang jin'. Mereka meminta Edy dipenjarakan. https://t.co/UrAD5NS5dc,20,7,3,2,2022-01-24,11,Monday,1,23,9
1485568905296896003,2022-01-24 11:03:22,DPRD Sulsel segera kirim surat ke Kemendagri untuk meminta Andi Sudirman Sulaiman dijadikan Gubernur Sulsel definitif. https://t.co/uaUu70Ax09,3,0,1,0,2022-01-24,11,Monday,1,4,0
1485568888708468741,2022-01-24 11:03:18,Manga Boruto chapter 66 resmi terbit pada 20 Januari dan sudah bisa dibaca di berbagai situs legal. Kawaki melawan Borushiki mati-matian di bab terbaru. https://t.co/KrjYhkwTYa,5,0,2,1,2022-01-24,11,Monday,1,7,1
1485568573221314562,2022-01-24 11:02:03,"Mengaku peduli lingkungan, rapper ini beli lobster untuk dilepaskan ke laut. Tak tanggung-tanggung, lobster bahkan diajak naik pesawat demi menuju laut!  https://t.co/5IyR1u3MsO",15,1,2,1,2022-01-24,11,Monday,1,17,2
1485568562236379141,2022-01-24 11:02:00,"Jika kamu pengguna TikTok, pastinya kamu sudah tidak asing lagi mendengar istilah pick me girl dan pick me boy. Ini artinya:  https://t.co/0CH2xwtwIy",7,0,1,0,2022-01-24,11,Monday,1,8,0
1485567921975971841,2022-01-24 10:59:27,Pemerintah menerapkan travel bubble dari Singapura ke Bintan dan Batam mulai hari ini. Berikut syarat dan prosedurnya! https://t.co/pgyNtwgkiY,7,1,2,1,2022-01-24,10,Monday,1,9,2
1485567280000151553,2022-01-24 10:56:54,"Tinggal di gubuk reyot yang nyaris rata dengan tanah, Untung Slamet (42) bersama dua anaknya di Brebes hidup dalam kondisi memprihatinkan.

Mari wujudkan keinginan untuk memiliki tempat tinggal yang layak dengan berdonasi di @berbuatbaik_id atau link https://t.co/kwWirH8KeT. https://t.co/rHLjvxw6eF",11,0,2,0,2022-01-24,10,Monday,1,13,0
1485567055264944129,2022-01-24 10:56:01,"Olimpiade Musim DIngin Beijing 2022 membuat heboh banyak orang, karena penyajian makanan unik dengan sistem robotik. https://t.co/N9gz7eCDzs",2,0,1,0,2022-01-24,10,Monday,1,3,0
1485567034536730624,2022-01-24 10:55:56,"Seorang pria di Ambon memilih makan malam dengan nasi Padang. Namun ketika sedang asyik makan, ia menemukan belatung hidup di rendang telur yang dimakannya!  https://t.co/RQJif2sKlm",4,1,1,0,2022-01-24,10,Monday,1,5,1
1485566728545476612,2022-01-24 10:54:43,Ada satu bumper mobil Toyota yang belum pernah ada di Indonesia. Apakah itu Toyota Fortuner Legender? https://t.co/InoIwaMDQH,6,0,1,0,2022-01-24,10,Monday,1,7,0
1485566708425371654,2022-01-24 10:54:38,"Seorang penumpang kendaraan menceritakan detik-detik angin kencang merobohkan pepohonan di jalan Sholeh Iskandar, Kota Bogor. https://t.co/oMaC6vtpOc",5,0,1,1,2022-01-24,10,Monday,1,6,1
1485566705908822026,2022-01-24 10:54:37,Polisi menangkap pria inisial R selaku pelaku pemukulan kepada lansia yang tewas dikeroyok usai dituding maling di Jaktim. R telah ditetapkan tersangka. https://t.co/KvEkA8vNCH,7,3,2,0,2022-01-24,10,Monday,1,9,3
1485565953303879681,2022-01-24 10:51:38,Jaksa KPK menyampaikan hal yang memberatkan dan meringankan Azis Syamsuddin terkait dengan tuntutan pidana 4 tahun dan 2 bulan penjara. Jaksa mengatakan ada 4 hal yang memberatkan tuntutan mantan Wakil Ketua DPR RI tersebut. https://t.co/r4o42JyENk,6,0,5,0,2022-01-24,10,Monday,1,11,0
1485565931829043205,2022-01-24 10:51:33,Kementerian PUPR menegaskan sampai hari ini belum ada anggaran untuk pembangunan ibu kota negara (IKN) baru.  https://t.co/CEW0pKAz3S,5,0,6,0,2022-01-24,10,Monday,1,11,0
1485565670674907137,2022-01-24 10:50:31,"Andrew Garfield diminta buat pakai kostum superhero lagi setelah sepulih tahun, ia ngaku ragu dengan bentuk tubuhnya kini. Ini penuturan Andrew Garfield:  https://t.co/eJwC8fvmKq",10,0,0,1,2022-01-24,10,Monday,1,10,1
1485565387362250755,2022-01-24 10:49:23,"Penjualnya mudah ditemukan di kaki lima, renyah gurihnya batagor seolah tak bisa ditolak. Di sini kamu bisa menemukan batagor mulai dari Rp 5 ribuan! https://t.co/rpm4RaxAw5",5,0,0,1,2022-01-24,10,Monday,1,5,1
1485565087599534084,2022-01-24 10:48:12,"Heboh soal konvoi mobil mewah di Tol Depok-Antasari yang disebut berhenti di tengah jalan untuk mengambil dokumentasi. Drifter nasional, Akbar Rais yang ikut dalam rombongan memberikan penjelasan. https://t.co/fOOdWu0Z0I",1,1,2,0,2022-01-24,10,Monday,1,3,1
1485564550615293956,2022-01-24 10:46:03,Besaran gaji yang dapat diterima bergantung pada golongan PPPK beserta lama kerja. Lalu berapa besaran gaji PPPK untuk S1?  https://t.co/2D9NeyBQ6C,6,1,3,1,2022-01-24,10,Monday,1,9,2
1485563757359251457,2022-01-24 10:42:54,Tottenham Hotspur takluk 0-2 dari Chelsea. Roy Keane cecar para pemain Spurs yang tidak kunjung bagus juga walau sudah diasuh Antonio Conte! https://t.co/OQch4Cf5Yl,8,1,1,0,2022-01-24,10,Monday,1,9,1
1485563410091851776,2022-01-24 10:41:32,Ridwan Kamil langsung menjajal jalan tol Cisumdawu seksi 1 Cileunyi-Pamulihan usai peresmian.  https://t.co/GUtnZvCOrL,8,0,0,2,2022-01-24,10,Monday,1,8,2
1485563389065797637,2022-01-24 10:41:27,"Presiden Joko Widodo (Jokowi) mengaku sangat berbahagia bisa berkunjung ke Kota Pagar Alam, Provinsi Sumatera Selatan. https://t.co/pNRQ0xw9M0",7,0,1,0,2022-01-24,10,Monday,1,8,0
1485563134723211270,2022-01-24 10:40:26,Keterlibatan publik menjadi salah satu yang dipersoalkan dalam pembentukan Undang-Undang Cipta Kerja (UUCK).  https://t.co/piUVCWlKF7,7,0,3,1,2022-01-24,10,Monday,1,10,1
1485562866661052419,2022-01-24 10:39:22,"Perusahaan neuroteknologi milik Elon Musk, Neuralink membuka lowongan pekerjaan. Lowongan yang dibuka untuk posisi Direktur Uji Klinis. #elonmusk   https://t.co/AvzqWCAOry",7,2,3,0,2022-01-24,10,Monday,1,10,2
1485562846696153090,2022-01-24 10:39:17,"Saksi berinisial AM di sidang kasus tindak pidana terorisme dengan terdakwa Munarman, mengungkap ide awal penyelenggaraan acara pembaiatan ISIS tanggal 24 Januari 2015 di Makassar. Menurutnya, ide itu diperoleh dari ceramah Habib Rizieq Syihab. https://t.co/MLWGjm0hBb",7,1,1,3,2022-01-24,10,Monday,1,8,4
1485562364007272452,2022-01-24 10:37:22,Sri Mulyani Indrawati sering mendapat kritikan hingga nyinyiran dari banyak kalangan soal utang yang meningkat selama pandemi COVID-19.  https://t.co/j9I9XUvmwN,3,0,1,0,2022-01-24,10,Monday,1,4,0
1485562345422311424,2022-01-24 10:37:18,Pemain-pemain Arema FC yang sempat terpapar COVID-19 sudah kembali ikut kegiatan tim danbisa tampil full team saat berjumpa Persipura Jayapura. https://t.co/he7yf1Zt4l,3,0,0,0,2022-01-24,10,Monday,1,3,0
1485562114735583235,2022-01-24 10:36:23,"Panglima TNI Jenderal Andika Perkasa merotasi jabatan sejumlah perwira tinggi. Beberapa di antaranya pernah ada di dekat Presiden Joko Widodo, dari mulai ajudan hingga Komandan Pasukan Pengamanan Presiden (Danpaspampres). https://t.co/LjRklpd4xO",5,0,2,0,2022-01-24,10,Monday,1,7,0
1485561868039200768,2022-01-24 10:35:24,"Pembukaan akan dilakukan untuk seksi I terlebih dahulu sepanjang 11,45 kilometer yang menghubungkan Cileunyi ke Pamulihan.   https://t.co/7x7fJjbYqG",7,0,0,0,2022-01-24,10,Monday,1,7,0
1485561853019406337,2022-01-24 10:35:20,Sri Mulyani Indrawati melaporkan tagihan perawatan pasien COVID-19 selama 2021 ada yang belum terbayar sebesar Rp 24 triliun!  https://t.co/zHCBPxQoyB,3,3,4,5,2022-01-24,10,Monday,1,7,8
1485561586848833539,2022-01-24 10:34:17,"Proyek Tol Solo-Jogja menyisakan sepenggal cerita dari keluarga Sumanto (58), warga Klaten. Ia tak punya lagi tetangga. https://t.co/fiiLH894di",44,4,18,1,2022-01-24,10,Monday,1,62,5
1485561566061813762,2022-01-24 10:34:12,Menteri Keuangan Sri Mulyani Indrawati berkelakar bahwa lubang hidungnya kemungkinan lebih besar karena sering dicolok buat keperluan tes PCR COVID-19!  https://t.co/7FzoVfwNLK,14,9,1,1,2022-01-24,10,Monday,1,15,10
1485561321542365187,2022-01-24 10:33:14,"Perusahaan manufaktur farmasi, PT Dankos Farma membuka lowongan kerja untuk lulusan baru.  https://t.co/egWuCUCtpo",5,0,2,1,2022-01-24,10,Monday,1,7,1
1485561320313393155,2022-01-24 10:33:13,"Kemenangan bagai harga mati buat Barcelona, demi bisa kembali bersaing ke papan atas. https://t.co/vZEgMWS4Ne",0,0,0,1,2022-01-24,10,Monday,1,0,1
1485560794435801090,2022-01-24 10:31:08,Mahkamah Konstitusi telah menerapkan bahwa Undang-Undang Cipta Kerja (UUCK) cacat formil dan inkonstitusional.  https://t.co/RO9WA0xQww,10,0,6,0,2022-01-24,10,Monday,1,16,0
1485560792363769856,2022-01-24 10:31:07,Temuan kerangkeng manusia di rumah Bupati Langkat bikin heboh. Gubernur Sumut Edy Rahmayadi mendesak polisi mengusut tuntas itu. https://t.co/TbkMqVrA9y,7,6,4,1,2022-01-24,10,Monday,1,11,7
1485559959559585792,2022-01-24 10:27:49,"Elon Musk tertarik untuk bikin landasan peluncuran pesawat di IKN Nusantara. Sementara itu, Snowbay viral karena sudah tinggal kenangan. https://t.co/GjrYvqNJSC",6,0,2,1,2022-01-24,10,Monday,1,8,1
1485558911214227458,2022-01-24 10:23:39,Aktris asal Korsel Song Ji Hyo disebut tak bisa menerima vaksin COVID-19 karena memiliki alergi obat yang diidapnya sejak kecil. Ini penjelasannya: https://t.co/rWQyHv871l,6,0,1,0,2022-01-24,10,Monday,1,7,0
1485558887524847617,2022-01-24 10:23:33,"Massa dari Aliansi Aktivis 98 gelar aksi di Gedung KPK, Jakarta. Mereka meminta KPK memerika dua putra Jokowi, Gibran dan Kaesang atas dugaan KKN. https://t.co/WkoRX4vMIQ",67,17,20,5,2022-01-24,10,Monday,1,87,22
1485558540446097408,2022-01-24 10:22:11,Ririe Fairus tak menyangka rumah tangga dengan Ayus Sabyan rusak karena perempuan yang sudah dekat dengannya. Ririe pilih tak lagi kenal dengan perempuan itu. https://t.co/SNWz5iDcxN,7,2,2,1,2022-01-24,10,Monday,1,9,3
1485558520137322498,2022-01-24 10:22:06,Simona Halep tersingkir di babak 16 besar Australian Open 2022 dan Daniil Medvedev susah payah maju ke perempatfinal. https://t.co/frbzwnUifX,3,0,0,0,2022-01-24,10,Monday,1,3,0
1485557801028132865,2022-01-24 10:19:14,"Lembaga swadaya pemerhati buruh migran, Migrant Care, melaporkan dugaan perbudakan modern di rumah Bupati Langkat ke Komnas HAM. https://t.co/HUYLkjT1Lj",14,0,8,3,2022-01-24,10,Monday,1,22,3
1485557255944781824,2022-01-24 10:17:04,"Inalillahi, artis cilik Matthew White meninggal dunia di usia 12 tahun. Kenali serba-serbi diabetes pada anak yang ternyata sempat diidap Matthew. https://t.co/S1idk74odH",15,1,7,0,2022-01-24,10,Monday,1,22,1
1485556974632722435,2022-01-24 10:15:57,"Penulis Layangan Putus, Mommy ASF memuji mantan suami meskipun sudah bercerai dan diselingkuhi. Ini pengakuannya:  https://t.co/JWsccadaUD",30,4,8,0,2022-01-24,10,Monday,1,38,4
1485555638998605829,2022-01-24 10:10:39,"Artis cilik pemain film 'Danur', Matthew White, meninggal dunia akibat penyakit diabetes. Berikut beberapa faktor risiko diabetes anak yang wajib diketahui. https://t.co/YYh15VmLDY",77,7,23,4,2022-01-24,10,Monday,1,100,11
1485555402104315904,2022-01-24 10:09:42,"Kasus COVID-19 di Jatim mulai merangkak naik. Awal pekan lalu, kasus aktif COVID-19 Jatim sebanyak 141. Kini, kasus aktif COVID-19 di Jatim menjadi 369. https://t.co/z1syLTywxi",13,2,2,1,2022-01-24,10,Monday,1,15,3
1485554877136789510,2022-01-24 10:07:37,"Menang 4-2 atas Empoli, Jose Mourinho menanggapi dua gol balasan Empoli itu dengan kelakar. https://t.co/qUdCGs8Z0W",2,0,0,1,2022-01-24,10,Monday,1,2,1
1485554370984960003,2022-01-24 10:05:36,"Di Jajanan Korea CA Taman Gajah, Bandar Lampung, kamu bisa menikmati tteokbokki ala Korea Selatan cukup dengan Rp 10 ribu rupiah!  https://t.co/PKPRsDvMXx",6,0,2,0,2022-01-24,10,Monday,1,8,0
1485553871195942913,2022-01-24 10:03:37,Biasanya masih hari Senin otak udah ngebul duluan. Lebih baik hibur diri sejenak dengan tebak-tebakan gambar ini. https://t.co/4EVJHvgANs,6,4,1,1,2022-01-24,10,Monday,1,7,5
1485553619491508230,2022-01-24 10:02:37,Banyak orang percaya tidur siang setelah makan bikin gemuk. Benarkah hal ini? Seperti apa penjelasannya dari sisi ilmiah?  https://t.co/rvyiLixKrk,6,0,2,0,2022-01-24,10,Monday,1,8,0
1485553088261992448,2022-01-24 10:00:31,"PTM 100 persen berlangsung di tengah naiknya COVID-19 RI akibat varian Omicron. Disorot Perhimpunan Dokter Paru Indonesia, begini pesan tegasnya: https://t.co/XbMxTaP6cS",31,0,15,2,2022-01-24,10,Monday,1,46,2
1485553063175806978,2022-01-24 10:00:25,Zlatan Ibrahimovic tak menuntaskan pertandingan melawan Juventus karena cedera.  https://t.co/mbYyk7KnXg,3,0,2,0,2022-01-24,10,Monday,1,5,0
1485552265956151296,2022-01-24 09:57:15,"""...Sentul itu ada satu pengembang yang sudah seperti negara di dalam negara, yang sudah sangat berkuasa di sana,"" kata Adies Kadir.  https://t.co/vfyfHMCZik",3,2,1,0,2022-01-24,9,Monday,1,4,2
1485551690845724672,2022-01-24 09:54:57,"Ada-ada saja tingkah nyeleneh bin ajaib dari traveler. Kali ini tidak patut ditiru, karena membahayakan keselamatan. https://t.co/uLZhOZRYgQ",14,1,4,0,2022-01-24,9,Monday,1,18,1
1485551183775289346,2022-01-24 09:52:57,"Atta Halilintar beberapa waktu lalu melelang bandana favoritnya. Tidak disangka, bandana tersebut laku sampai Rp 2,2 miliar. #AttaHalilintar  https://t.co/gRs4HjLDJ5",27,31,3,13,2022-01-24,9,Monday,1,30,44
1485550325864050691,2022-01-24 09:49:32,Kementerian PUPR meminta adanya perbaikan besar-besaran pada struktur jalan tol Trans Sumatera.  https://t.co/KAyovSkORJ,18,2,0,0,2022-01-24,9,Monday,1,18,2
1485550324605726720,2022-01-24 09:49:32,Gol Marcus Rashford jadi pembeda di laga MU vs West Ham. Masih ada saja fans West Ham yang tak terima dan menggugat soal Edinson Cavani offside. https://t.co/7YnsL1A6vy,5,0,0,1,2022-01-24,9,Monday,1,5,1
1485549793002803210,2022-01-24 09:47:25,"Pengadilan Negeri Jakarta Timur kembali menggelar sidang lanjutan kasus tindak pidana terorisme terdakwa Munarman, Senin (24/1/2022). Sidang beragendakan pemeriksaan saksi dari Jaksa Penuntut Umum (JPU). https://t.co/m3lPBFi38g",9,0,0,0,2022-01-24,9,Monday,1,9,0
1485549774686277635,2022-01-24 09:47:21,"Kota Batam bakal punya pelabuhan baru. Pelabuhan baru ini akan dibangun di kawasan Tanjung Pinggir, Sekupang, Kota Batam. Seperti apa kondisinya?  https://t.co/DAPKJTOwX4",17,3,1,0,2022-01-24,9,Monday,1,18,3
1485549285471105025,2022-01-24 09:45:24,Salah satu infrastruktur yang bakal ada di ibu kota negara (IKN) baru Nusantara adalah jalan tol yang berada di bawah laut.  https://t.co/GWZTLwHkgH,41,17,2,8,2022-01-24,9,Monday,1,43,25
1485549273030836226,2022-01-24 09:45:21,Gubernur Jawa Barat Ridwan Kamil mengatakan tol Cisumdawu seksi 1 mulai beroperasi Selasa (25/1) pukul 06.00 WIB.  https://t.co/WPa4rEiFbn,5,2,0,0,2022-01-24,9,Monday,1,5,2
1485548015075176449,2022-01-24 09:40:21,"Gelombang Omicron di Indonesia diprediksi bakal tiba Februari. Bersiap, ini peringatan Menkes untuk Jabodetabek. https://t.co/5iOQVHuSqC",44,59,11,29,2022-01-24,9,Monday,1,55,88
1485547875077877764,2022-01-24 09:39:48,"Komnas Perempuan mendorong perusahaan ride-hailing melakukan pencegahan dan penanganan tindak kekerasan seksual terhadap penumpang dan mitra driver perempuan. 
https://t.co/MtLNSEDje0",19,0,8,5,2022-01-24,9,Monday,1,27,5
1485547499632922624,2022-01-24 09:38:18,Vidi Aldiano dan Sheila Dara Aisha menggelar ngunduh mantu. Mereka datang dengan naik helikopter. Ini potretnya:  https://t.co/iiWcZ8Oq80,10,0,1,0,2022-01-24,9,Monday,1,11,0
1485547477168267265,2022-01-24 09:38:13,Ramalan zodiak cinta Scorpio tak perlu terlalu perhitungan agar tidak ada masalah yang mengganjal di hati. Simak ramalan zodiak cinta hari ini: https://t.co/wdPdfs8feE,1,0,0,0,2022-01-24,9,Monday,1,1,0
1485546977802825728,2022-01-24 09:36:14,"Menteri Kesehatan RI Budi Gunadi Sadikin mengatakan dari lebih 1.600 pasien Omicron yang terdata di Indonesia, hanya beberapa yang butuh bantuan oksigen. https://t.co/cZuQi40uLM",11,2,1,0,2022-01-24,9,Monday,1,12,2
1485545935916707842,2022-01-24 09:32:05,"Selama puluhan tahun Kantin RSPI terkenal dengan aneka kue hingga menu makanan enak. Kini semua makanan di kantin RSPI, bisa dinikmati di kafe modern ini.  https://t.co/msNzvmrXTZ",16,1,0,3,2022-01-24,9,Monday,1,16,4
1485545915729514500,2022-01-24 09:32:01,Tok! DPR melalui Komisi II menyepakati jadwal pemilu 14 Februari 2024. Tanggal itu juga telah disepakati oleh pemerintah dan KPU. https://t.co/6TXwULe2Uj,52,15,18,25,2022-01-24,9,Monday,1,70,40
1485545293718474752,2022-01-24 09:29:32,"Sederet artis Indonesia berikut membuktikan kepedulian dengan mendirikan berbagai lembaga pendidikan. Bahkan, ada yang hanya mematok SPP Rp 3.500. Via: detikedu  https://t.co/2dpzwTLVRQ",21,0,4,0,2022-01-24,9,Monday,1,25,0
1485544753047523333,2022-01-24 09:27:23,Julia Fox belakangan jadi sorotan karena berkencan dengan Kanye West. Ia disebut berkencan dengan Kanye hanya demi popularitas dan uang. Ini jawaban Julia Fox:  https://t.co/Fjy1Kov7PF,7,0,2,0,2022-01-24,9,Monday,1,9,0
1485544459836305416,2022-01-24 09:26:13,"Bule cantik asal Serbia bernama Ceu Nena ini mengaku betah tinggal bareng suaminya di Kuningan, Jawa Barat. Kira-kira apa ya alasannya? Berikut kisahnya. #detikNetwork  https://t.co/QVV6prJi4g",8,1,2,0,2022-01-24,9,Monday,1,10,1
1485543991210917889,2022-01-24 09:24:22,"Aceng Kurnia (50) salah satu pedagang kelontong di Pasar Atas Baru, Kota Cimahi mengaku pusing tujuh keliling gara-gara harga minyak. Begini curhatannya... https://t.co/yEE5rEcVOz",5,1,1,0,2022-01-24,9,Monday,1,6,1
1485543970604212224,2022-01-24 09:24:17,"Cara melihat e-tiket vaksin PeduliLindungi menjadi informasi penting bagi masyarakat. Lalu, bagaimana ya cara melihat e-tiket vaksin PeduliLindungi? https://t.co/Yehyys1ptI",3,0,4,0,2022-01-24,9,Monday,1,7,0
1485543445246660610,2022-01-24 09:22:12,"Tengkorak yang ditemukan di Peru ini disebut beberapa pihak mirip alien, lantaran bentuknya yang memanjang, tidak seperti tengkorak manusia biasa. Ini faktanya:  https://t.co/9vWGR66CBt",6,0,3,1,2022-01-24,9,Monday,1,9,1
1485543324870221826,2022-01-24 09:21:43,"Kemenangan Liverpool di markas Crystal Palace bernuansa kontroversi, menurut Mark Clattenburg dua proses golnya tidak sah. https://t.co/LLfBfYW4eE",0,1,0,0,2022-01-24,9,Monday,1,0,1
1485543299813462018,2022-01-24 09:21:37,"Enam minggu fokus jadi petarung MMA, dedikasi mantan stripper ini berbuah manis setelah akhirnya bisa mengalahkan lawan di babak prelimanary. Ini kisahnya:  https://t.co/misj3Lyk3U",4,0,1,0,2022-01-24,9,Monday,1,5,0
1485542528157995008,2022-01-24 09:18:33,Tok! DPR melalui Komisi II menyepakati jadwal pemilu 14 Februari 2024. Tanggal itu juga telah disepakati oleh pemerintah dan KPU. https://t.co/9EJFTu1Dwr,49,5,25,28,2022-01-24,9,Monday,1,74,33
1485542044256935943,2022-01-24 09:16:38,Kiriman jeruk warga Karo untuk Presiden Jokowi demi perbaikan jalan membuat Gubernur Sumut Edy Rahmayadi kena teguran. Begini runutan ceritanya. https://t.co/QsZJ0BM21y,7,2,1,1,2022-01-24,9,Monday,1,8,3
1485541210072793089,2022-01-24 09:13:19,"Personel Kep1er, Huening Bahiyyih jadi perbincangan karena diduga telah diabaikan penggemar. Ini fakta-faktanya:  https://t.co/m2lOHMaDgy",7,0,2,4,2022-01-24,9,Monday,1,9,4
1485540665618538513,2022-01-24 09:11:09,Inul Daratista tak minta kado dari Adam Suseno saat ulang tahun. Inul hanya ingin Adam Suseno setia...  https://t.co/KY7BGnagSQ,15,1,2,0,2022-01-24,9,Monday,1,17,1
1485540659498995718,2022-01-24 09:11:07,"Bintang Holidate, Emma Roberts mengumumkan berpisah dengan Garrett Hedlund usai setahun melahirkan anak laki-laki. https://t.co/8IHd2mZ7Zj",7,1,1,0,2022-01-24,9,Monday,1,8,1
1485539676761075713,2022-01-24 09:07:13,"IKN Nusantara dinilai tidak demokratis karena pemimpinnya tidak dipilih lewat pemilu, masa jabatan bisa diperpanjang tanpa batas, dan tak ada DPRD. https://t.co/wddlDhvt3b",88,54,24,9,2022-01-24,9,Monday,1,112,63
1485539136715038721,2022-01-24 09:05:04,"Saat menginap di hotel, jangan langsung melepaskan seprai dari kasur. Ini penjelasannya: https://t.co/iQhBVe8ui8",10,0,2,0,2022-01-24,9,Monday,1,12,0
1485538364082294789,2022-01-24 09:02:00,Jokowi menunjuk Menteri Koordinator Bidang Perekonomian Airlangga Hartarto sebagai Ketua Dewan Nasional Kawasan Ekonomi Khusus (KEK).  https://t.co/vpDAPGj0cB,5,1,2,0,2022-01-24,9,Monday,1,7,1
1485537254294573056,2022-01-24 08:57:36,"Kabar baik datang dari maskapai penerbangan nasional, Garuda Indonesia. Dia berhasil masuk dalam 20 maskapai dengan kelas bisnis terbaik di dunia. https://t.co/mMkj3OLWmD",23,0,3,0,2022-01-24,8,Monday,1,26,0
1485536217341046784,2022-01-24 08:53:28,"Kisah cinta pria asal Sorowako Luwu Timur, Sulawesi Selatan ini viral. Dia menikahi majikannya bule cantik yang berasal dari Jerman. Ini potretnya:  https://t.co/JmiTxGITti",38,5,4,4,2022-01-24,8,Monday,1,42,9
1485535938872762370,2022-01-24 08:52:22,Mencari paduan nama yang tepat untuk nama bayi perempuan? Ini inspirasi nama bayi perempuan Turki Islami dan artinya:  https://t.co/3P00kRJnaj,13,0,5,0,2022-01-24,8,Monday,1,18,0
1485535189052936194,2022-01-24 08:49:23,"Timnas Putri Indonesia akan melawan Thailand pada laga kedua Piala Asia Wanita 2022, Senin (24/1/2022). Shalika Aurelia tak mau kebobolan banyak gol lagi. https://t.co/tFgKK23h2h",12,0,1,1,2022-01-24,8,Monday,1,13,1
1485534684662710274,2022-01-24 08:47:23,Spider-Man: No Way Home meraih prestasi baru atas pendapatannya di box office. #SpiderManNoWayHome  https://t.co/a7GLosbPXG,16,1,3,1,2022-01-24,8,Monday,1,19,2
1485533910255779844,2022-01-24 08:44:18,Lansia tewas dikeroyok usai dituding maling di Jakarta Timur. Keluarga meminta polisi mengusut kasus itu hingga tuntas.  https://t.co/YWvzOyh8Qn,41,1,12,8,2022-01-24,8,Monday,1,53,9
1485533886553772034,2022-01-24 08:44:13,"Seekor sapi milik warga Leces, Probolinggo yang hilang dicuri selama sepekan ditemukan. Sapi jenis simental itu ditinggalkan di Lumajang. https://t.co/svBeGLUm0X",11,1,1,0,2022-01-24,8,Monday,1,12,1
1485533401222422531,2022-01-24 08:42:17,"Covid-19 varian Omicron di Indonesia terus meningkat, kini ada di angka 1.626 kasus. Meski begitu, pemerintah memastikan belum akan menerapkan PPKM darurat atau lockdown. https://t.co/DKkyZItgGI",10,6,5,1,2022-01-24,8,Monday,1,15,7
1485533384030015489,2022-01-24 08:42:13,Emma Waroka dan Kim Hawt datangi Polda Metro Jaya pada Senin 24 Januari 2022 untuk melaporkan hilangnya akun media sosial mereka. https://t.co/YZy2lwPc86,30,21,2,5,2022-01-24,8,Monday,1,32,26
1485531886227181570,2022-01-24 08:36:16,Artis cilik Matthew White meninggal dunia saat dirawat di salah satu rumah sakit di Jakarta. Pihak manajemen mengatakan Matthew mengidap diabetes sejak lama. https://t.co/3pEMwPdjBV,47,4,19,4,2022-01-24,8,Monday,1,66,8
1485531600792207362,2022-01-24 08:35:08,"Menteri Keuangan Sri Mulyani pernah mengatakan : ""Jadilah ASN yang memiliki integritas, karena bekerja di bidang keuangan negara"". https://t.co/em28IzsL4g",10,0,3,0,2022-01-24,8,Monday,1,13,0
1485531573751619584,2022-01-24 08:35:01,Buku Sultan Agung dalam Goresan S Sudjojono resmi diluncurkan secara hibrid di Tumurun Private Museum Solo dan virtual via Zoom akhir pekan lalu. https://t.co/CYHpC1D0Oz,3,0,0,0,2022-01-24,8,Monday,1,3,0
1485530730864287748,2022-01-24 08:31:40,Polisi memutuskan memilih menyelesaikan masalah 'Lingkaran Setan' Ciamis di luar peradilan. Hal itu menyusul keluarga korban dan terlapor berdamai. https://t.co/etxldXkMX8,2,0,1,0,2022-01-24,8,Monday,1,3,0
1485530703836053507,2022-01-24 08:31:34,"""Kalau mau investasi ya di instrumen keuangan, juga dilihat kebutuhannya jangka pendek, menengah atau panjang, harus benar-benar tahu apa yang dibutuhkan,"" papar Pengamat Perasuransian Irvan Rahardjo.  https://t.co/qA0JLQbym2",3,0,1,0,2022-01-24,8,Monday,1,4,0
1485530351493689350,2022-01-24 08:30:10,Singkong goreng berbumbu ungkep ini gurih mekar dan garing ini bisa bikin nagih. Bumbunya gurih wangi bikin susah berhenti ngunyah. Cocok buat ngopi.  https://t.co/ILRBvEmhPY,32,1,14,4,2022-01-24,8,Monday,1,46,5
1485530339929952259,2022-01-24 08:30:07,"Restoran di Kuningan, Jawa Barat ini menarik perhatian dengan menu ikannya. Limerr Resto menawarkan olahan ikan arwana seharga Rp 2 juta seekor!  https://t.co/xYks9soGRG",2,2,0,0,2022-01-24,8,Monday,1,2,2
1485530053987471366,2022-01-24 08:28:59,#Foto Jaksa KPK menuntut hakim jatuhkan hukuman kepada Azis Syamsuddin selama 4 tahun dan 2 bulan penjara. Begini ekspresinya.... https://t.co/1dUJeWc9AB,3,0,1,0,2022-01-24,8,Monday,1,4,0
1485529740983287811,2022-01-24 08:27:44,Advokat Azam Khan meminta maaf apabila pernyataannya telah menyinggung masyarakat Kalimantan. Ini ungkapannya. https://t.co/QtDs8DYS3V,119,255,22,45,2022-01-24,8,Monday,1,141,300
1485529395561484289,2022-01-24 08:26:22,Penghasilan satpam dan pengemudi tertinggi ada di wilayah DKI Jakarta sebesar Rp 5.344.000 per bulan!  https://t.co/WRJniid0Fa,11,1,4,3,2022-01-24,8,Monday,1,15,4
1485528794576347141,2022-01-24 08:23:59,Festival musik When We Were Young nyatanya membuat banyak orang histeris dan berbondong-bondong hendak menyaksikannya. Ingat lagi band emo dahulu ini:  https://t.co/mcShMp8zPS,20,3,6,0,2022-01-24,8,Monday,1,26,3
1485528224289468416,2022-01-24 08:21:43,Terbongkar! Polisi mendatangi kerangkeng manusia di rumah Bupati Langkat. Begini penampakan kerangkeng manusia yang dibuat Bupati Langkat itu. https://t.co/LDgk1c51WR,633,81,177,80,2022-01-24,8,Monday,1,810,161
1485528018630098944,2022-01-24 08:20:54,Nasabah unit link mengharapkan OJK bisa menghentikan produk tersebut karena menimbulkan banyak kerugian. Bisa nggak ya?  https://t.co/TpBotOjbjA,5,1,1,1,2022-01-24,8,Monday,1,6,2
1485527994336698372,2022-01-24 08:20:48,"RSDC menyiapkan generator oksigen untuk isi ulang tabung per hari. Selain itu, disiapkan juga ruang intensive care unit berjumlah 89, dan saat ini terisi 24. https://t.co/oUKKIHxMy5",4,0,0,0,2022-01-24,8,Monday,1,4,0
1485527320446308355,2022-01-24 08:18:07,Puasa Senin Kamis adalah salah satu ibadah sunnah yang jarang ditinggalkan Rasulullah SAW. Berikut alasan Rasulullah SAW rajin puasa Senin Kamis.  https://t.co/xROUOkx3Qr,50,4,10,0,2022-01-24,8,Monday,1,60,4
1485527044196913155,2022-01-24 08:17:01,"#Foto Pengerjaan revitalisasi Taman Tebet masih berlangsung. Dilengkapi thematic garden hingga jembatan, menanti potret wajah baru program unggulan Anies. https://t.co/x26k6ljQWj

Foto: Agung Pambudhy/detikcom https://t.co/Zq0CWlvfWQ",6,4,1,0,2022-01-24,8,Monday,1,7,4
1485527034990317571,2022-01-24 08:16:59,Luhut Pandjaitan hari ini mengunjungi lokasi calon pelabuhan baru di Batam.  https://t.co/BMHVvxT3mw,7,1,1,0,2022-01-24,8,Monday,1,8,1
1485526778034720770,2022-01-24 08:15:58,Menariknya perbandingan UMP di Jakarta yang tertinggi dengan UMP di Jawa Tengah yang terendah memiliki perbedaan yang cukup jauh.  https://t.co/PkIlIrEX5y,4,0,0,1,2022-01-24,8,Monday,1,4,1
1485526534517575681,2022-01-24 08:15:00,"Pembukaan akan dilakukan untuk seksi I terlebih dahulu sepanjang 11,45 kilometer yang menghubungkan Cileunyi ke Pamulihan.  https://t.co/WZEj8NuM0F",12,5,0,0,2022-01-24,8,Monday,1,12,5
1485525089085009920,2022-01-24 08:09:15,"Paceklik gol Romelu Lukaku masih berlanjut. Namun, Thomas Tuchel tetap memuji penampilan Lukaku. https://t.co/Afe1vd8wSK",6,0,1,0,2022-01-24,8,Monday,1,7,0
1485524614038044673,2022-01-24 08:07:22,"Nanti malam ada Eureka! Segmen tanya jawab langsung bersama pakar sains. Temanya ngobrolin exoplanet, alien, dan UFO. Tanya yuk! #Eureka https://t.co/2ZGWduRHk4",9,2,1,0,2022-01-24,8,Monday,1,10,2
1485524359741677568,2022-01-24 08:06:21,"Terkait kenaikan COVID-19 RI akibat varian Omicron, Menkes menyebut tingkat penerapan prokes di lokasi-lokasi bakal dibuka ke publik lewat PeduliLindungi. Siap? https://t.co/4vsBWy7c4G",8,3,6,2,2022-01-24,8,Monday,1,14,5
1485523828289671170,2022-01-24 08:04:15,"Jika keinginan warga itu tak dipenuhi Jokowi, kata Edy, mungkin warga itu datang ke Amerika. https://t.co/NzP53EYfrU",24,22,8,9,2022-01-24,8,Monday,1,32,31
1485522849720942595,2022-01-24 08:00:21,Kedatangan Acha Septriasa ke kediaman Irwansyah menyita perhatian banyak orang. Irwansyah disebut penuh keberanian melewati momen itu. https://t.co/rAxMzYzkYA,13,0,1,0,2022-01-24,8,Monday,1,14,0
1485522506920468480,2022-01-24 07:58:59,"KIA Carens teranyar yang baru diluncurkan beberapa waktu lalu ternyata sangat diminati konsumen India. Hari pertama mobil MPV tersebut dijual, angka pemesanan mencetak rekor fantastis, dengan jumlah SPK (Surat Pemesanan Kendaraan) lebih dari 7.000 unit https://t.co/BtKsxcS1HF",2,1,1,0,2022-01-24,7,Monday,1,3,1
1485521927217233922,2022-01-24 07:56:41,"Mantan Wakil Ketua DPR RI, Azis Syamsuddin dituntut 4 tahun dan 2 bulan penjara, serta denda Rp 250 juta subsider 6 bulan kurungan. Jaksa menilai Azis Syamsuddin terbukti memberi suap. https://t.co/rYAVYVZw8q",4,0,3,2,2022-01-24,7,Monday,1,7,2
1485521912877010944,2022-01-24 07:56:38,Sejumlah wilayah di Indonesia mengalami fenomena astronomi ekuiluks dalam sebulan ke depan. Ada 39 kota yang mengalami fenomena ini. Ini daftarnya:  https://t.co/oLNtUZTJff,10,0,3,0,2022-01-24,7,Monday,1,13,0
1485521377897680896,2022-01-24 07:54:30,Rachel Vennya menyesal hancurkan diri sendiri gara-gara kabur karantina. Dia pun menceritakan kondisi saat ketahuan kabur karantina. #RachelVennya  https://t.co/4cnLQHCs5C,29,27,2,6,2022-01-24,7,Monday,1,31,33
1485520868054867972,2022-01-24 07:52:29,"Vicky Prasetyo sempat bikin heboh karena pengakuannya 24 kali nikah. Beredar isu bisa di-blacklist KUA, Vicky Prasetyo beri penjelasan ini:  https://t.co/liqmsqyxQh",11,3,5,4,2022-01-24,7,Monday,1,16,7
1485520377371574277,2022-01-24 07:50:32,"""Sudah berlangsung selama 10 tahun untuk merehabilitasi korban-korban narkoba, pengguna narkoba,"" kata Kapolda Sumut. https://t.co/Czr6gPV6kF",10,1,4,2,2022-01-24,7,Monday,1,14,3
1485520369620500483,2022-01-24 07:50:30,Sejarawan Indonesia Bonnie Triyana dilaporkan ke kepolisian Belanda lantaran kontroversi soal istilah 'Periode Bersiap'. https://t.co/k8kM7xfOEM,5,0,2,1,2022-01-24,7,Monday,1,7,1
1485519818681991169,2022-01-24 07:48:19,"Komite Olimpiade dan Paralimpiade AS meminta atletnya tak menggunakan ponsel pribadi saat bertanding di Olimpiade Musim Dingin di Beijing, China bulan depan. https://t.co/rCTz9aRvXm",7,0,1,0,2022-01-24,7,Monday,1,8,0
1485519564834328582,2022-01-24 07:47:18,Persib Bandung memaksimalkan jeda kompetisi untuk mempersiapkan diri dengan menggeber latihan untuk menatap lanjutan BRI Liga 1 2022. https://t.co/5KGeYaij5d,1,1,0,0,2022-01-24,7,Monday,1,1,1
1485519311615709185,2022-01-24 07:46:18,"Pemerintah memulai program vaksinasi booster yang tengah berjalan sejak 12 Januari 2022 lalu. Lalu, apa saja kegunaan vaksin booster yang perlu kita ketahui? https://t.co/op07FVmtHO",4,1,2,0,2022-01-24,7,Monday,1,6,1
1485518053043585026,2022-01-24 07:41:18,"Pegiat media sosial Edy Mulyadi bikin heboh karena menyebut Kalimantan tempat jin buang anak. Kini, Edy meminta maaf dan menjelaskan maksud pernyataannya itu. https://t.co/Pgo35xEt21",9,24,0,4,2022-01-24,7,Monday,1,9,28
1485517322584571905,2022-01-24 07:38:23,Masyarakat China memiliki tradisi mengenakan pakaian baru dalam menyambut datangnya tahun baru Imlek. Ini jenis pakaian khas yang dipakai saat Imlek:  https://t.co/NbblWCG30R,5,0,0,0,2022-01-24,7,Monday,1,5,0
1485516783037603845,2022-01-24 07:36:15,"Jika keinginan warga itu tak dipenuhi Jokowi, kata Edy, mungkin warga itu datang ke Amerika. https://t.co/NzP53FfQQu",29,29,5,6,2022-01-24,7,Monday,1,34,35
1485516758794526721,2022-01-24 07:36:09,"Operasional Kereta Cepat Jakarta-Bandung molor hingga Juni 2023. Lantas bagaimana progres pembangunan kereta cepat ini di kawasan Bandung? Yuk, lihat.  https://t.co/4wbO2wWXj6",3,0,0,2,2022-01-24,7,Monday,1,3,2
1485516023826722818,2022-01-24 07:33:14,"Viral para pemain Timnas Putri Indonesia foto bareng penyerang Australia, Sam Kerr setelah dibantai 0-18. https://t.co/kpDU6wJJ0g",14,5,1,0,2022-01-24,7,Monday,1,15,5
1485515434975715328,2022-01-24 07:30:53,"Serikat buruh menyesalkan temuan diduga kerangkeng manusia di Rumah Bupati Langkat, Terbit Rencana Perangin Angin. Serikat buruh meminta polisi usut. https://t.co/X0hTPaVfYs",5,0,4,0,2022-01-24,7,Monday,1,9,0
1485515209129218048,2022-01-24 07:30:00,Koordinator PPKM Jawa Bali Luhut menekankan pemerintah tak akan memberlakukan PPKM darurat atau opsi lockdown di tengah lonjakan kasus Omicron. https://t.co/6XGWkVf10V,36,33,5,7,2022-01-24,7,Monday,1,41,40
1485514469233106946,2022-01-24 07:27:03,"Pemeran utama broadway Harry Potter, James Synder, dipecat karena dugaan melakukan pelecehan. Saat ini, kasusnya tengah diselidiki. https://t.co/m8Z660vKxW",10,1,2,0,2022-01-24,7,Monday,1,12,1
1485513733103407104,2022-01-24 07:24:08,"Gubernur Jawa Barat Ridwan Kamil digadang-gadang bakal memimpin Ibu Kota Negara Nusantara usai Presiden Jokowi menginginkan kriteria seorang arsitek. RK juga menampung pendapat masyarakat soal Nusantara, kode siap pimpin Ibu Kota Negara? https://t.co/S21TZ8opzo",8,5,0,1,2022-01-24,7,Monday,1,8,6
1485512965667368961,2022-01-24 07:21:05,Gubernur Sumut (Gubsu) Edy Rahmayadi mengaku ditegur oleh Pemerintah Pusat. Ini katanya. https://t.co/BRX3dVjkqd,38,36,4,4,2022-01-24,7,Monday,1,42,40
1485512082883850241,2022-01-24 07:17:34,Saksi inisial AM sebut ide acara pembaiatan ISIS di Markas FPI di Makassar pada 2015 lalu berasal dari ceramah Habib Rizieq. Apa respons pengacara Munarman? https://t.co/Ldo0k6vBl6,3,3,0,0,2022-01-24,7,Monday,1,3,3
1485511326956937219,2022-01-24 07:14:34,"Rachel Vennya mengunggah video di YouTube-nya dengan judul Story of My Life. Di video tersebut, Rachel kembali menyampaikan penyesalan terkait kasus kabur karantina usai pelesiran dari Amerika Serikat. Ia bahkan mengaku takut bertemu orang. https://t.co/5SLYRX1x1y",59,84,7,34,2022-01-24,7,Monday,1,66,118
1485510798692782085,2022-01-24 07:12:28,"Arca Agung Maha Patih Gajah Mada di Mojokerto menjadi patung Gajah Mada tertinggi di Indonesia. Tetapi, patung Mahapatih Majapahit itu dikritik. https://t.co/JS0DO5MX6O",41,11,6,3,2022-01-24,7,Monday,1,47,14
1485510301147668482,2022-01-24 07:10:29,Konvoi mobil mewah di Tol jadi sorotan lantaran disebut berhenti untuk ambil dokumentasi. Akbar Rais yang ikut dalam rombongan beri penjelasan. https://t.co/4g6EURjo07,8,2,4,4,2022-01-24,7,Monday,1,12,6
1485509774909358081,2022-01-24 07:08:24,Semua kendaraan pelat hitam sama kedudukannya di mata hukum. Jadi pelat nopol khusus masih berasa punya privilege? https://t.co/Wwxyx39WFj,23,7,4,2,2022-01-24,7,Monday,1,27,9
1485509543601840133,2022-01-24 07:07:29,Kepopuleran mie goreng Indonesia sampai juga ke Australia. Terbukti dengan kreasi mie goreng satu panci yang dibuat oleh pengguna TikTok asal Australia ini.  https://t.co/jHQKZrYY8q,2,0,1,0,2022-01-24,7,Monday,1,3,0
1485509293520691200,2022-01-24 07:06:29,Manchester City terus nyaman di puncak Klasemen Liga Inggris. Sementara Manchester United tembus empat besar. https://t.co/YUiJPcI4Ye,12,0,2,0,2022-01-24,7,Monday,1,14,0
1485509008433848324,2022-01-24 07:05:21,Fico Fachriza direkomendasikan untuk jalani rehabilitasi. Fico akan jalani rehabilitasi di RSKO selama 6 bulan. https://t.co/28M1weCPti,3,2,1,0,2022-01-24,7,Monday,1,4,2
1485508476612788224,2022-01-24 07:03:14,"Seorang turis dari Belanda berlibur ke Auschwitz, Polandia. Niatnya hari mau hepi, eh malah ditahan polisi. https://t.co/t1zFXvWC22",7,0,3,1,2022-01-24,7,Monday,1,10,1
1485508218218557443,2022-01-24 07:02:13,"#FOTO Kawasan Pecinan di Glodok, Jakarta Barat semakin semarak dengan lampion dan pernak-pernik serba merah. Pertanda Imlek dirayakan sebentar lagi. https://t.co/t5PStQ0NKO",6,1,0,0,2022-01-24,7,Monday,1,6,1
1485507905977819142,2022-01-24 07:00:58,Luhut Pandjaitan bersama Budi Karya Sumadi meninjau lokasi calon Pelabuhan baru di Batam.  https://t.co/t12dOkU6Dv,6,0,0,0,2022-01-24,7,Monday,1,6,0
1485507889745833985,2022-01-24 07:00:54,"Menparekraf Sandiaga Uno memastikan travel bubble antara Indonesia dan Singapura akan diujicoba per hari ini (24/1). Bagi Sandiaga, hal tersebut memiliki prospek strategis dalam upaya membangkitkan ekonomi dan pariwisata nasional. #detiknetwork  https://t.co/CRk9brsChI",4,0,1,0,2022-01-24,7,Monday,1,5,0
1485507758728359937,2022-01-24 07:00:23,Viral di TikTok permen Yupi haram karena disebut terbuat dari kulit babi. Ini penjelasan dari LPPOM MUI dan PT Yupi Indo Jelly Gum!  https://t.co/HrQceHMzaB,4,5,3,2,2022-01-24,7,Monday,1,7,7
1485507612456198145,2022-01-24 06:59:48,"Di kelas mobil listrik murni, Lexus punya wakil dari kelas compact SUV yakni UX 300e. Seberapa ngebut mobil listrik Lexus? https://t.co/Gk9erQoDeR",5,0,0,0,2022-01-24,6,Monday,1,5,0
1485507599403556868,2022-01-24 06:59:45,"Dari sisi perekonomian, sumbangsih IKN baru terhadap pertumbuhan ekonomi hanya sebesar 0,02%.  https://t.co/yoKsudP9ym",9,6,2,0,2022-01-24,6,Monday,1,11,6
1485507269739651073,2022-01-24 06:58:27,Bandara Halim Perdanakusuma ditutup untuk revitalisasi. PT Angkasa Pura II menyiapkan skenario perpindahan operasional penerbangan ke lima bandara penerima. https://t.co/CrKvHoA3RS,2,0,0,0,2022-01-24,6,Monday,1,2,0
1485506766758686722,2022-01-24 06:56:27,Haduh! Seorang pria Irlandia menolak memakai masker di pesawat selama penerbangan dari Dublin ke New York dan memelorotkan celana di hadapan pramugari. https://t.co/AiEkscda2S,7,0,1,0,2022-01-24,6,Monday,1,8,0
1485506201303531521,2022-01-24 06:54:12,"Kemenkes RI mengumumkan penambahan kasus Omicron di Indonesia menyentuh 1.626 kasus. Bagi yang sudah divaksinasi, bagaimana gejalanya? https://t.co/Zjbq05y3eX",10,3,7,1,2022-01-24,6,Monday,1,17,4
1485505643968618498,2022-01-24 06:51:59,"Lima organisasi medis minta pemerintah evaluasi kegiatan PTM 100 persen. Pasalnya, kegiatan PTM 100 persen picu kekhawatiran karena kasus Omicron kian meningkat. https://t.co/lqgbOgMjnq",11,0,5,0,2022-01-24,6,Monday,1,16,0
1485505618190422019,2022-01-24 06:51:53,"Dunia hiburan dikejutkan dengan kabar duka. Aktor cilik pemain film Danur, Matthew White, meninggal dunia pada usia 12 tahun. Berikut profil Matthew yang dikenal memerankan sosok Hendrick. https://t.co/mV4fL0K3f1",7,0,0,0,2022-01-24,6,Monday,1,7,0
1485505073564336132,2022-01-24 06:49:43,Barcelona menyambut jeda internasional sebagai suatu keuntungan di tengah penampilan yang belum konsisten. https://t.co/t163nTzJ4x,3,1,0,0,2022-01-24,6,Monday,1,3,1
1485504485761982464,2022-01-24 06:47:23,"""Menurut saya ini memperlihatkan KPK tidak serius memproses kasus ini. Ini bukan kasus biasa, melibatkan internal KPK, salah seorang penyidiknya terlibat..."" kata Pukat UGM. https://t.co/oKaiDnddTw",28,5,12,4,2022-01-24,6,Monday,1,40,9
1485504107536388098,2022-01-24 06:45:53,Polisi ungkap misteri tewasnya Deti Suminarsih (38). Mayat penjual jamu asal Garut itu ditemukan di dalam kiosnya. Ternyata nyawa korban dihabisi suami. https://t.co/evBQg5skbg,3,0,0,0,2022-01-24,6,Monday,1,3,0
1485503554655858688,2022-01-24 06:43:41,Apakah ibu hamil boleh vaksin booster? Pertanyaan ini seringkali ditanyakan mengingat kondisi ibu hamil. Ini ketentuannya: https://t.co/ADsU2OGdaN,4,0,2,0,2022-01-24,6,Monday,1,6,0
1485503239130857478,2022-01-24 06:42:26,"Vaksinasi booster COVID-19 dimulai hari ini. Khusus wilayah Jakarta Barat, ini daftar lokasi vaksin booster COVID-19. Yuk merapat biar Omicron cepat tamat! https://t.co/BV1yrfL4U3",10,1,4,1,2022-01-24,6,Monday,1,14,2
1485502945546448901,2022-01-24 06:41:16,"Arsenal gagal mengalahkan klub di dasar klasemen Liga Inggris, Burnley. Netizen pun mengejek mereka di media sosial. https://t.co/xZJgN3NOnk",6,1,1,1,2022-01-24,6,Monday,1,7,2
1485502645804675072,2022-01-24 06:40:04,WhatsApp di desktop akan diberikan kemampuan untuk menjeda dan melanjutkan saat melakukan untuk perekaman pesan suara. #WhatsApp  https://t.co/yeoUBv0SO8,3,0,0,0,2022-01-24,6,Monday,1,3,0
1485502074926292994,2022-01-24 06:37:48,"Ketiak hitam menjadi salah satu permasalahan banyak wanita. Untuk mencerahkannya, kamu bisa menggunakan racikan dari makanan atau bahan alami.  https://t.co/wVK27s5H1d",9,0,0,0,2022-01-24,6,Monday,1,9,0
1485501580170379267,2022-01-24 06:35:50,"Kemenkes melaporkan sudah 1.369 kasus konfirmasi varian Omicron di Indonesia. Sebanyak 840 kasus merupakan PPLN, terbanyak datang dari Arab Saudi dan Turki. https://t.co/IFzSi7RTGR",7,1,3,1,2022-01-24,6,Monday,1,10,2
1485501086249197569,2022-01-24 06:33:52,Pihak kampus pun bertanggung jawab penuh atas pembiayaan sejak dari rumah sakit hingga proses pemakaman. Ubaya juga memberikan santunan pada keluarga korban. https://t.co/UciH666diJ,16,0,3,1,2022-01-24,6,Monday,1,19,1
1485500707910389763,2022-01-24 06:32:22,"Sony adalah perusahaan yang terkena dampak dari akuisisi Activision Blizzard oleh Microsoft, yang nilainya hampir mencapai Rp 1.000 triliun (USD 69 miliar). https://t.co/hRkiqddjyC",1,0,1,0,2022-01-24,6,Monday,1,2,0
1485500332478238728,2022-01-24 06:30:53,Liga 1 2021 memasuki pekan ke-21. Semua laga akan digelar di Bali. Berikut jadwalnya: https://t.co/yY73bcq7vu,2,0,0,0,2022-01-24,6,Monday,1,2,0
1485499804163747841,2022-01-24 06:28:47,Sensitif terhadap gula membuat penderita diabetes memiliki aturan makan yang ketat. Tetapi tujuh minuman enak ini ternyata masih diperbolehkan untuk dikonsumsi.  https://t.co/pArS6Uxqt7,7,1,2,0,2022-01-24,6,Monday,1,9,1
1485499507685081091,2022-01-24 06:27:36,"Beberapa makanan fermentasi ini memiliki segudang manfaat. Mulai dari teh kombucha, kimchi hingga keju yang bagus untuk kesehatan.  https://t.co/Vm9Cumv4rn",3,0,0,0,2022-01-24,6,Monday,1,3,0
1485499486776578052,2022-01-24 06:27:31,Ririe Fairus mulai berani membagi pengalamannya hadapi perselingkuhan dan perceraian dengan Ayus Sabyan. Ini awal mula Ririe tahu Ayus Sabyan selingkuh:  https://t.co/kKEt3OXg1B,8,1,0,0,2022-01-24,6,Monday,1,8,1
1485499133523902464,2022-01-24 06:26:07,Harga emas Antam hari ini turun Rp 1.000. Emas Antam hari ini dijual seharga Rp 944.000 per gram.  https://t.co/AIKAHWcbKJ,6,0,1,0,2022-01-24,6,Monday,1,7,0
1485499132357849089,2022-01-24 06:26:07,"Polda Metro Jaya akan memperketat proses permohonan STNK berpelat khusus. Sebab, banyak pelat 'RF' yang melanggar aturan. Ini aturannya. https://t.co/Gx3nV6qa9g",29,13,4,2,2022-01-24,6,Monday,1,33,15
1485498762214715392,2022-01-24 06:24:38,Jokowi menerbitkan Peraturan Presiden (Perpres) No. 2/2022 yang mengatur tentang Pengembangan Kewirausahaan Nasional 2021-2024.  https://t.co/nlTNhfSSC1,2,0,3,0,2022-01-24,6,Monday,1,5,0
1485498394617516034,2022-01-24 06:23:11,"Kekayaan Jeff Bezos turun karena saham Amazon turun. Posisinya digeser oleh bos Louis Vuitton, Bernard Arnault!  https://t.co/Si5phncr1P",4,1,0,0,2022-01-24,6,Monday,1,4,1
1485498393430573060,2022-01-24 06:23:10,"Stefan William membuka 2022 dengan meniti doa dan harapan bersama Ria Andrews. Tapi, masih saja ada yang julid. https://t.co/fZgiU0lutH",2,4,0,0,2022-01-24,6,Monday,1,2,4
1485498046192435201,2022-01-24 06:21:48,"Jokowi meresmikan groundbreaking proyek hilirisasi batu bara menjadi dimetil eter (DME), di Kabupaten Muara Enim, Sumatera Selatan. Menteri Investasi, Bahlil Lahadalia mengungkapkan proyek hilirisasi ini akan terealisasi dalam 30 bulan.  https://t.co/YNZO7nVLV7",5,1,1,0,2022-01-24,6,Monday,1,6,1
1485498035136352257,2022-01-24 06:21:45,"""Ini Amerika investasinya cukup gede pak. Ini investasi kedua nomor dua setelah Freeport yang terbesar untuk tahun ini pak,"" papar Bahlil Lahadalia https://t.co/JkShVxRWwi",5,0,2,1,2022-01-24,6,Monday,1,7,1
1485497706999128081,2022-01-24 06:20:27,"Timnas Putri Indonesia kalah 0-18 dari Australia,  dengan hasil ini membuka mata betapa tertinggalnya pembinaan sepakbola putri di Indonesia. https://t.co/EBD3wA3AuR",19,5,1,1,2022-01-24,6,Monday,1,20,6
1485497685792763905,2022-01-24 06:20:22,"Punya cara unik merayakan pernikahan, pengantin ini hadirkan kue yang tak biasa. Ada kue tengkorak hingga berbentuk burger yang disajikan di pesta pernikahan.  https://t.co/naTVjBhsSi",2,0,1,0,2022-01-24,6,Monday,1,3,0
1485496892838531073,2022-01-24 06:17:13,Apa jadinya Yamaha Fazzio pakai gaya ala Vespa Sean Wotherspoon? berikut tampilannya! https://t.co/nC4Ea0UErf,19,0,3,1,2022-01-24,6,Monday,1,22,1
1485496876371742721,2022-01-24 06:17:09,Kira-kira sisa berapa ya? https://t.co/xZWJUdecpY,912,1409,111,140,2022-01-24,6,Monday,1,1023,1549
1485496629570555904,2022-01-24 06:16:10,#WargaKalimantanBukanMonyet menggema di Twitter. Ini alasan kenapa Kalimantan Timur cocok jadi Ibu Kota Negara.  https://t.co/SAJzI0bVw2,12,2,2,3,2022-01-24,6,Monday,1,14,5
1485496607411953667,2022-01-24 06:16:05,Saham-saham perusahaan teknologi di AS turun. Hal ini membuat kekayaan Elon Musk hingga Mark Zuckerberg pun ikut turun.  https://t.co/J9u6uwuDJm,2,0,1,1,2022-01-24,6,Monday,1,3,1
1485496316385972224,2022-01-24 06:14:55,"Ikan kembung yang berdaging padat dengan ras gurih. Cocok diolah dengan bumbu cabe, bawang putih atau pepes. Cocok buat lauk enak di tanggal tua.  https://t.co/RwB5ld2KuI",10,0,3,0,2022-01-24,6,Monday,1,13,0
1485495734715703296,2022-01-24 06:12:36,"Garena Indonesia berikan kode redeem Free Fire gratis, dalam rangka merayakan gelar yang baru saja didapatkan, yakni Most Downloaded Mobile Game. https://t.co/lz7cM8oGNO",2,0,0,0,2022-01-24,6,Monday,1,2,0
1485495205071667204,2022-01-24 06:10:30,Proyek hilirisasi batu bara menjadi dimethyl ether (DME) di Kabupaten Muara Enim bakal mengurangi impor khususnya liquified petroleum gas (LPG).  https://t.co/JVNpIplzbA,30,2,2,0,2022-01-24,6,Monday,1,32,2
1485495196322254848,2022-01-24 06:10:28,"Terkait peningkatan varian Omicron, kelima organisasi profesi medis meminta keberlangsungan PTM 100 persen dievaluasi. Seperti apa usulannya? https://t.co/vUg9bjzopo",7,0,3,0,2022-01-24,6,Monday,1,10,0
1485494954436796417,2022-01-24 06:09:30,"""Ini perintah sudah 6 tahun lalu saya sampaikan tapi memang kita ini sudah berpuluh-puluh tahun nyaman dengan impor, ada yang nyaman dengan impor,"" papar Jokowi  https://t.co/Dg0H6TLwcv",27,22,3,4,2022-01-24,6,Monday,1,30,26
1485494953367248896,2022-01-24 06:09:30,"Legenda sepakbola Inggris, Alan Shearer mengatakan, Liverpool tak seharusnya mendapat penalti. https://t.co/Rgft00HUY0",4,0,0,0,2022-01-24,6,Monday,1,4,0
1485494465322233857,2022-01-24 06:07:34,"Setelah merilis TV seri Q725 berukuran 65, 55, dan 50 inch, kini TCL memboyong TV berpanel QLED tersebut dengan ukuran 43 inch. https://t.co/Pedj7RRFHV",7,0,1,0,2022-01-24,6,Monday,1,8,0
1485494160924807172,2022-01-24 06:06:21,"Kondisi perekonomian Indonesia pada 2022 diprediksi semakin membaik dan menjadi momentum pemulihan. Meski begitu, masih ada beberapa tantangan  https://t.co/pdBmD99NZY",9,0,2,0,2022-01-24,6,Monday,1,11,0
1485494159737769985,2022-01-24 06:06:21,Kopi hitam dan dark chocolate sangat dianjurkan untuk dikonsumsi karena manfaatnya sehatnya. Seorang peneliti di Amerika mengungkapkan alasannya.  https://t.co/ym06X1X1o1,9,1,6,2,2022-01-24,6,Monday,1,15,3
1485493641078620162,2022-01-24 06:04:17,Kasus aktif COVID-19 di Kota Malang naik signifikan dalam beberapa pekan terakhir. Total saat ini ada 82 kasus aktif COVID-19. 15 Di antaranya sembuh. https://t.co/lgpyZjt1xh,8,3,3,5,2022-01-24,6,Monday,1,11,8
1485493085350019074,2022-01-24 06:02:05,Beberapa tempat makan di ITC Mangga Dua ini viral karena kelezatannya. Ada pula cerita bule yang 'korbankan' diet vegetariannya demi cicip babi guling.  https://t.co/KrJA9TCJF9,10,0,1,1,2022-01-24,6,Monday,1,11,1
1485492712136757255,2022-01-24 06:00:36,Sejumlah nasabah Prudential hari ini mendatangi kantor Prudential di Mal Kota Kasablanka. Seperti ini pengakuannya.  https://t.co/LrdENe7bYe,41,20,14,13,2022-01-24,6,Monday,1,55,33
1485492459811614723,2022-01-24 05:59:36,"Bahannya sederhana, sambal goreng krecek tahu ini enak buat lauk makan siang. Kenyal gurih krecek dan tahu dengan santan mantap disantap dengan nasi hangat.  https://t.co/SzEaGOGogV",6,0,1,0,2022-01-24,5,Monday,1,7,0
1485492221466091522,2022-01-24 05:58:39,Pemkab Banyuwangi menyulap tempat yang disebut angker menjadi Grand Watu Dodol (GWD). Sekarang GWD menjadi salah satu tujuan wisatawan. https://t.co/omfb4uTh6F,5,0,2,1,2022-01-24,5,Monday,1,7,1
1485491716601880577,2022-01-24 05:56:38,Karim Benzema cedera di laga Real Madrid dan rumahnya kemalingan ketika sedang bertanding! https://t.co/fFveZreO8A,8,0,1,0,2022-01-24,5,Monday,1,9,0
1485491217886502913,2022-01-24 05:54:40,"Apple tampaknya semakin menghargai murah ponsel Android, meskipun kelasnya flagship.  https://t.co/fyQD5qVYq7",10,1,3,0,2022-01-24,5,Monday,1,13,1
1485490732160983040,2022-01-24 05:52:44,Pemerintah menerapkan travel bubble dari Singapura ke Bintan dan Batam di Kepulauan Riau mulai hari ini. Berikut aturan dan syaratnya: https://t.co/Fit5u0oId2,8,0,3,1,2022-01-24,5,Monday,1,11,1
1485490427985813506,2022-01-24 05:51:31,Eric THE BOYZ positif COVID-19. Jadwal grup ini selama beberapa waktu kedepan akan disesuaikan. https://t.co/q2zJaFJvOo,4,0,1,1,2022-01-24,5,Monday,1,5,1
1485489885456871427,2022-01-24 05:49:22,Superyacht 80 meter yang digencet terjepit di bawah jembatan tidak dapat dilihat setiap hari. Jaraknya dengan dek teratas hanya beberapa sentimeter. https://t.co/agDnFdduXv,7,0,1,0,2022-01-24,5,Monday,1,8,0
1485489077596078094,2022-01-24 05:46:09,"Turnamen Mobile Legends Wanita, Woman Star League Season 4 telah berakhir. Belletron Era berhasil menyabet gelar Juara, dengan mengalahkan GPX Basreng. https://t.co/u82naiD6u2",8,1,2,1,2022-01-24,5,Monday,1,10,2
1485488603664953344,2022-01-24 05:44:16,"Kementerian Kesehatan RI memperbarui data kasus Omicron di Indonesia. Per 22 Januari 2022, ada total 1.396 kasus Omicron di Tanah Air. https://t.co/J7LZwc2qtp",7,1,3,0,2022-01-24,5,Monday,1,10,1
1485487829077696513,2022-01-24 05:41:12,Song Jia tuai kritik setelah ketahuan memakai baju Chanel palsu. Begini kabar terbaru sang influencer yang dilarang membaca komentar Instagram:  https://t.co/hS8uIKrWKi,3,0,1,0,2022-01-24,5,Monday,1,4,0
1485487804029284353,2022-01-24 05:41:06,Sebuah video seorang pria digelandang warga di Pacitan viral. Lelaki yang mengenakan jaket mirip seragam ojol itu tampak dibawa keluar dari sebuah rumah. https://t.co/00WKZ1PUO8,3,0,1,0,2022-01-24,5,Monday,1,4,0
1485487265468063752,2022-01-24 05:38:57,TMII yang tampak terbengkalai ternyata sedang dalam pengembangan ulang dan renovasi. Wajah baru TMII akan diluncurkan ulang pada tahun ini. https://t.co/aTzuQYPzbe,12,0,2,1,2022-01-24,5,Monday,1,14,1
1485486728915951618,2022-01-24 05:36:49,Rahma (14) dilaporkan hilang oleh keluarganya di Jakarta Pusat. Kamu yang mengetahui keberadaan Rahma bisa membantu dengan memberikan informasi. #detiktif https://t.co/xzpyV3k8u0,18,0,30,1,2022-01-24,5,Monday,1,48,1
1485486419099492353,2022-01-24 05:35:35,"Chef Steby Rafael pun turut berbagi kiat praktis untuk membuat liwetan. Ia mengatakan, kini nasi liwet bisa dimasak dengan praktis menggunakan rice cooker.  https://t.co/ZkbonTdMXO",3,0,1,0,2022-01-24,5,Monday,1,4,0
1485485768776855552,2022-01-24 05:33:00,"Desa Sembalun yang berada di kaki Gunung Rinjani, Lombok Timur, NTB ini memiliki hidangan khas dari ikan nila. Terasa sedap dimasak dengan bumbu kuning gurih.  https://t.co/9PJQgj9gak",30,2,7,1,2022-01-24,5,Monday,1,37,3
1485484986413297665,2022-01-24 05:29:54,"Setelah susut 35 kg, Rebel Wilson tampaknya ingin memulai hidup baru, termasuk mencari pacar. Ia dikabarkan mencari pasangan tanpa melihat gender. https://t.co/IPzPvV09Zx",10,2,0,0,2022-01-24,5,Monday,1,10,2
1485484426574376962,2022-01-24 05:27:40,Sejumlah wilayah di Indonesia akan mengalami fenomena astronomi bernama ekuiluks. Apa itu ekuiluks dan akan terjadi di wilayah mana saja? Apakah ada dampak yang ditimbulkan? Yuk simak penjelasan lengkapnya: https://t.co/0HEQKmUzDA,6,0,2,0,2022-01-24,5,Monday,1,8,0
1485483918782521345,2022-01-24 05:25:39,SpaceX terus menambah jumlah konstelasi satelit Starlink untuk memancarkan internet dari luar angkasa ke Bumi. #SpaceX  https://t.co/L47QAREsiW,3,0,0,0,2022-01-24,5,Monday,1,3,0
1485483408889425923,2022-01-24 05:23:38,"Park Shin Hye mengunggah foto prewedding berbusana tradisional. Meski mengenakan baju yang terkesan formal, pasangan itu sempat berpose kocak. https://t.co/y2fz6XeYhK",8,0,0,0,2022-01-24,5,Monday,1,8,0
1485482825713340416,2022-01-24 05:21:19,"Matthew White meninggal dunia di salah satu rumah sakit di Jakarta setelah berjuang lawan sakit diabetes. Kini, aktor berusia 12 tahun itu dimakamkan di Tegal. https://t.co/ZlDpPgnRKs",147,14,37,9,2022-01-24,5,Monday,1,184,23
1485482541175955457,2022-01-24 05:20:11,Bella Shofie blak-blakan menuturkan terkena virus Omicron saat liburan di AS. Ini yang dilakukan Bella Shofie saat tahu kena Omicron:  https://t.co/pGR6sUglL9,6,2,0,0,2022-01-24,5,Monday,1,6,2
1485482260660989954,2022-01-24 05:19:04,Kecelakaan maut terjadi di Balikpapan akibat sebuah truk mengalami rem blong. Truk tersebut memiliki dimensi yang tidak standar. https://t.co/XL0A8XKKi8,6,1,1,0,2022-01-24,5,Monday,1,7,1
1485481495024345088,2022-01-24 05:16:01,"Direktur Eksekutif Parameter Politik Indonesia, Adi Prayitno, menyebut saling sindir Gubernur DKI Jakarta Anies Baswedan dengan Ketua Umum PSI, Giring Ganesha, bisa menyehatkan demokrasi. Adi menyebut PSI melakukan itu sebagai pengawas kinerja Anies. https://t.co/7TIWrxF811",4,2,1,0,2022-01-24,5,Monday,1,5,2
1485481259069550595,2022-01-24 05:15:05,Bursa Efek Indonesia (BEI) merilis daftar terbaru perusahaan yang masuk pemantauan khusus. Ada PT Garuda Indonesia (Persero) Tbk (GIAA).  https://t.co/zolsS2KYyx,1,0,1,0,2022-01-24,5,Monday,1,2,0
1485481236831293446,2022-01-24 05:15:00,Timnas Indonesia akan melawan Timnas Timor Leste dalam laga jeda internasional. Berikut jadwalnya! https://t.co/eiq2Orpt76,2,0,0,0,2022-01-24,5,Monday,1,2,0
1485480991410073601,2022-01-24 05:14:01,"Kebakaran terjadi di klub malam Livs, Yaounde, Kamerun saat menggelar nobar piala Afrika. Sedikitnya 17 orang tewas akibat peristiwa tersebut. https://t.co/95D24uiEpX",13,0,0,0,2022-01-24,5,Monday,1,13,0
1485480464399937536,2022-01-24 05:11:56,Saksi menceritakan awal mula ide acara pembaiatan ISIS di Markas FPI di Makassar pada 2015 lalu. Saksi sebut de itu muncul dari ceramah Habib Rizieq. https://t.co/9pWwF1VM4R,23,2,7,1,2022-01-24,5,Monday,1,30,3
1485480197772267524,2022-01-24 05:10:52,"""Impor kita LPG itu gede banget mungkin Rp 80 triliun, dari kebutuhan Rp 100-an triliun impornya,"" ujar Jokowi  https://t.co/ZT3lom8d8w",3,4,1,1,2022-01-24,5,Monday,1,4,5
1485480196518129672,2022-01-24 05:10:52,"Gubernur Jawa Tengah, Ganjar Pranowo, mengikuti kegiatan susur Sungai Sekanak, Palembang. Kehadiran Ganjar pun tak terlepas dari sambutan meriah emak-emak yang berada di sekitar sungai. https://t.co/EirGdNNDTS",20,4,3,3,2022-01-24,5,Monday,1,23,7
1485479915382259713,2022-01-24 05:09:45,Menko Perekonomian Airlangga Hartarto menyatakan Indonesia butuh investasi sebesar Rp 5.900 triliun di tahun 2022 ini.  https://t.co/RR2J8zM16r,10,6,2,0,2022-01-24,5,Monday,1,12,6
1485479914057138180,2022-01-24 05:09:45,Rasyid Rajasa terbilang masih muda dan banyak menjalin pertemanan dengan orang baru. Ia pun mengaku pertemanannya dengan banyak orang adalah salah satu cara untuk membangun networking. https://t.co/L4A1pRBqYN,7,1,2,1,2022-01-24,5,Monday,1,9,2
1485479140853751809,2022-01-24 05:06:40,"Matthew White meninggal dunia. Semasa hidup, ia memiliki riwayat sakit diabetes. Selamat jalan Matthew White...  https://t.co/brOgdzVnzz",56,4,6,1,2022-01-24,5,Monday,1,62,5
1485478280467828736,2022-01-24 05:03:15,"Suara ledakan keras terdengar di Jalan KH Ahmad Dahlan, Kelurahan Pancuran Bambu, Kecamatan Sibolga Sambas, Kota Sibolga, Senin (24/01/2022) https://t.co/V7yWndn2u4",5,0,0,0,2022-01-24,5,Monday,1,5,0
1485478164939825154,2022-01-24 05:02:48,"Spotify masih merajai pasar musik streaming global. Pada Q2 2021, platform streaming musik asal Swedia itu memegang 31% pangsa pasar. https://t.co/N2TC5zBNmC",11,0,0,0,2022-01-24,5,Monday,1,11,0
1485477891089571841,2022-01-24 05:01:42,Jaksa KPK ungkap sejumlah pertimbangan memberatkan dan meringankan sebelum menuntut Azis Syamsuddin dengan pidana penjara 4 tahun 2 bulan. https://t.co/eN8PlSr9Lc,2,1,2,0,2022-01-24,5,Monday,1,4,1
1485477881379803137,2022-01-24 05:01:40,EmojiMix tengah viral di TikTok. Begini cara membuat EmojiMix di HP: #EmojiMix  https://t.co/jAQ2kRs35U,1,0,0,0,2022-01-24,5,Monday,1,1,0
1485477241802866689,2022-01-24 04:59:07,Petugas Damkar Kabupaten Ciamis menangkap seekor ular sanca kembang. Ular ini meresahkan warga lantaran kerap memangsa hewan ternak. #Ciamis https://t.co/cNLlwOsKI8,6,1,0,1,2022-01-24,4,Monday,1,6,2
1485477215051595778,2022-01-24 04:59:01,Samsung Galaxy S series di Indonesia selalu hadir dengan chip Exynos. Rumor terbaru menyebutkan Galaxy S22 untuk Asia Tenggara akan menggunakan chip Snapdragon.  https://t.co/NdQgzhBfJV,10,2,7,1,2022-01-24,4,Monday,1,17,3
1485476716055252995,2022-01-24 04:57:02,"Sergio Ramos baru saja mencetak gol pertamanya untuk PSG, ia mengakui kesulitan beradaptasi. https://t.co/RhAy23dodx",4,1,2,0,2022-01-24,4,Monday,1,6,1
1485476233794125826,2022-01-24 04:55:07,"Deretan foto ini tidak hanya bikin kamu terkecoh, saat melihatnya sekilas mata akan dibuat bingung. Buktikan sendiri jika kamu tidak percaya:  https://t.co/1GUbPV6GFE",5,0,0,0,2022-01-24,4,Monday,1,5,0
1485475721590067201,2022-01-24 04:53:05,"Duo psikolog dan penasehat seks beberkan bagaimana warna pakaian dalam yang kamu pakai dapat bercerita mengenai kepribadian, mood, emosi, dan perasaan. https://t.co/M2Q0b90oaV",5,0,0,0,2022-01-24,4,Monday,1,5,0
1485474959132667907,2022-01-24 04:50:03,"Beberapa pengguna iPhone 13 mengeluhkan terjadinya ""pink screen"". Diduga, layar perangkat mereka tiba-tiba berwarna pink karena kerusakan software. #iPhone13  https://t.co/hnFeDY0zEo",13,3,6,3,2022-01-24,4,Monday,1,19,6
1485474650335461377,2022-01-24 04:48:50,AC Milan imbang lawan Juventus. Kedua tim gagal menciptakan gol hingga pertandingan berakhir. https://t.co/WAARIDxeFw,7,1,2,2,2022-01-24,4,Monday,1,9,3
1485473652573409281,2022-01-24 04:44:52,Gubernur DKI Anies Baswedan saling berbalas komentar dengan Ketum PSI Giring Ganesha. Mulai dari pujian Anies ‘tanpa suara sumbang’ untuk Nidji sampai soal Giring kejeblos di lahan untuk sirkuit Formula E Ancol. https://t.co/IZ1wsSS8JC,7,9,2,0,2022-01-24,4,Monday,1,9,9
1485473633657044998,2022-01-24 04:44:47,"Hakim Ziyech lagi on fire, lagi dan lagi mecetak gol indah untuk bungkam Tottenham Hotspur. https://t.co/IQHEnFnoRO",6,0,0,0,2022-01-24,4,Monday,1,6,0
1485473238448803844,2022-01-24 04:43:13,"Aksi konnvoi mobil mewah di jalan Tol Depok-Antasari menjadi sorotan publik. Namun, tidak ada sanksi tilang yang diberikan polisi. Ini pertimbangannya. https://t.co/eik8gCB5uF",88,126,20,28,2022-01-24,4,Monday,1,108,154
1485471492519436289,2022-01-24 04:36:17,"Eks Sekjen PDIP, Pramono Anung, menceritakan ketegasan Megawati Soekarnoputri dalam memimpin partai. Pramono pun teringat kala Megawati mengancam memecat kader yang melakukan interupsi ketika sidang tahunan era SBY. https://t.co/nB8UAYtcQ7",5,1,1,0,2022-01-24,4,Monday,1,6,1
1485471476123947009,2022-01-24 04:36:13,Azis Syamsuddin dituntut 4 tahun dan 2 bulan penjara dan denda Rp 250 juta subsider 6 bulan kurungan! https://t.co/l8r1y9aDbs,16,10,4,1,2022-01-24,4,Monday,1,20,11
1485471262369533955,2022-01-24 04:35:22,"Netizen geram dengan pernyataan seorang pria yang menghina kota Kalimantan, tagar #WargaKalimantanBukanMonyet pun puncaki trending di linimasa Twitter. https://t.co/OZq2WZm9Ib",109,28,27,10,2022-01-24,4,Monday,1,136,38
1485471245244289028,2022-01-24 04:35:18,"Mantan perdana menteri Malaysia Mahathir Mohamad menjalani perawatan di rumah sakit khusus jantung. Dikabarkan sempat menjalani 'prosedur elektif', apa itu? https://t.co/vOB3DPpdPv",4,0,3,0,2022-01-24,4,Monday,1,7,0
1485469383912787969,2022-01-24 04:27:54,"Polisi menganggap konvoi mobil tersebut mengakibatkan kemacetan lantaran melakukan kegiatan foto-foto. Peserta konvoi, Akbar Rais, memberikan klarifikasinya. https://t.co/ZhnJZYQc2V",13,6,2,3,2022-01-24,4,Monday,1,15,9
1485469360764379139,2022-01-24 04:27:48,"Achmad Megantara resmi mempersunting kekasihnya, Asri Faradila. Ini yang bikin Achmad Megantara yakin menikah dengan Asri Faradila:  https://t.co/EN5A6EJqC4",14,1,3,0,2022-01-24,4,Monday,1,17,1
1485467610531700737,2022-01-24 04:20:51,"Ketua DPP Partai Golkar, Dave Laksono, mengungkap partainya sudah mengantongi sejumlah nama yang dipertimbangkan untuk diusung sebagai calon wakil presiden mendampingi Airlangga Hartarto di Pilpres 2024.  https://t.co/SjDugBqitJ",9,0,2,1,2022-01-24,4,Monday,1,11,1
1485466869825953793,2022-01-24 04:17:55,"NetEase dikabarkan akan meluncurkan game terbaru, Hyper Front, dari segi mekanik dan tampilan, diduga serupa dengan Valorant. https://t.co/hlJNuZs2JF",5,1,4,0,2022-01-24,4,Monday,1,9,1
1485466378752733185,2022-01-24 04:15:57,"Founder dari Geng Kapak (GPX), Oura dan Marsha, terpilih sebagai Top Streamer 2021. Mereka mendapatkannya di ajang penghargaan Nimo TV Gala 2021. https://t.co/aRmORhk4hH",6,0,2,1,2022-01-24,4,Monday,1,8,1
1485465864069693442,2022-01-24 04:13:55,"Dear Libra, bisnis lagi diserang dari kanan dan kiri maka harus ekstra waspada. Simak ramalan zodiak hari ini: https://t.co/UX0SCGcTeS",4,0,1,0,2022-01-24,4,Monday,1,5,0
1485465363877875716,2022-01-24 04:11:56,"#Foto Bila umumnya maling menjual motor hasil curian, aksi pencuri di Sukabumi ini terbilang nyeleneh. Ia malah bakar motor curian karena kesal motor tak menyala. Waduh! https://t.co/txkmozZDPJ

Foto: Syahdan Alamsyah/detikcom https://t.co/prWYvqkWq0",27,13,11,5,2022-01-24,4,Monday,1,38,18
1485465126492848129,2022-01-24 04:10:59,Dwi Andhika akhirnya buka suara terkait alasannya dirinya tak pernah ikut mengomentari polemik keluarga Vanessa Angel dan Bibi. Dhika mengaku ingin menghormati almarhum dan almarhumah dengan tidak ikut campur urusan tersebut. https://t.co/SvYII2UIB9,7,1,4,0,2022-01-24,4,Monday,1,11,1
1485464647901851649,2022-01-24 04:09:05,"The King Of Tears, Lee Bang Won jadi kontroversi usai melakukan penyiksaan pada seekor kuda. KBS memutuskan menghentikan penayangan drama tersebut. https://t.co/4s6JEwCDOy",5,1,1,0,2022-01-24,4,Monday,1,6,1
1485463882550415363,2022-01-24 04:06:02,"Para ilmuwan telah lama mengetahui kehidupan di luar angkasa berdampak buruk pada fisik astronaut. Salah satunya, membuat mereka menderita anemia. https://t.co/PqOjYxo1W6",12,1,7,1,2022-01-24,4,Monday,1,19,2
1485463378059530240,2022-01-24 04:04:02,"Edy Mulyadi berbohong soal IKN akan dibangun oleh China dan dihuni oleh orang China. Sampai saat ini, belum ada kejelasan soal proyek IKN. https://t.co/X3BUxwFupl",43,30,7,9,2022-01-24,4,Monday,1,50,39
1485462816538730499,2022-01-24 04:01:48,Direktorat Jenderal Pengelolaan Pembiayaan dan Risiko Kementerian Keuangan menerbitkan instrumen investasi obligasi negara ritel (ORI) seri 021 atau ORI021.  https://t.co/NIjZIeAoZP,9,1,1,0,2022-01-24,4,Monday,1,10,1
1485462573965271042,2022-01-24 04:00:50,Proyek hilirisasi batu bara pengganti LPG akhirnya dimulai. Ditandai dengan peletakan batu pertama proyek hilirisasi tersebut oleh Jokowi.  https://t.co/r7qyXdLch1,8,0,1,2,2022-01-24,4,Monday,1,9,2
1485462572740616198,2022-01-24 04:00:50,Bendahara umum DPC Partai Demokrat menjadi tersangka KPK di usia yang masih muda yaitu 24 tahun. Simak yuk fakta soal Nur Afifah Balqis yang turut tertangkap. #detiknetwork  https://t.co/LVFx0uXfrW,10,0,5,1,2022-01-24,4,Monday,1,15,1
1485462205512433666,2022-01-24 03:59:23,Kementerian PUPR melakukan penandatanganan kontrak paket tender seleksi dini untuk tahun anggaran 2022.  https://t.co/iGQ0oQgSzo,7,2,1,2,2022-01-24,3,Monday,1,8,4
1485461627180916740,2022-01-24 03:57:05,Irwansyah dan Zaskia Sungkar kedatangan Acha Septriasa di rumahnya. Ini momen pertemuan mereka:  https://t.co/mIX0zGIz1b,10,2,1,1,2022-01-24,3,Monday,1,11,3
1485461610185568265,2022-01-24 03:57:01,"Berikut beberapa jadwal vaksinasi COVID-19 baik dosis 1-2 maupun booster bagi warga Kota Pekalongan, Jawa Tengah. Simak syarat dan lokasinya ya: https://t.co/TbA24LUCVR",2,0,0,0,2022-01-24,3,Monday,1,2,0
1485460429816094720,2022-01-24 03:52:19,"Haikal Hassan membantah peristiwa penolakan dan pengusiran saat akan mengisi ceramah di Malang, Jatim. Menurutnya peristiwa tersebut hanya fitnah sosial media. https://t.co/vzbj810Qlt",5,8,2,0,2022-01-24,3,Monday,1,7,8
1485460185267253251,2022-01-24 03:51:21,"Menurut Jorge Lorenzo bukan Pecco Bagnaia yang jadi pebalap yang bakal kasih kejutan besar, lalu siapa? https://t.co/jblCYeKyJe",6,0,1,0,2022-01-24,3,Monday,1,7,0
1485459671041417219,2022-01-24 03:49:18,WHO memberikan prediksi menggembirakan mengenai pandemi COVID-19. Varian Omicron disebut akan membuat fase baru dan mengakhiri pandemi. https://t.co/tQbn8IipPc,113,24,53,16,2022-01-24,3,Monday,1,166,40
1485459425079054342,2022-01-24 03:48:20,Instagram telah mengambil langkah baru untuk membuat konten-konten yang dinilai berpotensi berbahaya untuk tidak terlalu terlihat di aplikasinya. https://t.co/a8wacsAI3G,10,0,2,0,2022-01-24,3,Monday,1,12,0
1485458863289733126,2022-01-24 03:46:06,"Pengguna sepeda motor konversi menghemat pengeluaran biaya BBM Rp 2,78 juta/tahun, belum termasuk biaya ganti oli.  https://t.co/fkyEqU6QAY",10,3,3,2,2022-01-24,3,Monday,1,13,5
1485458579666649097,2022-01-24 03:44:58,"Bella Shofie dan suaminya, sedang jalani karantina di salah satu hotel di Indonesia. Begini pengakuan Bella Shofie kena Omicron saat liburan di AS:  https://t.co/79gIH9vdJj",15,12,2,2,2022-01-24,3,Monday,1,17,14
1485457894661308417,2022-01-24 03:42:15,"Aksi maling di Sukabumi ini terbilang nyeleneh. Diduga kesal motor hasil curiannya tidak menyala, pelaku nekat melempar dan membakar motor itu. Ada- ada saja!
#Sukabumi https://t.co/gxTmQ5lt3j",10,2,4,2,2022-01-24,3,Monday,1,14,4
1485457556785057796,2022-01-24 03:40:54,"Komunitas korban asuransi Axa Mandiri, Prudential dan AIA akan mengadukan masalah yang mereka hadapi ke Jokowi!  https://t.co/tM9y91kVgv",22,15,6,0,2022-01-24,3,Monday,1,28,15
1485457058833084419,2022-01-24 03:38:55,"Kartika Berliana tidak bisa mengambil pekerjaan di luar kota karena pandemi COVID-19. Padahal, ia banyak diminta menjadi MC. https://t.co/pDNmegGRoJ",11,2,2,0,2022-01-24,3,Monday,1,13,2
1485456324704018433,2022-01-24 03:36:00,Ada 5 jenderal TNI yang sempat bertugas sebagai 'pendamping' Jokowi. Mereka pernah menjadi ajudan Jokowi hingga Danpaspampres. Berikut daftarnya: https://t.co/T72yI7KQiV,10,0,3,0,2022-01-24,3,Monday,1,13,0
1485456038702854146,2022-01-24 03:34:52,"Usai bermain imbang 0-0 dengan Juventus, Milan mesti mengalahkan Inter Milan demi terus dalam persaingan gelar juara. https://t.co/M23ZkP6uIh",2,1,1,0,2022-01-24,3,Monday,1,3,1
1485454994782539781,2022-01-24 03:30:43,"Polisi menindak ratusan pengendara mobil berpelat 'RF' di Jakarta. Mereka ditindak karena langgar ganjil genap hingga pakai rotator. Haduh, jangan ditiru! https://t.co/Hk5zi1rGkm",67,23,26,5,2022-01-24,3,Monday,1,93,28
1485454983017414661,2022-01-24 03:30:41,"PTM 100 persen mulai digelar di Depok, Senin (24/1/2022). Berikut aturan penyelenggaraan PTM 100 persen di Depok untuk jenjang TK hingga SMA. 
Via: detikedu  https://t.co/PWx45JLWIO",8,0,2,0,2022-01-24,3,Monday,1,10,0
1485454216395214850,2022-01-24 03:27:38,"#Terpopuler Polisi menegur pengemudi mobil mewah yang foto-foto di tengah jalan Tol Depok-Antasari, persisnya di KM 02+400 Tol Andara, Jakarta Selatan. https://t.co/uvsxrDGzhp",11,2,0,2,2022-01-24,3,Monday,1,11,4
1485453961566076931,2022-01-24 03:26:37,"Kembali disorot karena dikabarkan akan segera menikah. Pasangan Ridho Ilahi dan Dinar Candy makin gencar pamer kemesraan, terutama saat makan.  https://t.co/xgeOj8yxKj",9,1,0,0,2022-01-24,3,Monday,1,9,1
1485453334014222344,2022-01-24 03:24:07,"Jangan sembarangan scan QR code, salah-salah datamu bisa dicuri oleh penjahat. Waduh...  https://t.co/Ynv8cbRq0V",7,2,7,1,2022-01-24,3,Monday,1,14,3
1485452847047139329,2022-01-24 03:22:11,"Samsung dikabarkan tengah siapkan suksesor Galaxy A22. Sejumlah peningkatan diberikan pada ponsel bernama Galaxy A23 itu, salah satunya kamera berukuran 50 MP. https://t.co/MiLac3303R",3,0,0,1,2022-01-24,3,Monday,1,3,1
1485452349929922567,2022-01-24 03:20:13,Beberapa artis ini sukses bikin pangling banyak orang karena penampilannya berubah drastis. Mereka berhasil menurunkan berat badan hingga puluhan kilogram!  https://t.co/oBm0JxEish,5,1,2,0,2022-01-24,3,Monday,1,7,1
1485452330137014274,2022-01-24 03:20:08,Irwansyah dan Zaskia Sungkar terlihat kedatangan tamu istimewah. Dia adalah Acha Septriasa yang tak lain adalah mantan kekasih Irwansyah. https://t.co/K2LLpoVlck,18,0,3,1,2022-01-24,3,Monday,1,21,1
1485451496309280772,2022-01-24 03:16:49,Adinia Wirasti terlibat dalam film bertemakan bencana berjudul Kamu Tidak Sendiri. Film ini juga bentuk apresiasi pada para relawan yang bekerja keras.  https://t.co/Y8vFwHlc9j,7,0,1,0,2022-01-24,3,Monday,1,8,0
1485450751526776836,2022-01-24 03:13:52,"Seorang programmer terpaksa lengser dari posisi dan digantikan anak baru. Dia juga dipaksa menghapus data. Ternyata, keputusan itu disesali enam bulan kemudian. https://t.co/5KD0xqjTHY",28,4,6,3,2022-01-24,3,Monday,1,34,7
1485450512719822849,2022-01-24 03:12:55,Oxima dapat sanjungan dari Apple. Dibuat oleh anak negeri jebolan Apple Developer Academy yang diperuntukkan bagi atlet basket untuk meningkatkan stamina. https://t.co/E7Sai7l9jv,7,0,1,0,2022-01-24,3,Monday,1,8,0
1485449957909934087,2022-01-24 03:10:42,"Sebuah kabel listrik bawah tanah terbakar di Gambir, Jakarta Pusat. Kebakaran terjadi diduga karena korsleting listrik. https://t.co/oHQDViEsdU",6,0,2,0,2022-01-24,3,Monday,1,8,0
1485449711565918208,2022-01-24 03:09:44,Liverpool memangkas poin dengan Manchester City usai menang atas Crystal Palace. Juergen Klopp mengomentari persaingan timnya dengan The Citizens. Apa kata dia? https://t.co/9j2uOH7Z8D,7,0,2,1,2022-01-24,3,Monday,1,9,1
1485448673722978304,2022-01-24 03:05:36,Kabar duka dari dunia fashion. Desainer favorit selebriti dunia Thierry Mugler meninggal dalam usia 73 tahun. Selamat jalan Thierry Mugler...   https://t.co/Psk773DA8n,11,0,2,0,2022-01-24,3,Monday,1,13,0
1485448672137592835,2022-01-24 03:05:36,Miss Universe 2012 Olivia Culpo ditegur petugas bandara saat hendak terbang ke Meksiko. Ia nyaris dilarang naik pesawat karena baju yang dianggap kurang pantas. https://t.co/RPMsIhYE5t,7,0,0,0,2022-01-24,3,Monday,1,7,0
1485448214757183491,2022-01-24 03:03:47,"Manusia umumnya tahu lima panca indra yang dimiliki: sentuhan, penglihatan, pendengaran, membaui, dan mencicip. Ternyata ini indra keenam manusia:  https://t.co/inIFd8YNLU",13,0,3,0,2022-01-24,3,Monday,1,16,0
1485447346783768581,2022-01-24 03:00:20,Banyak mata uang kripto yang nilainya merosot. Hal ini menyusul sejumlah negara yang melarang dan berencana meninjau kripto.  https://t.co/Dpl966PkCR,6,2,3,1,2022-01-24,3,Monday,1,9,3
1485446796935581699,2022-01-24 02:58:09,"Dear Cancer, sikapi segala sesuatunya dengan menggunakan rasio dan bukan hanya perasaan. Simak ramalan zodiak hari ini: https://t.co/gZW0vPIzi6",5,0,1,0,2022-01-24,2,Monday,1,6,0
1485446534665850885,2022-01-24 02:57:06,Indeks Harga saham gabungan hari ini melemah. Pergerakan IHSG kompak dengan bursa Asia yang sama-sama 'kebakaran'.  https://t.co/ALQMC2ZMHl,4,0,1,1,2022-01-24,2,Monday,1,5,1
1485446533399076872,2022-01-24 02:57:06,Sebanyak dua Direktur Eksekutif Evergrande Group mengundurkan diri. Mereka adalah Lai Lixin dan Huang Xiangui.  https://t.co/aCksgBbatx,3,0,1,0,2022-01-24,2,Monday,1,4,0
1485446232445177859,2022-01-24 02:55:54,"Kabar duka menyelimuti dunia film Indonesia. Aktor cilik, Matthew White, pemain film Danur meninggal dunia di usia 12 tahun. Selamat jalan Matthew White...  https://t.co/1p4lY6JhgH",306,42,86,8,2022-01-24,2,Monday,1,392,50
1485446218729861120,2022-01-24 02:55:51,Kementerian Perdagangan (Kemendag) telah mengambil tindakan terhadap pusat perbelanjaan yang menjual minyak goreng Rp 14.000 per liter dengan syarat.  https://t.co/ZuwD0yWkiT,15,3,5,1,2022-01-24,2,Monday,1,20,4
1485445702511693825,2022-01-24 02:53:48,Dekorasi pernikahan di Surabaya ini viral bikin takjub karena bak pameran seni. Ini kisahnya:  https://t.co/bReC8tI15c,25,5,4,1,2022-01-24,2,Monday,1,29,6
1485444917837111299,2022-01-24 02:50:41,"Jokowi akan melakukan groundbreaking proyek hilirisasi batu bara menjadi dimetil eter (DME), di Kabupaten Muara Enim, Sumatera Selatan.  https://t.co/8LJ1dI083t",11,0,1,1,2022-01-24,2,Monday,1,12,1
1485444385798033412,2022-01-24 02:48:34,"Pensiunnya Rossi membuat sejumlah orang rindu dengan sosok Rossi di trek, termasuk petinggi Dorna saat ini Carmelo Ezpeleta. https://t.co/g1dMLyT1SD",12,0,0,0,2022-01-24,2,Monday,1,12,0
1485444370686001162,2022-01-24 02:48:30,"Ridwan Kamil tengah jadi sorotan belakangan ini. Sebab, nama tersebut dikait-kaitkan dengan calon Kepala Otorita Ibu Kota Negara, Nusantara. Betulkah?   https://t.co/3Ap1VpdO2w",32,32,3,4,2022-01-24,2,Monday,1,35,36
1485443877175762948,2022-01-24 02:46:33,Metaverse jadi konsep yang banyak digaungkan perusahaan teknologi saat ini. Tapi pencipta PlayStation Ken Kutaragi justru menyebut metaverse tidak berguna. https://t.co/uCleprnboA,22,1,6,2,2022-01-24,2,Monday,1,28,3
1485443633360867337,2022-01-24 02:45:35,"Pemerintah akan menghapus tenaga honorer di instansi pemerintah pada 2023. Namun, tenaga honorer masih punya kesempatan buat bekerja.  https://t.co/f5aFuFDq0t",21,6,6,0,2022-01-24,2,Monday,1,27,6
1485443356855570437,2022-01-24 02:44:29,"Buat para PNS, sudah siap pindah ke Kalimantan Timur, lokasi ibu kota negara yang baru? Pilih 'siap' dan 'belum siap' pada kolom komentar artikel polling ini.  https://t.co/gZlkOdva4C",48,43,9,7,2022-01-24,2,Monday,1,57,50
1485443066802622465,2022-01-24 02:43:19,"Barcelona memang mendominasi melawan Alaves, gol Frankie de Jong baru tercipta di menit-menit jelang laga bubar.  https://t.co/CYVi05TGPT",5,0,0,0,2022-01-24,2,Monday,1,5,0
1485442811986169860,2022-01-24 02:42:19,"Viral video menunjukkan keributan antara Polantas dengan seorang proa di jalan Pematangsiantar, Sumut. Apa yang sebenarnya terjadi? https://t.co/5xQ4NEN2AH",5,1,0,0,2022-01-24,2,Monday,1,5,1
1485442314982019072,2022-01-24 02:40:20,Justina Machado sering menjadi pengisi suara di sejumlah film animasi sebelumnya. Dalam film The Ice Age Adventures of Buck Wild ini. Ia mengaku tak ada kesulitan selama mengisi karakter Zee. https://t.co/QuNXWmj2uE,4,0,1,0,2022-01-24,2,Monday,1,5,0
1485441568295337987,2022-01-24 02:37:22,"Dorce Gamalama masih dalam proses penyembuhan. Sahabatnya, Ira Savira dan Hetty Soendjaya, menyebut Dorce memiliki semangat yang tinggi untuk bisa kembali sembuh dan berkarya lagi. https://t.co/fQDEXhMt7p",7,2,1,0,2022-01-24,2,Monday,1,8,2
1485440425536077826,2022-01-24 02:32:50,Kesehatan Pak Ogah diketahui menurun dan kini sudah berada di rumah sakit. Lekas pulih Pak Ogah...  https://t.co/27haYcaFiy,36,5,6,1,2022-01-24,2,Monday,1,42,6
1485439935494639617,2022-01-24 02:30:53,Manchester United sudah memetik kemenangan beruntun di Liga Inggris. Akankah momentum itu menjadi titik balik Setan Merah? https://t.co/x5dYQVlJhB,8,0,0,0,2022-01-24,2,Monday,1,8,0
1485438934700249093,2022-01-24 02:26:54,"Arsenal membuka tahun 2022 dengan performa memalukan, belum pernah menang dan banyak mengoleksi kartu merah! https://t.co/IK358rlw5J",6,0,2,0,2022-01-24,2,Monday,1,8,0
1485437919968083975,2022-01-24 02:22:52,Juventus kembali tumpul saat Massimiliano Allegri balik ke pinggir lapangan. https://t.co/eSUZQgMdLx,5,1,1,0,2022-01-24,2,Monday,1,6,1
1485437332970954752,2022-01-24 02:20:32,"Dalam memilih tempat tinggal, tentunya ingin dekat dengan pusat kota dengan harga terjangkau dan wilayah Cimanggis bisa menjadi pilihan.  https://t.co/BRhNe4mxW0",3,1,0,0,2022-01-24,2,Monday,1,3,1
1485437331674968068,2022-01-24 02:20:32,"Ketum PPK Kosgoro, Dave Laksono, menyebut hingga saat ini tak ada opsi lain selain Airlangga Hartarto yang akan diusung Golkar untuk Pilpres 2024. Keputusan tersebut sudah final. https://t.co/bcnaQk8eRL",2,0,1,2,2022-01-24,2,Monday,1,3,2
1485436833802694660,2022-01-24 02:18:33,Ini kumpulan puisi tentang ayah yang sudah meninggal. Semoga bisa mengobati kerinduanmu pada ayah tercinta...  https://t.co/P0ua9WuJpX,25,3,9,2,2022-01-24,2,Monday,1,34,5
1485436076151951364,2022-01-24 02:15:33,Maskapai terpaksa melakukan 'penerbangan hantu' karena kursi di pesawat hampir kosong di tengah penyebaran Omicron. Kenapa?  https://t.co/nxsTwRbM4u,14,4,2,0,2022-01-24,2,Monday,1,16,4
1485435334557147136,2022-01-24 02:12:36,"Ketua Umum PSI, Giring Ganesha, menyambangi warga Kampung Papanggo yang terletak di sekitar JIS, Jakarta Utara. Dalam kunjungannya, Giring mengajak warga bernyanyi bersama dan mengunggah postingannya tersebut dengan mengatakan sound system terbaik ialah... https://t.co/PzehrMyDzo",5,4,2,0,2022-01-24,2,Monday,1,7,4
1485435334322184195,2022-01-24 02:12:36,"Lowongan kerja BCA 2022 dibuka untuk lulusan S1-S2 fresh graduate berbagai jurusan. Cek syarat dan batas pendaftaran lowongan kerja BCA berikut. 
Via: detikedu  https://t.co/wsr4mEct4e",4,0,3,0,2022-01-24,2,Monday,1,7,0
1485434847434878976,2022-01-24 02:10:40,"Status PPKM di wilayah Jawa dan Bali akan dievaluasi hari ini. Pada sepekan terakhir, terjadi lonjakan terus menerus kasus harian positif COVID-19. https://t.co/SiJHXEmKYT",12,4,2,4,2022-01-24,2,Monday,1,14,8
1485434562348036097,2022-01-24 02:09:32,Alisson Becker punya peran krusial saat kemenangan Liverpool atas Crystal Palace. https://t.co/DMYwdRyWAu,7,0,0,0,2022-01-24,2,Monday,1,7,0
1485433777614733317,2022-01-24 02:06:25,Honda kembali menggoda pecinta mobil balap jalanan Civic Type R terbaru. https://t.co/NMvfeCD5Pb,16,1,2,1,2022-01-24,2,Monday,1,18,2
1485433244120236032,2022-01-24 02:04:18,"Zlatan Ibrahimovic masih menjadi sosok sentral di AC Milan, menurut Fabio Capello Ibra mempunyai peran ganda di Rossoneri. https://t.co/ingJZcb4O8",3,0,0,0,2022-01-24,2,Monday,1,3,0
1485432417821339650,2022-01-24 02:01:01,Pasien yang terkonfirmasi #covid19 Omicron maupun varian lainnya dengan kondisi klinis tanpa gejala atau gejala ringan dapat melakukan isoman di rumah. #CNNIndonesia #detiknetwork  https://t.co/eUZdwE0Lob,8,0,2,0,2022-01-24,2,Monday,1,10,0
1485431412639641605,2022-01-24 01:57:01,"Achmad Megantara resmi mempersunting kekasihnya, Asri Faradila. Begini ungkapan kebahagiaan Megantara usai menikah:  https://t.co/7tMqcEybOj",6,2,1,1,2022-01-24,1,Monday,1,7,3
1485431391500255237,2022-01-24 01:56:56,"Kalah 0-2 dari Chelsea, Antonio Conte menyebut level Tottenham tertinggal jauh sekali tertinggal! https://t.co/bphP5zsKEh",3,0,0,0,2022-01-24,1,Monday,1,3,0
1485430687373135873,2022-01-24 01:54:08,Pelat nomor kendaraan bermotor pribadi akan diubah dari dasar hitam tulisan putih menjadi dasar putih tulisan hitam. Apa tujuannya? https://t.co/vnPAkgA7Os,21,7,12,1,2022-01-24,1,Monday,1,33,8
1485430332375580678,2022-01-24 01:52:43,"Aprilio Manganang, mantan atlet voli putri memberikan kabar bahagia. Dia kini bertunangan dengan kekasihnya Claudia. Ini momen pertunangan mereka:  https://t.co/OhV0TUq24b",140,10,18,4,2022-01-24,1,Monday,1,158,14
1485428534642315271,2022-01-24 01:45:35,"Manajer Crystal Palace, Patrick Vieira, kecewa dengan keputusan wasit saat timnya bentrok dengan Liverpool. Dia mempertanyakan hadiah penalti untuk The Reds. https://t.co/Gbtdw9IDlB",3,0,0,0,2022-01-24,1,Monday,1,3,0
1485426475700568067,2022-01-24 01:37:24,Pelayanan Samsat keliling (Samling) pagi ini beroperasi di wilayah Jakarta. Samling tersedia di empat wilayah di Jakarta. https://t.co/pnWfXnDKqZ,5,0,0,0,2022-01-24,1,Monday,1,5,0
1485425474822184960,2022-01-24 01:33:25,"Usai resmi terdaftar di Kemenkum HAM, relawan Sahabat Ganjar membentuk Satuan Tugas Khusus (Satgassus) dengan nama 'Ninja Saga'. https://t.co/xK60qB6wjq",214,153,31,62,2022-01-24,1,Monday,1,245,215
1485424724930961408,2022-01-24 01:30:26,"Gubernur Jawa Barat Ridwan Kamil menjaring aspirasi di media sosial soal Ibu Kota Negara, Nusantara. Unggahan RK apakah kode siap pimpin Ibu Kota Nusantara? https://t.co/ADZLU7d71q",10,2,2,0,2022-01-24,1,Monday,1,12,2
1485423737642045445,2022-01-24 01:26:31,"Polisi menyelidiki kasus viral lansia yang ngebut diteriaki maling hingga tewas dikeroyok massa di Pulogadung, Jakarta Timur. Sebanyak 8 saksi telah diperiksa. https://t.co/cg6VbZQF4S",22,6,7,3,2022-01-24,1,Monday,1,29,9
1485422701745430529,2022-01-24 01:22:24,Kota Depok mulai menggelar pembelajaran tatap muka (PTM) 100 persen. Sekolah tatap muka mulai dilakukan hari ini. https://t.co/ZNBMC1LzBl,17,5,6,6,2022-01-24,1,Monday,1,23,11
1485421715262001152,2022-01-24 01:18:29,Bursa calon Kepala Otorita Ibu Kota Negara Nusantara mengerucut ke sosok kepala daerah berlatar belakang arsitek. Eks Wali Kota Surabaya Risma masuk daftar. https://t.co/2FryIIgnuh,17,5,2,1,2022-01-24,1,Monday,1,19,6
1485421424030498818,2022-01-24 01:17:19,Dua pasien Omicron yang meninggal dunia memiliki penyakit komorbid. Ini komorbid yang memperparah kondisi mereka. https://t.co/UOzR6Xlc81,2,0,1,0,2022-01-24,1,Monday,1,3,0
1485420675343044614,2022-01-24 01:14:21,"Juventus kembali tumpul saat Massimiliano Allegri balik ke pinggir lapangan. Padahal sebelumnya, Bianconeri bisa cetak empat gol kala tak ada Allegri. https://t.co/f2yg9WEOjW",4,0,1,1,2022-01-24,1,Monday,1,5,1
1485420656393166859,2022-01-24 01:14:16,Pelayanan Samsat keliling (Samling) pagi ini beroperasi di wilayah Jakarta. Samling tersedia di empat wilayah di Jakarta. https://t.co/WBF1kv1Bcr,4,0,0,0,2022-01-24,1,Monday,1,4,0
1485419390602518528,2022-01-24 01:09:15,Dua mantan ajudan Presiden Joko Widodo (Jokowi) yakni Brigjen Widi Prasetijono dan Kolonel Rudy Saladin mendapat promosi jabatan. https://t.co/ROoojtdg5k,6,1,1,0,2022-01-24,1,Monday,1,7,1
1485418840590888972,2022-01-24 01:07:04,"Kemenkes menyebut pasien Omicron yang meninggal dunia sempat rendah saturasi oksigen. Mengacu pada angka saturasi, kapan pasien perlu ke rumah sakit? https://t.co/XTGEXYUNyI",6,0,1,0,2022-01-24,1,Monday,1,7,0
1485418347357478917,2022-01-24 01:05:06,Lowongan kerja BCA 2022 dibuka untuk lulusan S1-S2 fresh graduate berbagai jurusan. Cek syarat dan batas pendaftaran lowongan kerja BCA berikut. https://t.co/2sIKyN59ko,12,0,3,0,2022-01-24,1,Monday,1,15,0
1485418078905188353,2022-01-24 01:04:02,Tottenham Hotspur digebuk Chelsea 0-2 dalam lanjutan kompetisi Liga Inggris. Manajer Antonio Conte menyebut level The Lilywhites tertinggal jauh sekali.cont https://t.co/zt6forydo2,7,0,0,0,2022-01-24,1,Monday,1,7,0
1485410933820342275,2022-01-24 00:35:38,Kemenkes melaporkan dua pasien COVID-19 varian Omicron di RI meninggal dunia. Seperti apa kondisinya sebelum meninggal dunia? Begini penjelasan Kemenkes. https://t.co/wp9yhEkcOZ,7,0,1,2,2022-01-24,0,Monday,1,8,2
1485409720282320900,2022-01-24 00:30:49,Ternyata ada sisi lain dari sikap Megawati terhadap SBY. Apa sisi lain tersebut? Simak selengkapnya. https://t.co/PVbsY21zuZ,9,2,0,0,2022-01-24,0,Monday,1,9,2
1485408978251177991,2022-01-24 00:27:52,Arsenal membuka tahun 2022 dengan performa memalukan. Meriam London belum pernah menang dan lebih banyak mengoleksi kartu merah ketimbang mencetak gol. Aduh... https://t.co/xswARYkXsy,5,0,1,2,2022-01-24,0,Monday,1,6,2
1485407987946639363,2022-01-24 00:23:56,Puasa Senin Kamis adalah salah satu ibadah sunnah yang jarang ditinggalkan Rasulullah SAW. Berikut alasan Rasulullah SAW rajin puasa Senin Kamis. https://t.co/e1EmfUjoI8,143,3,34,1,2022-01-24,0,Monday,1,177,4
1485407453185462276,2022-01-24 00:21:49,Tunisia berhasil melaju ke babak perempat final Piala Afrika 2021. Elang Cartagena menyingkikan tim favorit juara Nigeria. https://t.co/JevQAtSCjQ,3,0,1,0,2022-01-24,0,Monday,1,4,0
1485406947541229569,2022-01-24 00:19:48,Ada kesalahan yang sering muncul saat melakukan pendaftaran dalam SNMPTN. Perhatikan hal-hal berikut ini agar tidak salah lagi. https://t.co/PbJShyOYhs,10,0,2,0,2022-01-24,0,Monday,1,12,0
1485405951696027650,2022-01-24 00:15:51,"TNI AD tegaskan poster yang memuat informasi Haikal Hassan mengisi acara di Yonif Para Raider 502/Ujwala Yudha (UY), Malang adalah berita bohong atau hoax. https://t.co/ioBni6mp6w",12,9,3,1,2022-01-24,0,Monday,1,15,10
1485405470840041478,2022-01-24 00:13:56,"Mantan Wakil Ketua DPR, Azis Syamsuddin hari ini akan mendengarkan tuntutan jaksa KPK terkait dakwaan pemberian suap mantan penyidik KPK AKP Robin. https://t.co/LUujjVhdPl",3,0,1,0,2022-01-24,0,Monday,1,4,0
1485397849877716993,2022-01-23 23:43:39,Kemenkes RI menyebut 2 pasien Omicron yang meninggal dunia merupakan lansia dengan komorbid. Keduanya mengalami gejala berat dan mendapat suplementasi oksigen. https://t.co/4ETZkJ2FOM,5,6,2,1,2022-01-23,23,Sunday,7,7,7
1485397134614704131,2022-01-23 23:40:48,"DKI mencatatkan penambahan kasus COVID-19 sebanyak 1.739 kasus, Minggu (24/1/2022). Sementara jumlah kasus aktif bertambah 1.217, total menjadi 9.057 kasus. https://t.co/XZDq5n9T9a",0,0,2,2,2022-01-23,23,Sunday,7,2,2
1485395859424567303,2022-01-23 23:35:44,Puasa Senin Kamis adalah salah satu ibadah sunnah yang jarang ditinggalkan Rasulullah SAW. Berikut alasan Rasulullah SAW rajin puasa Senin Kamis. https://t.co/RMAgRPzVYP,146,0,20,0,2022-01-23,23,Sunday,7,166,0
1485395347153244165,2022-01-23 23:33:42,"Mantan PM Malaysia Mahathir Mohamad menjalani perawatan di Institut Jantung Negara (IJN), RS yang khusus masalah jantung. Dikabarkan, ia dalam kondisi stabil. https://t.co/tMj6IGYlqC",7,1,2,0,2022-01-23,23,Sunday,7,9,1
1485394834814758914,2022-01-23 23:31:40,"PSI menjawab sentilan dari Partai Gerindra soal kritik mereka hanya sebuah konten. Bagi PSI, mengajak M Taufik, yang mengkritik, blusukan. https://t.co/VGsegqNspT",7,5,0,1,2022-01-23,23,Sunday,7,7,6
1485393362186391552,2022-01-23 23:25:49,"Konvoi mobil mewah di jalan Tol Depok-Antasari bikin heboh. Pasalnya, para mengemudi berfoto-foto di tengah jalan. https://t.co/74IOhnY7Hu",40,21,10,6,2022-01-23,23,Sunday,7,50,27
1485392848094744581,2022-01-23 23:23:46,AC Milan bermain imbang lawan Juventus di laga lanjutan Serie A. Kedua tim gagal menciptakan gol hingga pertandingan berakhir. https://t.co/tZJpijb8Ms,5,4,1,0,2022-01-23,23,Sunday,7,6,4
1485392083213078531,2022-01-23 23:20:44,Gubernur DKI Anies Baswedan saling berbalas sindiran dengan Ketum PSI Giring Ganesha. Mulai soal check sound di JIS hingga proyek Formula E. https://t.co/WLUU4ztuzP,13,32,1,6,2022-01-23,23,Sunday,7,14,38
1485391528558272521,2022-01-23 23:18:32,Alisson Becker punya peran krusial saat kemenangan Liverpool atas Crystal Palace. Ia bikin penyelamatan mencegah The Eagles menyamakan kedudukan. https://t.co/48NDnMgIQB,2,0,0,0,2022-01-23,23,Sunday,7,2,0
1485390523217195017,2022-01-23 23:14:32,"Barcelona memang mendominasi laga melawan tim papan bawah, Alaves. Tapi, gol baru tercipta di menit-menit jelang laga bubar. Frenkie de Jong pahlawannya. https://t.co/hHsadmv23c",3,0,0,0,2022-01-23,23,Sunday,7,3,0
1485383640892776450,2022-01-23 22:47:11,"Sergio Ramos mencetak gol perdananya untuk PSG. Ramos menyarangkan si kulit bundar kala PSG bersua Reims. Di laga ini, PSG menang telak 4-0. https://t.co/4GZ1B7BLBm",11,1,0,1,2022-01-23,22,Sunday,7,11,2
1485380389145399298,2022-01-23 22:34:16,Barcelona susah payah meraih poin penuh saat melawan Deportivo Alaves di lanjutan Liga Spanyol. Gol telat Frenkie De Jong memenangkan Blaugrana 1-0. https://t.co/EYSclThGHG,8,0,0,0,2022-01-23,22,Sunday,7,8,0
1485379947720069122,2022-01-23 22:32:31,Nasih malang menimpa seorang sopir mobil berinisial HM (89). Dia dikeroyok hingga tewas karena dituduh sebagai maling. https://t.co/JH4zYs5J16,154,47,41,34,2022-01-23,22,Sunday,7,195,81
1485378317268176903,2022-01-23 22:26:02,AC Milan menghadapi Juventus berakhir imbang dalam laga giornata ke-23 Liga Italia. Kedua tim gagal mencetak gol hingga skor 0-0 menutup laga. https://t.co/BvnPnrh8gf,5,0,2,0,2022-01-23,22,Sunday,7,7,0
1485370859942469643,2022-01-23 21:56:24,"Paris Saint-Germain berpesta gol saat menjamu Reims dalam lanjutan Ligue 1. Les Parisiens menang 4-0, dengan salah satu gol disumbang Sergio Ramos. https://t.co/dRZludUsht",5,0,2,0,2022-01-23,21,Sunday,7,7,0
1485369140437295111,2022-01-23 21:49:34,"Kondisi eks PM Malaysia Mahathir Mohamad membaik usai dilarikan ke rumah sakit spesialis jantung, Kuala Lumpur. Mahathir kini dapat berinteraksi dengan keluarga https://t.co/Ve9SXRP5k5",19,0,7,1,2022-01-23,21,Sunday,7,26,1
1485368143749038083,2022-01-23 21:45:36,Kasus aktif COVID-19 di Indonesia mengalami kenaikan. DKI Jakarta masih menjadi provinsi dengan catatan kasus aktif sebanyak 8.961 pasien. https://t.co/LxPLm5m3VG,8,6,5,0,2022-01-23,21,Sunday,7,13,6
1485366148153720836,2022-01-23 21:37:41,Kasus Covid-19 di Indonesia kembali meningkat. Epidemiolog Dicky Budiman pun memberikan pesan kepada pemerintah untuk melakukan intervensi sesegera mungkin. https://t.co/WMtesiEux7,13,5,3,3,2022-01-23,21,Sunday,7,16,8
1485364928513028098,2022-01-23 21:32:50,"Tisu magic banyak dijadikan opsi oleh pasangan agar sesi bercinta jadi lebih tahan lama. Tapi, bagaimana cara pakai tisu magic yang benar? Begini caranya: https://t.co/xwjgpi8Foy",8,1,2,2,2022-01-23,21,Sunday,7,10,3
1485363398711955457,2022-01-23 21:26:45,Anggota Komisi I DPR Christina Aryani merespons pengangkatan Mayjend Maruli Simanjuntak sebagai Pangkostrad. Dia menilai Maruli sosok tegas yang tidak neko-neko https://t.co/Cq4X5fT1Pp,11,0,3,0,2022-01-23,21,Sunday,7,14,0
1485361184077496329,2022-01-23 21:17:57,"Akun Instagram (IG) milik Doni Salmanan mendadak hilang. Crazy rich asal asal Kabupaten Bandung, Jawa Barat, itu buka suara. https://t.co/JqsLum3lR4",77,35,18,5,2022-01-23,21,Sunday,7,95,40
1485360483670671361,2022-01-23 21:15:10,Polisi menuturkan Kakek Suroso berkendara tanpa kelengkapan surat. Kakek Suroso dibawa ke kantor PJR Induk Serang untuk dimintai keterangan. https://t.co/hYS8pyZXm8,6,0,3,0,2022-01-23,21,Sunday,7,9,0
1485359472683978763,2022-01-23 21:11:09,"Sopir minibus dan truk yang terlibat kecelakaan di lampu merah Klender, tepatnya di dekat Mall Citra Klender, Jakarta Timur (Jaktim), sepakat berdamai. https://t.co/lhK6RYYYeP",5,0,2,0,2022-01-23,21,Sunday,7,7,0
1485358191215009804,2022-01-23 21:06:04,Ninuk adalah guru tunarungu yang mengajar tata busana di Yayasan Santi Rama. Beliau berhasil melahirkan karya-karya indah dari imajinasi jari-jemarinya. https://t.co/bkAyDsjy1U,31,0,9,0,2022-01-23,21,Sunday,7,40,0
1485356898287296513,2022-01-23 21:00:55,Alun-alun Kota Depok di Jalan Boulevard Grand City dipadati warga pada Minggu pagi. Antrian mengular membuat kerumunan di pintu masuk. https://t.co/32tssQqfKX,10,1,1,1,2022-01-23,21,Sunday,7,11,2
1485355887606833157,2022-01-23 20:56:54,"Puluhan santri dan dua ustaz Pondok Pesantren Khalifah di Kecamatan Caringin, Kabupaten Sukabumi, mengalami keracunan massal setelah makan malam bersama. https://t.co/AA8aqhSEIX",4,0,3,0,2022-01-23,20,Sunday,7,7,0
1485353915579260932,2022-01-23 20:49:04,Pernyataan Ketua PCNU Banyuwangi KH. Moh Ali Makki (Gus Makki) mendukung Muhaimin Iskandar (Cak Imin) sebagai capres berbuntut panjang. Gus Makki dipanggil PBNU https://t.co/J5SRNSKLQF,4,2,1,0,2022-01-23,20,Sunday,7,5,2
1485352203741192196,2022-01-23 20:42:16,Kejari Kabupaten Sukabumi menyelidiki dugaan markup harga gas elpiji tiga kilogram untuk masyarakat miskin. https://t.co/1SSZiMf5Y6,7,1,2,1,2022-01-23,20,Sunday,7,9,2
1485350643195957253,2022-01-23 20:36:04,Aksi unjuk rasa tolak vaksinasi dan pembatasan aktivitas akibat Covid-19 di Belgia berakhir ricuh. Massa tak segan melemparkan pagar ke polisi. https://t.co/RkFW4CgaFC,25,2,4,0,2022-01-23,20,Sunday,7,29,2
1485349921251340294,2022-01-23 20:33:12,Polisi menindak tegas penjual dan pemilik bisnis pengemasan ciu dalam bentuk gelas plastik yang sepintas mirip air mineral di Kota Tasikmalaya. https://t.co/WpPyEoUwmk,7,0,2,0,2022-01-23,20,Sunday,7,9,0
1485349132252426247,2022-01-23 20:30:04,"Enam kasus Corona varian Omricon ditemukan di Kota Bandung, Jawa Barat. Sayangnya, masih banyak wisatawan yang abai protokol kesehatan. https://t.co/SWDJbDpvtA",5,0,1,0,2022-01-23,20,Sunday,7,6,0
1485348372391280644,2022-01-23 20:27:03,"Muhaimin Iskandar mendapat dukungan dari perajin batik untuk maju capres 2024. Meski mengaku terkejut, Cak Imin menganggap dukungan tersebut sebagai amanah. https://t.co/Vh1U4SFfd4",4,0,2,0,2022-01-23,20,Sunday,7,6,0
1485347506137485322,2022-01-23 20:23:36,Kabinet Israel lakukan penyelidikan formal atas dugaan adanya korupsi terkait kapal selam. Dugaan korupsi ini melibatkan eks perdana menteri Benjamin Netanyahu. https://t.co/bH8fCFVetA,6,0,1,0,2022-01-23,20,Sunday,7,7,0
1485346254448123911,2022-01-23 20:18:38,Tottenham tumbang lagi lawan Chelsea. Ini merupakan kekalahan ketiga secara beruntun Spurs lawan Chelsea tahun ini. https://t.co/N9Osz21cyj,12,0,3,1,2022-01-23,20,Sunday,7,15,1
1485345785583747074,2022-01-23 20:16:46,"Sebelum bisa menjawab soal matematika dalam gambar ini, kamu harus terlebih dahulu bisa melihat angka yang ada. Akan sulit bila kamu buta warna. https://t.co/po4cDE3Jyn",7,3,1,0,2022-01-23,20,Sunday,7,8,3
1485344503468892162,2022-01-23 20:11:40,Arsenal vs Burnley masih tanpa gol hingga babak pertama tuntas. The Gunners kesulitan untuk membongkar lini pertahanan The Clarets. https://t.co/VdQqr0W00L,2,0,0,0,2022-01-23,20,Sunday,7,2,0
1485343731830120457,2022-01-23 20:08:36,Ketum PKB Muhaimin Iskandar (Cak Imin) sedang getol safari ke tanah Jawa menjaring dukungan Nyapres. Lawatannya ke Jatim dan Yogyakarta nyatanya tak sia-sia. https://t.co/fvAJ2XlvyQ,46,2,32,2,2022-01-23,20,Sunday,7,78,4
1485342502806769666,2022-01-23 20:03:43,10 Prodi favorit SNMPTN 2021 di Unesa ini bisa menjadi referensi SNMPTN 2022. Simak di sini beserta tips agar lolos SNMPTN 2022. https://t.co/CgJZd5bFsN,4,0,1,0,2022-01-23,20,Sunday,7,5,0
1485340353318297608,2022-01-23 19:55:11,Pria di India ditangkap karena melakukan pelecehan seksual terhadap siswi di Ghaziabad dan Delhi. Ada 600 gadis yang menjadi korban. https://t.co/oXkMEk5UPV,4,2,0,0,2022-01-23,19,Sunday,7,4,2
1485338613529432072,2022-01-23 19:48:16,"Walkot Depok, M Idris memastikan semua sekolah melaksanakan PTM 100 persen besok. Keputusan ini dibuat untuk semua jenjang pendidikan. https://t.co/1Kb1iiKiHm",17,2,3,4,2022-01-23,19,Sunday,7,20,6
1485337338683133956,2022-01-23 19:43:12,Liverpool menang 3-1 atas tuan rumah Crystal Palace. Liverpool berhasil memangkas jarak dengan Man City. Keduanya kini terpaut 9 angka. https://t.co/iFpVsNbwJq,4,0,0,0,2022-01-23,19,Sunday,7,4,0
1485335215715360774,2022-01-23 19:34:46,"Body shaming adalah perilaku seseorang yang mengkritik fisik tubuh orang lain dengan cara negatif. Hati-hati, ini dampak buruknya bagi kesehatan mental korban. https://t.co/2piQi2iJwo",16,0,3,1,2022-01-23,19,Sunday,7,19,1
1485333672374980609,2022-01-23 19:28:38,Borneo FC menunjuk Fakhri Husaini sebagai pelatih kepala untuk sisa BRI Liga 1 2021. Eks juru Taktik Timnas Indonesia U-19 itu menggantikan Risto Vidakovic. https://t.co/r0cOaghxEN,3,0,1,0,2022-01-23,19,Sunday,7,4,0
1485332319032549378,2022-01-23 19:23:15,Turnamen GoBasket 3 Dekade telah bergulir. Ajang ini diharapkan bisa membuat olahraga basket terus populer. https://t.co/jqtknjmFso,2,1,0,0,2022-01-23,19,Sunday,7,2,1
1485331071986278409,2022-01-23 19:18:18,Kapolda Sumut Irjen Putra Panca membantu pengobatan terhadap seorang anak bernama M Aldi Kurniawan (11) yang menderita tumor abdomen asal Kabupaten Labuhanbatu. https://t.co/3i7HApQpcf,13,0,1,0,2022-01-23,19,Sunday,7,14,0
1485329838563069952,2022-01-23 19:13:24,Bayern Munich menang 4-1 atas Hertha Berlin. Die Roten kukuh di puncak klasemen menjauh dari kejaran Borussia Dortmund. https://t.co/Lcd78Rnxo6,6,0,1,0,2022-01-23,19,Sunday,7,7,0
1485328313124110340,2022-01-23 19:07:20,Hujan gol terjadi dalam laga Serie A antara Empoli kontra AS Roma. Pertandingan tuntas dengan skor 4-2 untuk kemenangan Il Lupi. https://t.co/UjcqAynM3m,5,1,0,1,2022-01-23,19,Sunday,7,5,2
1485328090771435528,2022-01-23 19:06:27,"Vivi Prysilia, bayi usia 2 tahun hanya bisa menangis saat merasakan sakit akibat hidrosefalus yang diidapnya. Ia butuh dioperasi segera agar kondisinya membaik. https://t.co/9lW76YQ8up",17,0,4,1,2022-01-23,19,Sunday,7,21,1
1485326745633005578,2022-01-23 19:01:06,"Seekor sapi yang diangkut menggunakan truk lepas karena pintu bak belakangnya terbuka. Sehingga, sapi tersebut turun ke Jl Tol Tangerang-Merak dan mengamuk. https://t.co/nU6AqqrcjN",8,0,2,1,2022-01-23,19,Sunday,7,10,1
1485325441862930438,2022-01-23 18:55:56,"Mantan pilot di era Presiden Megawati, Agus Sudarya mengungkap kalau Megawati kerap duduk di kokpit saat perjalanan dinas. Simak cerita lengkap Agus Sudarya. https://t.co/nszBvb4sUr",4,2,0,0,2022-01-23,18,Sunday,7,4,2
1485323880000598016,2022-01-23 18:49:43,Chelsea meraih poin penuh saat melakoni Derby London kontra Tottenham Hotspur di Liga Inggris. The Blues menang 2-0 lewat gol Hakim Ziyech dan Thiago Silva. https://t.co/mVQcyfclgZ,26,0,1,0,2022-01-23,18,Sunday,7,27,0
1485322118732648448,2022-01-23 18:42:43,Bamsoet mendorong kalangan akademisi dan KPK melakukan kajian pelaksanaan sistem demokrasi langsung yang selama ini telah diberlakukan. https://t.co/Lt8CDelg7e,4,0,1,1,2022-01-23,18,Sunday,7,5,1
1485320868666523651,2022-01-23 18:37:45,"""Kami harapkan, putra terbaik bangsa, putra terbaik Jawa Barat asli Sunda, masuk bursa Pilpres 2024,"" kata Ketua Relawan RK Jawara, Esha Prihan Jaya. https://t.co/9i8MTlsz0Y",11,2,3,0,2022-01-23,18,Sunday,7,14,2
1485318946219868160,2022-01-23 18:30:07,"Pihak kepolisian akan mengajukan pencabutan izin operasional Bar Flow, Jaksel. Pasalnya, tempat ini kembali melanggar aturan prokes terkait jam operasional https://t.co/RbOwsXuGpI",3,0,1,0,2022-01-23,18,Sunday,7,4,0
1485316814842249220,2022-01-23 18:21:39,"Hartono (38), penyandang tunarungu asal Kota Bandung yang kini menjadi driver ojek online (ojol) mengajak kepada para penyandang disabilitas agar tetap bekerja. https://t.co/jFAnI1pOPJ",19,1,2,1,2022-01-23,18,Sunday,7,21,2
1485315247007227907,2022-01-23 18:15:25,"Real Madrid vs Elche berjalan ketat dalam lanjutan kompetisi Liga Spanyol. Skor berakhir 2-2, di mana Los Blancos sempat tertinggal dua gol plus gagal penalti. https://t.co/3f0f2f55nR",10,0,1,0,2022-01-23,18,Sunday,7,11,0
1485312450077630465,2022-01-23 18:04:18,Siapa saja yang termasuk kelompok rentan berisiko tinggi bila terinfeksi Omicron? Berikut penjelasan epidemiolog Dicky Budiman. https://t.co/V0ciwIGeiq,6,2,1,0,2022-01-23,18,Sunday,7,7,2
1485311070210347014,2022-01-23 17:58:49,Seorang pengusaha kayu di Karawaci Dede Samunandar harus rela kehilangan motornya. Motornya digasak oleh seorang wanita yang awalnya datang meminjam motor. https://t.co/YicX12bO7d,4,0,1,0,2022-01-23,17,Sunday,7,5,0
1485309830969667588,2022-01-23 17:53:54,Seorang ibu dan anaknya dibacok sekelompok orang di Bandung Barat. Keduanya mengalami luka cukup parah akibat sabetan senjata tajam milik pelaku. https://t.co/p41AEYHqjI,6,0,1,0,2022-01-23,17,Sunday,7,7,0
1485308216112304135,2022-01-23 17:47:29,"Jumlah pasien rawat inap Omicron di RSDC Wisma Atlet Kemayoran sebanyak 627 orang. Sementara itu, jumlah pasien Omicron yang pulang sebanyak 604 orang. https://t.co/CHF01htiNW",13,0,5,1,2022-01-23,17,Sunday,7,18,1
1485306703813955586,2022-01-23 17:41:28,Chelsea vs Tottenham Hotspur masih sama kuat di babak pertama pertandingan pekan ke-24 Liga Inggris. Skor masih 0-0. https://t.co/Px8dbLU1wR,4,0,0,0,2022-01-23,17,Sunday,7,4,0
1485303869135593473,2022-01-23 17:30:12,Wakil Gubernur Jawa Barat Uu Ruzhanul Ulum menyatakan dukungannya terkait rencana pencalonan Gubernur Jawa Barat Ridwan Kamil untuk berlaga di Pilpres 2024. https://t.co/MsHX1H7BAe,11,2,1,2,2022-01-23,17,Sunday,7,12,4
1485302095104421906,2022-01-23 17:23:09,Dorce Gamalama mendapat bantuan dari Presiden Joko Widodo hingga Erick Thohir untuk biaya pengobatan. Kerabat mengaku sudah menerima bantuan tersebut berupa uang. https://t.co/7jCJfqGPMa,13,5,2,1,2022-01-23,17,Sunday,7,15,6
1485300877112053779,2022-01-23 17:18:19,Napoli berhasil menang meyakinkan atas Salernitana 4-1. Hasil ini membawa Il Partenopei ke urutan kedua menempel Inter Milan di puncak klasemen. https://t.co/sLZiqWCBS9,3,0,2,0,2022-01-23,17,Sunday,7,5,0
1485298633960476679,2022-01-23 17:09:24,"Traveler mungkin penasaran, apa yang terjadi bila ada penumpang yang meninggal di dalam pesawat? Pramugari membagikan prosedur penanganannya. https://t.co/Lc2JYTJOsh",10,0,4,1,2022-01-23,17,Sunday,7,14,1
1485297314491215886,2022-01-23 17:04:09,Partai Golkar menjawab beredarnya isu soal koalisi antara PKS-Golkar di Pemilu 2024. Dia menyebut akan membuka peluang terhadap semua partai untuk berkoalisi. https://t.co/TI23jlxJrE,7,2,1,0,2022-01-23,17,Sunday,7,8,2
1485296527870504963,2022-01-23 17:01:02,Anggota Komisi I DPR Christina Aryani merespons pengangkatan Mayjend Maruli Simanjuntak sebagai Pangkostrad. Dia menilai Maruli sosok tegas yang tidak neko-neko https://t.co/rKYBoIj0Eu,9,0,1,0,2022-01-23,17,Sunday,7,10,0
1485295736111652869,2022-01-23 16:57:53,"Jose Mourinho sudah puas dengan skuad AS Roma yang ada. Mourinho menegaskan, tidak akan belanja lagi sampai bursa transfer musim dingin Januari ini tuntas. https://t.co/qO13f2y7up",8,1,2,1,2022-01-23,16,Sunday,7,10,2
1485294994479063042,2022-01-23 16:54:56,Madura United mendapatkan pengakuan sebagai klub profesional. Laskar Sape Kerrab mendapatkan sertifikat dari AFC setelah memenuhi lima aspek utama versi AFC. https://t.co/xjFmFUvAF0,9,1,3,0,2022-01-23,16,Sunday,7,12,1
1485294182293979148,2022-01-23 16:51:43,Said Didu terpapar COVID-19 usai melakukan perjalanan keliling Pulau Jawa. Dia dinyatakan positif sejak Jumat (21/1/2022). https://t.co/xXCOcCPxJ7,24,34,2,1,2022-01-23,16,Sunday,7,26,35
1485293661755785216,2022-01-23 16:49:39,Suharso mengatakan hidup bisa terus berjalan dengan baik jika kita menjaga keseimbangan dalam kehidupan seperti bersepeda. https://t.co/6MPBozgWOL,4,1,0,1,2022-01-23,16,Sunday,7,4,2
1485293147118882818,2022-01-23 16:47:36,"Ketua Umum Terpilih Pengurus Provinsi (Pengprov) Perbasi DKI Jakarta, Lexyndo Hakim, mengapresiasi pelaksanaan Seri 1 IBL 2022 yang berjalan lancar. https://t.co/9oxi2ss28M",5,0,1,0,2022-01-23,16,Sunday,7,6,0
1485292372946731012,2022-01-23 16:44:31,"Bercinta tak hanya memberikan kenikmatan, tetapi juga memberikan sejumlah manfaat untuk kesehatan tubuh maupun mental. Wahai para pasutri, ini 9 manfaatnya. https://t.co/H48MZh4AgF",6,1,1,2,2022-01-23,16,Sunday,7,7,3
1485291624309604352,2022-01-23 16:41:33,Ekonom senior Faisal Basri menyinggung adanya lubang-lubang bekas tambang milik Luhut di ibu kota baru. Juru bicara Luhut meminta Faisal memperjalas ucapannya. https://t.co/z8w7WLI67i,10,10,1,0,2022-01-23,16,Sunday,7,11,10
1485290864763101190,2022-01-23 16:38:32,#Terpopuler Transplantasi jantung babi ke manusia untuk pertama kalinya jadi terobosan di dunia medis. Ini Muhammad Mohiuddin sosok di balik itu:   https://t.co/Iqj4uNdMoq,24,3,6,2,2022-01-23,16,Sunday,7,30,5
1485290123403186177,2022-01-23 16:35:35,"Ketum DPP PSI Giring Ganseha sempat berkunjung ke Kampung Papanggo, Jakarta Utara. Warga cerita momen nyanyi bareng Giring. https://t.co/AdpJu7C5y1",4,4,1,0,2022-01-23,16,Sunday,7,5,4
1485289801498701825,2022-01-23 16:34:18,Zlatan Ibrahimovic bicara soal masa depan Kylian Mbappe. Ibrahimovic menilai sudah saatnya Mbappe merasakan kompetisi di luar Prancis. https://t.co/bWDE7nB6xP,6,0,1,0,2022-01-23,16,Sunday,7,7,0
1485289312476401667,2022-01-23 16:32:22,Tiga lembaga ranking internasional mengeluarkan daftar ptn terbaik. Dua diantaranya menempatkan UGM sebagai urutan pertama. Simak lebih jelasnya di sini. https://t.co/oA9MIWWF2p,5,0,1,0,2022-01-23,16,Sunday,7,6,0
1485288431534198791,2022-01-23 16:28:52,"Mantan pilot di era Presiden Megawati, Agus Sudarya mengungkap kalau Megawati kerap duduk di kokpit saat perjalanan dinas. Simak cerita lengkap Agus Sudarya. https://t.co/uDMDRC435A",2,5,1,0,2022-01-23,16,Sunday,7,3,5
1485287701557522433,2022-01-23 16:25:58,"Seorang lansia tewas dikeroyok di Pulogadung, Jakarta Timur. Sebelumnya, dia dikejar dan diteriaki maling oleh sekelompok orang yang mengejarnya. https://t.co/xZc2Eh2mSe",166,77,63,50,2022-01-23,16,Sunday,7,229,127
1485286415906791429,2022-01-23 16:20:51,"Polisi kembali menyegel Bar Flow yang berlokasi di Kuningan Jaksel. Kali ini, Bar Flow ditetapkan melanggar Prokes terkait waktu operasional semasa PPKM. https://t.co/9Dy8f3gkax",6,0,1,0,2022-01-23,16,Sunday,7,7,0
1485286144065552386,2022-01-23 16:19:46,"Beberapa kali, PSI mengkritik Gubernur Anies Baswedan soal pagelaran Formula E. Namun, tiba-tiba politikus PSI menyampaikan hal mengejutkan. https://t.co/VSSdY4Dqo6",5,1,0,0,2022-01-23,16,Sunday,7,5,1
1485284724839006212,2022-01-23 16:14:08,Di media sosial ramai soal video viral belatung. Netizen syok dengan video yang tampak menunjukkan vagina berisi belatung hidup.  https://t.co/rI1oJRwlYe,14,1,3,1,2022-01-23,16,Sunday,7,17,2
1485283945457590286,2022-01-23 16:11:02,Anggota Komisi I DPR Christina Aryani merespons pengangkatan Mayjend Maruli Simanjuntak sebagai Pangkostrad. Dia menilai Maruli sosok tegas yang tidak neko-neko https://t.co/OpPGQsKMJr,6,0,1,1,2022-01-23,16,Sunday,7,7,1
1485283230978912258,2022-01-23 16:08:12,Direktur Parameter Politik Indonesia melihat serangan kritik yang dilancarkan Giring Ganesha justru secara tidak langsung memviralkan kinerja-kinerja Anies. https://t.co/ou6F8jha0n,17,6,4,0,2022-01-23,16,Sunday,7,21,6
1485283209466286082,2022-01-23 16:08:07,"Patah hati terhadap Indonesia? ""Iya, it broke my heart,"" kata Nadine Kaiser, sang pengawal Susi Air, putri Susi Pudjiastuti. Simak kisahnya di sini:   https://t.co/rhcqdDveBn",14,3,0,0,2022-01-23,16,Sunday,7,14,3
1485281347094691845,2022-01-23 16:00:42,Arsenal tertahan di kandang oleh Burnley. The Gunners gagal membongkar lini pertahanan The Clarets hingga skor 0-0 menutup laga. https://t.co/ngHzPg2CCz,7,2,0,0,2022-01-23,16,Sunday,7,7,2
1485280601242488832,2022-01-23 15:57:45,Panglima TNI Jenderal Andika Perkasa menunjuk Mayjen Maruli Simanjuntak sebagai Pangkostrad. TB Hasanuddin menilai penunjukan telah melalui pertimbangan matang. https://t.co/qFyrDAhtNM,10,3,2,1,2022-01-23,15,Sunday,7,12,4
1485279854790692868,2022-01-23 15:54:47,Liverpool tampil dominan atas tuan rumah Crystal Palace sepanjang babak pertama laga Premier League. The Reds unggul 2-0 hingga turun minum. https://t.co/rwEr4Gx8et,16,0,1,0,2022-01-23,15,Sunday,7,17,0
1485277470249164805,2022-01-23 15:45:18,Kecelakaan melibatkan dua truk di kawasan Jakarta Selatan memakan korban jiwa. Satu orang tewas dalam kecelakaan maut itu. https://t.co/E662XJjVLN,9,0,0,0,2022-01-23,15,Sunday,7,9,0
1485276399929901060,2022-01-23 15:41:03,Kinobi Scholarship menawarkan beasiswa untuk mahasiswa D3 - S1 semua jurusan tanpa batas minimal IPK. Cek syarat dan jadwal beasiswa Kinobi 2022. https://t.co/D0nnqtau75,27,0,7,0,2022-01-23,15,Sunday,7,34,0
1485275552823054341,2022-01-23 15:37:41,Relawan Anies kemudian berkelakar soal kepanjangan PSI. Kepanjangan PSI dipelesetkan jadi partai seputaran Ibu Kota. https://t.co/k3mriopZFm,40,9,3,7,2022-01-23,15,Sunday,7,43,16
1485274530801197062,2022-01-23 15:33:37,"Seperti halnya pisau, otak juga perlu diasah agar selalu tajam. Otak juga butuh diolahragakan agar lebih berstamina untuk menyambut awal pekan. Yuk dicoba! https://t.co/kkvG2uRWAy",43,38,5,1,2022-01-23,15,Sunday,7,48,39
1485273609241337862,2022-01-23 15:29:58,"Seorang lansia tewas dikeroyok di Pulogadung, Cakung, Jakarta Timur. Kini polisi memburu pelaku pengeroyokan. https://t.co/oPsp2v5cn0",17,6,6,6,2022-01-23,15,Sunday,7,23,12
1485272611701600257,2022-01-23 15:26:00,"Jumlah kasus positif COVID-19 di Indonesia bertambah 2.925, Minggu (23/1/2022). Total kasus positif 4.286.378, sembuh 4.123.267, dan meninggal 144.220. https://t.co/CC0QApqed8",14,1,5,2,2022-01-23,15,Sunday,7,19,3
1485270080468434948,2022-01-23 15:15:56,Elon Musk melalui perusahaannya Neuralink tengah merekrut direktur dan koordinator uji klinis untuk proyek penanaman chip ke otak manusia.  https://t.co/pEP8fRVuqh,22,6,6,11,2022-01-23,15,Sunday,7,28,17
1485269184267395072,2022-01-23 15:12:23,Sosok Edy Mulyadi yang menyebut Prabowo Subianto bak 'macan jadi mengeong' dikaitkan dengan PKS. PKS lantas mengklarifikasi status kepartaian Edy Mulyadi. https://t.co/9vw040qwPa,32,36,10,8,2022-01-23,15,Sunday,7,42,44
1485268441326145537,2022-01-23 15:09:26,Sebagian pria mungkin khawatir bila air maninya tampak encer. Sebenarnya apakah ini normal dan apa penyebabnya? Simak penjelasan berikut. https://t.co/Ch4z0BWEIr,20,2,5,0,2022-01-23,15,Sunday,7,25,2
1485267453613686794,2022-01-23 15:05:30,"DKI Jakarta menjadi daerah dengan penyumbang kasus tertinggi, yakni sebanyak 1.739 kasus. Berikut peta sebaran kasus baru Covid-19 terkini. https://t.co/yA1NnBgeRC",24,1,6,1,2022-01-23,15,Sunday,7,30,2
1485266027797745664,2022-01-23 14:59:50,"Satu unit rumah milik warga di Kecamatan Percut Sei Tuan, Deli Serdang, Sumut dilalap si jago merah. Satu orang penghuninya tewas dalam peristiwa tersebut. https://t.co/zHkdnoQbUo",10,0,1,0,2022-01-23,14,Sunday,7,11,0
1485265484744384514,2022-01-23 14:57:41,Sudirman dinanti pekerjaan besar bersama Persija Jakarta sampai akhir musim BRI Liga 1 2021. Manajemen menargetkan Macan Kemayoran finis di posisi 3 besar. https://t.co/vz2fNIBb6J,14,0,3,0,2022-01-23,14,Sunday,7,17,0
1485264456162676741,2022-01-23 14:53:35,"Dinas Kesehatan DKI Jakarta mencatat kasus aktif di Jakarta hari ini bertambah 1.217 orang, sehingga totalnya menjadi 9.057 orang. https://t.co/NR6RKSvBJW",34,7,15,6,2022-01-23,14,Sunday,7,49,13
1485262819989852160,2022-01-23 14:47:05,Forum Pemuda Lintas Agama Kalimantan Timur mengadukan Edy Mulyadi karena pernyataan yang diduga menghina Kalimantan ke polisi. https://t.co/KKC70YmOCG,108,20,20,8,2022-01-23,14,Sunday,7,128,28
1485262536236802054,2022-01-23 14:45:58,Golkar telah menetapkan Airlangga Hartato sebagai bakal calon presiden dalam Pemilu tahun 2024. Airlangga dipastikan calon tunggal yang diusung Partai Golkar https://t.co/3AKsq2OrFh,17,7,1,2,2022-01-23,14,Sunday,7,18,9
1485262197773193217,2022-01-23 14:44:37,"Marcus Rashford sudah kembali tajam untuk Manchester United. Pemain 24 tahun itu sudah kembali tersenyum, tim lawan harus waspada. https://t.co/7AaDhpj85e",14,0,1,1,2022-01-23,14,Sunday,7,15,1
1485261874543353856,2022-01-23 14:43:20,"Relawan Anies Baswedan, Geisz Chalifa menyebut PSI mendongkrak elektabilitas dengan cara mengkritik Anies Baswedan. PSI menyebut partainya bertugas mengawasi https://t.co/c0l8mhHMqR",30,18,2,3,2022-01-23,14,Sunday,7,32,21
1485260906208669698,2022-01-23 14:39:29,AC Milan menghadapi Juventus pada lanjutan Liga Italia dini hari nanti. Zlatan Ibrahimovic mempunyai rekor kurang oke saat melawan Bianconeri. https://t.co/vg0HmMvIEC,10,3,2,0,2022-01-23,14,Sunday,7,12,3
1485260348689158144,2022-01-23 14:37:16,"Seorang napi Lapas Argamakmur Bengkulu, Basuki (50) yang sempat kabur, akhirnya kembali ditangkap. Pria paruh baya itu dibekuk di Kabupaten Mukomuko. https://t.co/jJ0ehcwmst",12,0,2,0,2022-01-23,14,Sunday,7,14,0
1485258799925665794,2022-01-23 14:31:07,Sejumlah titik banjir dan genangan air di Jakarta terjadi akibat hujan ekstrem sejak 18 Januari. BPBD DKI Jakarta memastikan tak ada korban jiwa akibat banjir. https://t.co/NJlMUhlRRJ,9,0,3,2,2022-01-23,14,Sunday,7,12,2
1485256666388090885,2022-01-23 14:22:38,"Kabar duka dari dunia kedokteran, tokoh hepatitis Prof H Ali Sulaiman, PhD, SpPD-KGEH berpulang. Prof Ali meninggal di RS Pelni Jakarta, Minggu (23/1/2022). https://t.co/JH9Atbt607",88,5,17,4,2022-01-23,14,Sunday,7,105,9
1485256422027837442,2022-01-23 14:21:40,Satpol PP memberikan teguran tertulis ke Mall of Indonesia karena kerumunan event anime. https://t.co/dBThThqjBZ,77,11,23,18,2022-01-23,14,Sunday,7,100,29
1485255397887942658,2022-01-23 14:17:36,Tebak-tebakan ini belum tentu bisa dijawab oleh orang cerdas sekalipun. Coba pecahkan teka-teki receh ini sambil melatih otak. https://t.co/E7XHb9r29c,138,121,23,5,2022-01-23,14,Sunday,7,161,126
1485254346107494403,2022-01-23 14:13:25,"Kevin De Bruyne masuk dalam daftar elit, pemain dengan assist terbanyak di Liga Inggris. Ada delapan nama lagi, yang harus dia lewati untuk jadi raja assist! https://t.co/OWY5BROfcw",15,0,1,0,2022-01-23,14,Sunday,7,16,0
1485253005465329664,2022-01-23 14:08:05,Masih ingat Suster Cecilia di telenovela Carita de Angel? Penampilan terbarunya jauh berbeda dengan perannya di cerita tersebut. Ini potretnya:  https://t.co/MJeire89jW,29,1,13,4,2022-01-23,14,Sunday,7,42,5
1485251297846743045,2022-01-23 14:01:18,"Meski aromanya tak sedap, jengkol ternyata tetap jadi favorit sebagian orang. Coba bikin resep semur jengkol pedas untuk variasi menu sehari-hari, Bunda. #detiknetwork  https://t.co/9SF4lNLShy",27,2,4,2,2022-01-23,14,Sunday,7,31,4
1485249968105574403,2022-01-23 13:56:01,"Plaza Rawa Jombor di kawasan Rawa Jombor, Desa Krakitan, Kecamatan Bayat, Klaten, dipenuhi eceng gondok. Hal ini dikeluhkan oleh para pelaku pariwisata. https://t.co/H89QzRufVT",25,0,4,1,2022-01-23,13,Sunday,7,29,1
1485249188636078087,2022-01-23 13:52:55,"Ketika para pria ini mengalami kondisi medis yang memengaruhi organ intimnya, tim dokter berusaha membantu dengan membuatkan penis bionik. Ini kisah mereka: https://t.co/g6Eq6sjS5h",11,1,4,0,2022-01-23,13,Sunday,7,15,1
1485248445761921026,2022-01-23 13:49:58,"Para bintang TikTok semakin kaya raya, bahkan pendapatan sebagian dari mereka disebut telah menyamai bahkan melebihi penghasilan CEO di perusahaan top. https://t.co/UBuCbo2Rvk",34,0,8,2,2022-01-23,13,Sunday,7,42,2
1485247409810780163,2022-01-23 13:45:51,"Pertempuran antara kelompok ISIS dan pasukan Kurdi di Suriah terus memakan korban jiwa di hari keempat. Ada lebih dari 120 orang tewas, termasuk warga sipil. https://t.co/uBsNqau1Bt",14,0,6,1,2022-01-23,13,Sunday,7,20,1
1485246902757208064,2022-01-23 13:43:50,"13 Laga awal sudah dilalui Xavi sebagai pelatih Barcelona. Jika dibandingkan dengan 13 laga awal di era Ronald Koeman, lebih bagus siapa? https://t.co/VAajbyijMu",17,1,1,0,2022-01-23,13,Sunday,7,18,1
1485246357061386245,2022-01-23 13:41:40,"AS Roma akan menghadapi Empoli di lanjutan Liga Italia. Meski di atas kertas Roma diunggulkan, Jose Mourinho memprediksi laga tidak akan mudah untuk timnya. https://t.co/3fshZzdzeU",13,1,2,0,2022-01-23,13,Sunday,7,15,1
1485245691475775492,2022-01-23 13:39:02,"Relawan Anies Baswedan, Geisz Chalif kerap mencuit nama Anies Baswedan yang 'dimodifikasi'. Huruf B di nama lengkap Anies diganti jadi angka 8. Apa maknanya? https://t.co/bzXcK3lHdf",22,26,1,5,2022-01-23,13,Sunday,7,23,31
1485244547227602946,2022-01-23 13:34:29,Andrew Garfield juga membohongi Emma Stone soal penampilannya di Spider-Man: No Way Home. Begini kisahnya:  https://t.co/AbtZQRg6d6,18,0,3,1,2022-01-23,13,Sunday,7,21,1
1485243494511910913,2022-01-23 13:30:18,Seorang karyawan Raffi Ahmad dan Nagita Slavina yang bekerja di RANS Entertainment mengungkapkan biaya makan sehari:  https://t.co/DW1df4hwIj,14,9,6,6,2022-01-23,13,Sunday,7,20,15
1485241182041124871,2022-01-23 13:21:06,"PSI menyebut Anies Baswedan tidak melakukan upaya penanganan banjir jakarta. Sehingga, jika Jakarta tidak banjir, hal itu adalah hoki bagi Anies. https://t.co/eNu0BV9HRk",164,216,13,48,2022-01-23,13,Sunday,7,177,264
1485240175382958083,2022-01-23 13:17:06,Ketua DPP Golkar Dave Laksono menyebut partainya sudah mengantongi sejumlah nama cawapres untuk mendampingi Airlangga Hartarto di Pilpres 2024. https://t.co/PrUAxPIP9G,9,2,2,1,2022-01-23,13,Sunday,7,11,3
1485239446853275653,2022-01-23 13:14:13,"Dua orang tewas akibat terlindas truk di Jalan AH Nasution, Kota Tasikmalaya. Kasus kecelakaan maut ini ditangani Unit Gakkum Satlantas Polresta Tasikmalaya. https://t.co/5ELYzLUlHR",16,4,6,4,2022-01-23,13,Sunday,7,22,8
1485238374373937154,2022-01-23 13:09:57,"Secara mengejutkan, Priyanka Chopra mengumumkan kelahiran anak pertamanya bersama Nick Jonas. Ini detail kelahiran anak pertamanya yang lewat rahim pengganti. https://t.co/AV4Ou2p3rp",11,0,7,1,2022-01-23,13,Sunday,7,18,1
1485236835798458370,2022-01-23 13:03:50,Kemenkes baru-baru ini mengumumkan ada dua pasien Omicron di Indonesia yang meninggal dunia. Ini gejala berat yang sempat dikeluhkan pasien. https://t.co/CFC2PyUShz,30,9,4,4,2022-01-23,13,Sunday,7,34,13
1485234157534040064,2022-01-23 12:53:12,Manchester United memetik kemenangan dramatis atas West Ham United. Kepercayaan diri Setan Merah kian besar usai memetik kemenangan beruntun. https://t.co/p5RqretCre,17,0,2,0,2022-01-23,12,Sunday,7,19,0
1485232152719540229,2022-01-23 12:45:14,Bagaimana cuaca besok di Jabodetabek banyak dicari tahu masyarakat jelang beraktivitas pada Senin besok. Ini perkiraannya pada 24 Januari 2022. https://t.co/JWXbfpDqCA,6,0,5,0,2022-01-23,12,Sunday,7,11,0
1485231631954755586,2022-01-23 12:43:09,"Kejadian tak terduga dialami housekeeping di sebuah hotel Bogor. Pasalnya, dikabarkan ada sultan yang menebar puluhan lembar uang tip di lantai kamarnya. https://t.co/dB9oi9nGDn",24,4,3,1,2022-01-23,12,Sunday,7,27,5
1485230650030501896,2022-01-23 12:39:15,"Rumah tangganya sempat dikabarkan retak, Shandy Aulia terlihat bersama lagi dengan sang suami. Ini alasan Shandy soal kembali dengan sang suami:  https://t.co/yAnHFYsVAv",16,1,5,0,2022-01-23,12,Sunday,7,21,1
1485228886715736067,2022-01-23 12:32:15,"Korban keracunan makanan di Sodonghilir Tasikmalaya terus bertambah. Berdasarkan data Puskesmas Sodonghilir, jumlah korban keracunan mencapai 85 orang. https://t.co/okED2EyVo7",9,1,4,1,2022-01-23,12,Sunday,7,13,2
1485228071443705856,2022-01-23 12:29:01,Presiden Jokowi telah mengantongi nama calon Kepala Otorita Ibu Kota Negara (IKN). Bagaimana keunggulan masing-masing calon di mata pengamat politik? https://t.co/h2MPJrGppa,11,6,4,2,2022-01-23,12,Sunday,7,15,8
1485227158352113671,2022-01-23 12:25:23,Seorang ibu hamil berinisial MM (23) di Depok mau menjual ginjalnya lantaran terlilit utang. Begini penjelasan MM terkait penyebab utangnya mencapai Rp 1 M. https://t.co/LpnOjTNroK,18,11,8,3,2022-01-23,12,Sunday,7,26,14
1485226190747148290,2022-01-23 12:21:32,Seorang ibu hamil berinisial MM (23) di Depok mau menjual ginjalnya lantaran terlilit utang. Begini penjelasan MM terkait penyebab utangnya mencapai Rp 1 M. https://t.co/E0SnpIiSrw,16,2,7,2,2022-01-23,12,Sunday,7,23,4
1485224912705015817,2022-01-23 12:16:27,"Pungli, kata Arif, menjadi persoalan serius yang akan dibenahi oleh pemerintah dalam rangka menciptakan pemerintahan yang bersih. https://t.co/9zyIfL3Ivk",10,1,2,0,2022-01-23,12,Sunday,7,12,1
1485223360443334660,2022-01-23 12:10:17,Kondisi Ukraina terkait ancaman serangan Rusia kian panas. Berikut fakta-fakta terkini imbas memanasnya kondisi di Ukraina. https://t.co/1diVdUfDFE,15,1,4,0,2022-01-23,12,Sunday,7,19,1
1485223132470419464,2022-01-23 12:09:23,"Lion Air Group jadi salah satu maskapai utama di Bandara Internasional Halim Perdanakusuma. Terkait pembangunan bandara, berikut pengaturan penerbangannya. https://t.co/vaiJg5VJNF",9,1,1,1,2022-01-23,12,Sunday,7,10,2
1485221542313267204,2022-01-23 12:03:04,Chelsea vs Tottenham Hotspur jadi Derby London seru di Liga Inggris akhir pekan ini. Berikut link live streaming pertandingannya. https://t.co/SEd6o2P5op,11,0,1,0,2022-01-23,12,Sunday,7,12,0
1485220996751757313,2022-01-23 12:00:54,"Namun, meskipun lezat, Anda harus berhati-hati saat makan gorengan. Jika terlalu berlebihan, gorengan justru berbahaya untuk kesehatan dan disebut bisa meningkatkan risiko kematian. #CNNIndonesia #detiknetwork  https://t.co/lQKIHpAsBr",28,32,10,5,2022-01-23,12,Sunday,7,38,37
1485219713764446208,2022-01-23 11:55:48,"Pendiri platform Ethereum, Vitalik Buterin, mengusulkan peran hamil perempuan diganti dengan rahim buatan. Hal ini dianggap mengurangi ketidaksetaraan gender. https://t.co/LGn6PB2uDX",22,15,8,5,2022-01-23,11,Sunday,7,30,20
1485218692913065985,2022-01-23 11:51:45,Ternyata ada keuntungan bagi traveler yang masuk atau naik pesawat lebih dulu. Keuntungan ini pasti membuat Anda lebih nyaman terbang. https://t.co/N4hnnCVcKU,11,0,3,1,2022-01-23,11,Sunday,7,14,1
1485217073647308805,2022-01-23 11:45:19,Sejumlah mobil mewah diberhentikan polisi. Lantaran membuat kemacetan saat melakukan sesi dokumentasi di ruas Tol Andara pada Minggu (23/1). https://t.co/dhqPuNbiw5,38,23,18,6,2022-01-23,11,Sunday,7,56,29
1485215757667557378,2022-01-23 11:40:05,Pasien Omicron RI yang meninggal disebut mengalami penurunan saturasi oksigen. Ini ciri-ciri saturasi oksigen yang rendah. https://t.co/OsdGN4JAcV,17,2,9,0,2022-01-23,11,Sunday,7,26,2
1485214761256169477,2022-01-23 11:36:07,Kamu sedang mencari kata mutiara cinta yang menggambarkan suasana hati untuk pujaan hati? Berikut kumpulan kata mutiara cinta yang bisa dijadikan referensi. https://t.co/4u68av8QQ8,8,1,3,0,2022-01-23,11,Sunday,7,11,1
1485213742413529089,2022-01-23 11:32:04,"Meski demikian, polisi akan menyelidiki benar atau tidaknya keterangan Edy. Polisi akan mengecek riwayat perawatan truk di bengkelnya. https://t.co/TS1v788MIs",11,0,1,0,2022-01-23,11,Sunday,7,12,0
1485212728608309252,2022-01-23 11:28:03,Tisu magic sering digunakan oleh pria saat melakukan hubungan seksual. Benda ini biasa digunakan untuk menunda ejakulasi dini. Bagaimana efek sampingnya ya? https://t.co/X437dmfz1q,9,1,1,1,2022-01-23,11,Sunday,7,10,2
1485211693743542276,2022-01-23 11:23:56,Ramalan zodiak cinta Virgo berusahalah untuk selalu memberi yang terbaik untuknya. Bagaimana ramalan zodiak cinta anda hari ini: https://t.co/AuVSbKShJX,8,1,0,1,2022-01-23,11,Sunday,7,8,2
1485210672329895937,2022-01-23 11:19:52,Akbar Wicaksono mendadak jadi sorotan. Ia ngaku menghasilkan puluhan miliar per tahunnya sampai tetangga sempat curiga. https://t.co/Q9XTsLuu7n,138,18,17,10,2022-01-23,11,Sunday,7,155,28
1485209406102986754,2022-01-23 11:14:50,Ibu pengganti alias metode surrogate adalah proses 'menitipkan' anak di dalam rahim wanita lain seperti dilakukan oleh Priyanka Chopra. Berikut 5 faktanya. https://t.co/FyLVy4RbzU,10,4,5,2,2022-01-23,11,Sunday,7,15,6
1485207884896034823,2022-01-23 11:08:48,Hari ini dilaporkan ada tambahan 2.925 kasus positif COVID-19 di Indonesia. Sementara kasus sembuh bertambah 712 dan meninggal 14. https://t.co/EzfJADX0B5,15,1,5,2,2022-01-23,11,Sunday,7,20,3
1485206385025601537,2022-01-23 11:02:50,"Chelsea akan menjamu Tottenham Hotspur di lanjutan Liga Inggris. Juru taktik The Lilywhites, Antonio Conte, sadar akan melawan tim kuat. https://t.co/qXpRm5J3Pf",11,0,1,0,2022-01-23,11,Sunday,7,12,0
1485206135883939840,2022-01-23 11:01:51,"Erfando Ilham (19) meninggal di atas pos pendakian 4 Gunung Penanggungan, Mojokerto. Mahasiswa Ubaya itu sempat terjungkal 3 kali hingga mengalami luka. https://t.co/var46iUXLC",36,1,5,0,2022-01-23,11,Sunday,7,41,1
1485204761469140994,2022-01-23 10:56:23,"Sebagai simbolis wujud dukungan, para perajin batik memberikan seutas kain batik berwarna hijau bertulis 'Gus Muhaimin Presiden 2024'. https://t.co/Io2h5h7XID",13,11,1,0,2022-01-23,10,Sunday,7,14,11
1485203718228398081,2022-01-23 10:52:14,Polisi sedang memburu para pelaku pengeroyok sopir lansia hingga tewas di Jaktim. Korban dikeroyok dan bahkans empat diteriaki maling. https://t.co/Wn0joCkpdE,27,6,5,2,2022-01-23,10,Sunday,7,32,8
1485203435175788545,2022-01-23 10:51:07,"Jumlah kasus positif COVID-19 di Indonesia bertambah 2.925, Minggu (23/1/2022). Total kasus positif menjadi 4.286.378, sembuh 4.123.267, dan meninggal 144.220. https://t.co/fb9c1PCFez",9,1,4,2,2022-01-23,10,Sunday,7,13,3
1485203209811644419,2022-01-23 10:50:13,"Ketua Umum Pimpinan Pusat Muhammadiyah Haedar Nashir memastikan pembangunan rumah sakit di kawasan Ciparay, Kabupaten Bandung, ini rampung dalam waktu cepat. https://t.co/FweNMpDzkW",41,3,4,0,2022-01-23,10,Sunday,7,45,3
1485201962568200198,2022-01-23 10:45:16,"Gubernur Aceh Nova Iriansyah meresmikan ruas Jalan Balu-Lapeng di Pulo Breuh, Kecamatan Pulo Aceh, Aceh Besar. Kini warga tak perlu lagi menggunakan jalur laut. https://t.co/McrtqmkbEe",20,0,2,2,2022-01-23,10,Sunday,7,22,2
1485200122388619264,2022-01-23 10:37:57,Presiden Joko Widodo menyebut kriteria pemimpin Nusantara itu setidaknya berlatar belakang arsitek dan pernah menjadi kepala daerah. https://t.co/OSORItNXNC,25,8,5,0,2022-01-23,10,Sunday,7,30,8
1485199415535091722,2022-01-23 10:35:08,"Video penolakan dan pengusiran Haikal Hassan, viral di medsos dan grup whatsapp. Haikal membantah dirinya ditolak dan diusir. https://t.co/GQOBGdHPM9",14,21,2,2,2022-01-23,10,Sunday,7,16,23
1485198342225289223,2022-01-23 10:30:53,"Sosok Edy Mulyadi yang menyebut Prabowo Subianto 'macan jadi mengeong', dikaitkan dengan PKS. Jubir PKS meluruskan status Edy di partai itu. https://t.co/8lVY3ZR92E",18,21,4,4,2022-01-23,10,Sunday,7,22,25
1485197114749693952,2022-01-23 10:26:00,Ada beberapa petunjuk yang bisa kamu gunakan untuk menjawab tebak-tebakan berikut. Pikirkan baik-baik sebelum menjawabnya. Selamat mencoba! https://t.co/qo3FpvCSK5,44,61,7,2,2022-01-23,10,Sunday,7,51,63
1485195879321591809,2022-01-23 10:21:05,"Viral pria bernama Edy Mulyadi menyebut Prabowo seperti macan yang mengeong. Di awal pembicaraan, Edy membahas tentang siapa yang akan jadi pengembang di Ibu Kota Negara (IKN) Nusantara. https://t.co/0zhPf8hN14",19,13,3,2,2022-01-23,10,Sunday,7,22,15
1485194108247416834,2022-01-23 10:14:03,Pramono Anung cerita sikap tegas Megawati ancam kader di parlemen yang interupsi sidang tahunan era SBY. Simak cerita selengkapnya. https://t.co/kYbmGtGuvD,11,9,2,0,2022-01-23,10,Sunday,7,13,9
1485193607946641408,2022-01-23 10:12:04,Varian Omicron memang diklaim lebih cepat menular dibandingkan varian lainnya. Ini 3 gejala utama terinfeksi COVID-19 varian Omicron yang harus diwaspadai guys. https://t.co/PxFqJhh8v0,10,9,5,0,2022-01-23,10,Sunday,7,15,9
1485191789749444610,2022-01-23 10:04:50,Antonio Conte dikenal sebagai pelatih yang berapi-api di pinggir lapangan. Thomas Tuchel berharap tidak akan terpancing saat Chelsea melawan Tottenham. https://t.co/oYLkq2zsLO,11,1,0,0,2022-01-23,10,Sunday,7,11,1
1485191105763323905,2022-01-23 10:02:07,"Haikal Hassan buka suara terkait video viral dia ditolak dan diusir warga saat ceramah di Malang dan Batu, Jatim. Ia memastikan agenda ceramahnya kondusif. https://t.co/R3gy3LjCI2",4,10,0,1,2022-01-23,10,Sunday,7,4,11
1485189962433712131,2022-01-23 09:57:35,"Bantuan tersebut diberikan untuk memenuhi kebutuhan pendidikan, pembukaan usaha hingga peningkatan literasi keuangan bagi para PMI. https://t.co/jHiSzIgCpJ",4,1,0,0,2022-01-23,9,Sunday,7,4,1
1485187694594510851,2022-01-23 09:48:34,Beragam komentar warga terkait adanya pasien Omicron di RI yang meninggal dunia. Simak selengkapnya. https://t.co/2ArywVvZlz,12,4,5,0,2022-01-23,9,Sunday,7,17,4
1485186953620373504,2022-01-23 09:45:37,Seorang sopir di Jaktim menjadi korban pengeroyokan hingga tewas. Korban diketahui sempat menabrak pemotor. https://t.co/6QaYlrCQco,8,1,3,0,2022-01-23,9,Sunday,7,11,1
1485186680613134340,2022-01-23 09:44:32,Shin Tae-yong harus kembali membenahi ulang mental pemain Timnas Indonesia setelah kembali dari klub. Saat ini Garuda menjalani Pemusatan Latihan (TC) di klub. https://t.co/xKQcr4aGPM,14,3,1,0,2022-01-23,9,Sunday,7,15,3
1485186190135504897,2022-01-23 09:42:35,Witan Sulaeman langsung menjalani debut bersama FK Senica setelah resmi diumumkan jadi pemain baru klub. Pemain muda Indonesia bahkan juga main penuh 90 menit. https://t.co/NQmdF4GW3d,28,0,3,0,2022-01-23,9,Sunday,7,31,0
1485185662668218369,2022-01-23 09:40:30,"Kawasan Lapangan Bantemg, Jakarta, tampak ramai warga yang berolahraga. Mereka menikmati akhir pekan di tengah melonjaknya kasus Omicron. https://t.co/InS8oPD3Y2",13,2,4,1,2022-01-23,9,Sunday,7,17,3
1485184818841366528,2022-01-23 09:37:08,Tak jarang orang dengan tipe yang terlalu baik malah dimanfaatkan oleh orang lain. Cari tahu zodiak apa saja yang paling gampang untuk dimanfaatin. https://t.co/UQEQpaNkxa,9,0,3,3,2022-01-23,9,Sunday,7,12,3
1485183017618481154,2022-01-23 09:29:59,"Pendiri grup anti-vaksin Healing the Divide di Singapura, Iris Koh, ditangkap polisi. Iris diduga terlibat pemalsuan sertifikat vaksin COVID-19. https://t.co/3pkoalZSvW",8,0,3,0,2022-01-23,9,Sunday,7,11,0
1485182536653455361,2022-01-23 09:28:04,Rian mengatakan Formula E saat ini menggunakan anggaran yang berasal dari APBD dan nominalnya hampir setengah triliun rupiah. https://t.co/dXNCMFWgjk,56,71,6,7,2022-01-23,9,Sunday,7,62,78
1485182042312695808,2022-01-23 09:26:06,"Video aksi diduga preman melakukan pungutan liar (pungli) di Medan, Sumatera Utara (Sumut) viral di media sosial. Polisi pun menangkap pelaku tersebut. https://t.co/f2AM4Sf5oV",5,1,0,1,2022-01-23,9,Sunday,7,5,2
1485181563381989378,2022-01-23 09:24:12,Alun-alun Garut atau Lapangan Otto Iskandar Dinata (Otista) rampung direnovasi. Tempatnya kini lebih representatif dan banyak fasilitas baru. https://t.co/9g887TBnIA,3,1,1,1,2022-01-23,9,Sunday,7,4,2
1485180760986648583,2022-01-23 09:21:01,"Gak perlu keluar rumah!
-
Pilih layanan IndiHome terupdate sesuai kebutuhan.
-
Jadi lebih aman dan makin nyaman beraktivitas digital selama di rumah bersama IndiHome!
https://t.co/tYZpScKKN7

#AktivitasTanpaBatas
#InternetnyaIndonesia https://t.co/8Tm3pANtPu",4,1,2,0,2022-01-23,9,Sunday,7,6,1
1485180569185046528,2022-01-23 09:20:15,"Keracunan massal terjadi di Pondok Pesantren Khalifah, Kampung Salakopi, Kabupaten Sukabumi. Peristiwa keracunan itu terjadi usai mereka menyantap makanan. https://t.co/DRSoZgwKdC",5,1,1,0,2022-01-23,9,Sunday,7,6,1
1485179105133928451,2022-01-23 09:14:26,"Granit Xhaka disorot tajam karena kartu merahnya saat melawan Liverpool. Gelandang Arsenal itu merasa bakal salah, apapun keputusannya di lapangan. https://t.co/lybD8cAuPd",6,0,0,1,2022-01-23,9,Sunday,7,6,1
1485178145967857668,2022-01-23 09:10:37,Kisah cinta beda negara ini mendadak viral karena pria asal Sulawesi menikahi majikannya bule cantik asal Jerman. Seperti apa kisahnya? https://t.co/mSukverpS0,35,7,2,1,2022-01-23,9,Sunday,7,37,8
1485176795238486018,2022-01-23 09:05:15,Pasien Omicron RI yang meninggal disebut mengalami penurunan saturasi oksigen. Ini ciri-ciri saturasi oksigen yang rendah. https://t.co/bdP8o99C9t,7,0,3,0,2022-01-23,9,Sunday,7,10,0
1485176558964858882,2022-01-23 09:04:19,Chelsea vs Tottenham Hotspur jadi sajian super sunday Liga Inggris akhir pekan ini. Antonio Conte buru kemenangan pertama saat berhadapan dengan Thomas Tuchel. https://t.co/rLbpQBOhfF,5,0,2,0,2022-01-23,9,Sunday,7,7,0
1485175727142150148,2022-01-23 09:01:01,"Seperti orang tua lainnya, Pangeran William dan Kate Middleton punya panggilan sayang untuk ketiga anaknya lho Bunda. Penasaran apa saja? Yuk kita simak. #detiknetwork  https://t.co/H2MauACzCi",10,0,2,0,2022-01-23,9,Sunday,7,12,0
1485174471627530241,2022-01-23 08:56:01,"Duel utama di UFC 270, Francis Ngannou vs Ciryl Gane. Ngannou menang angka dan unggul dalam permainan gulat. https://t.co/Qp4PrlZXrW",6,0,0,0,2022-01-23,8,Sunday,7,6,0
1485172998692823045,2022-01-23 08:50:10,Pasangan artis Priyanka Chopra dan Nick Jonas mengumumkan kelahiran anak pertamanya menggunakan metode surrogate. Apa sih itu? Simak informasinya di sini. https://t.co/maRUpk6EYe,12,0,2,2,2022-01-23,8,Sunday,7,14,2
1485171387140608001,2022-01-23 08:43:46,Seorang lansia pengemudi mobil di Jaktim jadi korban amukan massa karena dikira maling. Korban dikeroyok hingga meninggal dunia. https://t.co/guTBLEmaex,118,66,38,71,2022-01-23,8,Sunday,7,156,137
1485170954288472064,2022-01-23 08:42:03,Jajanan di belakang GI dan PI jadi favorit banyak orang. Seperti dua tempat ini. Nasi Bebek Cak Heri dan Roti Penyet OTS layak dicoba. https://t.co/UQyKOBVRuh,59,9,18,7,2022-01-23,8,Sunday,7,77,16
1485169826712666113,2022-01-23 08:37:34,"Marcus Rashford jadi penyelamat Manchester United saat menang atas West Ham 1-0. Bukan sekali ini saja, Rashford jadi juru selamat Setan Merah! https://t.co/GtfaO3ppxw",14,0,0,0,2022-01-23,8,Sunday,7,14,0
1485168663451901954,2022-01-23 08:32:57,"Pendiri platform Ethereum, Vitalik Buterin, mengusulkan peran hamil perempuan diganti dengan rahim buatan. Hal ini dianggap mengurangi ketidaksetaraan gender. https://t.co/39II4LD85x",10,1,3,2,2022-01-23,8,Sunday,7,13,3
1485167633888595968,2022-01-23 08:28:51,Spirit doll tengah jadi perhatian karena banyak diadopsi para artis dan diperlakukan layaknya bayi sungguhan. Berikut potret 6 artis bersama para spirit doll. https://t.co/NivnKv95rx,6,2,0,1,2022-01-23,8,Sunday,7,6,3
1485166130801123328,2022-01-23 08:22:53,Pembangunan IKN memiliki tantangan tersendiri. Untuk mengangkut material pembangunan IKN dari Pulau Jawa menelan biaya Rp 50 juta per truk. https://t.co/Fj2diCUR3R,106,79,23,11,2022-01-23,8,Sunday,7,129,90
1485165108934361088,2022-01-23 08:18:49,Desain kawasan Istana Negara di ibu kota negara (IKN) baru Indonesia ditaksir bakal menelan biaya Rp 2 triliun untuk pembangunannya. https://t.co/pqwBm8iQdp,21,0,2,3,2022-01-23,8,Sunday,7,23,3
1485163944763432963,2022-01-23 08:14:12,"Harga minyak goreng di Malaysia cuma Rp 8.500 per liter, jauh lebih murah daripada yang ada di Indonesia. Kok bisa? https://t.co/QOvw0pjLp8",175,53,39,12,2022-01-23,8,Sunday,7,214,65
1485162878055366660,2022-01-23 08:09:57,Inter Milan tertinggal duluan sebelum akhirnya mengalahkan Venezia. Nerazzurri memang hobi memberikan harapan palsu untuk lawannya. https://t.co/JsD6gLVud5,17,0,4,1,2022-01-23,8,Sunday,7,21,1
1485161658469302276,2022-01-23 08:05:07,"Gaga Muhammad divonis 4,5 tahun bui terkait kecelakaan bersama mendiang Laura Anna. Ibunda Gaga Muhammad, Janariah, menanggapi vonis itu. https://t.co/MXRtYElswt",11,0,3,0,2022-01-23,8,Sunday,7,14,0
1485160589248839683,2022-01-23 08:00:52,Widi pernah menjabat sebagai Dandim 0735/Surakarta. Kala itu Presiden Jokowi masih menjabat sebagai Wali Kota Solo. https://t.co/09mNXmPGy7,9,0,3,0,2022-01-23,8,Sunday,7,12,0
1485159343469338624,2022-01-23 07:55:55,"Polisi menegur pengemudi mobil mewah yang foto-foto di tengah jalan Tol Depok-Antasari, persisnya di KM 02+400 Tol Andara, Jakarta Selatan. https://t.co/hoUQaJkAXM",399,234,98,95,2022-01-23,7,Sunday,7,497,329
1485157814033162242,2022-01-23 07:49:50,Sebelumnya sejak awal Januari 2022 operasional Biskita TransPakuan di Kota Bogor dihentikan sementara untuk dilakukan evaluasi. https://t.co/kti7CACmzr,17,0,4,0,2022-01-23,7,Sunday,7,21,0
1485156564336103428,2022-01-23 07:44:52,Kemenkes mengumumkan kasus pertama kematian pasien Omicron di RI. Selama ini Omicron sering disebut sebagai varian yang relatif bergejala ringan. https://t.co/YMGRI3HEEs,7,0,3,0,2022-01-23,7,Sunday,7,10,0
1485155060090916865,2022-01-23 07:38:53,"Dua remaja yang diduga geng motor menjadi bulan-bulanan kekesalan warga di kawasan Jagal, Jalan Ahmad Yani, Kota Tasikmalaya. https://t.co/P5Zy1pJTqA",11,3,3,3,2022-01-23,7,Sunday,7,14,6
1485153462686040067,2022-01-23 07:32:32,"Hartono adalah driver ojol penyandang disabilitas, tunarungu. Hartono tetap bersemangat di tengah keterbatasan ini. Simak semangat Hartono berikut ini. https://t.co/eS7xtWq3Ar",27,1,7,0,2022-01-23,7,Sunday,7,34,1
1485151775774904321,2022-01-23 07:25:50,"Selain angpao, salah satu hal yang tak boleh ketinggalan saat Tahun Baru Imlek adalah busananya.

https://t.co/ArZ8hh3tVV",6,1,3,2,2022-01-23,7,Sunday,7,9,3
1485151404020973569,2022-01-23 07:24:22,"Regina King tengah berduka. Sang putra, Ian Alexander Jr. meninggal dunia bunuh diri. https://t.co/wMFBrhk0aa",18,0,4,0,2022-01-23,7,Sunday,7,22,0
1485150405336174592,2022-01-23 07:20:24,"Raisa dan Hamish Daud mengajak sang putri, Zalina, ikut bersama mereka ke Amerika Serikat. Ada kejadian lucu yang terekam dalam perjalanan. https://t.co/nnnkNScq87",10,1,1,0,2022-01-23,7,Sunday,7,11,1
1485149109371740162,2022-01-23 07:15:15,Bukan hal baru jika video klip NOAH berisi model wanita cantik. Tradisi itu sudah ada sejak band itu bernama Peterpan. Siapa saja wanita itu? https://t.co/dfZ74uG7yd,27,2,6,1,2022-01-23,7,Sunday,7,33,3
1485147877869502470,2022-01-23 07:10:21,Berikut daftar lengkap mutasi TNI di jabatan strategis: https://t.co/Co9RFS1Psm,13,0,2,0,2022-01-23,7,Sunday,7,15,0
1485146893374078977,2022-01-23 07:06:26,"Berkaca dari kecelakaan di Jalan Sudirman, Jakarta Pusat, diduga terjadi akibat pengemudi mabuk. Ini 6 penyakit akibat dampak buruk konsumsi alkohol. https://t.co/L0SKyny9aw",6,2,2,2,2022-01-23,7,Sunday,7,8,4
1485145542703337473,2022-01-23 07:01:04,Peneliti dari lembaga antariksa milik Amerika Serikat (NASA) memperkirakan kekuatan letusan gunung berapi di Tonga mencapai 10 megaton TNT. #CNNIndonesia #detiknetwork  https://t.co/0JGiWDppgV,16,0,2,0,2022-01-23,7,Sunday,7,18,0
1485144570153345026,2022-01-23 06:57:12,Vicky Prasetyo dan Kalina Oktarani tetap berhubungan baik meski berpisah. Vicky pun mengaku merindukan sang mantan. https://t.co/XPz8stoMBJ,11,4,1,1,2022-01-23,6,Sunday,7,12,5
1485143818404044800,2022-01-23 06:54:13,Gol kemenangan Manchester United atas West Ham United dituding tidak sah karena Edinson Cavani yang memberi assist dianggap sudah offside. Benarkah demikian? https://t.co/12015DS35E,9,2,3,2,2022-01-23,6,Sunday,7,12,4
1485143051173572608,2022-01-23 06:51:10,"Dari video yang viral beberapa waktu lalu, dengan menggenggam tongkat komando di tangan kiri, nampak Achmad Fauzi berhadap-hadapan dengan Bahar Smith. https://t.co/RUrPM33iAG",6,0,1,0,2022-01-23,6,Sunday,7,7,0
1485142316167925761,2022-01-23 06:48:15,"Brandon Moreno vs Deiveson Figueiredo, tersaji seru di UFC 270. Laga berjalan panas dan ketat, Figueiredo menang angka tipis dari Moreno. https://t.co/fJsL0aa9Ud",8,0,1,0,2022-01-23,6,Sunday,7,9,0
1485141308960350210,2022-01-23 06:44:15,Dede Rayan Ardika (7) menjalani perawatan di RSUD Sumedang. Bocah lelaki tersebut luka berat akibat tertimpa bangunan saat rumahnya diterjang longsor. https://t.co/fm8GI7qRMB,11,0,1,0,2022-01-23,6,Sunday,7,12,0
1485140296363126787,2022-01-23 06:40:13,Sabtu (22/1) menjadi hari bahagia bagi Park Shin Hye dan Choi Tae Joon. Kedua aktor Korea Selatan tersebut akhirnya resmi menikah.  https://t.co/NQBa0RGxn8,13,0,3,0,2022-01-23,6,Sunday,7,16,0
1485139324635168781,2022-01-23 06:36:22,"Seorang mahasiswa Universitas Surabaya (Ubaya) meninggal dunia saat mendaki Gunung Penanggungan di Mojokerto. Saat ini, jenazah korban di Puskesmas Trawas. https://t.co/eUpZi6I0pj",14,0,6,1,2022-01-23,6,Sunday,7,20,1
1485138227312959488,2022-01-23 06:32:00,"Sejumlah nasabah mendatangi kantor perusahaan asuransi yaitu Prudential dan AIA untuk meminta uang mereka kembali. Karena itu, asuransi unit link jadi sorotan. https://t.co/4lYpQa6Y4P",24,0,13,1,2022-01-23,6,Sunday,7,37,1
1485137166137237505,2022-01-23 06:27:47,"Liburan akhir pekan ke Majene, Sulawesi Barat, singgahlah ke Pantai Dato. Pasir putih, terumbu karang dan tebing pegunungannya menjadi daya tarik pantai ini. https://t.co/ZcqpOfxG5h",9,2,1,1,2022-01-23,6,Sunday,7,10,3
1485136195000709120,2022-01-23 06:23:56,Putri Marino menonjolkan aura wanita Indonesia yang ayu lewat busana kebaya. Ini gaya pemeran Kinan di 'Layangan Putus' saat berkebaya. https://t.co/YXWMZa65zD,15,1,3,1,2022-01-23,6,Sunday,7,18,2
1485135180633411584,2022-01-23 06:19:54,Bubur ayam paling nikmat disantap saat sarapan. Beberapa orang Korea ini mencicipi bubur ayam khas Indonesia dan ternyata mereka sangat menyukainya. https://t.co/YobZffXjdB,9,2,1,0,2022-01-23,6,Sunday,7,10,2
1485134087379632128,2022-01-23 06:15:33,"Meski seorang wanita sudah menjalani pembekuan sel telur atau ‘egg freezing’, faktor keberhasilan kehamilannya nanti harus didukung kualitas yang sehat dari sperma sang suami.  https://t.co/MWaCPPPthF",16,0,1,0,2022-01-23,6,Sunday,7,17,0
1485133110174003201,2022-01-23 06:11:40,Terjawab sudah siapa yang mengisi posisi Pangkostrad selepas Jenderal Dudung jadi KSAD. Mayjen TNI Maruli Simanjuntak ditunjuk menjadi Pangkostrad. https://t.co/tElM7I7wgB,12,3,5,0,2022-01-23,6,Sunday,7,17,3
1485132075044941825,2022-01-23 06:07:33,"11 artefak peninggalan Nabi Muhammad SAW milik almarhum Prof Dr H Abdul Manan Embong dipamerkan di Aceh. Ada tongkat, sorban, hingga janggut Rasulullah. https://t.co/YXkw68CrUo",28,0,3,0,2022-01-23,6,Sunday,7,31,0
1485131082584494081,2022-01-23 06:03:37,Arnold Schwarzenegger terlibat dalam sebuah kecelakaan mobil. Salah satu perwakilan pun mengungkap kondisi terkini sang aktor. https://t.co/yzhag8Llyb,18,1,4,2,2022-01-23,6,Sunday,7,22,3
1485130573932810240,2022-01-23 06:01:35,Bandara Halim Perdanakusuma mulai menjalankan skenario perpindahan operasional penerbangan ke 5 bandara penerima (recipient). https://t.co/btFOSKUFeG,12,0,5,0,2022-01-23,6,Sunday,7,17,0
1485129747550158853,2022-01-23 05:58:18,Objek wisata Pantai Pangandaran sudah biasa diserbu wisatawan yang berlibur akhir pekan. Minggu pagi kerumunan seperti semut di pantai Barat. https://t.co/d4warQLRRK,12,3,2,0,2022-01-23,5,Sunday,7,14,3
1485128725721145344,2022-01-23 05:54:15,Tiga member iKON dinyatakan positif COVID-19. YG Entertainment pun merilis pernyataan soal kondisi mereka. https://t.co/j7qLGWf3px,14,0,4,1,2022-01-23,5,Sunday,7,18,1
1485128235130236928,2022-01-23 05:52:18,Edy Mulyadi dipolisikan terkait pernyataannya yang menyebut Prabowo Subianto 'macan jadi mengeong'. Simak pernyataan Edy Mulyadi selengkapnya. https://t.co/ms4OXrTOLk,21,8,1,0,2022-01-23,5,Sunday,7,22,8
1485127499310899203,2022-01-23 05:49:22,Edy Mulyadi dipolisikan gegara sebut Prabowi bak 'macan jadi mengeong'. Polisi kini sedang menyelidiki kasus tersebut. https://t.co/PbCB1oJMoE,34,11,2,3,2022-01-23,5,Sunday,7,36,14
1485126749113442306,2022-01-23 05:46:23,Publik belum lama ini dihebohkan dengan video yang memperlihatkan nisan bernama Upin dan Ipin. Rumah produksi pun akhirnya angkat bicara. https://t.co/hecrAcQoC4,11,0,0,0,2022-01-23,5,Sunday,7,11,0
1485125476981035008,2022-01-23 05:41:20,Ramalan zodiak Taurus ujian baru terpampang di hadapan anda maka cobalah lebih bijaksana dalam menyikapi setiap kejadian. Bagaimana ramalan zodiak anda hari ini https://t.co/cBlHQfrGYm,6,0,2,0,2022-01-23,5,Sunday,7,8,0
1485123984006029316,2022-01-23 05:35:24,Volker Eckert tercatat sebagai salah satu pembunuh dan psikopat yang begitu keji. Volker Eckert memiliki fetish pada rambut panjang. https://t.co/Gvr0w66E1f,6,0,0,0,2022-01-23,5,Sunday,7,6,0
1485122593938100227,2022-01-23 05:29:53,"Viral pria bernama Edy Mulyadi menyebut Prabowo seperti macan yang mengeong. Di awal pembicaraan, Edy membahas tentang siapa yang akan jadi pengembang di Ibu Kota Negara (IKN) Nusantara. https://t.co/nhaBdSpYd2",6,4,2,1,2022-01-23,5,Sunday,7,8,5
1485121120919511044,2022-01-23 05:24:02,Ibu Kota Negara (IKN) Nusantara menarik minat banyak pihak di dunia. Tak terkecuali Space Exploration Technologies Corporation (SpaceX) milik Elon Musk. https://t.co/ndlEseaUTa,64,23,19,7,2022-01-23,5,Sunday,7,83,30
1485119344782815233,2022-01-23 05:16:58,Seorang mahasiswa Universitas Surabaya (Ubaya) meninggal dunia saat mendaki Gunung Penanggungan di Mojokerto. Korban diduga kelelahan. https://t.co/8mVzNHhSNX,21,3,11,0,2022-01-23,5,Sunday,7,32,3
1485118099691118603,2022-01-23 05:12:01,Pria asal Indonesia ini menikah dan memiliki rumah di Jerman yang harganya hampir Rp7 Miliar. Seperti apa kisahnya? https://t.co/Zey0oiOeqL,35,6,3,2,2022-01-23,5,Sunday,7,38,8
1485116857606713347,2022-01-23 05:07:05,Ribuan ikan di waduk sekitar kawasan industri Rungkut mendadak mati. Ikan-ikan mati diduga tercemar limbah. https://t.co/YHSFtu3rH5,11,0,3,1,2022-01-23,5,Sunday,7,14,1
1485115294444044292,2022-01-23 05:00:52,Yuk latih otak kamu agar bisa lancar memecahkan masalah. Teka-teki ini bisa membuktikan apakah kamu jenius. https://t.co/97zW69X7ko,55,40,5,0,2022-01-23,5,Sunday,7,60,40
1485114046286336003,2022-01-23 04:55:55,"Pasca dinas ke Bintan, Menparekraf Sandiaga Uno melanjutkan perjalanan ke Subang dari Semarang. Ia pun sempat mampir ke rest area dan jajal makanan terpopuler. https://t.co/f41ashbkHJ",12,3,1,2,2022-01-23,4,Sunday,7,13,5
1485113318004166656,2022-01-23 04:53:01,Indonesia melaporkan kasus pertama kematian pasien COVID-19 varian Omicron. Mantan petinggi WHO menyoroti siapa saja yang rentan meninggal karena varian ini. https://t.co/WXgoKFOZcl,10,4,8,1,2022-01-23,4,Sunday,7,18,5
1485112820903694339,2022-01-23 04:51:03,Meat Loaf meninggal dunia di usia 74 tahun. Pihak keluarga sebelumnya tidak mengungkap penyebab dari kematian sang mendiang. https://t.co/h2YN06glNZ,10,0,1,0,2022-01-23,4,Sunday,7,11,0
1485111503195975682,2022-01-23 04:45:49,"Ibu kandung Rohana dikabarkan terpaksa menitipkannya pada Laoshi sejak usia dua bulan. Tidak begitu saja menghilang, ternyata ia pernah menjenguk sang anak. https://t.co/yqZYm3ETJk",21,0,2,1,2022-01-23,4,Sunday,7,23,1
1485110268908777472,2022-01-23 04:40:54,Aiptu Siswanto membeli sepeda motor matic seharga Rp 22.100.000 dengan menggunakan uang koin pecahan Rp 1.000. Diketahui Siswanto menabung sejak tahun 2013. https://t.co/ituOhafw2F,124,9,29,16,2022-01-23,4,Sunday,7,153,25
1485109008721752064,2022-01-23 04:35:54,"Nadine Kaiser diminta oleh ibunya, Susi Pudjiastuti, untuk membantu mengurus Susi Air. Bagi Nadine, Susi Air tak hanya sekadar tanggung jawab dari sang ibu yang harus ia lanjutkan. https://t.co/bTRv9H3aH9",12,0,1,0,2022-01-23,4,Sunday,7,13,0
1485107791098527746,2022-01-23 04:31:04,"Permintaan maaf Arteria Dahlan belum mampu menyudahi kisruh soal bahasa Sunda. Pasalnya, dua hari setelah Arteria minta maaf, muncul sindiran dan 'ancaman'. https://t.co/boczpatWHR",36,26,9,4,2022-01-23,4,Sunday,7,45,30
1485106748763607047,2022-01-23 04:26:55,"Riset baru bawa kabar kurang enak untuk pengguna vaksin Sinovac. Peneliti Hong Kong baru saja merilis riset tentang vaksin booster, dan ini hasilnya. https://t.co/9WZ9ESpUu0",37,14,18,2,2022-01-23,4,Sunday,7,55,16
1485105495782350848,2022-01-23 04:21:56,Album Virus nampaknya jadi perbincangan dan sangat ikonik dengan grup band Slank. Ini fakta di balik cover album Slank:  https://t.co/dAQXfFqtIh,9,1,4,0,2022-01-23,4,Sunday,7,13,1
1485104263856594947,2022-01-23 04:17:03,"Musisi gaek Meat Loaf meninggal di usia 74 tahun baru-baru ini. Penyebab kematiannya diungkap, ia disebut meninggal setelah bergelut dengan COVID-19. https://t.co/IinjeJk43Y",9,1,5,0,2022-01-23,4,Sunday,7,14,1
1485103035516964869,2022-01-23 04:12:10,"Dari 30 kecamatan di Kota Bandung, kasus positif aktif tersebar di 27 kecamatan. Tercatat tiga kecamatan lainnya nihil kasus. https://t.co/33G3ZnZQln",9,0,3,0,2022-01-23,4,Sunday,7,12,0
1485101758661672967,2022-01-23 04:07:05,Eks petinggi WHO memberi pesan pada pemerintah usai Indonesia mencatat lonjakan kasus COVID-19. Jumlah kasus harian tembus 3 ribu pada Sabtu (22/1/2022). https://t.co/Kx94LkEzay,11,2,3,2,2022-01-23,4,Sunday,7,14,4
1485100721590648835,2022-01-23 04:02:58,Anies Baswedan vs Giring Ganesha makin panas. Keduanya terlibat saling sindir belakangan ini mulai dari Formula E hingga proyek JIS. https://t.co/Lx5dhnHcPy,70,68,13,11,2022-01-23,4,Sunday,7,83,79
1485100167338639368,2022-01-23 04:00:46,"Video palsu 61 detik mirip Nagita Slavina belakangan menjadi perbincangan warganet. Video tersebut diduga dibuat dengan cara deepfake, Bunda. Apa itu? #detiknetwork  https://t.co/RMYX2JsZs9",10,0,5,0,2022-01-23,4,Sunday,7,15,0
1485099400242290688,2022-01-23 03:57:43,"Kecelakaan 2 truk terjadi di depan Balai Kartini, Jaksel. Akibat kejadian itu 1 orang sopir truk tewas. Begini detik-detiknya: https://t.co/09I3lqnTyX",3,0,1,0,2022-01-23,3,Sunday,7,4,0
1485098421505695747,2022-01-23 03:53:50,"WHO melaporkan peningkatan kasus COVID-19 Jawa Bali, DKI Jakarta mencatat kenaikan pasien rawat inap di RS. WHO minta waspada potensi klaster. https://t.co/5p6Tulh3rV",38,13,22,4,2022-01-23,3,Sunday,7,60,17
1485097637388947458,2022-01-23 03:50:43,Sejumlah idol KPop dikenal sebagai girl crush karena memiliki banyak fans pria dan wanita. Parasnya pun dinilai cantik sekaligus ganteng. Siapa saja? https://t.co/NcUUAVJEWO,9,1,1,0,2022-01-23,3,Sunday,7,10,1
1485096142505484288,2022-01-23 03:44:46,PT Angkasa Pura II selaku pengelola bandara mulai menjalankan skenario perpindahan operasional penerbangan ke 5 bandara penerima (recipient). https://t.co/C8GaGt2AZx,8,1,4,0,2022-01-23,3,Sunday,7,12,1
1485094903696736257,2022-01-23 03:39:51,Banyak orang memuji ketulusan dan kasih sayang dua orang berbeda ras dan agama tersebut. Simak kembali kisahnya. https://t.co/vkhwpAMO28,45,2,7,0,2022-01-23,3,Sunday,7,52,2
1485093897231609856,2022-01-23 03:35:51,Razman Arif Nasution tak terima diputus kuasanya secara sepihak oleh Richard Lee. Ia pun murka saat mengetahui hal itu. https://t.co/WkcmoBMaPm,13,5,3,2,2022-01-23,3,Sunday,7,16,7
1485092529171222529,2022-01-23 03:30:25,"Baru gabung di awal musim ini, Tammy Abraham langsung menunjukkan potensi besarnya di AS Roma. Jose Mourinho menantikan banyak hal lain dari sang penyerang. https://t.co/XTv9NywknS",6,0,0,0,2022-01-23,3,Sunday,7,6,0
1485090911512146077,2022-01-23 03:23:59,"Guru Besar IPB, Didin Damanhuri, mengkhawatirkan pemindahan ibu kota dari Jakarta ke Kalimantan timur akan bernasib sama dengan ibu kota baru Myanmar, Kenapa? https://t.co/RRUiSAZyHD",64,11,15,4,2022-01-23,3,Sunday,7,79,15
1485089591522738176,2022-01-23 03:18:44,Kalina Oktarani tidak hanya mengatakan Vicky Prasetyo berkali-kali minta cerai. Kalina juga jelaskan tidak ada nafkah yang pernah diterimanya. https://t.co/NDvWDCivyM,66,26,10,7,2022-01-23,3,Sunday,7,76,33
1485088293280788484,2022-01-23 03:13:35,Cerita Golan Mirah di Ponorogo bak kisah Romeo Juliet berawal dari percintaan Joko Lancur dan Siti Amirah. Legenda itu masih dipercaya warga dua desa hingga kini. https://t.co/RBCzS1ZDqQ,10,2,4,0,2022-01-23,3,Sunday,7,14,2
1485086569019195402,2022-01-23 03:06:44,Siapa yang tak kenal Tiwul?Makanan berbahan singkong ini makin dikenal seiring tren kuliner tradisional. Di Pacitan ada warung khusus menjual Nasi Tiwul Goreng. https://t.co/qsFz7uZ0Bk,18,0,3,1,2022-01-23,3,Sunday,7,21,1
1485085129844350977,2022-01-23 03:01:01,Rektor mengatakan tidak semua mahasiswa bisa mengikuti kegiatan perkuliahan luring di UB. Apa kriteria untuk mahasiswa yang tidak diperbolehkan? https://t.co/uaAtXVZLOe,7,1,2,0,2022-01-23,3,Sunday,7,9,1
1485084757025304576,2022-01-23 02:59:32,Kawasan terintegrasi Alun-alun dan Lapang Merdeka ditutup sementara. Penutupan tersebut hanya akan berlaku setiap hari Minggu saja. https://t.co/e1oaR8pnyc,9,0,1,0,2022-01-23,2,Sunday,7,10,0
1485084732270465027,2022-01-23 02:59:26,Sosok Achmad Fauzi sempat disorot beberapa waktu lalu lantaran mendatangi Habib Bahar Smith dan sempat berdebat panas. https://t.co/20RkIFkKJi,14,1,3,2,2022-01-23,2,Sunday,7,17,3
1485084500245848066,2022-01-23 02:58:31,Seorang penumpang pesawat maskapai American Airlines membuat geger seluruh penumpang pesawat karena menolak memakai masker. Begini cerita lengkapnya. https://t.co/3TsMICoIOm,6,1,4,0,2022-01-23,2,Sunday,7,10,1
1485083663058739200,2022-01-23 02:55:11,"Sudah 15 tahun Ninuk, mendedikasikan dirinya untuk mengajar dengan jari isyaratnya kepada anak-anak tunarungu. https://t.co/lNxnRdv51X",33,2,5,2,2022-01-23,2,Sunday,7,38,4
1485083647149547520,2022-01-23 02:55:07,Ada tiga bidang tambahan dalam Indonesia Esports Association (IESPA). Hal tersebut diungkapkan oleh ketua RM Ibnu Riza Pradipto. https://t.co/2b7y0nw28x,4,0,1,0,2022-01-23,2,Sunday,7,5,0
1485083366416392197,2022-01-23 02:54:00,"Kemenkes mengkonfirmasi dua pasien omicron meninggal dunia. Sementara itu, DKI Jakarta terus mencatatkan penambahan kasus Omicron, total menjadi 1.313 kasus. https://t.co/NfRAoqB7Lg",22,9,12,2,2022-01-23,2,Sunday,7,34,11
1485083133741608962,2022-01-23 02:53:05,"Isu sampah plastik ternyata juga menarik perhatian Aktivis Lingkungan cilik berusia 14 tahun, Aeshnina Azzahra. Terlebih ada banyak sampah plastik impor. https://t.co/EKMaEJlrQb",19,1,3,0,2022-01-23,2,Sunday,7,22,1
1485083110513467392,2022-01-23 02:52:59,Ada banyak cara yang dilakukan para penipu untuk mengelabui para korbannya. Salah satunya ialah berpura-pura menjadi agen spionase alias mata-mata. https://t.co/B5VCk7xnOS,5,1,1,0,2022-01-23,2,Sunday,7,6,1
1485082590684094469,2022-01-23 02:50:55,Ada lowongan kerja dari Kementerian Agama Bantul untuk posisi non pegawai negeri bagi lulusan SMA hingga D3. Cek persyaratannya di sini! https://t.co/Os23nV09C9,7,1,2,0,2022-01-23,2,Sunday,7,9,1
1485082573634248712,2022-01-23 02:50:51,Kasus DBD di Kota Bandung mengalami peningkatan di awal Januari 2022. Warga diimbau waspeda dengan menjaga kebersihan lingkungan rumahnya. https://t.co/1wyW4r1gSV,2,0,1,0,2022-01-23,2,Sunday,7,3,0
1485081058618101768,2022-01-23 02:44:50,"Belum habis, sindir menyindir antara Gubernur Anies Baswedan dan Ketum PSI Giring Ganesha masih berlanjut. Keduanya saling berbalas terkait sound system. https://t.co/LUJpCX8yoW",7,13,2,3,2022-01-23,2,Sunday,7,9,16
1485079768026464258,2022-01-23 02:39:42,"Polisi mengamankan 18 remaja di Makassar, Sulsel, karena tawuran anak panah. https://t.co/y6UoDueZK1",23,3,1,1,2022-01-23,2,Sunday,7,24,4
1485077810351853568,2022-01-23 02:31:56,"Kecelakaan yang melibatkan 2 truk besar terjadi di Jalan Gatot Subroto, Jaksel, tepatnya di depan Balai Kartini. Kecelakaan itu dilaporkan ada korban jiwa. https://t.co/7tGyfc4gLA",7,1,0,0,2022-01-23,2,Sunday,7,7,1
1485077544680443904,2022-01-23 02:30:52,"Lampu PJU di sejumlah titik ruas jalan kawasan Geopark Ciletuh Palabuhanratu, Kabupaten Sukabumi mati. Warga keluhkan rawan kecelakaan dan kejahatan. https://t.co/0SuuT0aNq1",3,1,0,1,2022-01-23,2,Sunday,7,3,2
1485077124889432065,2022-01-23 02:29:12,"Bikers Brotherhood 1% MC Indonesia menyatukan seluruh anggota dari Sabang sampai Merauke di pantai Madasari, Kabupaten Pangandaran. https://t.co/LFxPnNSbYv",15,2,4,0,2022-01-23,2,Sunday,7,19,2
1485076272086765568,2022-01-23 02:25:49,Seorang jurnalis wanita terkemuka di Turki ditahan. Dia diduga menghina Presiden Recep Tayyip Erdogan dalam siaran langsung di televisi. https://t.co/XDtwaAlGlX,19,9,10,12,2022-01-23,2,Sunday,7,29,21
1485075289919086597,2022-01-23 02:21:55,Pemerintah berencana membangun training camp baru buat atlet National Paralympic Committee (NPC) Indonesia. Modelnya akan mencontoh seperti di Korea. https://t.co/5nLOCJIEd7,9,0,0,1,2022-01-23,2,Sunday,7,9,1
1485073522603053061,2022-01-23 02:14:53,Indonesia melaporkan kasus pertama kematian pasien COVID-19 varian Omicron. Mantan petinggi WHO menyoroti siapa saja yang rentan meninggal karena varian ini. https://t.co/Z85AFq4QCQ,14,6,4,0,2022-01-23,2,Sunday,7,18,6
1485072798829719554,2022-01-23 02:12:01,Kemenkes RI mengumumkan dua pasien Omicron di Indonesia meninggal dunia. Varian Omicron diketahui memiliki tingkat penularan lebih tinggi ketimbang varian lain. https://t.co/fUQb12C6Tf,14,1,7,1,2022-01-23,2,Sunday,7,21,2
1485072306657710080,2022-01-23 02:10:03,Panglima TNI Jenderal Andika Perkasa menunjuk Brigjen TNI Widi Prasetijono sebagai Danjen Kopassus yang baru menggantikan Mayjen TNI Teguh Muji Angkasa. https://t.co/7B2eJhJ7Bs,15,0,4,1,2022-01-23,2,Sunday,7,19,1
1485071812891488256,2022-01-23 02:08:06,Pria bernama Edy Mulyadi dilaporkan ke polisi lantaran diduga menghina Menhan Prabowo Subiano. Gerindra mengungkapkan arahan Prabowo terkait hal tersebut. https://t.co/ab0oWObrWM,29,20,4,13,2022-01-23,2,Sunday,7,33,33
1485070831688560642,2022-01-23 02:04:12,Ibu Untung hidup di gubuk reyot terbuat dari bambu yang nyaris roboh. Kamu bisa bantu buruh cuci di Brebes ini lewat https://t.co/gJZ8ovBbIQ. https://t.co/tLM5ClPtzY,10,0,1,1,2022-01-23,2,Sunday,7,11,1
1485070375461470213,2022-01-23 02:02:23,"Seorang remaja bernama Ikpal Ahmad Kusmoyo (19) menjadi korban pembacokan begal bermotor di daerah Tapos, Depok. Polisi kini kini memburu para pelaku. https://t.co/PMRrVFjacb",9,5,2,1,2022-01-23,2,Sunday,7,11,6
1485070347833643011,2022-01-23 02:02:16,"Manchester City boleh saja gagal menang atas Southampton, tapi Pep Guardiola tak terlalu kecewa dengan penampilan timnya. Hanya nasib yang belum berpihak. https://t.co/fUjvcnC4yn",3,0,0,0,2022-01-23,2,Sunday,7,3,0
1485069977757564928,2022-01-23 02:00:48,"""Yang saya khawatirkan kalau setelah Ibu Kota pindah ke sana ekonominya merosot. Saya kurang setuju,"" kata seorang perantau di Jakarta, Roy. #SuaraArusBawah #CNNIndonesia #detiknetwork  https://t.co/41S9cjFqPC",88,68,12,1,2022-01-23,2,Sunday,7,100,69
1485069507358044161,2022-01-23 01:58:56,"Meski menang, Manchester United tak menunjukkan penampilan yang cukup meyakinkan melawan West Ham United. MU bermain terlalu gegabah dan kerap buntu. https://t.co/g4u5S3xNVN",4,0,0,0,2022-01-23,1,Sunday,7,4,0
1485068392222674950,2022-01-23 01:54:30,BNI kali ini menyerahkan apresiasi kepada ratusan tenaga perawat dan bidan yang tersebar di 17 wilayah BNI. https://t.co/ZA3EDRkhto,6,0,1,0,2022-01-23,1,Sunday,7,7,0
1485066385705381888,2022-01-23 01:46:32,Interupsi Hakim Itong di tengah berlangsungnya konferensi pers KPK soal OTT menghebohkan. Pihak keluarga Hakim itong dipersilakan membuat aduan ke Komnas HAM. https://t.co/QgLcsTOKFS,6,0,2,1,2022-01-23,1,Sunday,7,8,1
1485064675398139911,2022-01-23 01:39:44,Ada beberapa akun Twitter yang bisa membantu pelajar dan mahasiswa dalam mendapatkan informasi tertentu. Apa saja akun tersebut? https://t.co/895QFUpnlN,15,1,7,0,2022-01-23,1,Sunday,7,22,1
1485063671357362179,2022-01-23 01:35:45,"Berbagai cara dilakukan agar anak tertarik mengikuti vaksinasi Covid-19. Di Ciamis, anak yang telah divaksinasi diajak berwisata di Situs Astana Gede Kawali. https://t.co/Uv4J8kBb4V",5,2,1,0,2022-01-23,1,Sunday,7,6,2
1485062641940938755,2022-01-23 01:31:39,"Ansu Fati kembali masuk ruang perawatan karena cederanya. Tak mau pemainnya itu terus bermasalah, Barcelona bakal menyiapkan rencana khusus. https://t.co/TwpR0XMxwm",7,0,0,2,2022-01-23,1,Sunday,7,7,2
1485060888591847425,2022-01-23 01:24:41,Kemenkes melaporkan dua pasien COVID-19 varian Omicron meninggal dunia. Salah satu pasien yang meninggal diketahui belum disuntik vaksin. https://t.co/hRE9R1zcLS,35,18,6,7,2022-01-23,1,Sunday,7,41,25
1485059862518239235,2022-01-23 01:20:36,Panglima TNI Jenderal Andika Perkasa menunjuk Brigjen TNI Widi Prasetijono sebagai Danjen Kopassus yang baru menggantikan Mayjen TNI Teguh Muji Angkasa. https://t.co/EJ1XBIxhob,12,0,3,0,2022-01-23,1,Sunday,7,15,0
1485058607871934466,2022-01-23 01:15:37,"Menatap Asian Games 2022, PP PRSI memulai Seleksi Nasional polo air lebih awal. Persiapan cepat diyakini dapat membentuk Timnas yang kompetitif. https://t.co/8E5dy8drNQ",8,0,1,0,2022-01-23,1,Sunday,7,9,0
1485057605726871553,2022-01-23 01:11:38,Ancaman pidana menanti mantan Kapolres OKU Timur AKBP Dalizon yang diduga menerima uang suap dari Bupati Musi Banyuasin (Muba) nonaktif Dodi Reza Alex Noerdin. https://t.co/KTzAaKjuvd,5,1,2,1,2022-01-23,1,Sunday,7,7,2
1485056837741420549,2022-01-23 01:08:35,Hamster dikhawatirkan jadi sumber penularan virus COVID-19 di Hong Kong. Otoritas setempat memerintahkan pemusnahan lebih dari 2.000 ekor hamster. https://t.co/xehknDFxHL,17,1,3,3,2022-01-23,1,Sunday,7,20,4
1485056619029348358,2022-01-23 01:07:43,Upaya Chelsea membawa pulang Emerson Palmieri dari Lyon menemui jalan buntu. Klub asal Prancis itu ingin mempertahankannya hingga akhir musim. https://t.co/oLgVhG3iYM,7,0,0,0,2022-01-23,1,Sunday,7,7,0
1485056088001200131,2022-01-23 01:05:37,Mayjen Maruli Simanjuntak ditunjuk menjadi Pangkostrad. Sejumlah legislator meyakini jabatan itu dapat diemban dengan baik oleh Maruli. https://t.co/YxltNQKTRz,8,1,0,0,2022-01-23,1,Sunday,7,8,1
1485055398583414789,2022-01-23 01:02:52,"Lima remaja diamankan polisi saat akan melakukan balapan liar di Cempaka Putih, Jakarta Pusat. https://t.co/X4NTHULeLc",6,0,1,0,2022-01-23,1,Sunday,7,7,0
1485053421497552896,2022-01-23 00:55:01,"Ketua DPD RI, AA LaNyalla Mahmud Mattalitti, mengingatkan hakikat sejarah awal pendirian partai politik pada masa awal kemerdekaan. https://t.co/BMecSmYkC5",20,1,15,2,2022-01-23,0,Sunday,7,35,3
1485052927635070981,2022-01-23 00:53:03,"Agus Haryanto (46) diamankan pihak kepolisian di Jatinegara, Jaktim. Rupanya, Agus mengaku sebagai anggota TNI untuk mendapatkan hati seorang janda. https://t.co/zepAyOTW3y",7,2,0,5,2022-01-23,0,Sunday,7,7,7
1485052395826647042,2022-01-23 00:50:56,"Riset baru bawa kabar kurang enak untuk pengguna vaksin Sinovac. Peneliti Hong Kong baru saja merilis riset tentang vaksin booster, dan ini hasilnya. https://t.co/vND4TLEq2Y",153,76,79,9,2022-01-23,0,Sunday,7,232,85
1485051901217587207,2022-01-23 00:48:58,"Musisi gaek Meat Loaf meninggal di usia 74 tahun baru-baru ini. Penyebab kematiannya diungkap, ia disebut meninggal setelah bergelut dengan COVID-19. https://t.co/T7lVavgBps",9,1,1,1,2022-01-23,0,Sunday,7,10,2
1485051401956954112,2022-01-23 00:46:59,Eks petinggi WHO memberi pesan pada pemerintah usai Indonesia mencatat lonjakan kasus COVID-19. Jumlah kasus harian tembus 3 ribu pada Sabtu (22/1/2022). https://t.co/p8FzcHMZ8o,8,0,1,4,2022-01-23,0,Sunday,7,9,4
1485050905888280584,2022-01-23 00:45:01,"Polisi mengungkap motif lain pria di Bogor, ES (54), yang mencabuli lima orang anak. Pelaku menjanjikan uang Rp 3.000. https://t.co/pbbf9bbEA1",9,6,3,3,2022-01-23,0,Sunday,7,12,9
1485049912073019397,2022-01-23 00:41:04,"Satu anggota Satgas Damai Cartenz dari Brimob yang tertembak KKB dalam kontak tembak di Distrik Kiwirok, Pegunungan Bintang, Papua, dievakuasi ke Jayapura. https://t.co/vLfNlNA2ju",25,9,5,2,2022-01-23,0,Sunday,7,30,11
1485049160713871360,2022-01-23 00:38:05,"Kasus Corona di Indonesia menembus 3.205 kasus. Harian Corona tertinggi sejak pertengahan September, ini riwayat penambahan kasus selama sepekan. https://t.co/0ybiVHD84z",13,5,3,4,2022-01-23,0,Sunday,7,16,9
1485048651529523201,2022-01-23 00:36:04,Relawan yang menamakan diri barisan Prabowo-Muhaimin ini mulai mensosialisasikan pasangan yang dijagokannya dengan pemasangan poster di Angkot dan billboard. https://t.co/JXqXfoz8zo,18,17,4,0,2022-01-23,0,Sunday,7,22,17
1485048176197394433,2022-01-23 00:34:10,"Korban Keracunan masal di Kampung Narawita Desa/Kecamatan Sodonghilir Kabupaten Tasikmalaya, terus bertambah hingga 83 orang. Satu orang meninggal. https://t.co/OsxAQxSvWJ",8,0,3,0,2022-01-23,0,Sunday,7,11,0
1485047626131283971,2022-01-23 00:31:59,"WHO melaporkan peningkatan kasus COVID-19 Jawa Bali, DKI Jakarta mencatat kenaikan pasien rawat inap di RS. WHO minta waspada potensi klaster. https://t.co/SbI3Bc4eYD",19,5,5,1,2022-01-23,0,Sunday,7,24,6
1485047135326425092,2022-01-23 00:30:02,Varian Omicron menyebar cepat dengan tingkat penularan yang tinggi. Tahukah kita berapa lama orang yang dites positif harus mengisolasi diri? https://t.co/gGK8MsyUBy,8,1,2,0,2022-01-23,0,Sunday,7,10,1
1485046643951030272,2022-01-23 00:28:05,"Seorang siswi bemotor melaju melawan arah di antara mobil, truk, dan kendaraan lainnya. Videonya beredar di media sosial. Polisi bergerak. https://t.co/D4K9dOatXQ",7,0,2,0,2022-01-23,0,Sunday,7,9,0
1485045865953775617,2022-01-23 00:24:59,"Pemotor bernama Rahmat Zulfadillah (24) tewas tertabrak kereta api di Jalan Adinegoro, Padang, Sumbar, saat melintas di rel karena hendak pulang ke rumahnya. https://t.co/V0Nv8j7665",5,1,0,0,2022-01-23,0,Sunday,7,5,1
1485045329091305473,2022-01-23 00:22:51,"Polres Ciamis masih melakukan penyelidikan aktivitas 'Lingkaran Setan'. Menurut polisi, keluarga korban dan pelaku mengarah proses ishlah. https://t.co/v6ck7Y7b0s",8,0,0,0,2022-01-23,0,Sunday,7,8,0
1485044835727904769,2022-01-23 00:20:54,"Nama Pratama Arhan ramai menjadi perbincangan berkat aksi-aksinya di Piala AFF 2020. Di ajang ini, Arhan memang sempat memberikan penampilan yang memukau. https://t.co/lGM1l5LiC9",13,0,2,0,2022-01-23,0,Sunday,7,15,0
1485044336043732995,2022-01-23 00:18:55,Mantan Perdana Menteri (PM) Malaysia Mahathir Mohamad kembali dibawa ke rumah sakit spesialis jantung. https://t.co/bb4ppByWig,13,0,1,0,2022-01-23,0,Sunday,7,14,0
1485043844676792322,2022-01-23 00:16:58,Polisi sudah menangkap satu orang pelaku aksi vandalisme di Bandung. Polisi masih mengembangkan kasus dan memburu satu pelaku lainnya. https://t.co/xWkUextfGm,5,0,0,0,2022-01-23,0,Sunday,7,5,0
1485043304731394052,2022-01-23 00:14:49,"Sekelompok warga membakar 2 rumah di Elelim, Kabupaten Yalimo, Papua. Peristiwa itu terjadi menjelang pelaksanaan pemungutan suara ulang (PSU) di Yalimo. https://t.co/lpFWjvOsvT",5,0,0,0,2022-01-23,0,Sunday,7,5,0
1485042827902033925,2022-01-23 00:12:55,Pertempuran terus berkecamuk antara kelompok ISIS dan pasukan Kurdi di Suriah usai serangan ISIS ke sebuah penjara. https://t.co/Y3rTUvaFM3,7,0,1,1,2022-01-23,0,Sunday,7,8,1
1485042334303719431,2022-01-23 00:10:57,Ekonom senior Faisal Basri mengkritik pembangunan ibu kota baru di Kalimantan Timur. https://t.co/T010KdE51x,35,6,3,2,2022-01-23,0,Sunday,7,38,8
1485041829598973955,2022-01-23 00:08:57,"Usai mengawali tahun dengan apik, AC Milan tersandung oleh Spezia di laga kontroversial. Kini Rossoneri menantikan ujian lain melawan Juventus yang sedang oke. https://t.co/sydNBjS3EX",8,0,1,0,2022-01-23,0,Sunday,7,9,0
1485041338773118987,2022-01-23 00:07:00,"Sebanyak 96 warga Desa Sukamaju, Kecamatan Cijaku, Kabupaten Lebak diduga keracunan makanan. Mereka keracunan usai menyantap besek sukuran warga. https://t.co/L7I1Y4xpaJ",4,1,1,0,2022-01-23,0,Sunday,7,5,1
1485040833455960076,2022-01-23 00:05:00,Heboh dokter di Medan menyuntikan vaksin COVID-19 kosong ke siswa SD. Polisi mengatakan pelaku berinisial G yang merupakan seorang dokter terancam pidana. https://t.co/sLmHgPTBW7,69,2,11,8,2022-01-23,0,Sunday,7,80,10
1485040235910103040,2022-01-23 00:02:37,Manchester United menang dramatis 1-0 atas West Ham United di Liga Inggris. Setan Merah butuh 4 penyerang untuk bisa menaklukkan The Hammers. https://t.co/4LHSDfhCtf,10,0,2,2,2022-01-23,0,Sunday,7,12,2
1485039129809272833,2022-01-22 23:58:13,"Dua pasien Omicron di Indonesia meninggal, keduanya merupakan lansia dan mengidap komorbid. Kementerian Kesehatan kembali mengingatkan pentingnya pakai masker. https://t.co/LwgoWkm3gq",12,1,4,4,2022-01-22,23,Saturday,6,16,5
1485038647665733633,2022-01-22 23:56:18,"Ketua Umum PSI Giring Ganesha kembali bikin sensasi. Kini, dia mengajak warga bernyanyi di belakang proyek Jakarta Internasional Stadium (JIS). https://t.co/paf0QMtzi1",200,202,10,32,2022-01-22,23,Saturday,6,210,234
1485037629808816130,2022-01-22 23:52:16,Ganjar Pranowo tak hadir saat Puan Maharani meresmikan Pasar Legi Solo. PDIP dinilai sedang memainkan tiga strategi terkait capres 2024. https://t.co/nTGz3avCsN,20,17,6,3,2022-01-22,23,Saturday,6,26,20
1485036853799628802,2022-01-22 23:49:11,Kemenkes mengungkap dua orang pasien COVID-19 Omicron yang meninggal dunia mempunyai komorbid. Keduanya mengalami gejala berat. https://t.co/DlWqo3P00Z,8,3,2,3,2022-01-22,23,Saturday,6,10,6
1485035783195082754,2022-01-22 23:44:56,Pelatih Juventus Massimiliano Allegri sudah merestui keinginan Aaron Ramsey untuk cabut. Allegri berharap Ramsey bisa mendapatkan klub secepatnya. https://t.co/t9iOgaS1TU,5,0,1,1,2022-01-22,23,Saturday,6,6,1
1485035005260800002,2022-01-22 23:41:50,"Seorang siswi bemotor melaju melawan arah di antara mobil, truk, dan kendaraan lainnya. Videonya beredar di media sosial. Polisi bergerak. https://t.co/MojQVY1ooE",5,0,0,2,2022-01-22,23,Saturday,6,5,2
1485034029359505408,2022-01-22 23:37:57,Pemulung yang sudah uzur itu diduga telah mencabuli anak tetangganya yang berusia 4 tahun. https://t.co/oLTOLvH9tH,32,15,2,6,2022-01-22,23,Saturday,6,34,21
1485033253656481795,2022-01-22 23:34:52,Untung Slamet (42) ditinggal suaminya sejak 10 tahun lalu. Dia berupaya untuk terus tegar meski hidupnya serba sulit. Kamu bisa membantunya lewat https://t.co/gJZ8ovBbIQ https://t.co/2D1JSiwlTU,15,0,3,1,2022-01-22,23,Saturday,6,18,1
1485032173287755778,2022-01-22 23:30:35,Pakar IDI memprediksi puncak penyebaran varian Omicron akan terjadi beberapa pekan mendatang. Dikhawatirkan kasus transmisi lokal makin melonjak. https://t.co/TtV2zGjVrB,10,3,3,3,2022-01-22,23,Saturday,6,13,6
1485031135793094658,2022-01-22 23:26:27,"Mobil Honda Civic menabrak empat kendaraan di Jalan Sudirman, Jakarta Pusat, dini hari tadi. Pengemudi mobil pria inisial AL (21) diduga dalam kondisi mabuk. https://t.co/7R0mRnErR3",22,15,15,13,2022-01-22,23,Saturday,6,37,28
1485029603026558976,2022-01-22 23:20:22,Kemenkes melaporkan dua pasien Omicron meninggal dunia. Pimpinan Komisi IX Carles Honoris memberikan sejumla catatan untuk pemerintah. https://t.co/rXnwQteO8g,9,0,1,0,2022-01-22,23,Saturday,6,10,0
1485029256795197444,2022-01-22 23:18:59,Dirlantas Polda Metro Jaya Kombes Sambodo Purnomo Yogo membantah memfasilitasi nomor polisi mobil Arteria Dahlan yang berpelat dinas Polri. https://t.co/KKkM04OUWJ,53,54,20,9,2022-01-22,23,Saturday,6,73,63
1485027985208057865,2022-01-22 23:13:56,BMKG memprediksi hujan yang dapat disertai petir bakal terjadi di wilayah Jakarta Selatan dan Jakarta Timur pada hari ini. https://t.co/QDJsVRYQCA,6,1,1,2,2022-01-22,23,Saturday,6,7,3
1485027206703288320,2022-01-22 23:10:51,Harga minyak goreng di pasar tradisional Tasikmalaya belum turun ke Rp 14 ribu/liter. Wakil Menteri Perdagangan beri waktu sepekan pedagang menurunkannya. https://t.co/UeTiGSelLM,24,20,1,4,2022-01-22,23,Saturday,6,25,24
1485026224858664964,2022-01-22 23:06:57,Gubernur DKI Jakarta Anies Baswedan memamerkan JIS saat berkunjung ke Sulsel. PDIP menyindir 'Firaun' dan mengatakan Anies termakan omongannya sendiri. https://t.co/mszzgMDmCt,25,25,7,1,2022-01-22,23,Saturday,6,32,26
1485025223292428290,2022-01-22 23:02:58,"Wakil Ketua Komisi Informasi Pusat (KIP) Hendra J Kede menjadi korban penjambretan di depan gedung KONI, Jakarta Pusat. Polisi turun tangan. https://t.co/NnPEDTAf09",8,2,1,4,2022-01-22,23,Saturday,6,9,6
1485023312019431429,2022-01-22 22:55:22,"Bayi kembar empat lahir dengan selamat di Rumah Sakit Umum Pusat (RSUP) Sanglah Denpasar, Bali, pada Jumat (21/1) sekitar pukul 13.00 WITA. https://t.co/LR8xSsry4X",54,41,12,2,2022-01-22,22,Saturday,6,66,43
1485021796034392064,2022-01-22 22:49:21,Wakil Ketua MPR RI Hidayat Nur Wahid menilai pemindahan Ibu Kota Negara merupakan suatu hal yang sangat krusial. https://t.co/csf2imtzPz,11,6,2,1,2022-01-22,22,Saturday,6,13,7
1485020457380331526,2022-01-22 22:44:02,"Nama Pratama Arhan ramai menjadi perbincangan berkat aksi-aksinya di Piala AFF 2020. Di ajang ini, Arhan memang sempat memberikan penampilan yang memukau. https://t.co/wY90zrz2uU",25,1,2,0,2022-01-22,22,Saturday,6,27,1
1485018939788869632,2022-01-22 22:38:00,Bek Manchester City Benjamin Mendy sudah keluar dari penjara dengan jaminan. Ia kini menjadi tahanan rumah dan mengenakan gelang pelacak di kakinya. https://t.co/2gZKmVjna4,8,0,0,0,2022-01-22,22,Saturday,6,8,0
1485017429134692352,2022-01-22 22:32:00,Sikap Polantas yang tidak terpancing emosi saat diacungi pengendara motor perempuan yang tidak menggunakan helm di daerah Jakarta Timur diganjar penghargaan. https://t.co/umuLmkgOP5,25,23,5,3,2022-01-22,22,Saturday,6,30,26
1485015363909791747,2022-01-22 22:23:47,Heboh video sejumlah belatung muncul dari bagian organ intim wanita. Hal ini pun membuat warganet jijik dan syok. Ini tips psikolog untuk mengatasinya. https://t.co/rxpcBBwvKp,14,1,0,0,2022-01-22,22,Saturday,6,14,1
1485013576171630597,2022-01-22 22:16:41,Politisi yang akrab disapa HNW ini mengingatkan Ditjen PFM di tahun 2022 mengelola anggaran sebesar Rp 45 triliun untuk dua program bansos utama Kemensos. https://t.co/cakjUdSo0b,14,0,0,2,2022-01-22,22,Saturday,6,14,2
1485011327001280515,2022-01-22 22:07:45,Kemenkes RI mengumumkan dua pasien Omicron di Indonesia meninggal dunia. Varian Omicron diketahui memiliki tingkat penularan lebih tinggi ketimbang varian lain. https://t.co/ANeyseKc2e,24,1,5,2,2022-01-22,22,Saturday,6,29,3
1485010077060845570,2022-01-22 22:02:47,"Beberapa wanita bertanya apakah alat kelaminnya normal atau tidak, lantaran tampak berbeda dari bentuk vagina umumnya. Sebenarnya ada 7 variasi, ini daftarnya. https://t.co/0Tbz2cqUsG",5,0,3,0,2022-01-22,22,Saturday,6,8,0
1485007273525137408,2022-01-22 21:51:38,"Seorang model Playboy dan bintang porno asal Argentina, mengalami kelumpuhan di sebagian wajahnya setelah melakukan operasi plastik sebanyak 53 kali. https://t.co/HoQohdoKMo",11,4,0,3,2022-01-22,21,Saturday,6,11,7
1485005569824108546,2022-01-22 21:44:52,"Pria berinisial S (35) diciduk polisi setelah melapor kehilangan motor. Dari hasil penyidikan kepolisian, ternyata pria itu tersangka pencurian. https://t.co/HTrikfoV76",457,58,78,73,2022-01-22,21,Saturday,6,535,131
1485004068779134983,2022-01-22 21:38:54,Pemerintah kembali mengumumkan data kasus COVID-19 (Corona). Hari ini ada sebanyak 3.205 kasus dengan sumbangan kasus terbanyak dari DKI Jakarta sebanyak 1.825. https://t.co/WoJSlxgtQa,64,5,22,2,2022-01-22,21,Saturday,6,86,7
1485000200842264580,2022-01-22 21:23:32,Tisu magic sering digunakan oleh pria saat melakukan hubungan seksual. Benda ini biasa digunakan untuk menunda ejakulasi dini. Bagaimana efek sampingnya ya? https://t.co/b3TrfzUWTT,6,2,0,3,2022-01-22,21,Saturday,6,6,5
1484997793815187462,2022-01-22 21:13:58,"Tisu magic banyak dijadikan opsi oleh pasangan agar sesi bercinta jadi lebih tahan lama. Tapi, bagaimana cara pakai tisu magic yang benar? Begini caranya: https://t.co/2sraOR0JEw",10,0,4,0,2022-01-22,21,Saturday,6,14,0
1484996554947764226,2022-01-22 21:09:03,Amerika Serikat mengumumkan penangguhan 44 penerbangan pesawat penumpang China dari Amerika ke negeri raksasa Asia itu. https://t.co/d2ahK9ILAq,5,0,0,1,2022-01-22,21,Saturday,6,5,1
1484994977490952196,2022-01-22 21:02:47,"Manchester United sukses mengalahkan West Ham United. Berbekal dua kemenangan beruntun, Setan Merah bisa beristirahat sementara dengan tenang. https://t.co/X3i8OK7unR",7,0,0,0,2022-01-22,21,Saturday,6,7,0
1484993640757960706,2022-01-22 20:57:28,"Gelandang Juventus, Arthur Melo, dikabarkan menjadi incaran Arsenal. Pelatih Massimiliano Allegri memberi sinyal pemainnya itu tak akan dilepas. https://t.co/UrKRVHVNPN",6,0,0,0,2022-01-22,20,Saturday,6,6,0
1484992802421420034,2022-01-22 20:54:08,Ini deretan aktris Korea yang jadi istri konglomerat dan punya harta berlimpah:  https://t.co/L6fWP4Okx4,4,0,0,0,2022-01-22,20,Saturday,6,4,0
1484991802960715781,2022-01-22 20:50:10,"Amartha Hangtuah memulai IBL 2022 dengan mantap usai menyapu bersih seluruh laga. Tapi hal itu tak membuat Hangtuah puas, karena ini barulah awal. https://t.co/uaSwSJpA2H",5,0,0,0,2022-01-22,20,Saturday,6,5,0
1484989940903682050,2022-01-22 20:42:46,"Polrestabes Makassar menangkan pria berinisial MA (26), pelaku ujaran kebencian yang diduga menghina warga suku Makassar. https://t.co/2BmsN01Hh1",4,0,0,0,2022-01-22,20,Saturday,6,4,0
1484989394549460992,2022-01-22 20:40:36,"Di Manchester City, para pemain sama sekali tidak bisa bersantai-santai. Hal tersebut diungkapkan oleh Bernardo Silva. https://t.co/aYvhgZgwAT",6,1,0,0,2022-01-22,20,Saturday,6,6,1
1484985193559732227,2022-01-22 20:23:54,Hirving Lozano percaya Napoli lebih kuat dari Inter Milan dalam persaingan untuk Scudetto musim ini. Apa alasannya? https://t.co/L44FlOS0FW,3,0,0,0,2022-01-22,20,Saturday,6,3,0
1484981116146749445,2022-01-22 20:07:42,"Seragam satpam akan kembali diubah oleh Polri menjadi warna krem. Kira-kira, kamu sudah tahu belum makna dan sejarah dari warna coklat yang lebih muda ini? https://t.co/YYqjEnFMP7",5,5,0,0,2022-01-22,20,Saturday,6,5,5
1484978637237587970,2022-01-22 19:57:51,Gubernur DKI Jakarta Anies Rasyid Baswedan menghadiri acara 'Masyarakat Sulawesi Selatan Menyambut Anies Baswedan' di Kota Makassar. https://t.co/8yPS8QA4y2,29,3,5,1,2022-01-22,19,Saturday,6,34,4
1484974626769981443,2022-01-22 19:41:55,"Inter Milan harus susah payah mengalahkan Venezia dengan skor 2-1. Tertinggal duluan, Nerazzurri menang lewat gol Edin Dzeko di menit akhir. https://t.co/hdvOkMaCQm",3,1,0,0,2022-01-22,19,Saturday,6,3,1
1484973488872042501,2022-01-22 19:37:23,Manchester United menang dramatis 1-0 saat menjamu West Ham United dalam lanjutan Liga Inggris. Setan Merah menang berkat gol Marcus Rashford di injury time. https://t.co/A2NALYdiQB,7,0,0,1,2022-01-22,19,Saturday,6,7,1
1484971704732590082,2022-01-22 19:30:18,"Bom meledak di dalam sebuah minibus di Kota Herat, Afghanistan barat. Kejadian itu menewaskan 7 orang dan 9 orang lainnya luka-luka. https://t.co/GWERDL5xVm",0,0,0,0,2022-01-22,19,Saturday,6,0,0
1484969999018123273,2022-01-22 19:23:31,Arsenal tak mau menunggu Dusan Vlahovic terlalu lama. Meriam London memberikan tenggat waktu sampai tengah pekan depan. https://t.co/Rqvjr3nR2N,4,0,0,0,2022-01-22,19,Saturday,6,4,0
1484966896625721344,2022-01-22 19:11:12,Hari ini dilaporkan ada tambahan 3.205 kasus positif COVID-19 di Indonesia. https://t.co/ma7Xxryhnh,13,9,5,2,2022-01-22,19,Saturday,6,18,11
1484963429710450701,2022-01-22 18:57:25,"Polres Labuhanbatu, Sumatera Utara, menggagalkan rencana pengiriman 54 calon tenaga kerja Indonesia (TKI) ilegal, yang akan diselundupkan ke Malaysia. https://t.co/M3FP5bsWWn",9,0,3,1,2022-01-22,18,Saturday,6,12,1
1484961153096818699,2022-01-22 18:48:22,"Ketika para pria ini mengalami kondisi medis yang memengaruhi organ intimnya, tim dokter berusaha membantu dengan membuatkan penis bionik. Ini kisah mereka: https://t.co/hgDXNQTGzB",3,1,1,2,2022-01-22,18,Saturday,6,4,3
1484957109116616704,2022-01-22 18:32:18,"#Terpopuler Ghozali, mahasiswa asal Semarang viral dan dapat cuan sekitar Rp 1,5 miliar dari menjual foto selfie NFT. Mau buat apa uangnya? Ini kata Ghozali:  https://t.co/yNutmG2wey",15,5,3,0,2022-01-22,18,Saturday,6,18,5
1484955832148234246,2022-01-22 18:27:14,Sepakan terakhir Manchester United dari Marcus Rashford memastikan kemenangan atas West Ham United. Bukan pertama kali Rashford memberi MU kemenangan dramatis. https://t.co/ExiuXypnPn,3,0,1,0,2022-01-22,18,Saturday,6,4,0
1484952028694601729,2022-01-22 18:12:07,Penurunan Chelsea di Liga Inggris memberikan alarm bagi Thomas Tuchel. Si pelatih bisa saja dipecat sekalipun pernah mempersembahkan gelar Liga Champions. https://t.co/0dNXmhtsIj,6,0,2,1,2022-01-22,18,Saturday,6,8,1
1484949699534671877,2022-01-22 18:02:52,"Warga Tangsel tak perlu jauh-jauh ke Bogor, di Tangsel ada restoran keluarga cocok untuk bersantai. https://t.co/DjkjEWWEK8",33,1,10,0,2022-01-22,18,Saturday,6,43,1
1484945253257859072,2022-01-22 17:45:11,Kapolda Sumatera Utara (Sumut) Irjen Panca Putra menegaskan mantan Kapolrestabes Medan Kombes Riko Sunarko tidak terbukti menerima suap bandar narkoba. https://t.co/ipxyARXBwV,12,5,2,0,2022-01-22,17,Saturday,6,14,5
1484943649309929481,2022-01-22 17:38:49,"Drama lima gol terjadi di laga Hoffenheim vs Borussia Dortmund. Setelah melalui pertarungan sengit, Die Borussen menang 3-2. https://t.co/36FjG7JYZK",12,0,1,0,2022-01-22,17,Saturday,6,13,0
1484942441015017472,2022-01-22 17:34:01,"Pengamat transportasi menilai Korlantas Polri kurang serius menangani truk ODOL imbas kecelakaan maut yang terjadi di Balikpapan, Kaltim. Korlantas merespons. https://t.co/Pn3tqUssbP",5,5,4,1,2022-01-22,17,Saturday,6,9,6
1484940941366640650,2022-01-22 17:28:03,Nick Jonas dan Priyanka Chopra dikaruniai anak pertama yang dilahir melalui ibu pengganti. https://t.co/wWKDRQnl0X,19,6,5,2,2022-01-22,17,Saturday,6,24,8
1484938681781788682,2022-01-22 17:19:05,Han So Hee saat zaman sekolah ini bikin netizen gagal fokus. Ini dia pesona Han So Hee:  https://t.co/WuBEkNCBYM,23,0,2,0,2022-01-22,17,Saturday,6,25,0
1484936685800546306,2022-01-22 17:11:09,Erika Carlina tak tertarik dengan bule meski didekati Charlie Puth. Erika Carlina lebih suka dengan cowok Indonesia. https://t.co/tWm7iOFuA6,27,5,3,7,2022-01-22,17,Saturday,6,30,12
1484935452511592448,2022-01-22 17:06:15,"Saat kamu melintas di salah satu ruas jalan tol yang penuh tanjakan dan turunan, sering kali terlihat sebuah jalur yang menanjak ke atas. https://t.co/cd8Whd19eb",16,0,8,0,2022-01-22,17,Saturday,6,24,0
1484934002989580292,2022-01-22 17:00:29,"Wanita dinilai sulit meraih orgasme, namun berbagai macam orgasme ini bisa dilakukan untuk mendapatkan kenikmatan lebih besar, salah satunya orgasme puting. https://t.co/y2JR8qw8Gx",10,1,3,1,2022-01-22,17,Saturday,6,13,2
1484933981682475008,2022-01-22 17:00:24,"Mendukung klub kota kelahiran wajib hukumnya, tapi tidak dengan pengusaha Cilacap Maya Damayanti. Dia punya cita-cita mengakuisisi klub Liga 2 PSCS Cilacap. https://t.co/aoI4CRk7gm",4,1,2,0,2022-01-22,17,Saturday,6,6,1
1484933203064406021,2022-01-22 16:57:18,Yuk latih otak kamu agar bisa lancar memecahkan masalah. Teka-teki ini bisa membuktikan apakah kamu jenius. https://t.co/SN7CoSRvRy,84,78,13,2,2022-01-22,16,Saturday,6,97,80
1484932139007283204,2022-01-22 16:53:05,Ini deretan aktris Korea yang jadi istri konglomerat dan punya harta berlimpah:  https://t.co/41QO9tTSq4,12,0,1,0,2022-01-22,16,Saturday,6,13,0
1484932114181246977,2022-01-22 16:52:59,Kepala Baitul Mal Aceh Tenggara berinisial SA ditangkap polisi karena diduga memperkosa seorang santrinya yang berusia 16 tahun. https://t.co/DtAxAMEEG0,14,1,2,2,2022-01-22,16,Saturday,6,16,3
1484930785413156864,2022-01-22 16:47:42,"KPK melancarkan operasi tangkap tangan (OTT) di sejumlah daerah akhir-akhir ini. Tercatat, sudah ada empat kali KPK melakukan OTT di bulan Januari 2022. https://t.co/GENPRQKb5v",13,1,1,1,2022-01-22,16,Saturday,6,14,2
1484930004693798920,2022-01-22 16:44:36,MU bermain imbang tanpa gol di babak pertama saat menghadapi West Ham United di Liga Inggris. Setan Merah bahkan gagal melepaskan satu pun tembakan ke gawang. https://t.co/MqVi3cJOhq,5,0,0,0,2022-01-22,16,Saturday,6,5,0
1484928688357617664,2022-01-22 16:39:22,"Juara All England 2021 Lee Zii Jia dihukum 2 tahun larangan bertanding di turnamen internasional, menyusul keputusannya keluar dari Timnas Bulutangkis Malaysia. https://t.co/8GVKQrFXDG",9,0,2,1,2022-01-22,16,Saturday,6,11,1
1484927699122634756,2022-01-22 16:35:26,Akbar Wicaksono mendadak jadi sorotan. Ia ngaku menghasilkan puluhan miliar per tahunnya sampai tetangga sempat curiga. https://t.co/QNYCxFLGOK,97,8,14,2,2022-01-22,16,Saturday,6,111,10
1484926555201716227,2022-01-22 16:30:54,Di media sosial ramai soal video viral belatung. Netizen syok dengan video yang tampak menunjukkan vagina berisi belatung hidup.  https://t.co/2bPTHz4Av8,15,5,2,0,2022-01-22,16,Saturday,6,17,5
1484924855946461185,2022-01-22 16:24:08,"Seorang pria berinisial DD (22) di Kebon Jeruk, Jakbar, ditangkap polisi karena kedapatan hendak mencuri motor yang terparkir di sebuah klinik di Jakbar. https://t.co/NJQfkEh3L3",12,0,1,0,2022-01-22,16,Saturday,6,13,0
1484923500699729921,2022-01-22 16:18:45,"Mendukung klub kota kelahiran wajib hukumnya, tapi tidak dengan pengusaha Cilacap Maya Damayanti. Dia punya cita-cita mengakuisisi klub Liga 2 PSCS Cilacap. https://t.co/fg2B1SiuX8",10,1,0,1,2022-01-22,16,Saturday,6,10,2
1484922767095091209,2022-01-22 16:15:50,"Indonesia mencatat sebanyak 3.205 kasus baru COVID-19, Sabtu (22/1/2022). DKI menyumbang kasus terbanyak dengan jumlah 1.825. https://t.co/sZcdhbBzVW",17,3,6,6,2022-01-22,16,Saturday,6,23,9
1484921339786014724,2022-01-22 16:10:10,"Sebanyak 3,2 juta unit set top box gratis TV digital akan disalurkan ke rumah tangga miskin. STB ini membantu masyarakat mendapatkan siaran TV digital ketika TV analog dimatikan. https://t.co/pAvyKtaekR",21,3,8,1,2022-01-22,16,Saturday,6,29,4
1484920111219847174,2022-01-22 16:05:17,"Untuk jadi cuan, tidak sembarang NFT bisa laku. Simak tips dari CEO Baliola I Gede Putu Rahman Desyanta dan Musisi Souljah Benjamin di #dMentor ! https://t.co/XeMJIBI7y3",6,0,1,0,2022-01-22,16,Saturday,6,7,0
1484918750876950536,2022-01-22 15:59:53,"Sebelum melakukan aktivitas seksual, beberapa pasangan kerap melakukan hal yang sebenarnya menjadi pantangan sebelum bercinta. Catat 6 di antaranya. https://t.co/0C8fF6oyGh",10,2,1,1,2022-01-22,15,Saturday,6,11,3
1484917877555838983,2022-01-22 15:56:25,"MAKI mengadukan dugaan pungli yang dilakukan oknum pejabat Bea Cukai di Bandara Soekarno-Hatta ke Kejati Banten. Diduga korban rugi Rp 1,7 miliar. https://t.co/Qllej9LSTA",25,1,6,0,2022-01-22,15,Saturday,6,31,1
1484916104027856896,2022-01-22 15:49:22,"Dua kelompok remaja terlibat tawuran di Simpang Kedunghalang, Bogor. Polisi mengamankan mereka dan juga sejumlah alat yang dijadikan senjata. https://t.co/0IVqsX9No1",13,2,0,0,2022-01-22,15,Saturday,6,13,2
1484915060552212486,2022-01-22 15:45:13,"Propam Polri mendapati adanya sumbatan pada arahan Kapolri Jenderal Listyo Sigit kepada jajaran tingkat bawah. Ternyata, arahan itu mengendap di level kapolres. https://t.co/vrxvOsnZXE",77,14,24,5,2022-01-22,15,Saturday,6,101,19
1484913455010398208,2022-01-22 15:38:50,"Kebakaran melanda rumah tinggal di Kalibata, Jaksel, malam ini. Tim pemadam kebakaran (damkar) mengerahkan 3 unit mobil pemadam untuk memadamkan api. https://t.co/TpI8snrHh2",9,0,1,0,2022-01-22,15,Saturday,6,10,0
1484913453487857666,2022-01-22 15:38:50,Sesosok mayat laki laki bertato naga ditemukan di Sungai Ciwulan. Terdapat luka menganga di kepalanya. Korban tanpa identitas. https://t.co/MXI1goSjTv,11,0,0,0,2022-01-22,15,Saturday,6,11,0
1484912957805023233,2022-01-22 15:36:52,"Hikma (48), warga Palu, Sulawesi Tengah (Sulteng), mengungkap cerita pilu mendiang anaknya Upin dan Ipin yang makamnya viral belum lama ini. https://t.co/tqypK5p2mC",43,4,2,1,2022-01-22,15,Saturday,6,45,5
1484912216566603780,2022-01-22 15:33:55,Restoran Honke Owariya dinobatkan sebagai restoran paling tua di Jepang. Restoran ini tawarkan menu soba yang manis gurih.  https://t.co/9uw5e3nR6D,11,0,1,2,2022-01-22,15,Saturday,6,12,2
1484910716104720386,2022-01-22 15:27:57,"Beredar video di media sosial, mempelai wanita bergaun putih naik perahu menerjang banjir. Peristiwa itu terjadi di Lamongan. Seperti apa ceritanya? https://t.co/dUWUUYFLk6",28,2,3,1,2022-01-22,15,Saturday,6,31,3
1484910509350694920,2022-01-22 15:27:08,"V BTS merilis tas 'Mute Boston Bag' sebagai merchandise. Seperti sarannya, tas tersebut viral digunakan penggemar untuk membawa anjing peliharaan. https://t.co/JjUnPgwiBc",20,0,11,2,2022-01-22,15,Saturday,6,31,2
1484909414586982407,2022-01-22 15:22:47,Harga mahal dan stok minyak goreng yang susah didapat membuat masyarakat mengeluh. 20Detik mencoba mengecek ke sejumlah minimarket guna memastikan terkait stok dan harga minyak yang kini banyak dikeluhkan. https://t.co/r21vbvIbvP,13,7,3,0,2022-01-22,15,Saturday,6,16,7
1484908002683535367,2022-01-22 15:17:10,"Iran, Rusia dan China memulai latihan perang bersama yang melibatkan Angkatan Laut dan Udara mereka di Samudra Hindia. Apa tujuannya? https://t.co/grdOIBRetx",26,2,4,1,2022-01-22,15,Saturday,6,30,3
1484906719843082246,2022-01-22 15:12:04,Fatia Maulidiyanti mengaku memiliki banyak bukti yang kuat terkait polemiknya dengan Menko Marves Luhut Binsar Pandjaitan. https://t.co/Uno6cgQfXW,131,65,32,5,2022-01-22,15,Saturday,6,163,70
1484905236506497031,2022-01-22 15:06:11,Andrew Garfield juga membohongi Emma Stone soal penampilannya di Spider-Man: No Way Home. Begini kisahnya:  https://t.co/yB1qMFVDsY,20,2,2,1,2022-01-22,15,Saturday,6,22,3
1484904144905375755,2022-01-22 15:01:50,Tebak-tebakan yang seru sekaligus melatih kemampuan berpikir bisa jadi hal baik untuk menjaga ketajaman berpikir. Coba deh kamu jawab tebak-tebakan berikut. https://t.co/GhKSjrdw3r,7,0,1,0,2022-01-22,15,Saturday,6,8,0
1484903032164921344,2022-01-22 14:57:25,PIlih gombalan yang mana? Yang lucu atau yang bisa bikin baper? https://t.co/YO8I8OtfcD,23,0,3,2,2022-01-22,14,Saturday,6,26,2
1484901626783703042,2022-01-22 14:51:50,#LayanganPutus tidak cuma menarik karena drama perselingkuhan. Di dalam cerita itu ada juga Lastri si asisten rumah tangga yang menarik perhatian.  https://t.co/WJGwViwjpm,16,1,3,2,2022-01-22,14,Saturday,6,19,3
1484900280600776712,2022-01-22 14:46:29,"Kebakaran melanda rumah tinggal di Kalibata, Jaksel, malam ini. Tim pemadam kebakaran (damkar) mengerahkan 3 unit mobil pemadam untuk memadamkan api. https://t.co/YxuTcNpU4i",12,0,2,2,2022-01-22,14,Saturday,6,14,2
1484898594650042370,2022-01-22 14:39:47,"Banjir di wilayah Tegal Alur, Kalideres, Jakbar berangsur-angsur surut. Beberapa warga yang sempat mengungsi di posko pengungsian mulai kembali ke kediamannya. https://t.co/HQMGMWPwY1",10,0,5,0,2022-01-22,14,Saturday,6,15,0
1484897509008977924,2022-01-22 14:35:28,"Mobil angkutan kota (angkot) nomor 25 warna hitam terbakar di Jalan RH Didi Sukardi, Kota Sukabumi. Baik sopir maupun penumpang berhasil menyelamatkan diri. https://t.co/P1Self1pOo",24,1,3,0,2022-01-22,14,Saturday,6,27,1
1484895908617768967,2022-01-22 14:29:07,"Di dalam diri Georgina Rodriguez, Cristiano Ronaldo tampak sudah menemukan pasangan hidup pas setelah di masa lalu gagal merajut asmara dengan sejumlah wanita. https://t.co/TXPXQcgoFm",42,0,5,2,2022-01-22,14,Saturday,6,47,2
1484894767968309248,2022-01-22 14:24:35,"Panda terkenal pilih-pilih makanan namun tetap terlihat chubby, berbadan gemuk dan berpipi tembam. Gemas!  https://t.co/3ctSPo1Y4e",58,9,25,29,2022-01-22,14,Saturday,6,83,38
1484893390982598658,2022-01-22 14:19:07,"Para bintang TikTok semakin kaya raya, bahkan pendapatan sebagian dari mereka disebut menyamai bahkan melebihi penghasilan CEO di perusahaan top.  https://t.co/8YZY2EBtTk",29,1,5,1,2022-01-22,14,Saturday,6,34,2
1484892130741006336,2022-01-22 14:14:06,"Revitalisasi Kalimalang kian terwujud dalam waktu dekat. Kini, apa yang disebut 'Sungai Cheonggyecheon Bekasi' bakal menjadi kebanggaan. Wih! https://t.co/2EaqHr3WYG",21,3,8,1,2022-01-22,14,Saturday,6,29,4
1484890550440505352,2022-01-22 14:07:49,Louis Saha geram dengan anak-anak muda Manchester United yang enggan menerima masukan dari Cristiano Ronaldo. Dia mempertanyakan prestasi Mason Greenwood dkk. https://t.co/Uaev3DHeL6,121,2,10,2,2022-01-22,14,Saturday,6,131,4
1484890025707909120,2022-01-22 14:05:44,"Manajer West Ham, David Moyes, suka dengan ego Cristiano Ronaldo. Hal tersebut menurutnya dibutuhkan oleh semua tim besar. https://t.co/4OJIABOeP8",21,1,2,1,2022-01-22,14,Saturday,6,23,2
1484888730229948421,2022-01-22 14:00:35,"Aktris cantik Paramitha Rusady sudah jarang muncul di layar kaca maupun film. Meski begitu, wanita yang kini berusia 55 tahun itu masih terlihat awet muda. #detiknetwork  https://t.co/LSlN08n49v",34,7,2,0,2022-01-22,14,Saturday,6,36,7
1484887597470011394,2022-01-22 13:56:05,"Banyak sekali pengalaman yang dirasakan driver ojol, termasuk pengalaman ketika mendapat tip dengan jumlah super besar. https://t.co/OIhFqirRTY",19,1,2,0,2022-01-22,13,Saturday,6,21,1
1484886619622629376,2022-01-22 13:52:12,"Usai direnovasi, begini penampakan terbaru Stadion Jatidiri Semarang. https://t.co/RqMmVtnY1N",80,3,18,2,2022-01-22,13,Saturday,6,98,5
1484885490167951363,2022-01-22 13:47:43,Kriteria yang harus dimiliki calon pemimpin di IKN setidaknya pernah memimpin daerah dan memiliki latar belakang arsitek. Siapa saja ya yang punya latar belakang tersebut? https://t.co/dbfduZSN7O,35,11,6,5,2022-01-22,13,Saturday,6,41,16
1484885199007670272,2022-01-22 13:46:33,"Kontennya yang menggambarkan perjuangan hidupnya dan ketiga adiknya, dengan kondisi kedua orang tua yang bercerai dan menelantarkannya, membuat banyak dari netizen yang iba dan terinspirasi dengan kemandiriannya.  https://t.co/1xbGbLkJf1",18,1,5,0,2022-01-22,13,Saturday,6,23,1
1484883812018499585,2022-01-22 13:41:03,"Bagi mereka yang buta warna, beberapa gambar hewan berikut mungkin akan sulit terlihat. Bisakah kamu menebak hewan yang ada? https://t.co/vie7yoe7zT",20,18,8,1,2022-01-22,13,Saturday,6,28,19
1484882337095639045,2022-01-22 13:35:11,Belakangan ini dikabarkan sejumlah kasus anak meninggal usai melakukan vaksinasi COVID-19. Komnas KIPI menyebut ada beberapa hal yang perlu dikaji mendalam. https://t.co/cVf1hmN91Z,34,8,17,1,2022-01-22,13,Saturday,6,51,9
1484882335757647875,2022-01-22 13:35:11,Kemenkes membenarkan adanya dua pasien Omicron di Indonesia yang meninggal dunia. Ini merupakan laporan fatalitas pertama di Indonesia. https://t.co/q5G3njklAm,18,6,7,1,2022-01-22,13,Saturday,6,25,7
1484881469885587457,2022-01-22 13:31:44,Fenomena langka terjadi di Gurun Sahara. Salju hingga kristal es menghampar di padang pasir terbesar di dunia. https://t.co/s5kfoe82Sl,49,8,15,4,2022-01-22,13,Saturday,6,64,12
1484881201873981442,2022-01-22 13:30:40,Eks pemain Madrid meyakini bahwa Kylian Mbappe ke Real Madrid tidak akan terjadi! https://t.co/R4sNqcROwu,7,0,0,0,2022-01-22,13,Saturday,6,7,0
1484880434731393024,2022-01-22 13:27:38,"Aiptu Siswanto, anggota polisi di Kabupaten Cianjur, Jawa Barat membeli sepeda motor matic dengan menggunakan uang koin pecahan Rp 1.000. https://t.co/9jYcmdxfxK",26,6,7,1,2022-01-22,13,Saturday,6,33,7
1484879665907081221,2022-01-22 13:24:34,Jamie Carragher mengaku disebut keledai oleh Lionel Messi. https://t.co/n3iOmS2i9G,17,1,0,0,2022-01-22,13,Saturday,6,17,1
1484877788540768256,2022-01-22 13:17:07,"Kecelakaan truk tangki dengan ojol terjadi di Jl Panjang, Kebon Jeruk, Jakbar, tadi siang. Akibatnya, penumpang ojol meninggal dunia di lokasi. https://t.co/DClx1bvHGM",69,13,10,2,2022-01-22,13,Saturday,6,79,15
1484876972425682950,2022-01-22 13:13:52,Joaquin Correa mengalami cedera parah. Inter Milan kini dikabarkan membidik Felipe Caicedo untuk menambal kehilangan Correa. https://t.co/eLBqEagdZD,8,2,2,0,2022-01-22,13,Saturday,6,10,2
1484875199904456705,2022-01-22 13:06:49,"Dua pasien Omicron meninggal. Kemenkes RI mengungkap jenis masker yang ampuh dan tak efektif menangkal COVID-19, hingga gejala Omicron. https://t.co/mWo8hUkh8r",37,24,20,3,2022-01-22,13,Saturday,6,57,27
1484874066708344841,2022-01-22 13:02:19,Kasus COVID-19 di Indonesia kembali mengalami lonjakan sejak awal Januari 2022 seiring merebaknya varian Omicron di Tanah Air. https://t.co/DjvRs8VtdC,18,8,4,3,2022-01-22,13,Saturday,6,22,11
1484873668798955523,2022-01-22 13:00:44,"V BTS merilis tas 'Mute Boston Bag' sebagai merchandise. Seperti sarannya, tas tersebut viral digunakan penggemar untuk membawa anjing peliharaan. https://t.co/Um4fPgiHj4",643,2,179,3,2022-01-22,13,Saturday,6,822,5
1484872675600257030,2022-01-22 12:56:48,"Pernyataan anggota Komisi III DPR RI, Arteria Dahlan, meminta kepala kejaksaan tinggi diganti karena bicara bahasa Sunda dalam rapat masih berlanjut. Ini pernyataannya.. https://t.co/K7g2YGAK2W",11,0,3,0,2022-01-22,12,Saturday,6,14,0
1484871926715662344,2022-01-22 12:53:49,Gaji Cristiano Ronaldo di Manchester United terancam kena potong sampai 25 persen. Ada apa gerangan? https://t.co/BEwnp6fGS3,16,1,2,2,2022-01-22,12,Saturday,6,18,3
1484870875488964612,2022-01-22 12:49:38,Kemenkes mengungkap dua orang pasien COVID-19 Omicron yang meninggal dunia mempunyai komorbid. Keduanya mengalami gejala berat. https://t.co/hxfbfev49w,18,1,17,5,2022-01-22,12,Saturday,6,35,6
1484870874373181443,2022-01-22 12:49:38,"Banjir yang menggenangi wilayah Tegal Alur, Kalideres, Jakarta Barat (Jakbar) berangsur-angsur surut. Kendati demikian, tiga RT lainnya masih menggenang. https://t.co/pEbm860ybl",10,1,4,0,2022-01-22,12,Saturday,6,14,1
1484869782633648128,2022-01-22 12:45:18,"Dua pasien Omicron Indonesia meninggal dunia, berikut gejala COVID-19 yang sempat dikeluhkan! https://t.co/qWwSMzkvay",23,1,14,5,2022-01-22,12,Saturday,6,37,6
1484869765701468161,2022-01-22 12:45:14,"Gimana sih cara download video YouTube di HP tanpa aplikasi? Baca di sini ya detikers!

 https://t.co/i2MGq8YIiZ",22,0,9,0,2022-01-22,12,Saturday,6,31,0
1484868451088973828,2022-01-22 12:40:00,Park Shin Hye dan Choi Tae Joon menikah hari ini Sabtu (22/1/2022). Berikut fakta menarik pernikahan Park Shin Hye yang digelar saat sang aktris tengah hamil. https://t.co/ExrvUZThLI,52,0,7,0,2022-01-22,12,Saturday,6,59,0
1484866590805999620,2022-01-22 12:32:37,Kementerian Kesehatan RI mengumumkan dua kasus kematian pasien COVID-19 dengan varian Omicron dan menjadi kematian pertama pada pasien Omicron. https://t.co/fbVIcP5kir,9,0,3,2,2022-01-22,12,Saturday,6,12,2
1484866003284733953,2022-01-22 12:30:17,Park Shin Hye dan Choi Tae Joon menikah hari ini Sabtu (22/1/2022). Berikut fakta menarik pernikahan mereka! https://t.co/eJ9yTODVUc,37,0,3,0,2022-01-22,12,Saturday,6,40,0
1484865668495417351,2022-01-22 12:28:57,"Dua pasien Omicron Indonesia meninggal dunia, diumumkan Kemenkes RI per Sabtu (22/1/2022). Berikut gejala COVID-19 yang sempat dikeluhkan. https://t.co/42TYnLUTOq",73,8,30,2,2022-01-22,12,Saturday,6,103,10
1484865330778361866,2022-01-22 12:27:36,"Sebelum ada info pendaftaran, tidak ada salahnya mengintip daftar Sekolah Kedinasan dengan sedikit peminat pada tahun sebelumnya. Mungkin jadi peluang kamu? https://t.co/9GUDx5gnvi",13,0,5,1,2022-01-22,12,Saturday,6,18,1
1484864924262219778,2022-01-22 12:26:00,Daniil Medvedev dan Simona Halep menjejak babak 16 besar Australian Open 2022.  https://t.co/TuaIPym0wU,7,1,1,0,2022-01-22,12,Saturday,6,8,1
1484863952425299972,2022-01-22 12:22:08,Penampilan Nia Ramadhani saat menjalani sidang menjadi perhatian. Ia terlihat tampil modis dengan gaya rambutnya. https://t.co/9RYl1tjaWk,14,8,2,1,2022-01-22,12,Saturday,6,16,9
1484863069415219202,2022-01-22 12:18:37,3 perbedaan antara sosok Kinan di #LayanganPutus dengan Mommy ASF.. https://t.co/YT7ptfP2Zr,5,1,3,0,2022-01-22,12,Saturday,6,8,1
1484862416710254594,2022-01-22 12:16:02,"Mau dapat beasiswa pemerintah Polandia buat studi S2 dan S3? Buat inspirasi, yuk intip kisah kuliah Yolanda Rajagukguk, mahasiswa Indonesia di Polandia berikut. https://t.co/uHYvbssoO4",30,2,5,3,2022-01-22,12,Saturday,6,35,5
1484861370374008836,2022-01-22 12:11:52,Cegukan kamu nggak hilang-hilang? Coba deh mengatasinya sendiri dengan melakukan kiat-kiat menghilangkan cegukan berikut ini. #KuTips https://t.co/Z5MyA3mn97,5,2,3,1,2022-01-22,12,Saturday,6,8,3
1484860110199472130,2022-01-22 12:06:52,Kementerian Kesehatan RI mengumumkan dua kasus kematian pasien COVID-19 dengan varian Omicron. Keduanya menjadi kasus kematian pertama pada pasien Omicron. https://t.co/hozOJq0Ti7,20,1,6,1,2022-01-22,12,Saturday,6,26,2
1484860108614115332,2022-01-22 12:06:51,Burung Ivory-billed atau identitas asli kartun populer Woody Woodpecker resmi dinyatakan punah oleh pemerintah AS. Ini fakta terkait burung tersebut. https://t.co/fkTV4vkoAV,142,16,71,12,2022-01-22,12,Saturday,6,213,28
1484859505993306115,2022-01-22 12:04:28,Kalina Oktarani tidak hanya mengatakan Vicky Prasetyo berkali-kali minta cerai. Kalina juga jelaskan tidak ada nafkah yang pernah diterimanya. https://t.co/Uc8gsDq0oi,18,12,6,4,2022-01-22,12,Saturday,6,24,16
1484858824750161924,2022-01-22 12:01:45,Pete Broadhurst mengungkapkan mantan kekasihnya menyebut dia buruk rupa karena pipi-nya yang mirip hamster. Namun sayang semuanya malah jadi mimpi buruk. #CNNIndonesia #detiknetwork  https://t.co/MDAO8VFF32,7,1,2,0,2022-01-22,12,Saturday,6,9,1
1484857859083051016,2022-01-22 11:57:55,Sri Mulyani Indrawati mengungkapkan dibutuhkan pemanfaatan aset agar tak mubazir dan akan menyewakan gedung pemerintahan di Jakarta. https://t.co/RSUi0Zf1Bq,40,2,4,0,2022-01-22,11,Saturday,6,44,2
1484857348292329474,2022-01-22 11:55:53,Reza Paten akhirnya memberikan uang sebesar Rp 777 juta kepada Taqy Malik untuk pembangunan masjid. https://t.co/U3GFTGyzP5,8,2,2,0,2022-01-22,11,Saturday,6,10,2
1484856877242593281,2022-01-22 11:54:01,"Fico Fachriza ditangkap karena narkoba dan kini tengah menjalani rehabilitasi. Sebelumnya, ia kerap bicara soal memakai ganja dalam stand up-nya. https://t.co/UchkKs0Dvj",11,2,3,0,2022-01-22,11,Saturday,6,14,2
1484856862981988361,2022-01-22 11:53:58,"""Pak Maruli memenuhi kriteria yang pas, karena Pangkostrad adalah sosok yang harus setia kepada Presiden RI,"" kata Muhammad Farhan. https://t.co/iQm8UxHC7n",6,5,1,1,2022-01-22,11,Saturday,6,7,6
1484856842031407113,2022-01-22 11:53:53,Kemenkes mencatat dua kasus konfirmasi Omicron meninggal dunia. Kedua kasus tersebut didapat dari transmisi lokal dan perjalanan luar negeri. https://t.co/eZnlOSsVk4,6,1,2,2,2022-01-22,11,Saturday,6,8,3
1484856619389366279,2022-01-22 11:53:00,Kementerian Kesehatan mengumumkan dua pasien Omicron di Indonesia meninggal dunia. https://t.co/kGDQZ9vAfO,14,2,6,1,2022-01-22,11,Saturday,6,20,3
1484856325297299456,2022-01-22 11:51:49,Gubernur DKI Anies Baswedan memamerkan Jakarta International Stadium (JIS) saat menghadiri dialog dengan warga di Makassar. https://t.co/VJfeHOtLUD,99,74,6,2,2022-01-22,11,Saturday,6,105,76
1484856308989845504,2022-01-22 11:51:46,Gubernur DKI Anies Baswedan didampingi sejumlah petinggi DPD Partai NasDem Sulsel saat menghadiri acara 'Masyarakat Sulawesi Selatan Menyambut Anies Baswedan'. https://t.co/hAUvns0MVU,16,1,3,0,2022-01-22,11,Saturday,6,19,1
1484856288085426183,2022-01-22 11:51:41,Ada dua pasien Omicron di Indonesia yang meninggal dunia. Keduanya memiliki riwayat penyakit penyerta. Bagaimana status vaksinasinya? https://t.co/Th5upTRVJ9,5,0,2,2,2022-01-22,11,Saturday,6,7,2
1484856286810447875,2022-01-22 11:51:40,"Warga Kampung Pasir Nangka, Desa Pasir Kupa, Lebak diigegerkan dengan penemuan jenazah membusuk di salah satu rumah. https://t.co/Sv4Q0xLSqM",2,0,0,0,2022-01-22,11,Saturday,6,2,0
1484854626704838660,2022-01-22 11:45:04,Seorang pengendara roda dua viral di media sosial lantaran mendorong dan memaki anggota Polantas di Jalur Busway Pasar Raya Manggarai. Bagaimana ceritanya? https://t.co/SFyWhWfuWk,10,3,3,0,2022-01-22,11,Saturday,6,13,3
1484853701198102529,2022-01-22 11:41:24,Dua orang pasien COVID-19 varian Omicron meninggal dunia. Kemenkes mengatakan dua pasien itu meninggal di RS Sari Asih Ciputat dan di RSPI Sulianti Saroso. https://t.co/bGQOkMKSHA,44,12,24,5,2022-01-22,11,Saturday,6,68,17
1484851359384064002,2022-01-22 11:32:05,Park Shin Hye dan Choi Tae Joon menikah hari ini Sabtu (22/1/2022). Berikut fakta menarik pernikahan Park Shin Hye yang digelar saat sang aktris tengah hamil. https://t.co/KnbHLusE1w,319,1,22,6,2022-01-22,11,Saturday,6,341,7
1484849236768432128,2022-01-22 11:23:39,Bogor LavAni kembali menelan kekalahan di PLN Mobile Proliga 2022. Tim pendatang baru itu kini tunduk dari Surabaya Bhayangkara Samator. https://t.co/XEhbKrcSp0,5,0,0,0,2022-01-22,11,Saturday,6,5,0
1484848074715537408,2022-01-22 11:19:02,"Longsor Timpa Rumah di Sumedang, Sang Ibu Tewas Sambil Mendekap Anaknya https://t.co/sWQYsfjPjl",27,5,3,2,2022-01-22,11,Saturday,6,30,7
1484846847281795077,2022-01-22 11:14:10,Pemerintah merencanakan untuk memindahkan Pegawai Negeri Sipil (PNS) ke ibu kota baru. Berikut jadwalnya! https://t.co/VuVZQaXTI8,19,6,12,5,2022-01-22,11,Saturday,6,31,11
1484845926581784581,2022-01-22 11:10:30,Ralf Rangnick mendesak Cristiano Ronaldo agar menjaga emosi usai marah karena diganti. https://t.co/jFlcOXj462,11,0,1,0,2022-01-22,11,Saturday,6,12,0
1484844921739751429,2022-01-22 11:06:31,Park Shin Hye dan Choi Tae Joo resmi menikah. Netizen ramai-ramai ucapakan happy wedding di media sosial untuk pasangan romantis asal Korea Selatan ini. https://t.co/84Mh96bpfy,57,2,6,2,2022-01-22,11,Saturday,6,63,4
1484843829396127747,2022-01-22 11:02:10,"Badan Meteorologi, Klimatologi, dan Geofisika (BMKG) mencatat telah terjadi gempa dengan kekuatan magnitudo 3,9 di Kabupaten Bandung. https://t.co/fhqT3PLKPB",21,3,1,2,2022-01-22,11,Saturday,6,22,5
1484843473605910529,2022-01-22 11:00:45,Kunjungan Giring Ganesha ke warga korban gusuran di sekitar JIS sambil menyinggung proyek Firaun menuai sindiran. PSI membela Giring seraya bicara sosok Firaun. https://t.co/7dN8Mpe4QC,42,53,5,12,2022-01-22,11,Saturday,6,47,65
1484842356797059078,2022-01-22 10:56:19,Fashion show koleksi busana Louis Vuitton 2022 menampilkan tas unik terbaru  dengan bentuk kaleng cat. Berikut potret tas tersebut! https://t.co/bG5lAAbRsq,7,0,2,0,2022-01-22,10,Saturday,6,9,0
1484841608575172611,2022-01-22 10:53:21,Bukan main! Oddi Dermawan menjalani bisnis kuliner dan bisa laku 300 porsi sehari! https://t.co/X65woV3Sox,20,2,4,2,2022-01-22,10,Saturday,6,24,4
1484841104059080710,2022-01-22 10:51:20,"Saat berkendara sangat dibutuhkan konsentrasi yang tinggi, lengah sedikit akan berakibat fatal! https://t.co/s2Uty5LOzT",15,2,3,0,2022-01-22,10,Saturday,6,18,2
1484840621517033473,2022-01-22 10:49:25,"Menjelang pembukaan beasiswa pemerintah Polandia 2022, cek dulu yuk tips berburu beasiswa kuliah di Polandia ala mahasiswa Indonesia di sana. Apa saja? https://t.co/mGhCX5jK12",20,1,4,1,2022-01-22,10,Saturday,6,24,2
1484839067162451976,2022-01-22 10:43:15,Dokter rumah sakit Kanudjoso Djatiwibowo Balikpapan mengungkapkan kondisi terkini para korban kecelakaan maut Balikpapan. Seperti apa? https://t.co/zqT4wv0CUz,11,2,1,1,2022-01-22,10,Saturday,6,12,3
1484838564479254531,2022-01-22 10:41:15,"Seorang pengendara roda dua viral di media sosial lantaran mendorong dan memaki anggota Polantas di Jalur Busway Pasar Raya Manggarai, Tebet, Jakarta Selatan. https://t.co/ruzkA9MqyA",14,0,3,0,2022-01-22,10,Saturday,6,17,0
1484836688207794180,2022-01-22 10:33:48,Chelsea sedang menjalani puasa kemenangan di Liga Inggris. Kesempatan bagus bagi Chelsea untuk mengakhirinya saat menjamu Tottenham Hotspur. https://t.co/bDTAeum0tX,8,0,0,0,2022-01-22,10,Saturday,6,8,0
1484836052992933891,2022-01-22 10:31:16,Fadli Zon menyanyikan lagu Sunda berjudul 'Ayang-ayang Gung'. Fadli Zon menyebut lagu ini menceritakan tentang pejabat haus kekuasaan. https://t.co/1rjeMooidj,95,46,11,5,2022-01-22,10,Saturday,6,106,51
1484834666129600514,2022-01-22 10:25:45,Park Shin Hye dan Choi Tae Joon telah melangsungkan pernikahan. Intip potret pre wedding pasangan artis Korea yang elegan bak putri dan pangeran. https://t.co/67T32pMvKp,18,1,3,0,2022-01-22,10,Saturday,6,21,1
1484834632902352896,2022-01-22 10:25:38,"Di ITC Mangga Dua ada kantin jajanan Pontianak yang viral di media sosial. Selain karena sosok penjual yang cetar, kantin ini juga terkenal memiliki menu enak. https://t.co/qsTDS3SZbf",9,2,3,1,2022-01-22,10,Saturday,6,12,3
1484833056380887041,2022-01-22 10:19:22,"Warga Kecamatan Sodonghilir, Tasikmalaya, Jawa Barat, mengalami keracunan massal. https://t.co/xemQ6KZ7Bt",9,0,2,0,2022-01-22,10,Saturday,6,11,0
1484832805884473347,2022-01-22 10:18:22,"Kabar duka datang dari cabang olahraga biliar. Salah satu atlet andalan Indonesia, Oei Kiem Han, meninggal dunia di usia yang ke-49 tahun. https://t.co/eLOYyKOTEb",11,0,2,1,2022-01-22,10,Saturday,6,13,1
1484831709535289344,2022-01-22 10:14:01,Pemotor tabrak anggota tim Patroli Perintis Polda Metro Jaya di Jakarta Utara ditangkap. Polisi turut sita sabu dari pelaku. https://t.co/73FaL8OnlB,8,1,1,0,2022-01-22,10,Saturday,6,9,1
1484831167434182659,2022-01-22 10:11:51,"Aiptu Siswanto, anggota polisi di Kabupaten Cianjur, Jawa Barat membeli sepeda motor matic dengan menggunakan uang koin pecahan Rp 1.000. https://t.co/4jqPxA9eHj",44,9,7,0,2022-01-22,10,Saturday,6,51,9
1484830910394552323,2022-01-22 10:10:50,"Truk kontainer mengalami rem blong mengakibatkan kecelakaan maut di Simpang Rapak, Balikpapan. KNKT menginvestigasi kecelakaan maut tersebut. https://t.co/yarKLrg3Sx",13,2,2,0,2022-01-22,10,Saturday,6,15,2
1484830175594487808,2022-01-22 10:07:55,Baru-baru ini Cristiano Ronaldo kesal usai ditarik keluar di laga MU dan bukan ini saja ia manyun saat diganti. Berikut foto-fotonya! https://t.co/CuwAXq0GjS,11,2,2,0,2022-01-22,10,Saturday,6,13,2
1484829050623434752,2022-01-22 10:03:27,Manajer (interim) Manchester United Ralf Rangnick mengungkap efek trauma yang dialami Victor Lindelof dan keluarga usai rumahnya kemalingan. https://t.co/NALJFfF4Ns,5,1,5,0,2022-01-22,10,Saturday,6,10,1
1484828376749809664,2022-01-22 10:00:46,Gubernur DKI Jakarta Anies Baswedan menjawab pertanyaan soal agenda maju jadi calon presiden pada Pilpres 2024 mendatang. https://t.co/R1B2Ts5K7f,8,6,2,1,2022-01-22,10,Saturday,6,10,7
1484827899790307330,2022-01-22 09:58:52,"Bali United resmi mengantongi Club Licensing Sertificate, sebagai salah satu syarat tampil di ajang kompetisi Asia 2022 mendatang. https://t.co/DpAdKjZD1z",12,0,2,0,2022-01-22,9,Saturday,6,14,0
1484827112448176131,2022-01-22 09:55:45,4 Orang korban tewas dan 30 orang luka berat hingga ringan akibat peristiwa nahas ini. https://t.co/vY4SnFqZtn,9,0,3,0,2022-01-22,9,Saturday,6,12,0
1484827111202471937,2022-01-22 09:55:44,Rencana keuangan untuk belanja kebutuhan sehari-hari mulai dari beras hingga sayuran sering jadi topik hangat.  https://t.co/Fv9QBUQAtq,6,1,5,1,2022-01-22,9,Saturday,6,11,2
1484827064242950145,2022-01-22 09:55:33,Panglima TNI Jenderal Andika Perkasa menunjuk Mayjen TNI Maruli Simanjuntak sebagai Pangkostrad. Berapakah harta kekayaan menantu Luhut Binsar Pandjaitan itu? https://t.co/WuUHVu5seq,15,4,6,5,2022-01-22,9,Saturday,6,21,9
1484826925516402691,2022-01-22 09:55:00,Gubernur DKI Anies Baswedan merespons pertanyaan terkait Ketum PSI Giring yang menyinggung proyek buatan Firaun saat menemui warga yang tergusur di sekitar JIS. https://t.co/OrgdcbUVqy,20,27,2,1,2022-01-22,9,Saturday,6,22,28
1484825912919183365,2022-01-22 09:50:59,Edy Mulyadi dilaporkan ke Polda Sulut atas tuduhan dugaan penghinaan terhadap Menhan Prabowo Subianto. DPD Gerindra Sulut tidak terima ketum mereka dihina. https://t.co/91tN6JodPl,266,121,37,24,2022-01-22,9,Saturday,6,303,145
1484825371862310914,2022-01-22 09:48:50,Rencana keuangan untuk belanja kebutuhan sehari-hari menjadi topik hangat dan menjadi perdebatan netizen!  https://t.co/NVTnRsqww0,13,0,3,0,2022-01-22,9,Saturday,6,16,0
1484824602362757120,2022-01-22 09:45:46,Risty Tagor kembali ke dunia hiburan yang sudah membesarkan namanya. Beberapa penampilannya kini menjadi sorotan. https://t.co/N4knVrif8B,26,19,1,1,2022-01-22,9,Saturday,6,27,20
1484824100749168645,2022-01-22 09:43:46,"Satpol PP Kota Tangerang Selatan menggerebek spa massage di Ruko Golden Boulevard, Serpong. Terapis tak berbusana hingga alat kontrasepsi ditemukan. https://t.co/ddThjxJ5Rh",25,22,6,1,2022-01-22,9,Saturday,6,31,23
1484823602629332992,2022-01-22 09:41:48,Herry Wirawan menyesali perbuatannya karena memperkosa 13 santriwati hingga hamil dan melahirkan. Penyesalan Herry itu akan ditanggapi oleh Jaksa. https://t.co/MpqbSl8k3c,17,30,5,6,2022-01-22,9,Saturday,6,22,36
1484822848535515138,2022-01-22 09:38:48,"Warung sate maranggi ini kena hujat netizen, karena diduga endorse Rachel Vennya. https://t.co/cSRQdV4yYU",10,2,2,2,2022-01-22,9,Saturday,6,12,4
1484822370468704264,2022-01-22 09:36:54,Ketua Umum Partai Kebangkitan Bangsa (PKB) Abdul Muhaimin Iskandar kembali dapat mandat dukungan untuk maju pada pilpres 2024. https://t.co/zOeuG2l72s,5,5,1,0,2022-01-22,9,Saturday,6,6,5
1484822103371272193,2022-01-22 09:35:50,Venezia bakal tetap siap melawan Inter Milan. I Lagunari tak mundur sekalipun ada lima pemain yang masuk daftar perjalanan dinyatakan positif COVID-19. https://t.co/N0qPq3J4aI,3,1,2,0,2022-01-22,9,Saturday,6,5,1
1484821306965217282,2022-01-22 09:32:40,"Koalisi militer yang dipimpin Arab Saudi membantah laporan bahwa mereka membombardir sebuah penjara di kota Saada, Yaman utara, yang menewaskan 70 orang. https://t.co/eB3JBYAS8t",9,1,6,0,2022-01-22,9,Saturday,6,15,1
1484821084008505347,2022-01-22 09:31:47,"Pep Guardiola akan memutuskan masa depannya di akhir musim. Tetapi, Guardiola tidak akan mengkhianati City. https://t.co/BPgW57zogK",5,0,1,2,2022-01-22,9,Saturday,6,6,2
1484820802507878400,2022-01-22 09:30:40,Petenis unggulan dua Daniil Medvedev menjejak babak 16 besar Australian Open 2022. Juga lolos adalah eks petenis putri nomor satu dunia Simona Halep. https://t.co/vQdNaszHOJ,6,0,0,0,2022-01-22,9,Saturday,6,6,0
1484820784837443584,2022-01-22 09:30:36,Propam Polri mengungkapkan arahan Kapolri kerap 'mandek' sampai pada level kapolres. Polri mengungkapkan arahan Kapolri yang tidak sampai ke tingkat bawah. https://t.co/VLhlXmvA9q,25,3,6,1,2022-01-22,9,Saturday,6,31,4
1484819763285090306,2022-01-22 09:26:32,Kepala BMKG Dwikorita Karnawati bicara mengenai pentingnya bangunan tahan gempa di lokasi rawan gempa. Simak penjelasannya. https://t.co/CHdML0fbHz,14,1,1,1,2022-01-22,9,Saturday,6,15,2
1484819291971194880,2022-01-22 09:24:40,Studi terbaru mengungkap hasil riset tiga dosis vaksin Sinovac untuk melawan virus Corona varian Omicron. Seperti ini klaim studi. https://t.co/b3tDkuTaT9,16,5,3,2,2022-01-22,9,Saturday,6,19,7
1484818518319280130,2022-01-22 09:21:36,Misi Manchester United tetap di jalur kemenangan akan diuji West Ham malam ini. Berikut ini adalah 10 data dan fakta menarik seputar pertandingan itu. Simak ya! https://t.co/iJtXI3sEiO,8,1,1,0,2022-01-22,9,Saturday,6,9,1
1484818016181309440,2022-01-22 09:19:36,"Nia Ramadhani dan Ardi Bakrie divonis setahun penjara terkait kasus narkoba. Setelahnya, muncul petisi dukungan yang dibuat oleh teman-teman mereka. https://t.co/iDuxvUq9CE",17,4,2,1,2022-01-22,9,Saturday,6,19,5
1484817488491782146,2022-01-22 09:17:30,"Drama Vicky Prasetyo dan Kalina Oktarani masih terus berlanjut. Kini, Vicky seperti memberi kode sudah menemukan tambatan hati baru. https://t.co/30LM6pCPsI",12,9,1,1,2022-01-22,9,Saturday,6,13,10
1484816596304596993,2022-01-22 09:13:57,"Sebelum menjadi politisi, Putut berprofesi sebagai wartawan. Di partai, Putut menjabat Wakil Ketua DPC PDIP Solo dan Sekretaris Fraksi PDIP di DPRD Solo. https://t.co/U7ycI7hmRK",8,0,0,0,2022-01-22,9,Saturday,6,8,0
1484815271118483456,2022-01-22 09:08:41,"Viral seorang wanita mengalami hal memilukan. Sebuah gunting bedah tertinggal di perutnya selama 20 tahun, apa jadinya? https://t.co/TkLEj7qTcY",8,0,1,0,2022-01-22,9,Saturday,6,9,0
1484814457310171138,2022-01-22 09:05:27,Tasya Farasya dikenal karena kemampuan bermakeupnya. Ibu satu orang anak itu juga beberapa kali terlihat berdandan menirukan seleb luar negeri. Seperti apa? https://t.co/NACm6NSdRe,16,1,3,1,2022-01-22,9,Saturday,6,19,2
1484813369014202369,2022-01-22 09:01:08,"Seorang dokter cantik harus ikhlas setelah diselingkuhi sang suami ketika hamil. Mendengar ini, sang ayah langsung membela sekuat tenaga. Simak kisahnya, yuk! #detiknetwork  https://t.co/ZhXFVMQPyU",40,14,6,4,2022-01-22,9,Saturday,6,46,18
1484811503618478089,2022-01-22 08:53:43,Priyanka Chopra dan Nick Jonas dikaruniai anak pertama setelah tiga tahun menikah. Bayi mereka lahir melalui rahim pengganti. https://t.co/2FTGtZTqW6,24,3,1,1,2022-01-22,8,Saturday,6,25,4
1484810252172374017,2022-01-22 08:48:45,"Saat terinfeksi Omicron, memulihkan imunitas tubuh adalah kunci penyembuhan utama. Hindari juga 4 kebiasaan minum ini yang bakal memperparah gejala Omicron. https://t.co/TSDQcBePha",16,0,3,0,2022-01-22,8,Saturday,6,19,0
1484809240791470080,2022-01-22 08:44:44,Kebijakan ganjil genap di tiga kawasan wisata di DKI Jakarta masih berlaku. Jangan sampai putar balik ya! https://t.co/SZBKCgDJvT,10,0,2,0,2022-01-22,8,Saturday,6,12,0
1484808235597152259,2022-01-22 08:40:44,"Samsung Galaxy A03 resmi hadir di Indonesia. Ponsel entry level ini dibanderol dengan harga murah, apa saja spesifikasinya? https://t.co/L09nKaPSWW",12,2,1,0,2022-01-22,8,Saturday,6,13,2
1484806938152128512,2022-01-22 08:35:35,"#FOTO Pemindahan #IKN ke Kalimantan Timur kian serius. Pembangunan IKN akan segera dimulai, menyusul disahkannya Undang-undang Ibu Kota Negara. https://t.co/WHXkqhCzgB",17,6,5,0,2022-01-22,8,Saturday,6,22,6
1484805849591787524,2022-01-22 08:31:15,Ibu Kota Negara (IKN) baru sejatinya bukan hal asing. Myanmar dan Malaysia melakukannya lebih dulu namun nasib keduanya sangat berbeda. https://t.co/MHfy8Kgh3L,9,9,3,2,2022-01-22,8,Saturday,6,12,11
1484803656662802434,2022-01-22 08:22:32,Satpom Lanud Roesmin Nurjadin Riau mendalami keterlibatan oknum anggota Koptu Wn terkait kasus narkoba. Koptu Wn tengah diperiksa intensif. https://t.co/tJR0eZRtbY,7,0,1,0,2022-01-22,8,Saturday,6,8,0
1484803476538462209,2022-01-22 08:21:49,"Pengemudi Daihatsu Ayla menjadi salah satu korban kecelakaan truk kontainer di Balikpapan, Kalimantan Timur, Jumat (21/1/2022). https://t.co/enbZBmErpe",30,1,8,2,2022-01-22,8,Saturday,6,38,3
1484802324203778054,2022-01-22 08:17:15,Seorang pemotor ditangkap petugas di daerah Jakarta Utara. Pemotor itu ditangkap usai menabrak anggota Patroli Perintis Presisi Polda Metro Jaya https://t.co/7fgD08y0lx,12,2,1,0,2022-01-22,8,Saturday,6,13,2
1484801222670532608,2022-01-22 08:12:52,"Sebagai kekasih dari Cristiano Ronaldo, apakah Georgina Rodriguez juga menggemari olahraga itu? Seringkah ia ngobrol soal bola dengan CR7? https://t.co/HN3A8tNSZE",12,4,1,3,2022-01-22,8,Saturday,6,13,7
1484800225558548481,2022-01-22 08:08:54,"Patah hati terhadap Indonesia? ""Iya, it broke my heart,"" kata Nadine Kaiser, sang pengawal Susi Air, putri Susi Pudjiastuti. Simak kisahnya di sini:  https://t.co/q1iP3ApUbS",23,1,5,0,2022-01-22,8,Saturday,6,28,1
1484799419644002307,2022-01-22 08:05:42,Pengadilan militer Myanmar menjatuhkan hukuman mati terhadap seorang anggota partai Aung San Suu Kyi karena pelanggaran teror. https://t.co/TFd7cxUovK,14,1,2,0,2022-01-22,8,Saturday,6,16,1
1484798923583762440,2022-01-22 08:03:44,"Pada awal tahun 2022, pemerintah memberlakukan PPnBM DTP (Pajak Penjualan atas Barang Mewah Ditanggung Pemerintah) 100% untuk mobil LCGC. https://t.co/16NTn85k3j",3,1,1,0,2022-01-22,8,Saturday,6,4,1
1484797469284356097,2022-01-22 07:57:57,"Pengemudi mobil Honda Civic inisial AL (21) menabrak empat kendaraan di Jakarta Pusat, dini hari tadi. Pelaku diketahui sempati ingin kabur dari lokasi. https://t.co/3w2jbZA9uN",14,3,2,1,2022-01-22,7,Saturday,6,16,4
1484796507052253186,2022-01-22 07:54:08,"Saksi mata mengungkap momen pemotor berpakaian mirip seragam sekolah melawan arah di Jalan Jogja-Solo, Kecamatan Prambanan, Klaten, Jawa Tengah yang viral. https://t.co/bKRPbHx46b",8,3,2,1,2022-01-22,7,Saturday,6,10,4
1484795423432880130,2022-01-22 07:49:49,Seorang perwira senior kepolisian Inggris dibui 3 tahun setelah tertangkap menggunakan kamera pengintai tersembunyi untuk merekam wanita-wanita telanjang. https://t.co/boP2Ytf1qO,16,3,4,1,2022-01-22,7,Saturday,6,20,4
1484794007536521216,2022-01-22 07:44:12,Sebanyak 63 warga Sodonghilir Tasikmalaya keracunan makanan usai menghadiri hajatan tetangga mereka. Satu orang warga meninggal meninggal dunia. https://t.co/xbGQxkbxcN,11,1,1,1,2022-01-22,7,Saturday,6,12,2
1484792933907845124,2022-01-22 07:39:56,Salah satu mobil milik anggota DPR Arteria Dahlan yang terparkir di parkiran DPR RI tercatat menunggak pembayaran pajak hingga Rp 10 juta. Bapenda DKI mengecek. https://t.co/pTqEMWEk5X,34,11,8,8,2022-01-22,7,Saturday,6,42,19
1484791671590162433,2022-01-22 07:34:55,"Warga Pangandaran punya wisata baru nih untuk  keluarga! Datang saja ke Zeround Park, kebun binatang yang berisi puluhan reptil lokal hingga dunia lho. https://t.co/rlzfKPJigf",11,2,5,0,2022-01-22,7,Saturday,6,16,2
1484790931723370501,2022-01-22 07:31:58,"#FOTO  Tak hanya kaya akan budaya, Indonesia juga kaya akan harta karun, yaitu sumber daya alam berupa logam tanah jarang. https://t.co/SzG37KlGEX",8,1,3,3,2022-01-22,7,Saturday,6,11,4
1484790436787109888,2022-01-22 07:30:00,Han So Hee saat zaman sekolah ini bikin netizen gagal fokus. Ini dia pesona Han So Hee:  https://t.co/oqoGhyQiDS,9,0,0,0,2022-01-22,7,Saturday,6,9,0
1484789069041352707,2022-01-22 07:24:34,"""Beliau kan mantan Danpaspampres sehingga sudah terbiasa bergaul dengan Presiden Jokowi,"" kata anggota Komisi I Fraksi PPP DPR RI, Syaifullah Tamliha. https://t.co/HK5sO2wwuA",5,0,0,0,2022-01-22,7,Saturday,6,5,0
1484788326347550720,2022-01-22 07:21:37,"Mengikuti ibadah umrah di tengah pandemi Covid-19 tentu harus mengikuti sejumlah ketentuan. Berikut laporannya, langsung dari Makkah https://t.co/hr2o1qEFMY",5,0,4,1,2022-01-22,7,Saturday,6,9,1
1484787044564017152,2022-01-22 07:16:32,Jessica Iskandar atau Jedar membuat heboh karena video sedang joget di kamar mandi dalam kondisi hamil besar. Berikut 5 pose Jedar saat hamil: https://t.co/PfVB2LM44f,12,7,2,1,2022-01-22,7,Saturday,6,14,8
1484786550613364738,2022-01-22 07:14:34,Nama Celine Evangelista ikut terseret kisruh rumah tangga Vicky Prasetyo dan Kalina Oktarani. Ia disebut-sebut sebagai orang ketiga di pernikahan tersebut. https://t.co/7j3S7aRUiM,7,3,0,0,2022-01-22,7,Saturday,6,7,3
1484785821970583556,2022-01-22 07:11:40,Rhoma Irama dan Yati Octavia pernah dikabarkan pacaran. Sang Raja Dangdut pun akhirnya menjelaskan kabar tersebut. https://t.co/vh2n4MYey1,4,5,1,2,2022-01-22,7,Saturday,6,5,7
1484785069705285633,2022-01-22 07:08:41,Bisnis jasa curhat online kian marak. Pernah menggagalkan upaya bunuh diri pasien yang sedang galau.  https://t.co/sKsFYigMMG,11,2,3,0,2022-01-22,7,Saturday,6,14,2
1484784805451608069,2022-01-22 07:07:38,Maruli adalah Dan Grup 2 Kopassus saat sejumlah anggotanya menyerbu Lapas Cebongan. Apa keputusannya saat itu? Simak pula perkenalannya dengan putri Luhut. https://t.co/4J3KxNJCal,8,1,2,1,2022-01-22,7,Saturday,6,10,2
1484783172948832257,2022-01-22 07:01:09,Foto-foto koruptor tersebut dijual di platform OpenSea dalam sebuah koleksi yang mengatasnamakan lembaga antirasuah Komisi Pemberantasan Korupsi (KPK). #CNNIndonesia #detiknetwork  https://t.co/FlWCjheMbj,41,9,6,3,2022-01-22,7,Saturday,6,47,12
1484783084654538754,2022-01-22 07:00:47,Kombes Riko Sunarko dicopot dari jabatannya sebagai Kapolrestabes Medan buntut kasus dugaan suap dari bandar narkoba. Irwasda Polda Sumut mengisi posisi Riko. https://t.co/STKrrZjfft,13,2,6,0,2022-01-22,7,Saturday,6,19,2
1484782431341322242,2022-01-22 06:58:12,Wali Kota Solo Gibran Rakabuming buka suara soal suntikan modal Rp 71 miliar ke Goola. Bisnis es doger Gibran disuntik JWC Ventures pada 2019. https://t.co/4CAB02IMOu,18,8,4,3,2022-01-22,6,Saturday,6,22,11
1484781404537991168,2022-01-22 06:54:07,"Tragisnya kecelakaan truk di Muara Rapak, Balikpapan, Kalimantan Timur pada Jumat (21/1) kemarin, menyoroti peran yang terlibat dalam transportasi niaga. https://t.co/MLB2K6E02N",8,2,3,0,2022-01-22,6,Saturday,6,11,2
1484780360235892736,2022-01-22 06:49:58,"Pelaku utama pengeroyokan kepada Pratu Sahdi hingga meninggal dunia ditangkap. Pelaku bernama Baharudin ditangkap pada Selasa (18/1) saat bersembunyi di Dermaga Kepiting Pelabuhan Muara Baru, Jakarta. https://t.co/mQK1Eyiqd0",5,2,1,2,2022-01-22,6,Saturday,6,6,4
1484779620364869633,2022-01-22 06:47:02,"Ayah mendiang Upin dan Ipin di Palu, yang makamnya viral mengakui nama kedua putranya memang terinspirasi dari animasi Upin dan Ipin Malaysia. https://t.co/qcXyGpOHjI",8,0,2,2,2022-01-22,6,Saturday,6,10,2
1484779121519611907,2022-01-22 06:45:03,"Firdaus Oiwobo, kuasa hukum Tiara Marleen, merasa curiga. Laporan Emma Waroka tersebut dinilai memiliki cacat hukum. https://t.co/auj8uqBCt4",8,1,0,0,2022-01-22,6,Saturday,6,8,1
1484778365265584129,2022-01-22 06:42:02,Sudah tahu belum rute dan tarif KRL Jabodetabek terkini? Simak informasinya berikut ini. https://t.co/GoYc6rdjvL,15,0,2,3,2022-01-22,6,Saturday,6,17,3
1484777329884868609,2022-01-22 06:37:55,Nadzira Shafa buka-bukaan pada pengikutnya di Instagram. Dia mengaku sempat hamil anak Ameer Azzikra. https://t.co/HpNXEtQdeE,4,0,0,0,2022-01-22,6,Saturday,6,4,0
1484776304423706625,2022-01-22 06:33:51,Kapolda Sumut Irjen RZ Panca Putra Simanjuntak menyebut dokter G yang menyuntikkan vaksin kosong ke siswa SD bisa dijerat pidana. https://t.co/xfQVfY8M12,27,15,5,1,2022-01-22,6,Saturday,6,32,16
1484775499884810241,2022-01-22 06:30:39,"Agar model cincin tunangan tidak ketinggalan zaman, berikut ini beberapa model cincin tunangan simple dan elegan 2022 yang bisa dijadikan inspirasi. #wedding #engagement  https://t.co/FAdzTMwGhH",5,1,1,4,2022-01-22,6,Saturday,6,6,5
1484773926957948928,2022-01-22 06:24:24,Jabatan Pangkostrad dua bulan lebih mengalami kekosongan selepas Jenderal Dudung Abdurachman menjabat KSAD. Setelah kekosongan itu akhirnya Panglima TNI Jenderal Andika Perkasa menunjuk Mayjen TNI Maruli Simanjuntak. https://t.co/hguM5WP9QO,8,4,2,1,2022-01-22,6,Saturday,6,10,5
1484773912194039808,2022-01-22 06:24:21,"Sebuah mobil Honda Civic terlibat kecelakaan di Jalan Sudirman, Jakarta Pusat, dini hari tadi. Polisi menyebut pengemudi mobil itu dalam keadaan mabuk. https://t.co/PQnLOol5KL",15,3,4,3,2022-01-22,6,Saturday,6,19,6
1484773166581006341,2022-01-22 06:21:23,Dispendukcapil Magetan angkat bicara soal terbitnya akta kematian Suparlan yang ternyata masih hidup. Dispendukcapil mengaku sudah bekerja sesuai prosedur. https://t.co/VLlsXAbSKj,11,10,2,1,2022-01-22,6,Saturday,6,13,11
1484772602245697547,2022-01-22 06:19:08,"Australia berhasil membantai Indonesia 18-0 di Piala Asia Wanita 2022. Samantha Kerr mencetak 5 gol di laga tersebut, serta mencatat rekor untuk negaranya. https://t.co/HrTdxyb8YJ",14,2,3,0,2022-01-22,6,Saturday,6,17,2
1484771805848121346,2022-01-22 06:15:58,"Cristiano Ronaldo bicara kisahnya jatuh cinta dengan Georgina Rodriguez. Sejak awal jumpa, Georgina sudah bikin Ronaldo mabuk kepayang sampai terbayang-bayang. https://t.co/R9z8rAkuYv",22,2,3,1,2022-01-22,6,Saturday,6,25,3
1484771790589251586,2022-01-22 06:15:55,"Polisi menetapkan pelaku penjambretan HP salah satu bocah di Pamulang, Tangerang Selatan, sebagai tersangka. Saat ini pelaku sudah ditahan di Polsek Pamulang. https://t.co/uCVqKYQ5j9",7,0,1,0,2022-01-22,6,Saturday,6,8,0
1484770793489846276,2022-01-22 06:11:57,Publik belum lama ini dihebohkan dengan video syur yang diduga mirip Nagita Slavina. Sosok asli yang ada di video pun akhirnya terungkap! https://t.co/OFdSSwNBEK,5,0,1,0,2022-01-22,6,Saturday,6,6,0
1484769552961527814,2022-01-22 06:07:01,Kristina Ozturk merupakan wanita berusia 24 tahun yang memiliki 22 anak. Ini sosok Kristina yang kisahnya punya 22 anak di usia muda membuat penasaran. https://t.co/A8WeKmOVXD,55,6,19,9,2022-01-22,6,Saturday,6,74,15
1484768089753501696,2022-01-22 06:01:12,"Arteria Dahlan bicara ujug-ujug viral di media sosial dan disindir oleh budayawan Jawa Barat, Budi Dalton. Dijelaskan bahwa ujug-ujug merupakan bahasa Sunda. https://t.co/TYbcAs5zuj",53,17,8,2,2022-01-22,6,Saturday,6,61,19
1484767132718141441,2022-01-22 05:57:24,PT KAI Daop 8 #Surabaya masih menyediakan tes antigen bagi calon penumpang yang melakukan perjalanan jarak jauh. Tarif untuk layanan ini seharga Rp 35.000. https://t.co/9b1YhUHf0R,3,0,1,0,2022-01-22,5,Saturday,6,4,0
1484766139632730118,2022-01-22 05:53:27,"Kisah seorang sekuriti yang dipecat, karna dipecat justru menjadi selebriti tiktok. #viraldetikcom #tiktok https://t.co/TMT1WCfXE8",21,3,1,1,2022-01-22,5,Saturday,6,22,4
1484764730988367876,2022-01-22 05:47:52,"Kawasan rumah di Tegal Alur, Kalideres, Jakarta Barat (Jakbar) masih dilanda banjir. Terhitung sudah lima hari banjir wilayah ini belum kunjung surut. https://t.co/C92aC94DPy",19,22,7,9,2022-01-22,5,Saturday,6,26,31
1484763686380216321,2022-01-22 05:43:43,Menparkraf Sandiaga Uno meninjau kesiapan pelaksanaan travel bubble di Batam dan Kepulauan Riau. Dia mengunjungi Pelabuhan Nongsapura. https://t.co/I5MKWBLkBx,8,1,1,0,2022-01-22,5,Saturday,6,9,1
1484762410099560456,2022-01-22 05:38:38,#FOTO  Mayjen TNI Maruli Simanjuntak ditunjuk menjadi Panglima Komando Cadangan Strategis Angkatan Darat (Pangkostrad). Siapakah Maruli Simanjuntak? https://t.co/vuj28ceWol,22,6,3,1,2022-01-22,5,Saturday,6,25,7
1484761092026998784,2022-01-22 05:33:24,"Peluncuran tim Ducati untuk #MotoGP2022 dipastikan mundur hingga bulan depan. Hal ini disebabkan salah satu pebalap mereka, Jack Miller terinfeksi COVID-19. https://t.co/XSmsnLJBlW",13,1,2,0,2022-01-22,5,Saturday,6,15,1
1484760525040979969,2022-01-22 05:31:09,Virus COVID-19 varian Omicron sudah masuk ke Jawa Tengah. Hal itu diketahui paska keluarnya hasil whole genome sequencing (WGS) di berbagai daerah di Jateng. https://t.co/eYeMAkDrEy,43,34,18,12,2022-01-22,5,Saturday,6,61,46
1484759786059182083,2022-01-22 05:28:13,Mayjen TNI Maruli Simanjuntak ditunjuk menjadi Panglima Komando Cadangan Strategis Angkatan Darat (Pangkostrad). Siapakah Maruli Simanjuntak? https://t.co/YQRUoWMi48,14,1,3,1,2022-01-22,5,Saturday,6,17,2
1484759291890446337,2022-01-22 05:26:15,Wali Kota Depok Mohammad Idris menyebut sumur resapan efektif mencegah terjadinya banjir di Depok. Kenapa? https://t.co/VwTaj0OJsY,17,3,7,2,2022-01-22,5,Saturday,6,24,5
1484757788798636034,2022-01-22 05:20:16,"Polisi menangkap beberapa orang jambret yang merampas barang milik warga di Binjai, Sumatera Utara (Sumut). https://t.co/o0Hwjm6R70",4,0,2,0,2022-01-22,5,Saturday,6,6,0
1484757534422536192,2022-01-22 05:19:16,"Polisi mengungkap alasan sopir tronton maut di Balikpapan, M Ali (47), tak banting setir sebelum menabrak sejumlah kendaraan. Ini alasannya.. https://t.co/2mirNVlScl",78,30,26,10,2022-01-22,5,Saturday,6,104,40
1484756174612451330,2022-01-22 05:13:52,Putri Fadzilah dari Bruine Darussalam mengadakan perayaan pernikahan selama 10 hari. Sebelumnya sosok Putri Fadzilah tidak terlalu banyak disorot publik. https://t.co/RJBfp9BnBv,32,5,5,2,2022-01-22,5,Saturday,6,37,7
1484754396655325186,2022-01-22 05:06:48,"BMKG memutakhirkan gempa bumi di Kabupaten Melonguane, Sulut menjadi magnitudo 6. BMKG menyatakan gempa tersebut akibat aktivitas sesar. https://t.co/XRVOoqgOgM",5,0,2,1,2022-01-22,5,Saturday,6,7,1
1484752967328804864,2022-01-22 05:01:07,Kecelakaan maut yang melibatkan truk tonton terjadi di Balikpapan. Korlantas Polri serius menangani truk over dimension over loading (ODOL). https://t.co/5yZT9ACa57,15,3,6,1,2022-01-22,5,Saturday,6,21,4
1484751891112382464,2022-01-22 04:56:50,"Seorang pemotor tewas usai mengalami kecelakaan lalu lintas di Gunung Putri, Kabupaten Bogor. Pemotor tewas setelah terlindas truk dan tertabrak mobil.  https://t.co/f4j0zdJCBn",11,0,2,3,2022-01-22,4,Saturday,6,13,3
1484751632730660865,2022-01-22 04:55:49,Anggota TNI gadungan ditangkap di Jakarta Timur. Pelaku berpura-pura sebagai anggota TNI agar bisa menikahi janda. https://t.co/lf8GQC7tri,14,1,6,4,2022-01-22,4,Saturday,6,20,5
1484751613583577096,2022-01-22 04:55:44,"El Salvador bikin kejutan karena menjadi negara pertama yang melegalkan Bitcoin sebagai alat pembayaran yang sah. Namun negara itu malah terancam kolaps!
 https://t.co/5O3vC3DsP6",14,1,6,2,2022-01-22,4,Saturday,6,20,3
1484750459466305541,2022-01-22 04:51:09,"Kota Miura adalah seorang petarung MMA Jepang yang belakangan sedang viral. Selain karena laganya, Kora diperbincangkan karena visualnya yang mirip artis Korea. https://t.co/y8LGczxQYS",5,0,0,2,2022-01-22,4,Saturday,6,5,2
1484750446342324226,2022-01-22 04:51:06,"Akibat hujan lebat tower SUTT 150 KV No 107 di Tanjung Sakti, Sumatera Selatan, roboh akibat longsor. Akibatnya, listrik di 2 kabupaten di Bengkulu mati. https://t.co/KoL493mOeL",5,0,2,0,2022-01-22,4,Saturday,6,7,0
1484748387241107456,2022-01-22 04:42:55,"Isu panasnya hubungan Ganjar Pranowo dengan Puan Maharani kembali mencuat. Kali ini, Ganjar lagi-lagi absen saat Puan Maharani meresmikan Pasar Legi Solo. https://t.co/hGFZV3xc74",43,33,5,4,2022-01-22,4,Saturday,6,48,37
1484747797245083651,2022-01-22 04:40:34,Sebanyak 164 Pekerja Migran Indonesia (PMI) akan pulang ke Jawa Timur. Mereka datang melalui Bandara Juanda. https://t.co/6UbbiTUq19,7,0,2,1,2022-01-22,4,Saturday,6,9,1
1484747795990986754,2022-01-22 04:40:34,Kapolrestabes Medan Kombes Riko Sunarko dicopot untuk menjalani pemeriksaan di Polda Sumut terkait dugaan suap bandar narkoba. Begini duduk perkaranya. https://t.co/J3ZvU4Uinr,27,2,3,1,2022-01-22,4,Saturday,6,30,3
1484746395861012480,2022-01-22 04:35:00,"Kontak tembak dengan teroris KKB terjadi di Kiwirok, Pegunungan Bintang, Papua. Satu anggota Satgas Damai Cartenz dari Brimob kena tembak KKB. https://t.co/IO3mdtpabB",10,5,3,1,2022-01-22,4,Saturday,6,13,6
1484745310094176261,2022-01-22 04:30:41,DarkTracer kembali beberkan kebocoran data Bank Indonesia. Jumlah data dan PC yang diretas Conti Ransomware diduga lebih banyak dari yang diumumkan sebelumnya. https://t.co/9XyCE9rHCl,37,4,16,4,2022-01-22,4,Saturday,6,53,8
1484744033473863680,2022-01-22 04:25:37,"Menjadi salah satu organ vital, kesehatan hati perlu terus dijaga. Empat minuman enak ini dikatakan ampuh untuk bersihkan hati secara alami. https://t.co/eHAE13oblT",21,1,4,2,2022-01-22,4,Saturday,6,25,3
1484742774650019840,2022-01-22 04:20:37,Penulis web series Layangan Putus sehari-hari bekerja sebagai dokter hewan. Lalu bagaimana kisahnya hingga ia bisa membuat cerita Layangan Putus? https://t.co/qcgnxfX8rW,28,0,3,1,2022-01-22,4,Saturday,6,31,1
1484741479348252677,2022-01-22 04:15:28,"Berlian hitam yang luar biasa, siap dilelang dan akan menjadi milik penawar tertinggi. Apa keistimewaannya? Berlian ini berasal dari luar angkasa. https://t.co/bQhODkPQzN",38,3,10,0,2022-01-22,4,Saturday,6,48,3
1484740230037090304,2022-01-22 04:10:30,"Panglima TNI Jenderal Andika Perkasa menunjuk Mayjen Agus Subiyanto sebagai Wakasad. Tercatat di LHKPN, Agus memiliki harta Rp 714 juta. https://t.co/JrNbdGPka8",19,5,0,1,2022-01-22,4,Saturday,6,19,6
1484740221984022530,2022-01-22 04:10:28,Tebak-tebakan ini belum tentu bisa dijawab oleh orang cerdas sekalipun. Coba pecahkan teka-teki receh ini sambil melatih otak. https://t.co/E0VCSYX8d0,107,123,13,1,2022-01-22,4,Saturday,6,120,124
1484739191846150144,2022-01-22 04:06:23,"Seorang pria bernama Agus Haryanto ditangkap di daerah Jatinegara, Jakarta Timur. Agus ditangkap usai mengaku sebagai anggota TNI. https://t.co/ELg7sLGH9p",7,1,3,0,2022-01-22,4,Saturday,6,10,1
1484738196281954311,2022-01-22 04:02:25,Sebuah bom mobil meledak di daerah konflik kelompok-kelompok bersenjata di Kolombia Timur. Satu orang dinyatakan tewas dalam peristiwa tersebut. https://t.co/fjDHFY3ddr,7,3,1,0,2022-01-22,4,Saturday,6,8,3
1484737701870018566,2022-01-22 04:00:27,"Ada beberapa shio yang diprediksi ahli akan kurang beruntung di Tahun Macan Air ini, Bunda. Kira-kira shio mana saja, ya? Simak selengkapnya di sini, yuk! #detiknetwork  https://t.co/mpiLDMj68B",7,3,1,2,2022-01-22,4,Saturday,6,8,5
1484736655714324486,2022-01-22 03:56:18,"Tahun baru Imlek 2022 akan segera tiba. Dalam menyambut perayaan tersebut, para wanita Tionghoa biasanya mengenakan baju khas China yang disebut cheongsam. 

https://t.co/yqr2ZDYr8h",7,1,0,0,2022-01-22,3,Saturday,6,7,1
1484736204499304448,2022-01-22 03:54:30,"Eks Ketua BUMDes Amarta, Desa Patas, Bali bernama Hernawati ditetapkan sebagai tersangka dugaan korupsi oleh Kejari Buleleng. Hernawati korupsi ratusan juta. https://t.co/Wf9wgNiLBI",18,0,1,1,2022-01-22,3,Saturday,6,19,1
1484735179713392645,2022-01-22 03:50:26,"#TMII jadi perbincangan netizen karena kondisi bangunan yang terlihat terbengkalai. Namun, inilah fakta yang sebenarnya: https://t.co/MEas0b3Ly4",5,2,0,0,2022-01-22,3,Saturday,6,5,2
1484733835820548102,2022-01-22 03:45:06,Seorang guru Madrasah Diniyah (Madin) Pasuruan dibegal bandit bersenjata bondet. Motor korban berhasil dibawa kabur pelaku.  https://t.co/3C8iqCgZLR,9,1,2,0,2022-01-22,3,Saturday,6,11,1
1484732223945428995,2022-01-22 03:38:41,#Terpopuler Sempat heboh seorang dokter berhasil mencangkokkan jantung babi ke manusia di Amerika Serikat. Ini kata Ustaz:  https://t.co/IAZg0yfTe9,14,4,2,0,2022-01-22,3,Saturday,6,16,4
1484730896309702658,2022-01-22 03:33:25,Pakar keselamatan berkendara menyoroti kompetensi sopir yang membawa kendaraan besar tersebut. Kenapa sopir tak banting setir ke kiri? https://t.co/8Vi0FZo2Q2,36,21,4,2,2022-01-22,3,Saturday,6,40,23
1484729019488780289,2022-01-22 03:25:57,"Hujan deras yang mengguyur wilayah Kabupaten Cirebon, mengakibatkan Sungai Ciberes meluap dan merendam tiga desa sejak Sabtu Subuh. https://t.co/PhJ5wmDKHL",12,0,3,0,2022-01-22,3,Saturday,6,15,0
1484727866415845378,2022-01-22 03:21:22,Pemerintah berencana menghapus tenaga honorer pada 2023. Sementara saat ini jumlah tenaga honorer mencapai 400 ribu orang. Gimana nasib mereka? https://t.co/BUQNmPdNsH,20,6,1,4,2022-01-22,3,Saturday,6,21,10
1484726559902781442,2022-01-22 03:16:11,Detik-detik megerikan kecelakaan Balikpapan yang menunjukkan truk bermuatan kontainer seberat 20 ton menyeruduk sejumlah kendaraan di depannya viral. https://t.co/5ZjBkFliYu,27,0,3,1,2022-01-22,3,Saturday,6,30,1
1484726414612045824,2022-01-22 03:15:36,"Gempa berkekuatan magnitudo (M) 6,1 mengguncang Melonguane, Sulawesi Utara (Sulut). Berdasarkan catatan BMKG, gempa dirasakan cukup kuat. https://t.co/uiEcANKw60",18,0,4,0,2022-01-22,3,Saturday,6,22,0
1484726228921864192,2022-01-22 03:14:52,"Geger dokter berinisial G menyuntik vaksin kosong saat pelaksanaan vaksinasi anak. Kemenkes RI ikut buka suara, ini penegasannya. https://t.co/Xyxw8rA5Mp",12,3,0,1,2022-01-22,3,Saturday,6,12,4
1484724475572723715,2022-01-22 03:07:54,"Australia berhasil membantai Indonesia 18-0 di Piala Asia Wanita 2022. Samantha Kerr mencetak 5 gol di laga tersebut, serta mencatat rekor untuk negaranya. https://t.co/tt3K4lAnma",14,4,0,0,2022-01-22,3,Saturday,6,14,4
1484723951473500162,2022-01-22 03:05:49,Tim Maung Galunggung Polres Tasikmalaya Kota mengamankan belasan remaja yang hendak tawuran gegara pertandingan futsal. https://t.co/fNZ07ngvFL,6,1,1,0,2022-01-22,3,Saturday,6,7,1
1484723502976573443,2022-01-22 03:04:02,Anies menanggapi inspeksi PSI dengan menyebut waktu mereka longgar betul. Namun ternyata saling balas antara #AniesBaswedan dan #PSI belum tuntas. https://t.co/G6qokjfnTd,13,18,1,2,2022-01-22,3,Saturday,6,14,20
1484723201217376257,2022-01-22 03:02:50,"Selain menunjuk Mayjen Maruli Simanjuntak sebagai Pangkostrad, Panglima TNI Jenderal Andika Perkasa juga menunjuk Mayjen Agus Subiyanto sebagai Wakasad. https://t.co/xX2tYkhVhf",8,0,2,0,2022-01-22,3,Saturday,6,10,0
1484722454220132354,2022-01-22 02:59:52,"Aturan ganjil genap kembali diberlakukan di Kota Bogor. Sesuai tanggal, maka hanya kendaraan bernopol genap yang boleh melintas hari ini. ##gag #bogor  https://t.co/kL25Uhkiie",10,1,2,0,2022-01-22,2,Saturday,6,12,1
1484721811925446663,2022-01-22 02:57:19,Transplantasi jantung babi ke manusia untuk pertama kalinya jadi terobosan di dunia medis. Ini Muhammad Mohiuddin sosok di balik itu:  https://t.co/VG28Bs2c1G,56,7,14,6,2022-01-22,2,Saturday,6,70,13
1484720330383974400,2022-01-22 02:51:26,Minyak goreng setelah harganya dipatok Rp 14.000/liter justru malah banyak yang kosong di minimarket. Apa nih biang keroknya? https://t.co/ihz9dqPI2F,28,16,6,8,2022-01-22,2,Saturday,6,34,24
1484719034662891521,2022-01-22 02:46:17,"Rumah tangganya sempat dikabarkan retak, Shandy Aulia terlihat bersama lagi dengan sang suami. Ini alasan Shandy soal kembali dengan sang suami:  https://t.co/98rjfOgRw5",13,1,0,0,2022-01-22,2,Saturday,6,13,1
1484717452990853122,2022-01-22 02:40:00,Timnas Malaysia resmi menunjuk Kim Pan-gon sebagai pelatih anyar. Pria Korea Selatan itu pernah mendepak Shin Tae-yong dari kursi pelatih Taeguk Warriors. https://t.co/no67ROWWes,10,2,0,2,2022-01-22,2,Saturday,6,10,4
1484715657124061189,2022-01-22 02:32:51,"Warga ibukota Jakarta, ada info lokasi sentra vaksin booster lagi nih. Sekarang lokasinya di mal loh. Yuk, kunjungi sekarang biar bisa menangkal Omicron. https://t.co/keXuxRHtp5",11,1,1,0,2022-01-22,2,Saturday,6,12,1
1484714171732467712,2022-01-22 02:26:57,Panglima TNI Jenderal Andika Perkasa menunjuk Mayjen TNI Maruli Simanjuntak sebagai Pangkostrad. Berapakah harta kekayaan menantu Luhut Binsar Pandjaitan itu? https://t.co/YQZ8iwklKr,36,16,7,6,2022-01-22,2,Saturday,6,43,22
1484712593562513410,2022-01-22 02:20:41,PDIP Jawa Barat menanggapi dingin soal gema tagar #SundaTanpaPDIP yang sempat menjadi trending topik di twitter. Hal itu dianggap dinamika politik. https://t.co/XEId1NNUqH,26,16,3,3,2022-01-22,2,Saturday,6,29,19
1484712592492933126,2022-01-22 02:20:41,Giring PSI mengunjungi warga gusuran di sekitar JIS sambil menyinggung pernyataan proyek buatan firaun. Gerindra bertanya balik apa yang telah dilakukan Giring. https://t.co/md7IwRsewO,80,43,12,7,2022-01-22,2,Saturday,6,92,50
1484711099886886913,2022-01-22 02:14:45,Deepika Padukone menerima tantangan mesra dengan Siddhant Chaturvedi di film Gehraiyaan. Film ini jadi proyek paling beda buat sang bintang Bollywood.  https://t.co/4FVgsfc4sj,4,0,1,0,2022-01-22,2,Saturday,6,5,0
1484707994688536578,2022-01-22 02:02:25,Detik-detik megerikan kecelakaan Balikpapan yang menunjukkan truk bermuatan kontainer seberat 20 ton menyeruduk sejumlah kendaraan di depannya viral. https://t.co/kHm96N0g4J,8,0,1,1,2022-01-22,2,Saturday,6,9,1
1484707726102081536,2022-01-22 02:01:21,Balas berbalas Gubernur DKI Jakarta Anies Baswedan dengan Ketua Umum PSI Giring Ganesha belum tuntas. Saling balas Anies vs Giring malah makin panas. #aniesbaswedan #giring https://t.co/p3Eo9CZkjX,12,16,1,5,2022-01-22,2,Saturday,6,13,21
1484707706262990849,2022-01-22 02:01:16,Arteria Dahlan yang terpilih dari Daerah Pemilihan Jawa Timur VI itu sudah sering mendapatkan sorotan tajam publik karena berbagai macam pernyataan dan tingkah kontroversialnya. Berikut beberapa pernyataan dan tingkah kontroversialnya. #detiknetwork  https://t.co/qhjv4xWvkz,12,11,6,1,2022-01-22,2,Saturday,6,18,12
1484707016182480899,2022-01-22 01:58:31,Panglima TNI Jenderal Andika Perkasa menunjuk Mayjen TNI Maruli Simanjuntak menjadi Pangkostrad. https://t.co/HKhbINpQ15,263,126,59,29,2022-01-22,1,Saturday,6,322,155
1484706917763145728,2022-01-22 01:58:08,"Hasil asesmen BNNP DKI terhadap musisi Ardhito Pramono keluar. Ardhito direkomendasikan untuk direhabilitasi di RSKO Cibubur, Jakarta Timur, selama 6 bulan. https://t.co/C24JbqH2eH",4,0,0,1,2022-01-22,1,Saturday,6,4,1
1484706897072689152,2022-01-22 01:58:03,Rafael Benitez belum lama ini dipecat oleh Everton. Steven Gerrard mengaku heran melihat mantan pelatihnya itu menerima pekerjaan tersebut musim panas lalu. https://t.co/e0kgYNvqao,2,0,0,0,2022-01-22,1,Saturday,6,2,0
1484706632659615750,2022-01-22 01:57:00,"Jihadis membunuh 2 orang pria dan menculik 20 anak di negara bagian Borno, Nigeria. Lokasi tersebut merupakan tempat gerilyawan melakukan pemberontakan. https://t.co/PWNHGouEy4",6,0,3,0,2022-01-22,1,Saturday,6,9,0
1484706395731681285,2022-01-22 01:56:03,"Berdasarkan data BPBD Jakarta, penurunan permukaan tanah yang diakibatkan oleh eksploitasi air dan infrastruktur meningkatkan ancaman banjir. https://t.co/KVOm7J8rFx",10,1,5,1,2022-01-22,1,Saturday,6,15,2
1484706116244328451,2022-01-22 01:54:57,"Walkot Bekasi nonaktif, Rahmat Effendi menyampaikan permintaan maaf usai rapat lewat zoom dari rutan KPK. Permintaan maaf disampaikan melalui kuasa hukumnya. https://t.co/sSQA2rKI7U",3,0,0,0,2022-01-22,1,Saturday,6,3,0
1484706096262660097,2022-01-22 01:54:52,Surat Yasin ayat 62 berisi tentang nasihat Allah SWT kepada manusia untuk memerangi godaan setan. Begini cara yang diungkap dalam ayat tersebut. https://t.co/EbE7N2wJo1,44,0,10,0,2022-01-22,1,Saturday,6,54,0
1484705824232648705,2022-01-22 01:53:47,"Polisi tengah menyelidiki dugaan kekerasan seksual terhadap anak berinisial CT (10) di Manado, Sulawesi Utara. Polisi telah memeriksa 9 saksi. https://t.co/2G8Rno9AVu",6,1,0,0,2022-01-22,1,Saturday,6,6,1
1484705804120956928,2022-01-22 01:53:42,"Geger dokter berinisial G menyuntik vaksin kosong saat pelaksanaan vaksinasi anak. Kemenkes RI ikut buka suara, ini penegasannya. https://t.co/Oec5qSU8Bf",12,0,3,0,2022-01-22,1,Saturday,6,15,0
1484705581084651529,2022-01-22 01:52:49,Serangan udara menghantam sebuah penjara di Yaman. Doctors Without Borders mengatakan sebanyak 70 orang tewas dan 138 luka-luka dalam serangan itu. https://t.co/SoiC3kUyDN,4,0,0,0,2022-01-22,1,Saturday,6,4,0
1484705331850756099,2022-01-22 01:51:50,"James Ward-Prowse memang bukan nama tenar di Premier League. Tapi, kemampuannya sebagai eksekutor bola mati jangan diragukan lagi. https://t.co/A7lUYDZxma",2,0,0,1,2022-01-22,1,Saturday,6,2,1
1484705103286353925,2022-01-22 01:50:55,"Truk tronton Balikpapan menabrak sejumlah pengendara di Muara Rapak, Kota Balikpapan. Inilah awal mula terjadinya kecelakaan tersebut.. https://t.co/l4tWFEiiAD",3,0,0,0,2022-01-22,1,Saturday,6,3,0
1484705076111421443,2022-01-22 01:50:49,Jangan pernah anggap remeh nyeri di area leher ya detikers! Bisa saja menandakan ada masalah yang lebih buruk. Segera periksa jika mengalami gejala ini. https://t.co/3gh2OJRCVF,5,0,5,0,2022-01-22,1,Saturday,6,10,0
1484705072349171713,2022-01-22 01:50:48,"Ducati kembali gagal merengkuh gelar juara dunia di MotoGP 2021. Ada beberapa seri yang dianggap kurang maksimal, tapi tak ada penyesalan menuju MotoGP 2022. https://t.co/rObrvAJSTD",3,0,1,0,2022-01-22,1,Saturday,6,4,0
1484703801357516801,2022-01-22 01:45:45,"Tanah longsor terjadi di sejumlah titik di Boyolali, Jumat malam (21/1). Longsor juga menutup total jalan Boyolali-Magelang di Desa Tlogolele, Kecamatan Selo. https://t.co/JimjmIid7g",7,0,1,0,2022-01-22,1,Saturday,6,8,0
1484703036752769024,2022-01-22 01:42:43,"Disebut-sebut sebagai pemicu dua pertiga efek samping vaksin COVID-19, nocebo adalah efek semacam placebo atau plasebo yang muncul karena pengaruh pikiran. https://t.co/5SmcyKRIbm",5,3,2,0,2022-01-22,1,Saturday,6,7,3
1484702993597571073,2022-01-22 01:42:32,Polisi mengungkap kronologi lengkap kecelakaan maut di Balikpapan. Kondisi truk diklaim normal saat diambil alih tersangka. https://t.co/P9yr86kyHd,9,1,1,0,2022-01-22,1,Saturday,6,10,1
1484701700493611010,2022-01-22 01:37:24,Louis Saha geram dengan anak-anak muda Manchester United yang enggan menerima masukan dari Cristiano Ronaldo. Dia mempertanyakan prestasi Mason Greenwood dkk. https://t.co/pf4RvcjLIs,93,10,10,1,2022-01-22,1,Saturday,6,103,11
1484701245315108867,2022-01-22 01:35:35,"Australia berhasil membantai Indonesia 18-0 di Piala Asia Wanita 2022. Samantha Kerr mencetak 5 gol di laga tersebut, serta mencatat rekor untuk negaranya. https://t.co/KqrzX3mnQc",12,2,1,0,2022-01-22,1,Saturday,6,13,2
1484701225077592065,2022-01-22 01:35:31,Kementerian Kesehatan mengeluarkan aturan baru soal isolasi pasien Omicron. Pasien yang memenuhi kriteria tertentu boleh isolasi di rumah sendiri. https://t.co/vwtXIypEjD,8,1,1,0,2022-01-22,1,Saturday,6,9,1
1484700633919901701,2022-01-22 01:33:10,"Kasus positif varian Omicron ternyata pernah dialami seorang warga Sukoharjo, Jawa Tengah. Tapi varian Omicron itu terdeteksi setelah pasien sembuh. https://t.co/phAIx6QFIi",12,3,4,0,2022-01-22,1,Saturday,6,16,3
1484700375303303172,2022-01-22 01:32:08,Kompolnas berbicara mengenai anggota DPR Arteria Dahlan yang punya pelat dinas Polri. Kompolnas menyebut Arteria bisa punya pelat polisi dengan syarat tertentu. https://t.co/lQXWBHEV7l,24,32,10,5,2022-01-22,1,Saturday,6,34,37
1484700086152175619,2022-01-22 01:30:59,"Riyad Mahrez diberikan waktu libur seminggu demi menenangkan dirinya. Setelah itu, Mahrez bisa beraksi lagi untuk Manchester City. https://t.co/9n4r6uZfl8",1,0,0,0,2022-01-22,1,Saturday,6,1,0
1484699807469953029,2022-01-22 01:29:53,"Muhammad Yamin, salah satu korban kecelakaan maut Balikpapan, Kalimantan Timur (Kaltim) dikabarkan telah melewati masa kritis. Dia kini terus dirawat intensif. https://t.co/uyecLaDyKz",7,2,0,0,2022-01-22,1,Saturday,6,7,2
1484698474675417088,2022-01-22 01:24:35,Manchester United kemungkinan besar takkan diperkuat Cristiano Ronaldo saat melawan West Ham United. Ronaldo disebut belum fit betul. https://t.co/MCabdJ1zWZ,7,0,0,1,2022-01-22,1,Saturday,6,7,1
1484697160889380865,2022-01-22 01:19:22,"Hakim PN Surabaya, Itong Isnaeni Hidayat melakukan interupsi saat dipamerkan KPK. PPP kurang setuju dengan aksi 'memamerkan' tersangka https://t.co/BSVKgBNjMF",46,55,1,4,2022-01-22,1,Saturday,6,47,59
1484696690238140417,2022-01-22 01:17:29,"Seorang warga di Magetan bernama Suparlan kaget bukan kepalang. Tiba-tiba ia mendapat kiriman dokumen akta kematian, padahal masih hidup. https://t.co/AcY0Q606hj",11,3,2,0,2022-01-22,1,Saturday,6,13,3
1484695916649058308,2022-01-22 01:14:25,Sungguh tak terpuji aksi pemotor di Jakarta Timur berinisial RS. Ia berkendara di jalur khusus TransJakarta hingga menabrak polantas https://t.co/dcINsfau0D,3,2,0,0,2022-01-22,1,Saturday,6,3,2
1484695900312252416,2022-01-22 01:14:21,Din Syamsuddin berencana menggugat UU IKN ke Mahkamah Konstitusi. Gugatan itu akan dilayangkan jika sudah resmi dinomorkan. https://t.co/a3C0AIcgy2,136,32,16,7,2022-01-22,1,Saturday,6,152,39
1484694792743366664,2022-01-22 01:09:57,"Kecelakaan maut di Balikpapan, Kaltim dimana truk tronton menyeruduk sejumlah pengendara di turunan Simpang Rapak, Jalan Soekarno Hatta berakhir tragis. https://t.co/PbYidhvB1w",20,2,2,0,2022-01-22,1,Saturday,6,22,2
1484693242910326784,2022-01-22 01:03:48,Ibu Kota Negara (IKN) baru sejatinya bukan hal asing. Myanmar dan Malaysia melakukannya lebih dulu namun nasib keduanya sangat berbeda. https://t.co/DCRXms1Wxh,10,2,3,0,2022-01-22,1,Saturday,6,13,2
1484692799505240068,2022-01-22 01:02:02,"Di satu musim yang sama, bahkan dalam hitungan bulan, klub Rusia CSKA Moskow dua kali bikin kontroversi. Dari Bad Barbie hingga 'Banyak Natasha'. https://t.co/G0ip64Bi42",3,1,1,0,2022-01-22,1,Saturday,6,4,1
1484691942407561217,2022-01-22 00:58:37,Prajurit Satgas Korps Marinir membantu kesulitan penduduk ataupun suku yang lokasinya sulit untuk dijangkau di pedalaman Papua. https://t.co/06EerBrv9W,22,0,6,0,2022-01-22,0,Saturday,6,28,0
1484691157955358725,2022-01-22 00:55:30,Seorang pelaku penjambretan tertangkap warga saat hendak melarikan diri. Penjambret itu babak belur setelah diamuk massa. https://t.co/2907tcKJG4,7,3,1,0,2022-01-22,0,Saturday,6,8,3
1484690333615198208,2022-01-22 00:52:14,Lima kecamatan di DKI Jakarta masuk zona merah kasus COVID-19 varian Omicron. Status zona merah ini pun memaksa Pemprov DKI menerapkan micro-lockdown. https://t.co/1rKICqoVgT,9,3,2,1,2022-01-22,0,Saturday,6,11,4
1484688804418134016,2022-01-22 00:46:09,"Sampah kulit kabel yang menjadi salah satu penyebab banjir ditemukan di gorong-gorong Kemayoran, Jakpus. Penemuan kulit kabel di Jakarta ini tidak hanya 1 kali. https://t.co/oIQYmGRkPV",11,4,1,0,2022-01-22,0,Saturday,6,12,4
1484688323222380546,2022-01-22 00:44:15,"Ada 4 calon yang mencuat disinyalir memimpin ibu kota baru, yakni Ridwan Kamil, Tri Rismaharini, Nova Iriansyah, dan Danny Pamonto. Bagaimana peluangnya? https://t.co/RWpaY8Q8qt",20,24,5,2,2022-01-22,0,Saturday,6,25,26
1484687568532877312,2022-01-22 00:41:15,"Disebut-sebut sebagai pemicu dua pertiga efek samping vaksin COVID-19, nocebo adalah efek semacam placebo atau plasebo yang muncul karena pengaruh pikiran. https://t.co/Sffc1J32BZ",1,0,0,0,2022-01-22,0,Saturday,6,1,0
1484686528190234625,2022-01-22 00:37:07,"Siswa yang lolos SNMPTN 2022 tidak bisa ikut UTBK SBMPTN tahun ini dan berikutnya. Namun, apakah siswa yang lolos SNMPTN bisa ikut seleksi sekolah kedinasan? https://t.co/T7qotQo07g",7,0,1,1,2022-01-22,0,Saturday,6,8,1
1484685191142641665,2022-01-22 00:31:48,"Polisi masih menyelidiki kasus siswa SD disuntik vaksin kosong di Medan, Sumatera Utara. Polisi memeriksa lima orang saksi terkait hal ini. https://t.co/oZoxLoGTwK",9,1,5,0,2022-01-22,0,Saturday,6,14,1
1484684152561676294,2022-01-22 00:27:40,Pemkab Pangandaran akan taat azas pemerintah pusat terkait wacana penghapusan tenaga honorer di instansi pemerintah. https://t.co/R3d8aoWqxe,19,0,4,2,2022-01-22,0,Saturday,6,23,2
1484682817871269893,2022-01-22 00:22:22,"Memerankan karakter Alisha, Deepika Padukone ditantang buat beradegan panas dengan lawan mainnya Siddhant Chaturvedi. https://t.co/4u0ufCd1kM",7,0,2,2,2022-01-22,0,Saturday,6,9,2
1484681071782469636,2022-01-22 00:15:26,Itong Isnaeni Hidayat menginterupsi jumpa pers operasi tangkap tangan KPK saat dihadirkan sebagai tersangka. PKB menyebut hal tersebut wajar. https://t.co/JknI7C79BQ,7,2,1,0,2022-01-22,0,Saturday,6,8,2
1484680519191306240,2022-01-22 00:13:14,"Waspada kasus Omicron melonjak, Epidemiolog Dicky Budiman mengimbau agar anak-anak terutama yang belum vaksin penuh untuk melakukan sekolah dari rumah. Setidaknya hingga bulan Maret. https://t.co/HACFvFCHoR",32,2,26,3,2022-01-22,0,Saturday,6,58,5
1484677920371191812,2022-01-22 00:02:54,"Arteria Dahlan disorot lantaran mobil-mobilnya dipasangi pelat nomor polisi. Angka di pelat nomor kendaraannya juga sama, 4196-07. Fakta baru mulai muncul. https://t.co/8vztqLGeaq",169,82,74,24,2022-01-22,0,Saturday,6,243,106
1479603371946426368,2022-01-07 23:58:28,PSIS Semarang sudah membuka jalan agar Pratama Arhan berkarier di luar negeri. Lampu hijau diberikan oleh Junianto. https://t.co/tlHdzNA0Zx,29,0,3,1,2022-01-07,23,Friday,5,32,1
1479602881816940545,2022-01-07 23:56:31,"Kecelakaan melibatkan mobil dan 3 pengendara motor. Salah satu korban, pemotor terlempar hingga jatuh dari atas flyover Pesing. https://t.co/SvSo09bCJk",1,0,1,2,2022-01-07,23,Friday,5,2,2
1479602069606735880,2022-01-07 23:53:17,"""Hemat saya, kasus ini adalah permainan kewenangan, mencari kesempatan di tengah pandemi,"" kata Waketum PKB, Jazilul Fawaid. https://t.co/Uq6jh7Pde5",15,1,1,1,2022-01-07,23,Friday,5,16,2
1479602043249737729,2022-01-07 23:53:11,Kejari Depok sampaikan kabar terbaru terkait kasus dugaan korupsi Damkar Depok. Penyidik Kejari Depok menetapkan satu orang lagi sebagai tersangka berinisial WI https://t.co/1t0AnRcwbu,4,0,0,0,2022-01-07,23,Friday,5,4,0
1479601249855102979,2022-01-07 23:50:02,Jefri Nichol dan Amanda Rawles kembali dipasangkan dalam film Dear Nathan: Thank You Salma. Ini merupakan film ketiga dari seri Dear Nathan. https://t.co/izqXX809Aj,14,1,0,0,2022-01-07,23,Friday,5,14,1
1479600218861707264,2022-01-07 23:45:56,Pemuka Hizbullah memberi cap 'teroris' kepada Raja Arab Saudi Salman bin Abdulaziz al Saudi. Ucapan pemuka Hizbullah itu membuat darah Saudi mendidih. https://t.co/RjgW6Kb53x,21,4,7,0,2022-01-07,23,Friday,5,28,4
1479598975086997504,2022-01-07 23:40:59,Jumlah kasus aktif COVID-19 di DKI Jakarta naik menjadi 1.394. Ahmad Riza Patria mengungkap dugaan penyebab naiknya kasus Corona di Ibu Kota. https://t.co/I5pJQ5mX2g,6,4,3,1,2022-01-07,23,Friday,5,9,5
1479597941757202432,2022-01-07 23:36:53,"Ashanty terinfeksi Omicron sepulang dari Turki, Kemenkes-Satgas membeberkan fakta di balik kabar tersebut. Termasuk gejala yang diidap, ini fakta-faktanya. https://t.co/oHVOj8iCxP",4,2,0,1,2022-01-07,23,Friday,5,4,3
1479596707205849088,2022-01-07 23:31:59,Seorang nenek bernama Sadinem harus dilarikan ke rumah sakit gegara diserang kawanan tawon Vespa affinis. Kondisi nenek ini terus gemetar kesakitan. https://t.co/LtSalZdQSq,8,0,0,1,2022-01-07,23,Friday,5,8,1
1479595459513618434,2022-01-07 23:27:01,KPK melaksanakan putusan PK terpidana Bupati Pakpak Bharat Remigo Yolanda Berutu yang sebelumnya divonis 7 tahun penjara. Kini vonis Remigo menjadi 4 tahun. https://t.co/68v2TPKBRu,7,0,0,0,2022-01-07,23,Friday,5,7,0
1479594165918912513,2022-01-07 23:21:53,"R, teman kencan S, wanita yang tewas di hotel, tengah menjalani pemeriksaan. Polisi mengatakan saat ini pengakuan R belum mengarah ke kematian korban. https://t.co/1Jfc2JAxdw",1,1,0,0,2022-01-07,23,Friday,5,1,1
1479592692254486528,2022-01-07 23:16:01,Warga melihat korban 'terbang' dari flyover Pesing setelah mendengar benturan keras. https://t.co/MZOZW49OwN,6,1,2,0,2022-01-07,23,Friday,5,8,1
1479591188491558915,2022-01-07 23:10:03,Nama Ahok mencuat di tengah ramainya perbincangan bursa calon Gubernur DKI pengganti Anies. Sekjen PDIP mengungkapkan rencana Ahok ke depan. https://t.co/v7JSp90vbk,28,36,5,2,2022-01-07,23,Friday,5,33,38
1479589925251162112,2022-01-07 23:05:02,Video ibu-ibu merangkak naik dari tepi kali di Depok usai mengalami kecelakaan ramai beredar. Begini kondisi di lokasi. https://t.co/6SiSCnMZvL,0,0,0,0,2022-01-07,23,Friday,5,0,0
1479588642712698884,2022-01-07 22:59:56,"PDIP buka suara terkait banyaknya gugatan presidential threshold ke MK. Hasto mengatakan adanya PT untuk mencari pemimpin yang matang, bukan menghambat. https://t.co/3hKlghWGal",25,67,7,11,2022-01-07,22,Friday,5,32,78
1479587549324759045,2022-01-07 22:55:35,Daun kelor sejak lama dipercaya memiliki berbagai khasiat bagi kesehatan. Berikut ini beberapa manfaat daun kelor untuk kesehatan dan kecantikan. https://t.co/5l5Zq6COcZ,37,4,11,1,2022-01-07,22,Friday,5,48,5
1479586647012429832,2022-01-07 22:52:00,Pemprov DKI berencana mengalokasikan sejumlah anggaran BTT untuk penyesuaian UMP 2022 bagi PJLP. Kemendagri ingatkan target penerima penyesuaian UMP tidak salah https://t.co/x65RWk38po,3,2,1,1,2022-01-07,22,Friday,5,4,3
1479585755118854150,2022-01-07 22:48:28,Manchester United dikabarkan berisiko ditinggalkan banyak pemainnya karena keretakan di ruang ganti. Manajer interim MU Ralf Rangnick merespons kabar tersebut. https://t.co/h3gfpxRr9Y,7,0,1,1,2022-01-07,22,Friday,5,8,1
1479585244747603968,2022-01-07 22:46:26,Manchester City terus melaju di Piala FA. The Citizens sukses melumat Swindon dengan skor 4-1 di putaran ketiga. https://t.co/uiAhMWf7bk,10,0,1,0,2022-01-07,22,Friday,5,11,0
1479582622175137793,2022-01-07 22:36:01,Artis Naufal Samudra ditangkap polisi untuk kedua kalinya. Naufal kembali berurusan dengan polisi karena kasus narkoba. https://t.co/4mzEueM7HN,8,2,4,0,2022-01-07,22,Friday,5,12,2
1479582142120275968,2022-01-07 22:34:06,Pemkab Bogor menggelar acara menyambut Kapolres dan Dandim baru di Bogor. Bupati Bogor mengucapkan selamat datang kepada Kapolres dan Dandim baru. https://t.co/mAhC218CcT,2,0,1,1,2022-01-07,22,Friday,5,3,1
1479580808247713799,2022-01-07 22:28:48,"Pemotor ARS di Jakbar terjun bebas dari atas flyover Pesing karena ditabrak pengemudi mobil. Saksi becerita, insiden seperti itu bukan pertama kalinya terjadi. https://t.co/EMBLNoqXE2",6,2,4,1,2022-01-07,22,Friday,5,10,3
1479579453579796480,2022-01-07 22:23:25,Proses hukum dugaan penyekapan dan pemerkosaan siswi SMP di Riau terus berlanjut. Meja hijau kini menanti tersangka yang merupakan anak anggota DPRD Pekanbaru. https://t.co/cMhNKXuhUq,27,6,2,1,2022-01-07,22,Friday,5,29,7
1479577951800860675,2022-01-07 22:17:27,Siluet hewan dalam gambar ini akan mudah terlihat bagi yang bisa melihat warna dengan sempurna. Bagi yang kesulitan bisa jadi itu tanda buta warna. https://t.co/DUkhBLoGx0,7,14,0,1,2022-01-07,22,Friday,5,7,15
1479576892273483780,2022-01-07 22:13:14,"Pelatih tim biliar Sumut, Choki, mendapat balasan somasi dari Pemprov Sumut Usai membuat laporan polisi karena dijewer Gubsu Edy. Apa isi balasan somasinya? https://t.co/unIvdMjsve",6,4,0,1,2022-01-07,22,Friday,5,6,5
1479575539337895943,2022-01-07 22:07:52,"Nawal Citra Ardina, siswi kelas 3 SMP 1 Pasuruan dilaporkan hilang. Gadis berusia 14 tahun itu belum diketahui kabarnya hingga saat ini. https://t.co/Cvs9rxk3iF",16,2,8,1,2022-01-07,22,Friday,5,24,3
1479574278307778561,2022-01-07 22:02:51,"Nama-nama mulai bermunculan mengisi bursa Pilgub DKI Jakarta 2024. Mulai dari Wagub DKI Jakarta Ahmad Riza Patria, sampai PSI yang mengajukan nama sejumlah kadernya. https://t.co/JLM5K3xrom",0,0,0,1,2022-01-07,22,Friday,5,0,1
1479572966522466315,2022-01-07 21:57:39,"Polisi menetapkan empat tersangka dalam insiden salah bacok yang mengakibatkan remaja berinisial R (15) di Cengkareg, Jakarta Barat, tewas. https://t.co/KGweu8lqgR",6,0,1,1,2022-01-07,21,Friday,5,7,1
1479571921524207620,2022-01-07 21:53:29,Bek Everton Lucas Digne telah meminta dimasukkan daftar jual ke klub. Manajer The Toffees Rafael Benitez mengonfirmasi hal tersebut. https://t.co/TGyYtkUaWD,6,0,0,0,2022-01-07,21,Friday,5,6,0
1479570936777031680,2022-01-07 21:49:35,Sidang perwalian Gala Sky Ardiansyah hingga saat ini masih dalam tahap mediasi antara pihak Haji Faisal dan Doddy Sudrajat. https://t.co/SXjLmAPniI,9,3,2,0,2022-01-07,21,Friday,5,11,3
1479569643547332620,2022-01-07 21:44:26,"Proyek rehabilitasi Jalan Ahmad Yani, Liang Anggang, Kota Banjarbaru tak kunjung selesai. Kini jalan itu seperti kubangan dan menghambat aktivitas warga. https://t.co/9xDclguQXW",11,2,3,0,2022-01-07,21,Friday,5,14,2
1479569144148336641,2022-01-07 21:42:27,"Anggota keluarga korban HAM berat masa lalu, Bayan, tak mempermasalahkan pengangkatan eks Tim Mawar Mayjen Untung Budiharto jadi Pangdam Jaya. Apa alasannya? https://t.co/rEqAtKQlz0",2,0,2,0,2022-01-07,21,Friday,5,4,0
1479567626951176192,2022-01-07 21:36:25,Seorang lelaki mantan pasien RSJ di Semarang ditangkap polisi karena mencuri 47 tabung gas LPG ukuran 3 kg. Pengakuan pelaku berkali-kali bikin kaget polisi. https://t.co/OOBUI28Vzk,21,3,5,7,2022-01-07,21,Friday,5,26,10
1479565532093366272,2022-01-07 21:28:06,Jujutsu Kaisen jadi manga yang tengah bersinar di industri Jepang. Kelanjutan ceritanya selalu dinanti-nantikan oleh pembaca setia manga. https://t.co/Grisb4cS5C,8,0,1,0,2022-01-07,21,Friday,5,9,0
1479563296575569923,2022-01-07 21:19:13,"Irwansyah akhirnya memilih jalur perdata atas kasus penipuan sang adik, Hafiz Fatur. Ia pun akan segera mencabut laporannya di Polres Jakarta Selatan setelah mengajukan gugatan perdata ke Pengadilan Negeri Tangerang. https://t.co/9AsZOTBJoN",10,0,0,0,2022-01-07,21,Friday,5,10,0
1479561959854985218,2022-01-07 21:13:54,Setiap wanita memiliki aroma vagina yang bervariasi dari yang bau asam hingga seperti bau amis. Kenali 7 variasi bau vagina ada yang disebabkan oleh infeksi. https://t.co/itmLRdj3YX,3,2,0,2,2022-01-07,21,Friday,5,3,4
1479559588412284935,2022-01-07 21:04:29,Ring Project diluncurkan dalam penyelenggaraan Jakarta Biennale yang masih berlangsung sampai 21 Januari 2021 di Museum Nasional Indonesia. https://t.co/nZmdFEcKtY,2,0,1,0,2022-01-07,21,Friday,5,3,0
1479558237057916928,2022-01-07 20:59:07,Polisi mengungkap fakta baru terkait kasus dugaan siswa SMP oleh anak anggota DPRD Pekanbaru. Polisi menyebut pelaku dan korban pacaran. https://t.co/rKoQR4BiNj,10,22,3,3,2022-01-07,20,Friday,5,13,25
1479556909757874179,2022-01-07 20:53:50,"Di tengah tren adopsi spirit doll alias boneka arwah, ada sebagian orang yang justru takut sama boneka. Ketakutan ini dikenal sebagai pediophobia. https://t.co/oPBI4Pc6Ik",3,2,0,1,2022-01-07,20,Friday,5,3,3
1479555605689942022,2022-01-07 20:48:39,Chelsea membuka diri dengan kemungkinan merekrut pemain di bursa transfer Januari ini. Thomas Tuchel mengaku tengah memantau perkembangan di bursa. https://t.co/RbwTSm98dl,5,0,0,0,2022-01-07,20,Friday,5,5,0
1479555585188282371,2022-01-07 20:48:34,Video seorang laki-laki yang onani di atas motornya saat berhenti di tepi jalan viral. Aksi tak senonohnya itu terhenti setelah diteriaki seorang wanita https://t.co/jHmSVhe4AY,10,0,0,1,2022-01-07,20,Friday,5,10,1
1479554849406656521,2022-01-07 20:45:39,Mangaa One Piece 1037 libur akhir pekan ini. Bagaimana kelanjutan pertarungan Luffy melawan Kaido?  https://t.co/GHTka5DNBb,6,0,2,0,2022-01-07,20,Friday,5,8,0
1479553529106817032,2022-01-07 20:40:24,Masa jabatan Anies Baswedan sebagai Gubernur DKI Jakarta berakhir tahun ini. Bagaimana nasib larangan penggunaan air tanah mulai 2023? https://t.co/7o2sliud1G,4,1,3,0,2022-01-07,20,Friday,5,7,1
1479550430300487681,2022-01-07 20:28:05,"""Pemohon pernah melewati masa konflik Pemerintah Pusat dengan Gerakan Aceh Merdeka dan masih menimbulkan rasa traumatik."" https://t.co/POoTbBB357",6,1,1,0,2022-01-07,20,Friday,5,7,1
1479549082444181508,2022-01-07 20:22:44,"Soal audio, Galaxy Buds 2 memiliki 2-way speaker yang dilengkapi dengan tweeter untuk menangani suara tinggi, dan woofer untuk menangani suara rendah. https://t.co/yoYcJ39hnm",5,0,1,0,2022-01-07,20,Friday,5,6,0
1479547227664179206,2022-01-07 20:15:22,Karakter Gorya yang diperankan Tu Tontawan adalah salah satu perempuan kuat di serial TV. Ini alasan kamu harus stan dia! https://t.co/Ak3xEYEFsJ,5,0,0,0,2022-01-07,20,Friday,5,5,0
1479545942097690624,2022-01-07 20:10:15,Polrestabes Semarang menangkap dua pelaku pemerasan yang mengaku sebagai polisi. Mereka memaksa korbannya menggadaikan motor dan pulangnya disuruh jalan kaki. https://t.co/VUw8JEOThf,2,0,0,0,2022-01-07,20,Friday,5,2,0
1479543921223028743,2022-01-07 20:02:14,Huawei dan Ditjen Dikti Kemendikbud Ristek menyediakan 1.000 akun Huawei Cloud E-Learning Service bagi 500 universitas di Indonesia. https://t.co/XIR1M3H18k,3,0,3,2,2022-01-07,20,Friday,5,6,2
1479542515481128967,2022-01-07 19:56:38,"MK memberikan nasihat kepada pasangan suami istri dari Jakut, Johanes Halim dan Syilfani Lovatta Halim saat mencari keadilan ke MK. Apa nasihatnya? https://t.co/66ALmaPgN7",4,0,3,0,2022-01-07,19,Friday,5,7,0
1479541261669388295,2022-01-07 19:51:39,"Ugi, seorang pedagang di Cipinang, Jaktim, jadi korban pencurian ponsel dengan modus pelaku memesan makanan dengan dalih untuk 'Jumat Berkah'. https://t.co/Kb3oLTXoDQ",7,2,5,0,2022-01-07,19,Friday,5,12,2
1479539015539998733,2022-01-07 19:42:44,"Rayyanza, anak kedua Raffi Ahmad dan Nagita Slavina, pertama kali diajak mengunjungi pusat perbelanjaan. Stroller mahalnya mencuri perhatian. Ini potretnya:  https://t.co/nO22bUc7BL",8,0,0,0,2022-01-07,19,Friday,5,8,0
1479537596858572802,2022-01-07 19:37:06,Bareskrim Polri tengah mengusut dugaan kasus suap karantina Rachel Vennya. Bareskrim telah memeriksa 3 orang saksi. https://t.co/yk4e0zGPEa,13,8,4,0,2022-01-07,19,Friday,5,17,8
1479535576562946048,2022-01-07 19:29:04,Anang Hermansyah dan Atta Halilintar baru-baru ini melakukan transplantasi rambut di Turki. Prosedur apakah itu dan seberapa efektif mengatasi kebotakan? https://t.co/gpHFLNm7gL,3,0,0,1,2022-01-07,19,Friday,5,3,1
1479534198067286018,2022-01-07 19:23:35,Banyak orang menganggap bahwa pria lebih sering memikirkan seks daripada wanita. Lalu siapa sebenarnya yang lebih sering memikirkan seks? Ini hasil studinya. https://t.co/lFaxlOURKr,5,0,0,0,2022-01-07,19,Friday,5,5,0
1479532919077154827,2022-01-07 19:18:30,"Aaron Ramsey santer dikabarkan bakal meninggalkan Juventus. Patrick Vieira percaya andai Ramsey memperkuat klub di Liga Inggris, itu bakal memberi keuntungan. https://t.co/kEVaZzdrWP",4,1,1,0,2022-01-07,19,Friday,5,5,1
1479531643291451393,2022-01-07 19:13:26,"Pemotor terjun bebas dari flyover Pesing, Jakbar setelah tertabrak mobil. Untuk diketahui, flyover Pesing tidak boleh dilintasi motor. https://t.co/MDqr72OHtg",46,16,18,0,2022-01-07,19,Friday,5,64,16
1479528973650571271,2022-01-07 19:02:50,Polres Sumedang mengungkap asal-usul hubungan bocah lelaki dan pelaku tindak pidana kekerasan. Korban disekap-diikat rantai di rumah pelaku. https://t.co/NR0vnpYHav,9,0,6,1,2022-01-07,19,Friday,5,15,1
1479526492103139328,2022-01-07 18:52:58,"Bos UFC Dana White akan naik ring untuk menantang Chatri Sityodtong selaku bos ONE Championship. Menurut Anda, siapa bakal menang? https://t.co/N8Q3gCavcF",10,0,1,0,2022-01-07,18,Friday,5,11,0
1479525104111521795,2022-01-07 18:47:27,Petugas damkar Bogor mengevakuasi 3 buah sarang tawon. Salah satu sarang yang dievakuasi berukuran sebesar galon air! https://t.co/NAv8zXMQHR,9,1,2,2,2022-01-07,18,Friday,5,11,3
1479523488717287426,2022-01-07 18:41:02,Majalengka punya ikon baru untuk menyambut datangnya tahun 2022. Ikon itu berupa Tugu Mangga Gedong Gincu. Seperti apa penampakannya? Mari kita lihat! https://t.co/wsztTLiGsl,5,0,1,0,2022-01-07,18,Friday,5,6,0
1479520633394544645,2022-01-07 18:29:41,Polda Aceh hentikan penyidikan kasus Bupati Aceh Besar Mawardi Ali yang dilaporkan terkait dugaan penipuan terhadap pengusaha Rp 5 miliar saat kampanye. https://t.co/0mlDddxyfD,11,1,1,0,2022-01-07,18,Friday,5,12,1
1479519007690481666,2022-01-07 18:23:14,Ferdinand Hutahaean meminta maaf atas cuitan Allahmu ternyata lemah yang kontroversial beberapa waktu lalu. Ferdinand mengaku tak bermaksud membuat gaduh dan meminta bimbingan ulama agar dirinya dan keluarganya bisa menjadi muslim yang lebih baik. https://t.co/LbbI76l57c,24,14,9,10,2022-01-07,18,Friday,5,33,24
1479517570550145024,2022-01-07 18:17:31,"Seorang pemuda bernama Indra (23) warga Kudus, dibacok begal hingga telapak tangannya putus. Polisi masih memburu pelaku. https://t.co/28LXc2iCH5",34,12,8,7,2022-01-07,18,Friday,5,42,19
1479516331980509189,2022-01-07 18:12:36,Viral di TikTok seorang konten kreator mukbang asal Korea menyantap 5 bungkus Indomie goreng sekaligus dengan lahap. Intip keseruannya! https://t.co/yPqVd2iI9A,5,0,1,0,2022-01-07,18,Friday,5,6,0
1479514973218955269,2022-01-07 18:07:12,"Kemendagri RI menegaskan hasil rekomendasi evaluasi Raperda APBD DKI Jakarta 2022 bersifat final. Sehingga, rekomendasi tersebut tak bisa diubah lagi. https://t.co/ztvLCN4W4q",2,1,0,0,2022-01-07,18,Friday,5,2,1
1479513794527301632,2022-01-07 18:02:31,"Seorang bocah perempuan 7 tahun warga Brebes, Jawa Tengah diduga memiliki kelainan pada alat kelamin. Terlahir perempuan, tapi tumbuh benjolan menyerupai penis. https://t.co/f1CcxueeS5",1,0,0,1,2022-01-07,18,Friday,5,1,1
1479512342115323910,2022-01-07 17:56:45,Pengemudi mengaku kecelakaan terjadi akibat dirinya silau terkena cahaya matahari. Berikut penjelasannya: https://t.co/Z8r7e6AU76,9,0,2,1,2022-01-07,17,Friday,5,11,1
1479511346626580486,2022-01-07 17:52:47,Seorang ibu di Cimahi mengoleksi ratusan boneka. Ibu bernama Sandra Susan itu telah mengumpulkan boneka sejak tahun 2000-an lalu. Seperti apa ya? https://t.co/jXjV8cvSQG,5,3,2,0,2022-01-07,17,Friday,5,7,3
1479510159512776704,2022-01-07 17:48:04,Yuk latih otak kamu agar bisa lancar memecahkan masalah. Teka-teki ini bisa membuktikan apakah kamu jenius. https://t.co/6p1K7foe4U,117,94,15,3,2022-01-07,17,Friday,5,132,97
1479508804442243073,2022-01-07 17:42:41,Ukuran penis besar diyakini para pria bisa memuaskan pasangan di ranjang. Memangnya berapa ukuran ideal penis yang bisa bikin klimaks? https://t.co/z26J8wZfbs,15,0,2,3,2022-01-07,17,Friday,5,17,3
1479507634122338312,2022-01-07 17:38:02,Kanye West kini tengah berkencan dengan Julia Fox. Sang aktris membongkar trik Kanye untuk menggaet hatinya. https://t.co/BpFUW08pYG,6,1,0,0,2022-01-07,17,Friday,5,6,1
1479506978150010890,2022-01-07 17:35:26,"Setiap makhluk hidup, pasti akan mengalami kematian. Berikut ini beberapa tanda-tanda kematian yang menandakan ajal sudah dekat. https://t.co/lnBPJn1FHh",89,14,27,7,2022-01-07,17,Friday,5,116,21
1479505802838913034,2022-01-07 17:30:45,Booster vaksin Covid-19 dimulai 12 Januari 2022 mendatang. Ini serba-serbi informasinya. https://t.co/QQv29Z0f6A,9,0,2,1,2022-01-07,17,Friday,5,11,1
1479504557730316295,2022-01-07 17:25:49,Nazaruddin Razali mengajukan permohonan suntik mati alias euthanasia karena tak kuat dengan tekanan yang dialami. Bagaimana posisi suntik mati di mata hukum? https://t.co/VL33lGBPLo,12,3,5,1,2022-01-07,17,Friday,5,17,4
1479503922054189060,2022-01-07 17:23:17,Polisi menyebutkan Dinda Kirana ada di lokasi saat Naufal Samudra ditangkap. Naufal Samudra ditangkap di rumahnya di Jaksel. https://t.co/tIXP0UXNgP,6,0,2,0,2022-01-07,17,Friday,5,8,0
1479503250537824257,2022-01-07 17:20:37,India kembali alami lonjakan kasus Covid-19 setelah mencatat lebih dari 100 ribu kasus dalam sehari pada Jumat (7/1). India juga mencatat hampir 91.000 kasus infeksi Covid-19 pada Kamis (6/1).  https://t.co/LJuKK1lyN1,13,0,1,0,2022-01-07,17,Friday,5,14,0
1479502106172313600,2022-01-07 17:16:04,"Video sekelompok pelajar berlarian di jalan di kawasan Jakarta Pusat, viral di media sosial. Para pelajar iu diduga hendak melakukan tawuran. https://t.co/cvUSvhHUM5",7,0,0,1,2022-01-07,17,Friday,5,7,1
1479500727403884554,2022-01-07 17:10:35,"Ashanty positif COVID-19 usai balik dari Turki. Kemenkes mengatakan Ashanty belum terkonfirmasi varian omicron, namun netizen terlanjur ramai. https://t.co/onaTfJTufr",4,2,0,0,2022-01-07,17,Friday,5,4,2
1479500070995247114,2022-01-07 17:07:59,"Tim penyidik KPK melakukan penggeledahan di beberapa lokasi di Kota Bekasi. Hal ini dilakukan untuk menemukan serta mengumpulkan bukti tambahan terkait operasi tangkap tangan (OTT) Wali Kota Bekasi, Rahmat Effendi. https://t.co/SON2Qf2ICX",6,4,2,0,2022-01-07,17,Friday,5,8,4
1479498835034574852,2022-01-07 17:03:04,PD Pasar Jaya memutuskan untuk membangun ulang kawasan tersebut. #detikcomdoyourmagic https://t.co/t1CahnBOqL,4,0,1,0,2022-01-07,17,Friday,5,5,0
1479497915861188611,2022-01-07 16:59:25,Ashanty positif COVID-19 lewat tes PCR S-gene target failure (SGTF). Ashanty mengungkap gejala COVID-19 yang dikeluhkan lewat Instagram story miliknya. https://t.co/r80DQxQ6N1,14,4,1,1,2022-01-07,16,Friday,5,15,5
1479496886465794048,2022-01-07 16:55:20,Aurel Hermansyah meminta doa terbaik untuk kesembuhan Ashanty yang terpapar Corona lagi. https://t.co/6KvqNFDXdC,23,16,2,1,2022-01-07,16,Friday,5,25,17
1479495582066614275,2022-01-07 16:50:09,"""Jika terus tertunda, kita sama dengan bersikap abai atas perlindungan perempuan dalam bangsa ini,"" kata Amiruddin. https://t.co/6HJ961o1og",20,0,8,2,2022-01-07,16,Friday,5,28,2
1479494368998400006,2022-01-07 16:45:19,Dulu orang tuanya tak mampu belikan ayam KFC. Kini ia bisa mentraktir kedua orangtuanya makan ayam KFC menggunakan uang hasil jerih payah sendiri. https://t.co/JDwZ58Qisj,223,8,32,2,2022-01-07,16,Friday,5,255,10
1479493126255517698,2022-01-07 16:40:23,"Uang suami saya yang pegang semua, uang jajan dia pun minta sama saya. Tapi dia tetap bisa pesan PSK online lewat HPnya, mutasi rekening pun membuktikannya. #detikNetwork  https://t.co/3weFS4sAnd",7,3,2,2,2022-01-07,16,Friday,5,9,5
1479493109985824779,2022-01-07 16:40:19,"Kasus kontroversial cuitan Ferdinand Hutahaean Allahmu Lemah kini sedang dalam penyidikan polisi. Di tengah berjalannya kasus, Ferdinand mengaku sudah menjadi mualaf sejak 2017. https://t.co/Qc5iywfQ8h",9,18,2,2,2022-01-07,16,Friday,5,11,20
1479492397008568324,2022-01-07 16:37:29,"Budiono (61) warga asal Depok, Jawa Barat, sudah 8 hari hilang. Keberadaan Budiono yang merupakan penderita demensia itu masih dicari. #detiktif https://t.co/eLLyGCQYPP",15,0,6,0,2022-01-07,16,Friday,5,21,0
1479490733040193546,2022-01-07 16:30:53,"China menghadapi kritikan atas praktik pemberian pinjaman kepada negara-negara miskin yang sulit dibayar sehingga rentan terhadap tekanan dari Beijing.
Kritikan itu ditepis oleh China. https://t.co/YF0pOJETJZ",6,3,4,0,2022-01-07,16,Friday,5,10,3
1479490692632260612,2022-01-07 16:30:43,"Seorang pria di Bali, I Wayan Wiadnyana ditangkap Polisi. Polisi berhasil menyita barang bukti berupa mobil dan sabu senilai Rp 1 miliar dari tangan pelaku. https://t.co/P0bzcMTr1l",9,1,1,0,2022-01-07,16,Friday,5,10,1
1479490083136978948,2022-01-07 16:28:18,"Ada satu destinasi menarik yang baru dibuka di kawasan Cinere. Berada di kawasan yang sudah direvitalisasi, begini suasananya. https://t.co/DivlzSotwx",16,2,3,0,2022-01-07,16,Friday,5,19,2
1479489518403264517,2022-01-07 16:26:03,"Salah satu pendiri WhatsApp, Jan Koum, saat ini benar-benar menikmati kerja kerasnya usai mundur dari perusahaannya itu. https://t.co/Y6PWnJYpS7",21,1,5,2,2022-01-07,16,Friday,5,26,3
1479488908316524545,2022-01-07 16:23:37,"Tisu magic banyak dijadikan opsi oleh pasangan agar sesi bercinta jadi lebih tahan lama. Tapi, bagaimana cara pakai tisu magic yang benar? Begini caranya: https://t.co/YpyUghEO8C",36,10,4,6,2022-01-07,16,Friday,5,40,16
1479488244135997442,2022-01-07 16:20:59,"Beda dari yang lain, 8 artis Indoensia ini malah adopsi bayi arwah dan diperilakukan layaknya bayi sungguhan. Siapa saja mereka? Tonton di sini ya. https://t.co/dO55uTUtOY",28,44,7,10,2022-01-07,16,Friday,5,35,54
1479486957713559552,2022-01-07 16:15:52,Pengetahuan Jan Ethes Srinarendra akan nama-nama pemimpin dunia 'diuji'. Seperti apa momennya? https://t.co/BdShDQoV0p,30,3,4,1,2022-01-07,16,Friday,5,34,4
1479486587905974273,2022-01-07 16:14:24,Roberto Mancini mendapat firasat lewat mimpi kalau Timnas Italia bakal juara Piala Dunia 2022. Jorginho jadi pencetak gol lewat titik putih. https://t.co/7EsBqufxQT,19,7,2,0,2022-01-07,16,Friday,5,21,7
1479483896618262537,2022-01-07 16:03:43,Petugas office boy (OB) menemukan bungkusan serbuk diduga narkoba jenis sabu di Gerbang Tol Serpong. Serbuk kristal itu dibungkus plastik klip kecil. https://t.co/pRE2xB3ZAd,3,0,1,0,2022-01-07,16,Friday,5,4,0
1479482632043905031,2022-01-07 15:58:41,"Naufal Samudra diamankan polisi karena kasus narkoba pada hari ini, Jumat (7/1). Polisi mengamankan Naufal di lokasi saat ada kekasihnya, Dinda Kirana. https://t.co/ZD3ltEl4Yn",7,3,2,0,2022-01-07,15,Friday,5,9,3
1479481691005763586,2022-01-07 15:54:57,"Sekjen PDIP, Hasto Kristiyanto, menegaskan partainya belum menentukan kader yang akan diusung di Pilgub DKI Jakarta. Namun Hasto menyebut PDIP memiliki sejumlah nama potensial yang telah terbukti berhasil dalam memimpin. https://t.co/BiJtA1z9L9",15,14,3,2,2022-01-07,15,Friday,5,18,16
1479479682601041925,2022-01-07 15:46:58,"Eks Direktur WHO Asia Tenggara, mengungkapkan sejumlah indikasi terkait sebagian masyarakat RI yang telah memiliki 'Super-Immunity'. Begini penjelasannya: https://t.co/6PHFbMAKA2",10,0,1,4,2022-01-07,15,Friday,5,11,4
1479479316568322049,2022-01-07 15:45:31,"#Terpopuler Warga Lamongan, Suyanto membuat pesawat terbang jenis STOL. Pesawat buatannya akan dijual dengan harga Rp 2 miliar. https://t.co/tKB4jjxt5F",10,1,2,1,2022-01-07,15,Friday,5,12,2
1479477180312825858,2022-01-07 15:37:01,Ciamis kini punya stadion atletik berstandar internasional dari IAAF (International Association of Athletics Federations) kelas 2 Asia. Proses pembangunannya pun hampir rampung. https://t.co/nGmxz3ok1P,8,0,1,0,2022-01-07,15,Friday,5,9,0
1479476098215948288,2022-01-07 15:32:43,"RI melaporkan total 254 kasus COVID-19 varian Omicron. Mayoritas bergejala batuk dan pilek, lantas bagaimana membedakan infeksi varian Omicron dengan flu biasa? https://t.co/LqKzotN0w5",11,2,7,1,2022-01-07,15,Friday,5,18,3
1479475029243011082,2022-01-07 15:28:28,Indonesia terpilih menjadi tuan rumah Piala AFF U-16 dan Piala AFF U-19 2022. Hal itu diumumkan di laman resmi AFF dan sudah dikonfirmasi oleh PSSI.  https://t.co/pShjSaRtcF,67,3,12,0,2022-01-07,15,Friday,5,79,3
1479473226363424772,2022-01-07 15:21:19,Cerita wanita berusia 39 tahun kesulitan tidur selama empat tahun akibat gangguan tidur langka yang disebut somniphobia. Ini kisah selengkapnya. https://t.co/BwM2h27vAO,17,1,2,2,2022-01-07,15,Friday,5,19,3
1479472525520289795,2022-01-07 15:18:32,"Sebagian pria mungkin sudah tahu eksistensi dari tisu magic. Tapi, bagaimana dengan fungsinya? Berikut ini 4 fungsi tisu magic yang perlu diketahui. https://t.co/Ag4HjD4Kbr",10,3,2,2,2022-01-07,15,Friday,5,12,5
1479471433373958147,2022-01-07 15:14:11,"Ada tempat nongkrong baru nih di Cinere, konsepnya mengusung kawasan kuliner tepi danau hingga wisata Bali. Seperti apa sih? https://t.co/x4eTfO9l4a",52,3,11,2,2022-01-07,15,Friday,5,63,5
1479470359002898436,2022-01-07 15:09:55,Varian Omicron yang semakin menggila bikin Sundance Film Festival tahun ini terpaksa digelar online lagi.  https://t.co/ew1RU910Db,12,0,2,0,2022-01-07,15,Friday,5,14,0
1479469663927033860,2022-01-07 15:07:09,Pejabat tinggi China menyerukan agar pemotongan pajak lebih banyak. https://t.co/ur0V2VJGwE,8,2,1,0,2022-01-07,15,Friday,5,9,2
1479468875960000515,2022-01-07 15:04:01,"Alun-alun Kota Yogyakarta, ramai diperbincangkan gegara dijual secara virtual di Metaverse. Sultan ikut angkat bicara. Berikut sejumlah fakta yang terungkap. https://t.co/w99eVhkNPs",18,3,1,0,2022-01-07,15,Friday,5,19,3
1479467809054863364,2022-01-07 14:59:47,"Pemilihan Ketua RW 03 Jelambar, Jakarta Barat memanas. Muncul spanduk mosi tidak percaya yang dianggap menyerang calon petahana. https://t.co/wK9KjiFpXr",7,1,1,1,2022-01-07,14,Friday,5,8,2
1479467148464558088,2022-01-07 14:57:10,"Gunung Rinjani dan kisah Dewi Anjani seolah tidak bisa dipisahkan. Terkait pula dengan ritual mengasuh gunung, apa itu? https://t.co/MRXpRQiLw4",18,0,4,1,2022-01-07,14,Friday,5,22,1
1479465351876329478,2022-01-07 14:50:01,Aliansi militer yang dipimpin Rusia mengirimkan pasukan ke Kazakhstan untuk membantu memadamkan kerusuhan. Ini dilakukan seiring situasi di Kazakhstan memanas. https://t.co/Az8QVp04wp,5,1,4,0,2022-01-07,14,Friday,5,9,1
1479464638706290688,2022-01-07 14:47:11,Sebanyak empat Pejabat Utama (PJU) dan lima Kapolres di jajaran Polda Jatim resmi berganti. Upacara sertijab dipimpin langsung Kapolda Jatim Irjen Nico Afinta. https://t.co/ht9VqwrZqX,5,0,2,0,2022-01-07,14,Friday,5,7,0
1479464067924467722,2022-01-07 14:44:55,Fillet ayam goreng tepung yang renyah garing ini favorit banyak orang. Ini karena rasanya gurih garing dan empuk. Apalagi dicocol saus tomat atau saus tartar. https://t.co/baSa0yVbDA,2,0,3,1,2022-01-07,14,Friday,5,5,1
1479462992915877897,2022-01-07 14:40:39,Polisi telah melakukan penyelidikan kasus begal payudara kepada seorang ART di Kemayoran yang terjadi bulan Desember 2021 lalu. Pelaku telah ditangkap. https://t.co/54qsvyLUSP,2,1,0,0,2022-01-07,14,Friday,5,2,1
1479462789504712707,2022-01-07 14:39:50,Berita terpopuler: Dua pria di Malaysia ini rugi Rp 476 juta karena berjualan nasi lemak. Ada juga bumbu masakan yang haram hingga kisah diet karena diejek oleh sang pacar. https://t.co/c1uMsdBDaX,4,0,2,0,2022-01-07,14,Friday,5,6,0
1479460641031311361,2022-01-07 14:31:18,"Sri Sultan Hamengku Buwono X tak permasalahkan penjualan aset Kesultanan secara virtual. Diketahui bahwa kompleks Istana Keraton dijual seharga 244.51 USDT atau United States Dollar Tether. Menurutnya, penjualan itu bukan secara fisik. https://t.co/MpnhMtAk86",10,0,3,1,2022-01-07,14,Friday,5,13,1
1479459918327558144,2022-01-07 14:28:26,Pasukan keamanan Sudan menembak mati tiga pengunjuk rasa dalam demonstrasi menentang militer pada Kamis (6/1). Kondisi unjuk rasa di Sudan pun semakin mencekam. https://t.co/b7AvMtqTkv,8,0,0,0,2022-01-07,14,Friday,5,8,0
1479459595584213004,2022-01-07 14:27:09,"Kuasa Hukum Haji Faisal, Sandy Arifin, menyatakan pihaknya siap menghadapi laporan Doddy Sudrajat. Apalagi kalau tidak terbukti benar. https://t.co/2PA13VXdWH",3,0,0,0,2022-01-07,14,Friday,5,3,0
1479459226057641984,2022-01-07 14:25:41,"Publik menyoroti pernyataan Janariyah, ibu Gaga Muhammad, yang menyinggung soal keputusan keluarga melakukan operasi ke Laura Anna. Pernyataan itu buat keluarga Laura Anna geram. https://t.co/ZxyoO7bBis",13,1,2,0,2022-01-07,14,Friday,5,15,1
1479459100174045186,2022-01-07 14:25:11,Kasus kecelakaan yang menewaskan Vanessa Angel dan Bibi Ardiansyah memasuki babak baru. Faisal berikan komentarnya soal hal itu:  https://t.co/wIgfGyUhLi,8,0,1,0,2022-01-07,14,Friday,5,9,0
1479459083463938050,2022-01-07 14:25:07,Aiptu Wayan Putra Yasa diberhentikan secara tidak hormat alias dipecat dari Polri. Putra terbukti melakukan penipuan terhadap CPNS Rp 350 juta. https://t.co/MUqdPydE0S,10,0,0,1,2022-01-07,14,Friday,5,10,1
1479457685250748422,2022-01-07 14:19:33,"Bocah 3 tahun terjepit di saluran air kolam renang di Pamulang, Tangerang Selatan. Bocah tersebut berhasil diselamatkan setelah 3 jam. Seperti apa? https://t.co/f80O4zFpTn",19,0,2,1,2022-01-07,14,Friday,5,21,1
1479456606173732864,2022-01-07 14:15:16,Bagaimana bila si pemilik HP keberatan? #detiksAdvocate https://t.co/u83zAWgsxM,5,5,4,0,2022-01-07,14,Friday,5,9,5
1479455531945369600,2022-01-07 14:11:00,"Letaknya yang berada di tengah kota, membuat banyak usaha ragam kuliner tumbuh di sepanjang jalan Kapten Tendean, Jakarta Selatan. Mulai dari usaha restoran, rumah makan sederhana hingga pedagang kaki lima.  https://t.co/81XUdSkzTt",2,0,0,1,2022-01-07,14,Friday,5,2,1
1479454471080095746,2022-01-07 14:06:47,Seandainya perusahaan mau berkontribusi maka dana tersebut bisa disalurkan untuk beragam pembangunan yang menghadirkan manfaat langsung bagi masyarakat Kalteng. https://t.co/3qKBouF7j6,3,0,0,0,2022-01-07,14,Friday,5,3,0
1479453408176320517,2022-01-07 14:02:34,Ribuan penerbangan dari sejumlah maskapai asal Amerika Serikat (AS) terpaksa harus dibatalkan atau ditunda. Semua gara-gara Omicron. https://t.co/Du9TmXBuj0,9,0,1,0,2022-01-07,14,Friday,5,10,0
1479452688983240707,2022-01-07 13:59:42,"Philippe Coutinho kembali ke Liga Inggris, tepatnya ke Aston Villa. Coutinho memang lebih galak di Inggris di banding di Liga Spanyol!  https://t.co/6dckkDvGby",8,1,0,0,2022-01-07,13,Friday,5,8,1
1479451646262484995,2022-01-07 13:55:34,"Dosen Fakultas Olahraga dari Unimed, Agustin Sastrawan, menilai aksi jewer Gubsu Edy Rahmayadi ke pelatih Biliar PON hal yang wajar. Kenapa? https://t.co/hCQy97GVQU",22,48,4,3,2022-01-07,13,Friday,5,26,51
1479450937236279296,2022-01-07 13:52:44,"Lagi dan lagi, Gareth Bale bak hilang ditelan Bumi. Bale sudah lama tidak masuk ke skuad Real Madrid, lantas apa kabarnya, nih?  https://t.co/obI2o7Kkla",12,2,3,1,2022-01-07,13,Friday,5,15,3
1479450930143764480,2022-01-07 13:52:43,"Cristiano Ronaldo sedang tidak baik-baik saja di Manchester United. Buktinya, Ronaldo lagi sulit menyerang gawang lawan, jumlah tembakannya sedikit banget!  https://t.co/on1IReMbHs",7,2,3,0,2022-01-07,13,Friday,5,10,2
1479450233843363843,2022-01-07 13:49:57,Kemendikbudristek menyatakan kurikulum prototipe diterapkan sebagai kurikulum nasional pada tahun 2024 mendatang. Via: detikedu  https://t.co/8fazxku7GO,7,0,2,0,2022-01-07,13,Friday,5,9,0
1479449886445735938,2022-01-07 13:48:34,Jakarta Popsivo Polwan memetik kemenangan perdana di laga pembuka Proliga 2022. Amalia Fajrina dkk. menang 3-2 atas Jakarta Elektrik PLN.  https://t.co/rtJfTtfK7w,10,0,1,0,2022-01-07,13,Friday,5,11,0
1479449537379016706,2022-01-07 13:47:11,"#Terpopuler Nur Afiah (28), ART warga keturunan asal Bulukumba, Sulsel, dibunuh secara sadis oleh majikan eks finalis MasterChef Malaysia. Bagaimana ceritanya? https://t.co/xTv8pHCcwB",20,4,1,0,2022-01-07,13,Friday,5,21,4
1479448828424114182,2022-01-07 13:44:22,Gugus Tugas Percepatan Penyelesaian Sanksi Badan Anti-Doping Dunia mendesak WADA segera mereview sanksi. Indonesia ditunggu deadline pencalonan dua tuan rumah.  https://t.co/J4MGHlAAca,2,0,1,0,2022-01-07,13,Friday,5,3,0
1479448176482566145,2022-01-07 13:41:46,Komnas Perlindungan Anak meminta agar Doddy Sudrajat dan H. Faisal menyudahi polemik tentang hak asuh Gala Sky. Kedunya pun disarankan untuk duduk bersama menyelesaikan masalah. https://t.co/VM9LfGxCw2,8,3,2,2,2022-01-07,13,Friday,5,10,5
1479448151778078722,2022-01-07 13:41:40,"Ketombe dan panu ternyata bisa diatasi dengan menggunakan obat antijamur, lho! Seperti misalnya Ketoconazole. Simak selengkapnya berikut: https://t.co/bqyg7P9aZO",19,0,3,0,2022-01-07,13,Friday,5,22,0
1479446784577527814,2022-01-07 13:36:14,Kudeta militer di Sudan pada 25 Oktober 2021 lalu masih menuai protes warga pada Kamis (6/1). Bentrokan antara warga dan militer pun kembali terjadi. https://t.co/oYD1tygPuz,4,0,2,1,2022-01-07,13,Friday,5,6,1
1479446765191446529,2022-01-07 13:36:10,Presiden Joko Widodo mencabut izin konsesi lahan hutan dan izin usaha pertambangan mineral dan batu bara dari ratusan perusahaan. https://t.co/yk7gtcCpJk,24,2,5,0,2022-01-07,13,Friday,5,29,2
1479446040898121728,2022-01-07 13:33:17,#Terpopuler Lili mengaku rela datang dari Boyolali ke Tangerang terkait gugatannya terhadap Ustaz Yusuf Mansur. Dia mengaku sakit hati. https://t.co/IfpeQfTGSJ,74,10,31,0,2022-01-07,13,Friday,5,105,10
1479445275651588096,2022-01-07 13:30:15,Polisi mengamankan Naufal Samudra terkait narkoba. Ia diamankan seorang diri. #NaufalSamudra  https://t.co/ExmY2rjxZa,12,0,3,1,2022-01-07,13,Friday,5,15,1
1479445261487386626,2022-01-07 13:30:11,Kadal dipercaya mampu mengobati asma hingga gatal-gatal. Ternyata begini hukum konsumsi kadal bagi Muslim walaupun untuk pengobatan. https://t.co/EUZEsk5VRt,6,3,3,2,2022-01-07,13,Friday,5,9,5
1479444279097442306,2022-01-07 13:26:17,Lionel Messi diklaim bisa langsung pergi dari PSG akhir musim ini andaikan ada satu hal yang tak kuasa diwujudkan klub kaya Prancis itu. Apa?  https://t.co/t07OP0Xu5P,6,0,0,0,2022-01-07,13,Friday,5,6,0
1479444267428945925,2022-01-07 13:26:14,"Pierre-Emerick Aubameyang positif Corona ketika gabung ke Timnas Gabon untuk ajang Piala Afrika. Disinyalir, Aubameyang positif gegara keluyuran malam-malam!  https://t.co/hC5sR0eLPq",6,0,1,0,2022-01-07,13,Friday,5,7,0
1479444249880014857,2022-01-07 13:26:10,"Badan Geologi Kementerian ESMD resmi meningkatkan status Gunung Dempo, Sumsel ke level waspada. Masyarakat diminta untuk waspada potensi erupsi freatuik. https://t.co/Abdsw5Rq9w",9,1,1,0,2022-01-07,13,Friday,5,10,1
1479443786170314754,2022-01-07 13:24:20,"Para penderita diabetes tetap boleh makan sayuran. Ada sayuran yang membantu mengontrol gula darah. Jenis sayurannya beragam, ada wortel, bayam hingga jamur. https://t.co/bjqO7z4RQg",17,0,3,1,2022-01-07,13,Friday,5,20,1
1479443682214531073,2022-01-07 13:23:55,Naufal Samudra ditangkap karena narkoba. Hal itu dibenarkan oleh Kabid Humas Polda Metro Jaya. #NaufalSamudra  https://t.co/jLR8ambDcu,10,0,1,0,2022-01-07,13,Friday,5,11,0
1479442995669876736,2022-01-07 13:21:11,Jesse Lingard lagi-lagi gagal bersinar di Manchester United. Pemain 29 tahun itu kini dikabarkan mau kembali ke West Ham United.  https://t.co/RxWjMtMGwn,7,0,2,1,2022-01-07,13,Friday,5,9,1
1479442994084392962,2022-01-07 13:21:11,"Philippe Coutinho resmi ke Aston Villa. Hal itu turut membuatnya akan reuni dengan eks rekan satu timnya di Liverpool yang kini menangani Villa, Steven Gerrard.  https://t.co/wmbrICLtIq",8,0,3,0,2022-01-07,13,Friday,5,11,0
1479442559059513351,2022-01-07 13:19:27,PT LIB membuka peluang Liga 1 di Bali dapat ditonton langsung dari stadion. Beberapa syarat harus dipenuhi dan harga tiket segera diumumkan.  https://t.co/2oQAcTC2ew,6,0,0,0,2022-01-07,13,Friday,5,6,0
1479442094540398600,2022-01-07 13:17:36,"Viral aksi lima remaja atau ABG membobol kotak amal masjid, Klaten. Aksi ABG di masjid yang berada di tepi jalan Klaten-Boyolali itu terekam kamera CCTV. https://t.co/d9W2XSgw8M",5,3,4,1,2022-01-07,13,Friday,5,9,4
1479441521267068932,2022-01-07 13:15:20,Serial Layangan Putus yang berkisah tentang suami berselingkuh menjadi viral di media sosial. Dosen Unair menyoroti hal tersebut. Via: detikedu  https://t.co/cFse4mRp0L,15,2,2,0,2022-01-07,13,Friday,5,17,2
1479440992101179397,2022-01-07 13:13:13,Menjadi pembawa acara membuat Maria Vania harus menjaga penampilannya. Ternyata ada lima tips diet yang jadi rahasianya untuk jaga tubuh tetap ramping. https://t.co/AWiTyd7swm,7,0,3,0,2022-01-07,13,Friday,5,10,0
1479439490733199360,2022-01-07 13:07:15,Seorang ASN digeruduk oleh istri sahnya diduga saat sedang kumpul kebo dengan wanita lain. ASN ini bekerja di Dinas Kesehatan Kabupaten Tangerang. https://t.co/3NB2L5Qver,15,5,4,3,2022-01-07,13,Friday,5,19,8
1479437831890165763,2022-01-07 13:00:40,Hujan deras sekitar 2 jam membuat sejumlah kawasan di Surabaya banjir. Wali Kota Surabaya Eri Cahyadi meminta maaf dan langsung mengecek titik banjir. https://t.co/NY5BuW7JWM,9,0,0,1,2022-01-07,13,Friday,5,9,1
1479437580915687436,2022-01-07 12:59:40,"Berperan sebagai pelakor dalam serial Layangan Putus, akting Anya Geraldine mampu membuat para penontonnya merasa kesal, bahkan sampai terbawa di dunia nyata. https://t.co/oQHMv5ffY8",38,1,2,0,2022-01-07,12,Friday,5,40,1
1479437102232354816,2022-01-07 12:57:46,Kalimantan Timur bakal jadi Ibu Kota Negara (IKN) baru Indonesia. Rencana ini kemungkinan mulai dilakukan pada 2024. https://t.co/3GFVvTkBYR,10,1,2,1,2022-01-07,12,Friday,5,12,2
1479436607266729986,2022-01-07 12:55:48,"Mengawali 2022, Balmain dan Barbie berkolaborasi lagi. ""Ini bukan cuma impian seorang desainer, tapi juga cita-cita seorang anak,"" kata Olivier Rousteing. https://t.co/NmsCwgsuK4",5,0,1,0,2022-01-07,12,Friday,5,6,0
1479435849888641024,2022-01-07 12:52:47,Objek wisata Pemandian Cipanas Sekarwangi di Sumedang kondisinya memprhatinkan. Pembangunannya terbengkalai. https://t.co/OdK1nPPTPY,5,0,0,0,2022-01-07,12,Friday,5,5,0
1479435353442377733,2022-01-07 12:50:49,Hubungan cinta Kanye West dan aktris Julia Fox akhirnya terungkap. Sang aktris buka-bukaan kisah asmaranya dengan mantan suami Kim Kardashian itu. https://t.co/uzKGtaC0Cu,5,1,0,0,2022-01-07,12,Friday,5,5,1
1479434357496598530,2022-01-07 12:46:52,"Fuji kembali mencuri perhatian melalui foto unggahan terbarunya di media sosial. Pada unggahannya, Fuji tampak memamerkan foto lawas keluarganya. https://t.co/Pda7NGaDbc",26,3,1,0,2022-01-07,12,Friday,5,27,3
1479433831513997322,2022-01-07 12:44:46,"Tiket termahal untuk menonton balap MotoGP di Sirkuit Mandalika seharga Rp 15 juta sudah habis terjual, beberapa jam setelah loket penjualan dibuka pada Kamis. https://t.co/58cw6XVwKM",35,14,6,4,2022-01-07,12,Friday,5,41,18
1479433752937828352,2022-01-07 12:44:27,"Di sepanjang tahun 2021, IndiHome banyak memperoleh penghargaan atas prestasi, kontribusi serta inovasi terhadap kemajuan teknologi digital di Indonesia, lho detikers.
- 
Yuk, simak penghargaan yang diterima IndiHome!
-
#AktivitasTanpaBatas #InternetnyaIndonesia https://t.co/uTsTiRkYg8",3,4,0,1,2022-01-07,12,Friday,5,3,5
1479432534786293762,2022-01-07 12:39:37,Huawei berinisiatif melahirkan talenta digital terampil agar transformasi digital mampu berjalan maksimal.  https://t.co/wxDLjfQeh0,3,0,0,1,2022-01-07,12,Friday,5,3,1
1479432506529226754,2022-01-07 12:39:30,Video petugas sigap mobil ambulans terbakar viral di media sosial (medsos). Kebakaran di ambulans tersebut bisa dipadamkan dalam waktu kurang dari semenit. https://t.co/XG7EqZUX1Z,3,0,0,0,2022-01-07,12,Friday,5,3,0
1479431737029632004,2022-01-07 12:36:27,"Merger Indosat dan Tri jadi Indosat Ooreodo Hutchison, jumlah operator seluler di Indonesia tinggal empat. Ini daftarnya:  https://t.co/JaKrEs8a7u",7,2,4,1,2022-01-07,12,Friday,5,11,3
1479431189509328902,2022-01-07 12:34:16,KPK mengeksekusi mantan Sekretaris MA Nurhadi ke Lapas Sukamiskin. Nurhadi akan menjalani hukuman penjara selama 6 tahun. https://t.co/PK7qdvm5JW,3,2,0,0,2022-01-07,12,Friday,5,3,2
1479430649559797763,2022-01-07 12:32:08,Seorang nenek di Mojokerto telah menghilang selama 8 jam. Sang nenek kemudian ditemukan tewas di dalam sumur. https://t.co/RFvfQeolPp,11,0,2,0,2022-01-07,12,Friday,5,13,0
1479430324614578183,2022-01-07 12:30:50,Tangkapan layar Instagram Stories Natya Shina ramai dibicarakan. Balasan selebgram itu buat DM yang memintanya jadi joki UAS juga tak lepas dari nyinyiran. https://t.co/vl7N2vUlC1,14,1,2,2,2022-01-07,12,Friday,5,16,3
1479430024352747521,2022-01-07 12:29:38,"Dell Technologies mengungkapkan konsep baru, yang dirancang untuk mengurangi limbah elektronik, bertajuk Concept Luna. Ini visi yang dibawa:  https://t.co/NURvjCmXyv",8,0,0,0,2022-01-07,12,Friday,5,8,0
1479429525989699588,2022-01-07 12:27:40,Belakangan ini beredar daftar harga vaksin booster di media sosial. Begini pernyataan resmi Kemenkes tentang informasi yang simpang siur tersebut. https://t.co/kkJDzAMkMZ,4,2,1,0,2022-01-07,12,Friday,5,5,2
1479429027974848512,2022-01-07 12:25:41,Dishani Chakraborty adalah anak angkat aktor Bollywood Mithun Chakraborty. Bayi yang ditemukan di tempat sampah ini tumbuh jadi wanita cantik. Ini potretnya:  https://t.co/NNmJiUE5TQ,11,0,1,0,2022-01-07,12,Friday,5,12,0
1479428488088240129,2022-01-07 12:23:32,Jefri Nichol dan Anya Geraldine beradu akting di Bagai Bintang di Surga milik NOAH. https://t.co/4bMyCbiNHx,182,9,28,7,2022-01-07,12,Friday,5,210,16
1479427195542159361,2022-01-07 12:18:24,PT LIB membuka peluang Liga 1 di Bali dapat ditonton langsung dari stadion. Beberapa syarat harus dipenuhi dan harga tiket segera diumumkan. https://t.co/8r7RvCCwNo,5,0,1,1,2022-01-07,12,Friday,5,6,1
1479426707350294533,2022-01-07 12:16:28,"Hujan deras membuat sejumlah kawasan di Surabaya terendam banjir. Soal banjir, Surabaya selatan membutuhkan penanganan paling serius. https://t.co/yoUZJaGDJ1",21,5,5,1,2022-01-07,12,Friday,5,26,6
1479425743042056195,2022-01-07 12:12:38,Bioskop yang pernah jaya di era 90-an itu disegel karena dianggap tidak sesuai dengan peruntukannya. https://t.co/wQbXJLsDQ5,3,1,0,1,2022-01-07,12,Friday,5,3,2
1479425209098809348,2022-01-07 12:10:30,Ditresnarkoa Polda Metro Jaya menangkap artis Naufal Samudera terkait kasus narkoba. Artis itu kini masih diperiksa intensif. https://t.co/L6N2mwwi4Z,5,1,2,1,2022-01-07,12,Friday,5,7,2
1479424738401435648,2022-01-07 12:08:38,"Bagi sebagian orang yang tidak mengerti etika dan tanggung jawab mengelola data, antisipasi sangat merepotkan. Tetapi ini adalah bentuk tanggung jawab besar. https://t.co/97qcpFTmfS",3,0,2,1,2022-01-07,12,Friday,5,5,1
1479423190279626755,2022-01-07 12:02:29,"Polisi menangkap artis Naufal Samudra terkait dugaan penyalahgunaan narkoba. Naufal Samudra sedang bersama pacarnya, Dinda Kirana saat ditangkap. https://t.co/6D4OE3MvrD",28,4,7,6,2022-01-07,12,Friday,5,35,10
1479422595359559680,2022-01-07 12:00:07,"Wahana Ngopi in The Sky di Teras Kaca, Pantai Nguluran, Gunungkidul, yang menggunakan crane barang dihentikan Pemerintah Daerah Istimewa Yogyakarta. #CNNIndonesia #detikNetwork  https://t.co/BYLCnbXMuE",26,5,5,5,2022-01-07,12,Friday,5,31,10
1479422582659207170,2022-01-07 12:00:04,"Sebuah tengkorak manusia ditemukan di Dusun Senepo Lor, Desa Barurejo, Siliragung, Banyuwangi. Tengkorak itu ditemukan warga di sebuah sungai setempat. https://t.co/v1mxJ5DEfF",8,0,0,0,2022-01-07,12,Friday,5,8,0
1479422116013518853,2022-01-07 11:58:13,"Mangaka Attack on Titan, Hajime Isayama punya resolusi besar di tahun ini yakni tidak bekerja sama sekal.  https://t.co/HcDNm2J7jI",26,3,3,3,2022-01-07,11,Friday,5,29,6
1479421366747156481,2022-01-07 11:55:14,Pemerintah membangun Bendungan Sepaku Semoi di ibu kota baru negara. Bendungan ini dibangun untuk memenuhi kebutuhan air bakudan mereduksi banjir. https://t.co/zm2c1qtIfB,23,3,2,1,2022-01-07,11,Friday,5,25,4
1479420628285415432,2022-01-07 11:52:18,"Untuk mempermudah pemain dalam proses pemilihan nickname PUBG Mobile 2022, berikut hasil penelusuran detikINET dari berbagai sumber yang bisa kamu gunakan:  https://t.co/3RbzXwBChi",2,0,0,1,2022-01-07,11,Friday,5,2,1
1479420281865318406,2022-01-07 11:50:56,Sejumlah artis Korea Selatan meninggal dunia di usia muda. Beberapa bahkan sedang berada di puncak karier. Ini daftarnya:  https://t.co/RAy4zTaIvG,8,0,0,1,2022-01-07,11,Friday,5,8,1
1479420033138925570,2022-01-07 11:49:56,Adik kandung Gus Dur menolak anggapan yang menyamakan cuitan Ferdinand dengan tulisan Gus Dur. Mari simak kembali tulisan Gus Dur itu. https://t.co/B4r7CLs2u6,56,13,15,0,2022-01-07,11,Friday,5,71,13
1479419282089988096,2022-01-07 11:46:57,Kemedagri berencana menghadirkan e-KTP digital yang bisa disimpan di handphone. https://t.co/0SfQGTeHMp,169,102,73,86,2022-01-07,11,Friday,5,242,188
1479418628852363271,2022-01-07 11:44:22,"Pembangunan depo LRT (Light Rail Transit) di Jatimulya, Bekasi, Jawa Barat, terus dikebut. Saat ini progres pembangunan telah mencapai 84,76 persen. https://t.co/oSh0IBsYbM",9,0,1,0,2022-01-07,11,Friday,5,10,0
1479418463529709569,2022-01-07 11:43:42,"Seorang pria tega memukuli istri sirinya sendiri di Kota Semarang dengan alasan cemburu. Tak sendirian, pelaku menganiaya istri bersama temannya. https://t.co/DygIz6xZCW",5,1,2,0,2022-01-07,11,Friday,5,7,1
1479417833075400705,2022-01-07 11:41:12,Menteri Keuangan Sri Mulyani Indrawati akan memangkas tunjangan PNS Kementerian Keuangan yang terlambat masuk kantor. https://t.co/D9ka4qp3gO,26,3,4,1,2022-01-07,11,Friday,5,30,4
1479417339678535682,2022-01-07 11:39:14,Polda Metro Jaya menangkap artis Naufal Samudra terkait kasus narkoba. Saat ini Naufal masih diperiksa polisi. https://t.co/Qepcre7yKc,28,11,2,4,2022-01-07,11,Friday,5,30,15
1479417090977243149,2022-01-07 11:38:15,Polda Metro Jaya menangkap artis Naufal Samudra terkait kasus narkoba. Saat ini Naufal masih diperiksa polisi. https://t.co/d9XoEcQOxv,4,0,2,1,2022-01-07,11,Friday,5,6,1
1479416625199779847,2022-01-07 11:36:24,Harga minyak naik sekitar 2% pada hari Kamis di tengah meningkatnya kerusuhan di Kazakhstan yang merupakan negara pengekspor minyak terbesar kesembilan dunia. https://t.co/gRnhohEoka,1,0,0,0,2022-01-07,11,Friday,5,1,0
1479416375856795650,2022-01-07 11:35:24,Pemprov DKI Jakarta menetapkan 14 cagar budaya sepanjang tahun 2020-2021. Apa saja? https://t.co/nEHtCZa0hG,4,0,2,0,2022-01-07,11,Friday,5,6,0
1479415623453184010,2022-01-07 11:32:25,Rekaman video sejumlah warga menghajar seorang pria viral via media sosial. Pria itu ternyata bukan penculik. Bagaimana ceritanya? https://t.co/NGzNgN3lT5,3,0,0,0,2022-01-07,11,Friday,5,3,0
1479415073634496515,2022-01-07 11:30:14,"Relawan Sahabat Ganjar akan menempuh langkah hukum jika ada unsur fitnah dalam laporan Adhie Massardi. Kemarin, Adhie melaporkan Ganjar ke KPK soal kasus e-KTP. https://t.co/tjPKdR1Xel",21,4,3,0,2022-01-07,11,Friday,5,24,4
1479414107283628041,2022-01-07 11:26:24,"Duel AC Milan vs AS Roma berjalan panas dan diwarnai dua kartu merah. Bisa saja bertambah jika saja Jose Mourinho tak ""menyelamatkan"" Tammy Abraham.  https://t.co/9kgukd8TT9",2,0,0,0,2022-01-07,11,Friday,5,2,0
1479413587399614466,2022-01-07 11:24:20,"Hujan deras mengguyur Surabaya selama satu jam. Sejumlah jalan protokol terpantau banjir, banyak kendaraan terjebak kemacetan saat jam pulang kerja. https://t.co/TU0aWiDxME",6,4,1,0,2022-01-07,11,Friday,5,7,4
1479413095483289600,2022-01-07 11:22:22,PSS Sleman merebut poin sempurna saat menghadapi Persiraja Banda Aceh dalam lanjutan BRI Liga 1. Super Elja menang 4-1 atas Laskar Rencong.  https://t.co/MIKhKKU3Lq,0,0,0,0,2022-01-07,11,Friday,5,0,0
1479411983032193026,2022-01-07 11:17:57,"Presiden Kazakhstan, Kassym-Jomart Tokayev, mengakui memberikan perintah tembak di tempat terhadap orang-orang yang disebutnya 'bandit' dan 'teroris'. https://t.co/6eoyKkb4uY",16,2,3,2,2022-01-07,11,Friday,5,19,4
1479411747941457925,2022-01-07 11:17:01,Sedang bingung menentukan nickname Free Fire yang simpel? Ini beragam nama yang bisa digunakan:  https://t.co/4sMdKHrPGx,1,1,1,0,2022-01-07,11,Friday,5,2,1
1479411227596148739,2022-01-07 11:14:57,Seorang pria berinisial E harus berurusan dengan polisi. Dia tega memerkosa anak tirinya dengan cara mengikat tangannya dan melakban mulutnya. Sudah tiga kali pria ini melakukan aksi bejatnya. https://t.co/vHxCZ69pye,5,4,3,1,2022-01-07,11,Friday,5,8,5
1479410729048498176,2022-01-07 11:12:58,"Armand Maulana sebagai vokalis GIGI menjelaskan, bahwa saat ini bandnya ditagih untuk segera menggelar konser lagi. #GIGI  https://t.co/oFKNC0IjmR",11,3,0,0,2022-01-07,11,Friday,5,11,3
1479410707657641985,2022-01-07 11:12:53,"Philippe Coutinho resmi dipinjamkan Barcelona ke Aston Villa sampai akhir musim. Manajer Steven Gerrard, diyakini masih kagum sama mantan rekannya itu.  https://t.co/aDxJUcrumS",41,1,2,0,2022-01-07,11,Friday,5,43,1
1479410475611959298,2022-01-07 11:11:58,"Asnawi Mangkualam resmi memperpanjang kontrak di Ansan Greeners. Kinerja pemain Indonesia itu diapresiasi pelatih Ansan Greeners, Jo Min-guk.  https://t.co/Q7R3r5EkVX",17,0,2,0,2022-01-07,11,Friday,5,19,0
1479410474366218243,2022-01-07 11:11:57,Mangut lele yang harum sedap dengan kuah pedas ini bisa dinikmati di Bekasi. Mangut lele lezat racikan Pak Gianto yang harum sedap diguyur kuah yang pedas gurih. https://t.co/TZm2ZmN66L,25,0,6,1,2022-01-07,11,Friday,5,31,1
1479410207235190786,2022-01-07 11:10:54,11 Artis ini tidak hanya berprestasi di dunia seni tapi bisa menyelesaikan pendidikan tinggi dengan membanggakan. Siapa saja? Via: detikedu  https://t.co/4P30qvLMek,10,1,0,1,2022-01-07,11,Friday,5,10,2
1479410193779900416,2022-01-07 11:10:50,"Ratusan rumah di Kota Jayapura, Papua terendam banjir sejak Jumat (7/1) dini hari. Banjir dipicu hujan deras yang turun sejak Kamis (6/1) sore hingga Jumat (7/1) pagi. https://t.co/bTF42DQRtL",1,0,0,0,2022-01-07,11,Friday,5,1,0
1479409586448781313,2022-01-07 11:08:26,"KPK menyebut ada bukti dugaan suap Rp 5,7 M ditemukan saat OTT Walkot Bekasi. Namun, duit yang disita berjumlah Rp 3 M dan Rp 2 M di rekening. Ke mana sisanya? https://t.co/IycEyIT4Hr",8,3,0,0,2022-01-07,11,Friday,5,8,3
1479409233506488321,2022-01-07 11:07:02,"New Xpander hadir dengan pilihan transmisi baru, yakni CVT. Transmisi barunya ini menyalurkan tenaga dari mesin ke dua roda depan alias front wheel drive.  https://t.co/dWgkfGbxic",3,2,1,1,2022-01-07,11,Friday,5,4,3
1479408948377800709,2022-01-07 11:05:54,"Setiap tahunnya, penyelenggaraan Golden Globes 2022 selalu dinantikan oleh pencinta film. Tapi tahun ini Golden Globes 2022 bakal digelar tertutup.   https://t.co/Tnyg1yf6lz",0,0,0,0,2022-01-07,11,Friday,5,0,0
1479408947085950976,2022-01-07 11:05:53,Tujuh jurusan kuliah rumpun Saintek ini menjadi pilihan favorit siswa jurusan IPA dalam SNMPTN 2021. Kira-kira apa saja ya? Via: detikedu  https://t.co/EZ0vnalEEA,2,0,1,0,2022-01-07,11,Friday,5,3,0
1479408705858945027,2022-01-07 11:04:56,"Pemuda ini memilih drop out dari kuliah karena lebih ingin menambang Bitcoin. Walau tidak patut ditiru, ia saat ini mengaku berhasil dengan pilihannya itu. https://t.co/xzZ7bdYzmm",4,0,2,4,2022-01-07,11,Friday,5,6,4
1479407882110132226,2022-01-07 11:01:39,"Jembatan Youtefa berdiri dengan gagah di kota Jayapura, Papua. Membentang sejauh 1.200 meter di atas Teluk Youtefa, begini potret jembatan kebanggaan Papua itu: https://t.co/BkgPUsJAbr",7,1,1,0,2022-01-07,11,Friday,5,8,1
1479407626513494020,2022-01-07 11:00:38,Pemerintah Brunei Darussalam kembali membuka beasiswa untuk jenjang S1-S2 tahun 2022. Beasiswa ini memberikan fasilitas lengkap. Apa saja? Via: detikedu  https://t.co/cfq6WPsngN,36,3,4,0,2022-01-07,11,Friday,5,40,3
1479407604774408192,2022-01-07 11:00:33,"Zaskia Sungkar belajar ikhlas menerima ujian yang sedang dialaminya. Soal Hafiz Fatur, Zaskia Sungkar akhirnya bicara hal ini:  https://t.co/mEHGo5SKeo",7,1,0,0,2022-01-07,11,Friday,5,7,1
1479407336355729408,2022-01-07 10:59:29,Sekelompok pemburu harta karun yang tergabung dalam Finders Keepers melayangkan gugatan hukum kepada FBI terkait temuan emas seberat 9 Ton. Bagaimana kisahnya? https://t.co/mse8kZ2659,5,0,0,0,2022-01-07,10,Friday,5,5,0
1479407254763937805,2022-01-07 10:59:10,"Memilih jurusan sesuai minat makin lengkap dengan mengetahui prospek karirnya ke depan. Berikut profesi paling dicari di 2025 dan jurusan kuliahnya. Apa saja? 
Via: detikedu  https://t.co/jz8YLwiQQD",6,0,1,0,2022-01-07,10,Friday,5,7,0
1479407009619488778,2022-01-07 10:58:11,Gubernur Jateng Ganjar Pranowo mengunggah video Presiden Jokowi bagi-bagi kaos dengan cara melemparnya dari mobil. Video itu ramai dibully warganet di twitter. https://t.co/s40QsFVvGm,39,41,4,2,2022-01-07,10,Friday,5,43,43
1479406232700174342,2022-01-07 10:55:06,"Ashanty positif COVID-19 pasca perjalanan ke Turki, salah satu negara yang diwaspadai terkait Omicron. Negara ini salah satu penyumbang terbanyak Omicron RI. https://t.co/hYtdPqdaNu",32,4,2,2,2022-01-07,10,Friday,5,34,6
1479405911798161411,2022-01-07 10:53:50,Tren mengadopsi boneka yang dirawat layaknya anak sendiri sedang tren di kalangan artis. Boneka-boneka ini konon menyimpan arwah di dalamnya.  https://t.co/dJHpDkPzO9,2,3,0,0,2022-01-07,10,Friday,5,2,3
1479405889543188484,2022-01-07 10:53:44,"Hujan deras yang mengguyur Surabaya mengakibatkan sejumlah lokasi banjir. Tak hanya itu, banjir juga membuat sejumlah kendaraan mogok. https://t.co/VLHVTBB0bA",5,1,0,1,2022-01-07,10,Friday,5,5,2
1479405645887647750,2022-01-07 10:52:46,Indonesia perlu menambah talenta digital untuk pertumbuhan ekonomi. Salah satu inisiatif di tahun 2021 adalah Huawei dengan pengembangan digital talent. https://t.co/2gFNKTV6aN,2,0,0,0,2022-01-07,10,Friday,5,2,0
1479405099021746179,2022-01-07 10:50:36,"""Apa pun agamanya kalau menghina Tuhan orang lain adalah salah besar,"" kata Ketua PP Muhammadiyah, Dadang Kahmad. https://t.co/ProkOmqo1f",100,33,7,3,2022-01-07,10,Friday,5,107,36
1479404845668909058,2022-01-07 10:49:35,Kapolri Jenderal Listyo Sigit Prabowo mengungkapkan cara kerja aplikasi Monitoring Karantina Presisi untuk memperketat pelaku perjalanan luar negeri. Ini cara kerjanya:  https://t.co/S78P7XfiZ2,3,0,0,1,2022-01-07,10,Friday,5,3,1
1479404602877489156,2022-01-07 10:48:37,"Selain Scream, Wes Craven juga dikenal lewat saga A Nightmare on Elm Street. Dua film horor yang kini sudah jadi bagian tak terpisahkan dari budaya populer.  https://t.co/mGhfQTqGnN",1,0,1,0,2022-01-07,10,Friday,5,2,0
1479404132020764673,2022-01-07 10:46:45,Mau tahu negara mana saja yang punya ratusan bahasa daerah? Cek data bahasA dunia dan populasinya dari lembaga riset Ethnologue: Languages of the World ini. Via: detikedu  https://t.co/ugdbyw5bNA,2,0,0,0,2022-01-07,10,Friday,5,2,0
1479403308406263810,2022-01-07 10:43:29,"Ferdinand mengaku masih awam terkait pemahaman agama, ia pun meminta tolong agar bisa dibimbing. https://t.co/HgjyClPcSI",44,79,5,11,2022-01-07,10,Friday,5,49,90
1479403275615145985,2022-01-07 10:43:21,"Ibunda Gaga Muhammad dikecam karena bicara soal operasi Laura Anna. Kini, giliran ibunda Laura Anna yang beri penjelasan tegas:  https://t.co/p8LMYQjcRS",8,0,1,1,2022-01-07,10,Friday,5,9,1
1479403258137518083,2022-01-07 10:43:17,Menkeu Sri Mulyani Indrawati berbicara mengenai pajak dan prostitusi dalam Podcast Deddy Corbuzier yang dipandu langsung oleh empunya. Begini katanya: https://t.co/aGDfipUKXp,14,5,1,3,2022-01-07,10,Friday,5,15,8
1479402728363376640,2022-01-07 10:41:11,Sebuah bayangan yang diduga berasal dari suatu obyek cukup besar wujudnya telah terekam di layanan peta Google Maps. Ini penampakannya:  https://t.co/94Kwk0rP5p,5,0,0,0,2022-01-07,10,Friday,5,5,0
1479401383870746624,2022-01-07 10:35:50,"Mulai hari ini, Indonesia resmi menutup pintu masuk untuk WNA dari 14 negara. Adapun aturan perjalanan terbaru luar negeri bisa disimak di sini. https://t.co/ct142Hd226",19,1,7,5,2022-01-07,10,Friday,5,26,6
1479401157386772480,2022-01-07 10:34:56,Jaring laba-laba ternyata bahkan lebih kuat dari baja. Sejumlah peneliti membuktikan alasan di balik fakta ini. Via: detikedu  https://t.co/WtvC9HRnSk,18,0,2,2,2022-01-07,10,Friday,5,20,2
1479400156684603394,2022-01-07 10:30:57,"Tahun ini, Rosamund Kwan berusia 59 tahun. Tapi penampilannya dianggap masih sangat muda. Ini potretnya:  https://t.co/iqxIEmsira",21,1,2,0,2022-01-07,10,Friday,5,23,1
1479399914740363266,2022-01-07 10:30:00,Irwansyah akhirnya memilih jalur perdata dalam menggugat Hafiz Fatur. Ia akan mengajukan gugatan ke Pengadilan Negeri Tangerang. https://t.co/dNy0ZaCaTi,5,0,2,0,2022-01-07,10,Friday,5,7,0
1479399638113431555,2022-01-07 10:28:54,"Nama-nama mulai bermunculan mengisi bursa Pilgub DKI Jakarta 2024. Mulai dari Wagub DKI Jakarta Ahmad Riza Patria, sampai PSI. https://t.co/8OomTEJ0XG",1,0,0,0,2022-01-07,10,Friday,5,1,0
1479399175733366785,2022-01-07 10:27:04,Brisia Jodie melewati awal tahun dengan kabar kurang enak. Ia baru saja mengalami kemalingan. #BrisiaJodie   https://t.co/oLjQTWWWDv,3,0,0,0,2022-01-07,10,Friday,5,3,0
1479399165520191488,2022-01-07 10:27:01,Tidak sedikit yang menyuarakan tentang pembiayaan penanganan COVID-19 Ashanty selama di rumah sakit. Bayar sendiri atau ditanggung? https://t.co/0cPWIuBQni,5,5,1,1,2022-01-07,10,Friday,5,6,6
1479398696294961154,2022-01-07 10:25:09,Ashanty menumpahkan kesedihannya karena dianggap membawa virus usai pulang liburan. Begini curahan hatinya:  https://t.co/wJjjq09nVX,211,242,31,71,2022-01-07,10,Friday,5,242,313
1479398676023947281,2022-01-07 10:25:04,"Sebagian orang merasa kopi bisa membangkitkan semangat, namun ada yang justru menyebabkan rasa tersiksa. Terkadang secangkir kopi justru menyebabkan sakit perut. https://t.co/8wmuRcOpo0",0,1,0,0,2022-01-07,10,Friday,5,0,1
1479398194396160006,2022-01-07 10:23:10,Pengantin wanita ini mendadak viral karena atraksi silat saat hari pernikahannya. Ini kisahnya:  https://t.co/TfDOzUEhjH,7,0,0,2,2022-01-07,10,Friday,5,7,2
1479398175945461767,2022-01-07 10:23:05,Gubsu Edy mengaku merasa konyol dirinya menjadi gubernur di zaman sekarang. Kenapa? https://t.co/pm8QhT4fQv,2,9,0,0,2022-01-07,10,Friday,5,2,9
1479397969447243776,2022-01-07 10:22:16,My Man is Cupid mempersatukan Jang Dong Yoon dan Nana After School. Drama ini bergenre fantasi-romansa. #MyManisCupid  https://t.co/y4vsW8AeZv,2,0,0,1,2022-01-07,10,Friday,5,2,1
1479397952040935426,2022-01-07 10:22:12,Berikut daftar harga mobil Wuling bulan Januari 2022. Termurah dibanderol mulai Rp 140 jutaan.  https://t.co/BYEOoxsHLQ,7,0,0,1,2022-01-07,10,Friday,5,7,1
1479396856056721423,2022-01-07 10:17:51,Penyidik KPK melakukan penggeledahan di pendopo Wali Kota Bekasi dan membawa sejumlah dokumen. https://t.co/vEEAXo8tU5,10,0,0,1,2022-01-07,10,Friday,5,10,1
1479396610706747395,2022-01-07 10:16:52,Peringatan bagi klub-klub peminat Erling Haaland di musim panas. Meski klausul rilisnya 'murah' total ongkos transfer Haaland bisa mencapai hampir Rp 5 triliun.  https://t.co/kZhGeWbdB0,1,0,0,0,2022-01-07,10,Friday,5,1,0
1479396607527473154,2022-01-07 10:16:51,PSS Sleman merebut poin sempurna saat menghadapi Persiraja Banda Aceh dalam lanjutan BRI Liga 1. Super Elja menang 4-1 atas Laskar Rencong. https://t.co/icnPnX7nBJ,7,0,0,0,2022-01-07,10,Friday,5,7,0
1479396383237058561,2022-01-07 10:15:58,"Ramai rumor soal Cristiano Ronaldo mau cabut dari Manchester United andai Setan Merah terus tampil buruk. Mau pilih salah satu dari empat klub ini, CR7?  https://t.co/Y0qXhSqMIC",5,1,0,0,2022-01-07,10,Friday,5,5,1
1479396372466081793,2022-01-07 10:15:55,"Philippe Coutinho resmi bergabung ke klub Premier League, Aston Villa. The Little Magician didatangkan dengan status pinjaman.  https://t.co/EDNqdMoUfY",4,1,0,0,2022-01-07,10,Friday,5,4,1
1479396108786966529,2022-01-07 10:14:52,Hujan deras disertai angin kencang yang mengguyur Kota Surabaya mengakibatkan sejumlah lokasi banjir. Banjir mulai dari ketinggian 10 hingga 30 sentimeter. https://t.co/FGk6rYNXe4,5,0,2,1,2022-01-07,10,Friday,5,7,1
1479395644905332736,2022-01-07 10:13:02,Gaji staff bandara jadi hal yang perlu kamu perhatikan kalau ingin bekerja di bandara. Lalu berapa sih besaran gaji staff bandara? https://t.co/pDzhiXsG5X,6,0,0,1,2022-01-07,10,Friday,5,6,1
1479395629541511168,2022-01-07 10:12:58,Newcastle United mendatangkan pemain pertama di era kepemilikan konsorsium Arab Saudi. Kieran Trippier yang menjadi rekrutan perdananya.  https://t.co/9rvHECAmUg,2,0,2,1,2022-01-07,10,Friday,5,4,1
1479394348395798530,2022-01-07 10:07:53,"Warga menembus hujan salju yang turun di Tokyo, Jepang. Kota di bibir teluk itu pun memutih berlapis salju. Suhu menunjukkan 4 derajat Celcius. Dingin. https://t.co/Dih8zYIc3U",2,0,0,0,2022-01-07,10,Friday,5,2,0
1479394106619084802,2022-01-07 10:06:55,Kerusuhan di Kazakhstan menjalar pada masalah baru. Kondisi itu mendorong kenaikan harga uranium yang jadi bahan bakar pembangkit listrik tenaga nuklir. https://t.co/Vt5BtZzXD1,2,0,2,0,2022-01-07,10,Friday,5,4,0
1479393336217718785,2022-01-07 10:03:51,"Philippe Coutinho resmi bergabung ke klub Premier League, Aston Villa. The Little Magician didatangkan dengan status pinjaman. https://t.co/IfIcrmT1hP",29,2,5,1,2022-01-07,10,Friday,5,34,3
1479392554940604417,2022-01-07 10:00:45,Pendaftaran Dewan Komisioner OJK dibuka mulai hari ini 7 Januari 2022. Simak lagi cara dan syaratnya: https://t.co/XxTU8yo3Nc,1,1,1,0,2022-01-07,10,Friday,5,2,1
1479392367853637635,2022-01-07 10:00:00,"Yuk! Ulas Kilas Balik Peristiwa Penting Sepanjang 2021 Bareng detikcom
https://t.co/TfZyprxXHq.",2,0,0,0,2022-01-07,10,Friday,5,2,0
1479391304647905284,2022-01-07 09:55:47,"Tahukah kamu, tim mana yang paling sering kena kartu merah di Liga Inggris? Jawabannya adalah Arsenal, jumlah kartu merahnya sudah 100!  https://t.co/Qfx5uGvjWt",6,1,2,1,2022-01-07,9,Friday,5,8,2
1479390290419011587,2022-01-07 09:51:45,"GMKI dukung Jokowi cabut izin peruahaan minerba dan kehutanan yang tidak lapor rencana kerja. Namun, perusahaan perusak lingkungan juga harus dicabut. https://t.co/q4uIzsngS9",6,0,0,0,2022-01-07,9,Friday,5,6,0
1479389357182226433,2022-01-07 09:48:03,"Indonesia mencatat sebanyak 518 kasus baru COVID-19, Jumat (7/1/2022). DKI menyumbang kasus terbanyak dengan jumlah 300. https://t.co/O82njVSa7D",7,0,1,3,2022-01-07,9,Friday,5,8,3
1479389284889210880,2022-01-07 09:47:45,"GMKI dukung Jokowi cabut izin peruahaan minerba dan kehutanan yang tidak lapor rencana kerja. Namun, perusahaan perusak lingkungan juga harus dicabut. https://t.co/Vec4b5ETES",8,0,3,0,2022-01-07,9,Friday,5,11,0
1479389050377224195,2022-01-07 09:46:49,Petugas Damkar Jaktim mengevakuasi ibu yang sakit di dalam mobil. Keluarga pasien meminta bantuan damkar karena kesulitan mengeluarkan sang ibu dari mobil. https://t.co/HVfJAnH73M,5,0,0,1,2022-01-07,9,Friday,5,5,1
1479388783820918785,2022-01-07 09:45:46,Air mata Azis Syamsuddin menetes ketika mendengarkan kesaksian Yanti Sumiati dalam persidangan. Seperti apa? https://t.co/H5vKwl56Vp,2,2,1,0,2022-01-07,9,Friday,5,3,2
1479388287617978371,2022-01-07 09:43:48,"Selain Ashanty, beberapa orang di rombongannya yang pergi ke Turki juga dikonfirmasi positif Covid-19. Informasi ini diungkapkan pihak Kementerian Kesehatan. https://t.co/ZF1Otd5IYq",62,10,8,8,2022-01-07,9,Friday,5,70,18
1479388272786911234,2022-01-07 09:43:44,"Hayo, gimana coba? https://t.co/lyvs2j2TXM",108,29,14,8,2022-01-07,9,Friday,5,122,37
1479387499550105601,2022-01-07 09:40:40,"Dear Leo, dengan kata-kata lembut ucapan dan arahan kamu akan benar-benar bisa menyentuh hatinya. Simak ramalan zodiak cinta hari ini:  https://t.co/CATkFC6rd7",1,1,0,0,2022-01-07,9,Friday,5,1,1
1479386985341108230,2022-01-07 09:38:37,"Ledakan keras mengagetkan warga di Jalan Donorejo Wetan DKA, Tambakrejo, Simokerto. Satu orang dilarikan ke rumah sakit akibat kejadian itu. https://t.co/q7Q1HBDPIq",5,0,0,0,2022-01-07,9,Friday,5,5,0
1479385747077664769,2022-01-07 09:33:42,Newcastle United mendatangkan pemain pertama di era kepemilikan konsorsium Arab Saudi. Kieran Trippier yang menjadi rekrutan perdananya. https://t.co/xYN1P2hxmU,9,0,3,0,2022-01-07,9,Friday,5,12,0
1479385269971394561,2022-01-07 09:31:48,Kabar Indonesia terancam krisis energi heboh belakangan ini. Hal ini menyusul munculnya kebijakan larangan ekspor batu bara di Januari 2022. https://t.co/u27D0eQOo9,4,0,0,1,2022-01-07,9,Friday,5,4,1
1479384502279544836,2022-01-07 09:28:45,"KPI menyatakan 8 pelaku perundungan dan pelecehan pegawai KPI, MS, sudah tidak lagi bekerja di KPI. Mereka tidak lagi bekerja sejak 1 Januari 2022. https://t.co/qllf2qbgyA",12,1,4,4,2022-01-07,9,Friday,5,16,5
1479384275069943811,2022-01-07 09:27:51,Doddy Sudrajat sempat layangkan somasi terbuka untuk salah satu anggota keluarga H Faisal. Ini tanggapan Faisal:  https://t.co/dkqRMNRCqe,3,0,1,0,2022-01-07,9,Friday,5,4,0
1479384262587658241,2022-01-07 09:27:48,Sederet drama bertema zombie ini siap menguji adrenaline para penonton. Ini daftarnya:  https://t.co/boS4g2G4Y7,9,0,2,1,2022-01-07,9,Friday,5,11,1
1479383504836345859,2022-01-07 09:24:47,"Pasangan drama Korea What's Wrong with Secretary Kim, Park Min Young dan Park Seo Joon kembali digosipkan berpacaran. Ini alasannya:  https://t.co/7PJSWv0H66",8,0,1,4,2022-01-07,9,Friday,5,9,4
1479383488981831680,2022-01-07 09:24:44,Penyidik KPK melakukan penggeledahan di Pendopo Wali Kota Bekasi dan membawa sejumlah dokumen. https://t.co/MnSbHoML1x,6,0,0,0,2022-01-07,9,Friday,5,6,0
1479382904832671753,2022-01-07 09:22:24,Inilah kisah seekor anjing Alaskan Malamute bernama North yang dengan setia menunggui pemiliknya yang terjatuh dari atas gunung salju selama 13 jam! https://t.co/HRIpQMJn8a,35,3,2,1,2022-01-07,9,Friday,5,37,4
1479382881894117379,2022-01-07 09:22:19,Korban meninggal akibat tanah longsor di Jayapura tercatat menjadi 7 orang. https://t.co/GVfAhe5EgL,4,1,0,0,2022-01-07,9,Friday,5,4,1
1479382412572475397,2022-01-07 09:20:27,"Seorang turis 21 tahun, Melaniya Pavlova, terjebak di Kazakhstan. Dia bilang situasi saat ini sangat mencekam dan menakutkan dengan suara tembakan bertubi-tubi. https://t.co/nE2OW4ZnD4",5,0,1,0,2022-01-07,9,Friday,5,6,0
1479382394411044867,2022-01-07 09:20:23,"MA menolak gugatan warga terhadap Perpres Nomor 14 Tahun 2021. Alhasil, sanksi pidana bagi yang tidak mau divaksin dikuatkan MA. https://t.co/Akbf0uFmtT",17,8,7,11,2022-01-07,9,Friday,5,24,19
1479382298495651841,2022-01-07 09:20:00,"Hai para suami, yuk kasih tau istrinya suruh ikutan program ""Modal Usaha untuk Suami"" dari detikcom! Di program ini para istri berkesempatan mendapatkan hadiah ""Modal Usaha untuk Suami"" senilai jutaan rupiah lho.⁣⁣⁣
⁣⁣⁣
Langsung aja kunjungi https://t.co/dG0yoZAZCY ya! https://t.co/pkPQ2QuxHR",11,2,1,0,2022-01-07,9,Friday,5,12,2
1479381897734144002,2022-01-07 09:18:24,"Pelatih tim biliar Sumut pada PON Papua, Choki, yang dijewer Edy Rahmayadi mendapat surat jawaban somasi dari Pemprov Sumut. Apa isinya? https://t.co/onMdiwt0k7",5,2,0,0,2022-01-07,9,Friday,5,5,2
1479381883251302400,2022-01-07 09:18:21,Sejumlah peserta tampak membawa spanduk dan poster tuntutan mereka. Spanduk tersebut antara lain bertuliskan 'Tangkap!! Ferdinand Hutahaean Merendahkan Tuhan'. https://t.co/Fe1JbnjhGR,5,5,2,1,2022-01-07,9,Friday,5,7,6
1479381617919643651,2022-01-07 09:17:17,"Siew Pui Yi, juga dikenal sebagai MsPuiyi, merupakan selebgram asal Malaysia. Ia jadi cewek pertama Malaysia yang tampil di majalah Penthouse. Ini sosoknya:  https://t.co/bAjpUvNUPa",17,1,2,3,2022-01-07,9,Friday,5,19,4
1479381154830639107,2022-01-07 09:15:27,"Meskipun pencoretan Praveen Jordan/Melati Daeva Oktavianti dari Pelatnas belum pasti, namun keduanya dinilai masih pantas diberi kesempatan.  https://t.co/zgHajGfEUr",3,0,0,0,2022-01-07,9,Friday,5,3,0
1479381144886038531,2022-01-07 09:15:25,Komnas Perlindungan Anak menyambangi rumah keluarga H. Faisal. Komnas PA menyebut kondisi Gala Sky dalam keadaan sehat bersama keluarga H. Faisal. https://t.co/ctV2CGwPIo,5,0,0,0,2022-01-07,9,Friday,5,5,0
1479380890241445894,2022-01-07 09:14:24,Mobil yang ditumpangi Kolonel Priyanto dan dua anggota TNI lainnya mengubah cat mobil setelah membuang mayat Handi Saputra dan Salsabila. Ketiganya diduga hendak mencoba menghilangkan barang bukti. https://t.co/vLjWyBBKdO,12,5,2,0,2022-01-07,9,Friday,5,14,5
1479380649895211009,2022-01-07 09:13:27,Ibu-ibu itu terjatuh ke kali usai sepeda motornya yang ditumpanginya mengalami kecelakaan. Bagaimana ceritanya? https://t.co/BSt05jeGEI,2,1,1,0,2022-01-07,9,Friday,5,3,1
1479380345392930819,2022-01-07 09:12:14,"Bareskrim melakukan pemeriksaan saksi ahli di kasus cuitan Ferdinand Hutahaean soal 'Allahmu ternyata lemah'. Total, ada 15 orang saksi yang sudah diperiksa. https://t.co/UshgfJZGYf",13,7,4,2,2022-01-07,9,Friday,5,17,9
1479379838662291457,2022-01-07 09:10:13,Rahmat Effendi ditetapkan sebagai tersangka KPK. Simak sejumlah fakta terkait penangkapannya: https://t.co/af5b09YLPH,4,2,1,0,2022-01-07,9,Friday,5,5,2
1479379820584783876,2022-01-07 09:10:09,Indonesia akan segera memulai program vaksinasi booster. Kapan dan siapa saja penerimanya?  https://t.co/6lwWPEq4hr,5,0,6,3,2022-01-07,9,Friday,5,11,3
1479378524020477952,2022-01-07 09:05:00,"Buat detikers yang menjadi anak pertama, atau bahkan punya kakak anak pertama ada kejutan spesial nih dari detikcom untuk kamu. Di program ini, semua anak pertama berkesempatan mendapatkan handphone senilai belasan juta rupiah lho.⁣⁣
⁣⁣
Klik link https://t.co/7nSz174sWC https://t.co/0ytCbefXuZ",15,1,6,1,2022-01-07,9,Friday,5,21,2
1479377801769857024,2022-01-07 09:02:08,"Indonesia melaporkan 518 kasus COVID-19 pada Jumat (7/1/2022). Total kasus positif menjadi 4.265.187, sembuh 4.115.572, dan meninggal 144.121. https://t.co/2SvBV5bZDR",5,0,1,0,2022-01-07,9,Friday,5,6,0
1479377800100519937,2022-01-07 09:02:07,"Salma Mahesa (15), gadis asal Kabupaten Sukabumi dikabarkan hilang usai gagal menikah. Salma disebut kerap kabur dari rumah. https://t.co/cqKk9NK99C",4,1,3,1,2022-01-07,9,Friday,5,7,2
1479377719435710466,2022-01-07 09:01:48,"Pemakaian kartu kredit sangat perlu diawasi, apalagi jika akun terhubung dengan gadget Si Kecil. Jangan sampai mengalami hal seperti pria ini. #detikNetwork  https://t.co/4N90qFvwnR",1,0,3,0,2022-01-07,9,Friday,5,4,0
1479377454733144064,2022-01-07 09:00:45,Benarkah Gading Marten dan Gisel rujuk? Raffi Ahmad berikan kode ini:  https://t.co/CAg5eyiSeA,8,0,3,2,2022-01-07,9,Friday,5,11,2
1479377220053389312,2022-01-07 08:59:49,Atta Halilintar dan Aurel Hermansyah menegaskan dan memastikan tak terpapar COVID-19. Atta dan Aurel berikan bukti ini:  https://t.co/Hr1vGqeQ1V,2,0,1,0,2022-01-07,8,Friday,5,3,0
1479376930717712385,2022-01-07 08:58:40,Siswi bernama Nawal Citra Ardina (14) itu tak pulang setelah sebelumnya pamit ke sekolah dan jalan bersama temannya. #detiktif https://t.co/osv1W7IQwB,8,0,4,0,2022-01-07,8,Friday,5,12,0
1479376687586545664,2022-01-07 08:57:42,Komnas Perlindungan Anak meminta agar Doddy Sudrajat dan H. Faisal menyudahi polemik tentang hak asuh Gala Sky. Kedunya pun disarankan untuk duduk bersama menyelesaikan masalah. https://t.co/TcQEDJuSzx https://t.co/NxUWHHJ6cd,4,1,1,1,2022-01-07,8,Friday,5,5,2
1479376093190803459,2022-01-07 08:55:20,"""Munculnya cuitan itu adalah akibat dari dan atas pergumulan pribadi saya yang memang sedang menderita penyakit yang sudah menahun dan tidak kunjung sembuh,"" kata Ferdinand. https://t.co/lRZaAMiCYU",70,216,17,64,2022-01-07,8,Friday,5,87,280
1479376073716609025,2022-01-07 08:55:16,"Secara tampilan luar, tentu Mitsubishi New Xpander tipe Sport hadir mirip dengan tipe Ultimate. Namun tipe Sport dipangkas fitur cruise control-nya.  https://t.co/KRX3272wiO",1,1,1,0,2022-01-07,8,Friday,5,2,1
1479375578012819464,2022-01-07 08:53:17,What?! Harga minyak goreng di Korea Utara tembus 45.000 won Korea Utara atau setara dengan Rp 719 ribu! https://t.co/ZaHaHSDOoJ,42,16,7,6,2022-01-07,8,Friday,5,49,22
1479375089003122689,2022-01-07 08:51:21,Ashanty sebut jadi beban negara saat terpapar COVID-19 usai liburan. Begini jawaban menohok Ashanty:  https://t.co/pnp3HMusNd,46,40,17,6,2022-01-07,8,Friday,5,63,46
1479374837034336258,2022-01-07 08:50:21,"Hai detikers, udah pada ikutan program Kalung untuk Istri belum? Kali ini para suami se-Indonesia punya kesempatan bikin senang istri dengan bawa pulang hadiah kalung emas lho. 

Caranya klik di sini https://t.co/fdrW1ukSpm https://t.co/BHMaMoU3D2",2,0,0,0,2022-01-07,8,Friday,5,2,0
1479374207536406532,2022-01-07 08:47:51,"Hai detikers, udah pada ikutan program Motor untuk Mertua belum? Di program ini para menantu dan calon menantu se-Indonesia bisa bawa pulang motor untuk para mertua / calon mertua. Ini saatnya kamu menjadi menantu idaman. Caranya bisa cek di sini ya https://t.co/T0EAWsdQMi https://t.co/kCnUiL7qOd",3,1,0,0,2022-01-07,8,Friday,5,3,1
1479373997351616512,2022-01-07 08:47:01,"Mantan Bupati Sidoarjo, Saiful Ilah bebas murni. Sebelumnya, ia tersandung kasus suap proyek infrastruktur di Dinas PUPR. https://t.co/zdawLIDk6V",1,1,2,0,2022-01-07,8,Friday,5,3,1
1479373423541374978,2022-01-07 08:44:44,Philippe Coutinho tinggal selangkah lagi bergabung ke Aston Villa. Barcelona kabarnya sepakat meminjamkan The Little Magician ke klub Inggris tersebut.  https://t.co/5Jka6UXF2a,3,0,0,0,2022-01-07,8,Friday,5,3,0
1479372659213406209,2022-01-07 08:41:42,Umat muslim diajarkan untuk memuliakan tamu. Ketika mengundang keluarga atau kerabat maka wajib hukumnya menjamu dengan makanan yang baik dan jumlahnya cukup. https://t.co/dQRZXgorXS,14,2,6,0,2022-01-07,8,Friday,5,20,2
1479372646202724354,2022-01-07 08:41:38,"JK Rowling kembali tuai kontroversi setelah tudingan antisemitisme beredar. Kini sebuah sekolah di kawasan Essex, Inggris mengganti nama sekolahnya. https://t.co/xN04eq8nWi",1,1,1,0,2022-01-07,8,Friday,5,2,1
1479372169486516225,2022-01-07 08:39:45,Pihak Gubsu Edy mengungkit bonus Rp 100 juta yang diterima Khoirudin Aritonang atau Choki sebagai pelatih biliar tim Sumut untuk PON. Pihak Choki heran. https://t.co/NmmZvBaePl,5,3,1,2,2022-01-07,8,Friday,5,6,5
1479372145390194692,2022-01-07 08:39:39,Kekalahan AS Roma dari AC Milan diwarnai ejekan berbau pelecahan rasial kepada Zlatan Ibrahimovic. Jose Mourinho pun langsung mencegah aksi fans I Lupi itu.  https://t.co/CVYud0XMsZ,1,0,1,1,2022-01-07,8,Friday,5,2,1
1479371657022218241,2022-01-07 08:37:43,Bareskrim Polri terus mengusut dugaan suap Rachel Vennya agar bebas dari karantina usai dari luar negeri. Rachel Vennya segera dipanggil. https://t.co/Aqn0nECySu,5,1,2,0,2022-01-07,8,Friday,5,7,1
1479371398569242626,2022-01-07 08:36:41,Farida Nurhan atau akrab disapa Omay merupakan food vlogger hits di Indonesia. Omay punya banyak followers dan sejumlah fakta yang menarik diketahui. https://t.co/4F7pMEmzmc,1,0,1,0,2022-01-07,8,Friday,5,2,0
1479370900478865411,2022-01-07 08:34:42,Danau Cinere yang dulu sempat terbengkalai kini berubah menjadi kawasan wisata dan kuliner. Suasananya yang bersih dan nyaman membuat Cinere Garden Food Street cocok untuk menghabiskan waktu bersama keluarga dan kerabat.  https://t.co/537pahdyqy,5,0,1,0,2022-01-07,8,Friday,5,6,0
1479370408596021259,2022-01-07 08:32:45,"Tol Gedebage-Tasikmalaya-Cilacap sepanjang 206,65 km membutuhkan biaya investasi Rp 56,2 triliun. Dari mana dana pembangunannya? https://t.co/pWTBCb6iap",5,1,5,1,2022-01-07,8,Friday,5,10,2
1479370195915395081,2022-01-07 08:31:54,Makan Konate absen membela Persija Jakarta saat melawan PSIS Semarang. Kenapa?  https://t.co/CnieHHvRU2,2,0,1,0,2022-01-07,8,Friday,5,3,0
1479369869414051845,2022-01-07 08:30:36,"Dua dari tiga kawanan pencuri kambing ditangkap dan dihakimi massa di Purwakarta, Jawa Barat. Dalam aksinya, pelaku meracuni kambing milik korban hingga mati dan menjual bangkainya. Satu pelaku masih diburu. https://t.co/tmvmDBrSrv",7,2,2,0,2022-01-07,8,Friday,5,9,2
1479369851449876481,2022-01-07 08:30:32,"Menilik jadwal BRI Liga 1, pada hari Jumat (7/1) ini akan dua partai yang dihelat. Termasuk duel Persib Bandung Vs Persita Tangerang nanti malam.  https://t.co/XAG6Pc65FE",3,0,0,0,2022-01-07,8,Friday,5,3,0
1479369601855148035,2022-01-07 08:29:33,PT LIB menyurati Gubernur Bali Wayan Koster. Itu buntut adanya protes dari Persebaya Surabaya yang menyatakan ruang ganti pemain di stadion sempit dan panas.  https://t.co/xyn8ClQeY1,11,5,1,3,2022-01-07,8,Friday,5,12,8
1479369600525602818,2022-01-07 08:29:32,"Di tengah kasus yang menderanya soal cuitan 'Allahmu lemah', Ferdinand Hutahaean ngaku sudah jadi seorang mualaf sejak tahun 2017. https://t.co/3vuqvQJLaV",22,42,0,3,2022-01-07,8,Friday,5,22,45
1479368861057269761,2022-01-07 08:26:36,"Dua tersangka telah ditangkap terkait temuan mayat, dengan penyelidikan terus dilakukan otoritas setempat. https://t.co/txOiap1jNv",2,0,0,0,2022-01-07,8,Friday,5,2,0
1479368665992728576,2022-01-07 08:25:49,"Dua dari tiga kawanan pencuri kambing ditangkap dan dihakimi massa di Purwakarta, Jawa Barat. Dalam aksinya, pelaku meracuni kambing milik korban hingga mati dan menjual bangkainya. Satu pelaku masih diburu. https://t.co/K5jDLoPaog https://t.co/nZAwehT5Hk",4,2,0,0,2022-01-07,8,Friday,5,4,2
1479368381660807174,2022-01-07 08:24:42,"Adik Gus Dur, Lily Wahid, membenarkan dirinya menjadi saksi saat Ferdinand Hutahaean menjadi mualaf. Dia juga menyampaikan sikap soal kasus Ferdinand. https://t.co/XmLigrn0nV",475,96,76,23,2022-01-07,8,Friday,5,551,119
1479368373280681989,2022-01-07 08:24:40,Pemotor inisial ARS terlempar dari atas flyover Pesing usai tertabrak mobil. Ia mengalami patah tulang dan dirawat di rumah sakit. https://t.co/I19TzfCAiG,3,4,1,2,2022-01-07,8,Friday,5,4,6
1479367805640261632,2022-01-07 08:22:24,"Korban mengaku telah mengirimkan siomai sesuai pesanan terlapor. Namun, hingga saat ini uang pembelian seharga Rp 4,2 juta tidak kunjung dibayar terlapor. https://t.co/CApWqeMZbp",5,0,3,0,2022-01-07,8,Friday,5,8,0
1479367717031493636,2022-01-07 08:22:03,"Jl Saluran Irigasi Gempol, Pondok Ungu, Medan Satria, Kota Bekasi hancur. Sehingga, pengendara harus berhati-hati saat melintas di lokasi. #detikcomdoyourmagic https://t.co/BOcX1pl6Yg",4,2,0,1,2022-01-07,8,Friday,5,4,3
1479367700916977665,2022-01-07 08:21:59,"Operasional mobil listrik wisata di Kota Solo mendapatkan kritikan dari pengamat transportasi, Djoko Setijowarno karena dianggap melanggar aturan.  https://t.co/e60tvWleG6",5,1,1,0,2022-01-07,8,Friday,5,6,1
1479366961649836037,2022-01-07 08:19:03,"Kerupuk biasanya digoreng menggunakan minyak goreng, namun netizen asal Malaysia punya cara lain. Ia memakai garam kasar untuk menggoreng kerupuk. https://t.co/mpCxl8xyAC",3,3,0,1,2022-01-07,8,Friday,5,3,4
1479366416096804864,2022-01-07 08:16:53,Tiket MotoGP Mandalika sudah mulai dijual. Paling mahal tiket ini dijual dengan harga Rp 15 juta. Ribuan tiket kelas sultan itu langsung habis terjual.  https://t.co/GG1rzbeXa6,69,11,11,4,2022-01-07,8,Friday,5,80,15
1479366164606296065,2022-01-07 08:15:53,SMA CT Arsa Sukoharjo tengah membuka pendaftaran siswa ajaran 2023/2023. Murid diberi beasiswa penuh sampai asrama. Via: detikedu  https://t.co/L4Sez0quZe,3,0,2,1,2022-01-07,8,Friday,5,5,1
1479366151088099332,2022-01-07 08:15:50,Warga Petamburan menyampaikan terima kasih ke Anies telah mencabut Kepgub 122 tahun 1997 tentang hak tanah. Warga Petamburan mengundang Anies untuk syukuran. https://t.co/a9ikLG8ZFw,5,2,1,0,2022-01-07,8,Friday,5,6,2
1479365890005209088,2022-01-07 08:14:48,"Gaji Gubernur BI mungkin membuat sebagian orang penasaran. Ternyata segini besarannya. Eits, jangan kaget. https://t.co/T7hRXjRPtH",7,1,1,0,2022-01-07,8,Friday,5,8,1
1479365303977054208,2022-01-07 08:12:28,Ashanty menceritakan kondisinya yang kini menjalani perawatan di rumah sakit karena positif Covid-19. Ia ngaku tak merasakan gejala berat. #Ashanty  https://t.co/yv78dW2Ods,10,0,0,0,2022-01-07,8,Friday,5,10,0
1479364806410911746,2022-01-07 08:10:29,Mark Sungkar dikabarkan tengah terbaring di rumah sakit. Mark mengidap sakit jantung yang makin parah. Lekas pulih Mark Sungkar...  https://t.co/M3bxhSYwz4,7,0,0,0,2022-01-07,8,Friday,5,7,0
1479364805169451008,2022-01-07 08:10:29,Gunung Merapi kembali memuntahkan awan panas siang hari ini. #Merapi https://t.co/2zqpof6Sbr,12,1,0,0,2022-01-07,8,Friday,5,12,1
1479364556300431361,2022-01-07 08:09:30,"Seorang wanita di Asahan, Sumatera Utara disiram air keras oleh suaminya sendiri. Salah satu mata korban nyaris buta. https://t.co/M7wxhvd0eR",6,1,1,0,2022-01-07,8,Friday,5,7,1
1479364301387350018,2022-01-07 08:08:29,"Sempat viral soal Jan Ethes yang mampu mengingat nama-nama pemimpin dunia dengan baik, ternyata ada fakta ilmiah terkait hal ini. Yuk, simak penjelasannya. 
Via: detikedu  https://t.co/FqmUvVPKl5",41,8,3,1,2022-01-07,8,Friday,5,44,9
1479363793868185605,2022-01-07 08:06:28,"Ada banyak jurusan kuliah yang bisa dipilih siswa IPS. Di antara jurusan tersebut, 10 jurusan ini diketahui paling favorit di kalangan mereka. Apa saja? Via: detikedu  https://t.co/uBALiE02rM",3,1,1,1,2022-01-07,8,Friday,5,4,2
1479363066328502273,2022-01-07 08:03:34,Budiono dihukum mati oleh PN Sanggau. Budiono terbukti mengontrol penyelundupan sabu dari Malaysia ke Indonesia lewat jalur tikus. https://t.co/n5I9sIlGs6,20,3,0,0,2022-01-07,8,Friday,5,20,3
1479363060691345414,2022-01-07 08:03:33,Surat penunjukan Tri sebagai Plt Wali Kota Bekasi diserahkan langsung oleh Gubernur Jabar Ridwan Kamil di Bandung. https://t.co/kpcVDHfth5,4,2,0,0,2022-01-07,8,Friday,5,4,2
1479362238444093446,2022-01-07 08:00:17,"Hobi Ivan Kurniawan akan reptil ternyata bisa menjadi sumber rezeki di masa pandemi. Dengan menjual tokek hias atau gecko, Ivan meraup untung puluhan juta rupiah setiap bulan. https://t.co/5GhELSlkBY",2,1,0,0,2022-01-07,8,Friday,5,2,1
1479361993236783106,2022-01-07 07:59:19,"Menghangatkan tubuh di musim hujan seperti ini bisa dengan menyantap hot pot berkuah hangat. Di Jakarta, ada beberapa restoran hot pot yang terkenal enak. https://t.co/YxYKJSlfru",5,0,0,1,2022-01-07,7,Friday,5,5,1
1479361500791857154,2022-01-07 07:57:21,"Ruang publik di Kabupaten Majalengka, Jawa Barat, semakin bertambah dengan kehadiran ‘Taman Sejarah Majalengka’. Taman senilai Rp 3,5 miliar ini menggambarkan kisah sejarah hingga deretan tokoh pimpinan Majalengka. https://t.co/vmWew4rtzU",3,0,1,0,2022-01-07,7,Friday,5,4,0
1479360999916507138,2022-01-07 07:55:22,Bareskrim Polri mengusut dugaan suap demi bisa kabur karantina yang dilakukan selebgram Rachel Vennya. Ada saksi yang sudah diperiksa. https://t.co/WPemqMq7Kc,6,1,3,1,2022-01-07,7,Friday,5,9,2
1479360986981318656,2022-01-07 07:55:19,"Munculnya wahana baru di Teras Kaca, Ngopi in The Sky, memantik polemik. Kini, wahana itu ditutup oleh Pemda Daerah Istimewa Yogyakarta. https://t.co/e2wQeMrKpM",12,3,6,1,2022-01-07,7,Friday,5,18,4
1479360490962927617,2022-01-07 07:53:20,"Bagi yang berminat memilih UI sebagai PTN pilihan untuk SNMPTN 2022 nanti, tidak ada salahnya untuk mengintip besaran uang kuliah di sana. Cek di sini yuk! Via: detikedu  https://t.co/ABMbT6dOE6",2,1,1,0,2022-01-07,7,Friday,5,3,1
1479360222527377410,2022-01-07 07:52:16,Arist Merdeka Sirait sebagai Ketua Komnas PA bersedia jadi saksi ahli dalam sidang perwalian Gala Sky. https://t.co/c8BkLwQxaq,3,0,0,1,2022-01-07,7,Friday,5,3,1
1479359689284595713,2022-01-07 07:50:09,Sampai saat ini Ashanty belum merasakan gejala yang berat usai terpapar virus COVID-19 lagi. #Ashanty  https://t.co/IsFAustzhR,4,5,0,0,2022-01-07,7,Friday,5,4,5
1479359194604134403,2022-01-07 07:48:11,Film Dear Nathan: Thank You Salma jadi penutup dari trilogi. Filmnya pun mengangkat isu kekerasan seksual dan membawa pesan positif. https://t.co/5ZGixEzsXI,7,0,0,0,2022-01-07,7,Friday,5,7,0
1479358937011007489,2022-01-07 07:47:10,Ashanty akhirnya berikan penjelasan soal bagaimana dirinya bisa terpapar COVID-19 untuk kedua kali. Begini kronologinya:  https://t.co/iEemLqnj6b,7,10,0,0,2022-01-07,7,Friday,5,7,10
1479358658299453441,2022-01-07 07:46:03,"Siswa DKI Jakarta yang ingin daftar SNMPTN 2022 di UI, apakah dihitung beda provinsi jika pilih dua PTN? Jawaban LTMPT begini. via: detikedu  https://t.co/wmRYS0bExr",4,0,2,0,2022-01-07,7,Friday,5,6,0
1479358635243413506,2022-01-07 07:45:58,Atta Halilintar membantah dirinya positif COVID-19 sepulang dari Turki. Kabar ini langsung ia sampaikan di akun Instagram pribadi miliknya. https://t.co/DgihRoGIsT,3,1,0,1,2022-01-07,7,Friday,5,3,2
1479358135093633024,2022-01-07 07:43:59,Garena Indonesia mengumumkan bahwa Advance Server Free Fire resmi dibuka. Segera daftar dan dapatkan ratusan hingga ribuan diamond gratis. https://t.co/rIWlV130IN,3,0,0,0,2022-01-07,7,Friday,5,3,0
1479357109317734400,2022-01-07 07:39:54,"Setelah terakhir membintangi drama Run On pada 2020, Im Si Wan siap menyapa penggemar dengan kembali berakting di serial Tracer. #Tracer  https://t.co/giAa9wZIsH",7,1,1,2,2022-01-07,7,Friday,5,8,3
1479356370751299585,2022-01-07 07:36:58,Manga My Hero Academia menuju final. Komiknya pun dikabarkan mengalami kenaikan penjualan mencpai 50 juta eksemplar di seluruh dunia. https://t.co/7XcDb6Giml,7,0,2,0,2022-01-07,7,Friday,5,9,0
1479355586655539200,2022-01-07 07:33:51,Armand Maulana bicara soal aksi fanatisme fans musisi Indonesia. Begini kata Armand:  https://t.co/docDZzAGLL,4,1,0,0,2022-01-07,7,Friday,5,4,1
1479354592064323588,2022-01-07 07:29:54,"Kemendagri tengah melakukan uji coba e-KTP digital. Konsepnya, identitas dan dokumen kependudukan nantinya hanya tersimpan di handphone. https://t.co/l9LdBnuP7P",160,140,32,46,2022-01-07,7,Friday,5,192,186
1479354335763083264,2022-01-07 07:28:53,Fintech makin sering diucapkan di era sekarang. Sebenarnya apa itu fintech dan seperti apa manfaat yang diberikan oleh fintech? Simak di sini:  https://t.co/ynEY1jTy6x,2,0,0,0,2022-01-07,7,Friday,5,2,0
1479353936813432833,2022-01-07 07:27:18,Tugu #Pamulang yang sempat disorot banyak pihak karena berbeda dengan gambar desain hampir selesai direnovasi. Begini wujudnya yang siap diresmikan! https://t.co/Jqe2grfCmO,2,0,1,3,2022-01-07,7,Friday,5,3,3
1479353244434550784,2022-01-07 07:24:33,Penyanyi Ashanty dikabarkan positif COVID-19 varian omicron usai balik pelesiran dari Turki. Kemenkes beri penjelasan. https://t.co/NtakPubBt4,10,10,0,1,2022-01-07,7,Friday,5,10,11
1479353004742647810,2022-01-07 07:23:36,Wapres Ma'ruf Amin mengatakan penambahan posisi Wamendagri didasari oleh besarnya volume pekerjaan. https://t.co/iD6UclSCdY,6,1,1,0,2022-01-07,7,Friday,5,7,1
1479352708188549121,2022-01-07 07:22:25,"Pemerintah berencana bikin e-KTP digital yang bisa disimpan di handphone, lengkap dengan dokumen yang terintegrasi e-KTP. Lantas, bagaimana nasib e-KTP fisik? https://t.co/PBfjm9xZVl",28,38,9,9,2022-01-07,7,Friday,5,37,47
1479352119983579144,2022-01-07 07:20:05,Di Malaysia ada aturan denda Rp 34 juta jika penjual ketahuan membungkus makanan pakai staples atau benda membahayakan lainnya. https://t.co/CnKP4Dj2nI,107,11,33,10,2022-01-07,7,Friday,5,140,21
1479351613869412360,2022-01-07 07:18:04,"Elizabeth Holmes jadi pemberitaan karena akhirnya dinyatakan bersalah telah mendirikan startup mentereng yang ternyata bodong, Theranos. Ini sosoknya:  https://t.co/FzGGc0AYAD",9,1,2,0,2022-01-07,7,Friday,5,11,1
1479351128231981057,2022-01-07 07:16:08,"Dengan panjang tol 206,65 km, maka total biaya yang dibutuhkan untuk menjajal Gedebage-Tasikmalaya-Cilacap secara penuh kurang lebih Rp 418.500. https://t.co/WXa5BrLH1z",12,3,1,2,2022-01-07,7,Friday,5,13,5
1479350377782861828,2022-01-07 07:13:09,"Samsung Galaxy Tab A8 resmi diperkenalkan pertengahan Desember 2021. Kabar baiknya, tablet Android murah ini segera hadir di Indonesia.  https://t.co/fokLv9YPIh",3,0,2,0,2022-01-07,7,Friday,5,5,0
1479349878572871680,2022-01-07 07:11:10,"Google akan meningkatkan integrasi perangkat di ekosistem Android, Chromebook, dan Windows. Integrasi ini mirip seperti yang ditawarkan Apple saat ini.  https://t.co/8x7Ss56b6C",6,0,1,0,2022-01-07,7,Friday,5,7,0
1479349111522529280,2022-01-07 07:08:07,Sedang dirancang pesawat antariksa yang akan melaju begitu jauh selama puluhan tahun dan menjangkau area luar angkasa di mana Matahari sudah tidak ada pengaruhnya. https://t.co/dLmichguNF,3,1,1,0,2022-01-07,7,Friday,5,4,1
1479348576413175812,2022-01-07 07:06:00,"Rendang daging bumbu putih ini tidak pedas tetapi gurih meresap mantap. Meskipun tanpa cabe merah, rasanya juga lezat dan enak dimakan sebagau lauk nasi. https://t.co/GcVZ7GmbX7",4,0,0,0,2022-01-07,7,Friday,5,4,0
1479347843584471044,2022-01-07 07:03:05,Bocoran harga Samsung Galaxy S22 series terkuak tidak lama sebelum rilis. Ponsel flagship anyar ini rumornya akan dijual dengan harga mulai dari Rp 14 jutaan. https://t.co/StmzlJblyJ,5,0,2,1,2022-01-07,7,Friday,5,7,1
1479347825960013825,2022-01-07 07:03:01,"Ajang penghargaan game yang diselenggarakan Valve, The Steam Awards 2021 sudah berakhir. Beragam judul berkualitas pun hadir. Ini daftar pemenangnya:  https://t.co/pki1nQEny2",0,0,1,0,2022-01-07,7,Friday,5,1,0
1479347539971297286,2022-01-07 07:01:53,"Pengamat Transportasi Nasional Djoko Setijowarno menilai, sebaiknya Wali Kota Solo Gibran Rakabuming Raka menghentikan operasional mobil listrik untuk wisata.  https://t.co/1NW48Jx4kF",6,0,0,0,2022-01-07,7,Friday,5,6,0
1479347189809881088,2022-01-07 07:00:29,"Sebelumnya Ashanty dikabarkan sempat menjalani karantina di sebuah hotel di Jakarta. Diketahui, Ashanty dan keluarga besarnya baru saja pulang liburan dari Turki. #CNNIndonesia #detiknetwork  https://t.co/JbgDsjQEP2",5,2,1,1,2022-01-07,7,Friday,5,6,3
1479346700624056322,2022-01-07 06:58:33,China resmi meluncurkan kapal induk terbarunya pada akhir Desember 2021. Yuk intip spesifikasinya.  https://t.co/dyHmz9cyKe,5,0,0,0,2022-01-07,6,Friday,5,5,0
1479346202214903809,2022-01-07 06:56:34,Aksi pembobolan warung bakso di Klaten viral di media sosial. Pencuri nekat menggasak 9 kotak infak di warung samping Mapolsek Manissrenggo itu. https://t.co/kIDi6AjtEZ,2,2,0,0,2022-01-07,6,Friday,5,2,2
1479345961126277121,2022-01-07 06:55:36,Ferdinand mengaku dia merupakan seorang muslim. Bagaimana pengakuannya? https://t.co/KUa1BsV2Q0,174,192,34,55,2022-01-07,6,Friday,5,208,247
1479345959884705795,2022-01-07 06:55:36,PDHI mengajukan gugatan karena merugikan UU Ciptaker merugikan. https://t.co/1OaSMPMNGU,6,0,2,1,2022-01-07,6,Friday,5,8,1
1479345472938688512,2022-01-07 06:53:40,Ashanty dipastikan terinfeksi COVID-19. Namun anak-anaknya dipastikan negatif COVID-19. https://t.co/pl5cVHbjlC,3,0,1,0,2022-01-07,6,Friday,5,4,0
1479345214854774787,2022-01-07 06:52:38,"Harley-Davidson bakal menggandeng pabrikan Taiwan, Kymco, untuk mengembangkan motor listrik. Ini detail kerja samanya.  https://t.co/1saZDXTVk4",14,1,4,0,2022-01-07,6,Friday,5,18,1
1479344933072949250,2022-01-07 06:51:31,Huawei MateBook 14s dan 14 resmi dirilis Desember 2021 di Indonesia. Kedua laptop ini digadang sebagai pesaing MacBook Air M1. Segini harganya:  https://t.co/xeVbW3CpKB,3,1,1,0,2022-01-07,6,Friday,5,4,1
1479344691564982273,2022-01-07 06:50:34,Comeback Lionel Messi bersama PSG dibayangi tuduhan miring. Messi dituding tak menghormati Mauricio Pochettino saat positif virus corona belum lama ini.  https://t.co/E3dKkm0LZo,4,0,1,0,2022-01-07,6,Friday,5,5,0
1479344690197680128,2022-01-07 06:50:33,Samsung mulai gulirkan update One UI 4.0 ke perangkat menengahnya. Galaxy A52 dan A72 jadi dua ponsel yang segera mendapatkan update berbasis Android 12.  https://t.co/Y2X6UTZ5a6,8,0,2,1,2022-01-07,6,Friday,5,10,1
1479343878444662788,2022-01-07 06:47:20,"Sebuah mobil menabrak 3 motor di flyover Pesing, Jakarta Barat. Salah satu pemotor terlempar hingga jatuh ke bawah. Bagaimana kejadiannya? https://t.co/Loo1iI50Em",24,5,7,5,2022-01-07,6,Friday,5,31,10
1479343633589768192,2022-01-07 06:46:21,Sampah antariksa berpotensi membuyarkan mimpi Elon Musk untuk menmbangun kehidupan di planet lain dan membuat manusia terperangkap di Bumi. https://t.co/7aRI8cqLS6,4,0,1,0,2022-01-07,6,Friday,5,5,0
1479343346552393730,2022-01-07 06:45:13,"Deretan foto ini menimbulkan efek ilusi optik yang mengecoh mata dan otak. Akibatnya kepala jadi pusing setelah melihatnya, berani coba? https://t.co/aD2kLPPIaT",5,1,2,0,2022-01-07,6,Friday,5,7,1
1479342842921328641,2022-01-07 06:43:13,"Kemenkes menyebut setidaknya ada enam kasus positif COVID-19 dari rombongan Ashanty, berdasarkan pemeriksaan tes PCR SGTF. Apa saja gejala yang dikeluhkan? https://t.co/dkcV3S4Dod",23,12,4,10,2022-01-07,6,Friday,5,27,22
1479342828232888324,2022-01-07 06:43:09,Pesepakbola Riyad Mahrez dikabarkan diam-diam sudah menikah. Sebelumnya Riyad melamar Taylor dengan cincin berlian seharga Rp 8 miliaran.  https://t.co/7Rn7YJZgvQ,13,0,2,1,2022-01-07,6,Friday,5,15,1
1479341318119821315,2022-01-07 06:37:09,PSS Sleman begitu agresif di bursa transfer paruh musim ini. Klub berjuluk Super Elang Jawa itu mendatangkan total 14 pemain baru di semua lini.  https://t.co/mUhLXB4UE0,1,0,0,0,2022-01-07,6,Friday,5,1,0
1479340798923714562,2022-01-07 06:35:05,Penyanyi Ashanty positif COVID-19 usai kembali dari liburan ke Turki. Ia juga sempat melakukan karantina di hotel sebelum dirujuk ke RS. Begini kronologinya: https://t.co/lU2aDkutDN,5,3,1,1,2022-01-07,6,Friday,5,6,4
1479340324568895491,2022-01-07 06:33:12,Dirjen WHO Tedros Adhanom Ghebreyesus mengingatkan pemberian vaksin booster bukan jawaban untuk menghentikan pandemi COVID-19. Ini alasannya: https://t.co/kUgnHdJ9Po,13,4,9,2,2022-01-07,6,Friday,5,22,6
1479340310580846593,2022-01-07 06:33:09,Ashanty positif COVID-19 lewat tes PCR S-gene target failure (SGTF). Bagaimana kondisinya saat ini? Simak kondisi Ashanty usai positif COVID-19. https://t.co/57MmObbSWr,1,3,1,0,2022-01-07,6,Friday,5,2,3
1479339578834276356,2022-01-07 06:30:15,Kabar pencoretan Praveen/Melati dan Hafiz/Gloria dari pelatnas ikut ditanggapi legenda bulutangkis Imelda Wiguna. Ia berharap Hafiz/Gloria dipertahankan.  https://t.co/Cg34JJYr8I,4,1,0,0,2022-01-07,6,Friday,5,4,1
1479339552867328003,2022-01-07 06:30:08,Sora Aoi kini telah jadi ibu dua anak laki-laki kembar yang lucu dan menggemaskan. Ia bercerita tentang proses yang dialaminya itu:  https://t.co/SPK6tivbcx,10,4,3,3,2022-01-07,6,Friday,5,13,7
1479339281181249536,2022-01-07 06:29:04,DJP Kementerian keuangan menunjuk 94 pelaku usaha Perdagangan Melalui Sistem Elektronik (PMSE). Salah satunya Airbnb. https://t.co/snBMndrRDs,7,3,1,1,2022-01-07,6,Friday,5,8,4
1479339042886066180,2022-01-07 06:28:07,Lokasi pemotor jatuh dari atas flyover Pesing ini memiliki ketinggian sekitar 15 meter. Korban jatuh ke jalur busway di bawahnya. Begini potret lokasinya: https://t.co/0X6v3tvcwJ,4,0,1,2,2022-01-07,6,Friday,5,5,2
1479339030722584577,2022-01-07 06:28:04,"Fettucine merupakan jenis pasta populer yang pipih kenyal. Cocok juga dipadukan dengan saus carbonara yang gurih renyah. Tambah keju, makin enak! Bikin yuuu... https://t.co/onHiwnZ8j6",10,0,1,1,2022-01-07,6,Friday,5,11,1
1479338791517274112,2022-01-07 06:27:07,"Humas Pengadilan Negeri Tangerang, Arief Budi Cahyono, menjelaskan detail ketiga kasus yang melibatkan nama Ustaz Yusuf Mansur. Ini detail perkaranya:  https://t.co/0xnAsqpj0M",2,1,0,0,2022-01-07,6,Friday,5,2,1
1479338776036007939,2022-01-07 06:27:03,Sani Fahreza merupakan pendatang baru yang membintangi Dear Nathan: Thank You Salma. Ia memerankan sosok seorang pelaku kejahatan seksual. https://t.co/cu9BlckG16,2,1,0,1,2022-01-07,6,Friday,5,2,2
1479338536289644545,2022-01-07 06:26:06,Cristiano Ronaldo mengultimatum manajemen Manchester United. Ronaldo bakal pergi musim depan jika klub tak bisa mendapatkan manajer yang oke!  https://t.co/LobV2QfEOD,18,12,0,3,2022-01-07,6,Friday,5,18,15
1479338534771306497,2022-01-07 06:26:06,#Kazakhstan mengalami kerusuhan terberat dalam sejarahnya. Padahal sebelumnya negara ini dianggap salah satu yang paling stabil di kawasannya. Apa yang terjadi? https://t.co/SfxKtFhoh4,15,6,7,0,2022-01-07,6,Friday,5,22,6
1479338027340247045,2022-01-07 06:24:05,Anang Hermansyah bicara tentang kondisi Ashanty. Ia juga khawatir karena Ashanty ada autoimun. #Ashanty  https://t.co/os3Q7fu5Zk,9,19,0,5,2022-01-07,6,Friday,5,9,24
1479338002178576384,2022-01-07 06:23:59,Ganjil genap Jakarta Januari 2022 jadi informasi penting yang perlu diperhatikan. Ini daftar ruas jalan yang berlakukan gage. https://t.co/TQCJHsb6iG,2,0,0,0,2022-01-07,6,Friday,5,2,0
1479337750692311042,2022-01-07 06:22:59,Anang Hermansyah tahu benar netizen banyak yang menyalahkannya soal jalan-jalan ke Turki di akhir tahun. Anang beri pembelaan ini:  https://t.co/oYjjn2DOOz,15,53,1,4,2022-01-07,6,Friday,5,16,57
1479336161768316930,2022-01-07 06:16:40,"Ashanty dipastikan positif tes PCR SGTF, tes yang dipakai untuk melihat kemungkinan Omicron. Dari rombongan Ashanty, disebutkan ada 6 orang yang terpapar. https://t.co/8traec7TvD",222,126,48,60,2022-01-07,6,Friday,5,270,186
1479335760985796609,2022-01-07 06:15:04,"Awas penipuan mengatasnamakan ShopeePay! Jika kamu pernah terkena penipuan yang melibatkan ShopeePay, ini cara melaporkannya ke tim ShopeePay:  https://t.co/MMujIiy6ZZ",4,0,1,0,2022-01-07,6,Friday,5,5,0
1479335011283316739,2022-01-07 06:12:06,Seorang kolektor non-fungible token (NFT) Todd Kramer kehilangan 16 dari Bored Ape Yacht Club (BAYC). Kehilangan koleksi NFT tersebut diduga karena diretas. https://t.co/PWyHQbRMu9,10,1,2,2,2022-01-07,6,Friday,5,12,3
1479334514849681408,2022-01-07 06:10:07,Warga melapor karena jalanan berdebu dan licin akibat tanah bekas galian. https://t.co/VZrI6L4vPt,3,1,1,1,2022-01-07,6,Friday,5,4,2
1479333992067481600,2022-01-07 06:08:03,"Sukses berjualan popcorn, wanita cantik ini berhasil membeli rumah seharga di atas Rp 10 miliar. Namun, ia hanya menempatinya untuk staycation di akhir pekan. Ini potret rumahnya:  https://t.co/J3eJCezm6Y",2,1,1,1,2022-01-07,6,Friday,5,3,2
1479333470711263234,2022-01-07 06:05:58,Pepen terancam hukuman 20 tahun penjara. https://t.co/wtb94EqXyX,7,5,2,0,2022-01-07,6,Friday,5,9,5
1479333469570404354,2022-01-07 06:05:58,Pada musim liburan Apple berhasi menjual deretan iPhone series 13nya dengan pencapaian 40 juta unit. #iPhone  https://t.co/Aw5kafr5ZR,6,0,1,0,2022-01-07,6,Friday,5,7,0
1479333204909830144,2022-01-07 06:04:55,"Kemendagri menyebut salah satu syarat pembuatan e-KTP digital ialah kepemilikan handphone. Lalu, bagaimana nasib warga yang tak punya ponsel? https://t.co/K8JIq2DY5q",9,8,4,1,2022-01-07,6,Friday,5,13,9
1479333184135380993,2022-01-07 06:04:50,TikTok sedang menguji coba fitur baru bernama Repost. Cara kerja fitur ini ternyata agak mirip fungsi Retweet di Twitter. #TikTok  https://t.co/q5YuY4vsO5,29,2,11,1,2022-01-07,6,Friday,5,40,3
1479332694207180804,2022-01-07 06:02:53,Belakangan sedang tren sneakers dan sepatu platform yang bisa dipakai pria maupun wanita. Ini rekomendasinya dari brand sepatu unisex:  https://t.co/UKjEmssXW4,4,0,3,0,2022-01-07,6,Friday,5,7,0
1479332136683552768,2022-01-07 06:00:40,"Di balik keriuhan suporter Liga Inggris dalam sengitnya pertandingan di stadion, terselip sejumlah kisah hantu. Berikut lima stadion paling angker Inggris.  https://t.co/DGiBYoW1MP",5,2,1,0,2022-01-07,6,Friday,5,6,2
1479331403485659139,2022-01-07 05:57:45,Jumlah kasus aktif Corona di Jakarta 1.170 orang. 908 di antaranya dari jumlah kasus aktif merupakan pelaku perjalanan luar negeri. https://t.co/DYjLI3eRgY,99,30,44,42,2022-01-07,5,Friday,5,143,72
1479331388709089283,2022-01-07 05:57:42,Gabriel Barbosa tampil moncer bersama Flamengo di Liga Brasil. Pemain yang dijuluki Gabigol itu pun berniat mengadu nasib lagi di Eropa.  https://t.co/xSDktBqTS4,6,1,1,0,2022-01-07,5,Friday,5,7,1
1479331231657508869,2022-01-07 05:57:04,Aurel Hermansyah mengaku mengalami sesak napas saat liburan di Turki. Kenapa? https://t.co/WPbJrArxki,74,62,6,15,2022-01-07,5,Friday,5,80,77
1479331124786745346,2022-01-07 05:56:39,"Sial betul Antoine Griezmann. Baru saja comeback usai terserang virus corona, striker Atletico Madrid itu sudah harus menepi lagi karena dibekap cedera.  https://t.co/f8jOm97q25",5,0,1,0,2022-01-07,5,Friday,5,6,0
1479330666059911168,2022-01-07 05:54:50,"Pelatih AS Roma Jose Mourinho mengungkapkan, dia senang karena pernah menolak tawaran melatih AC Milan di masa lalu. Menyusul kekalahan AS Roma dari Milan 1-3.  https://t.co/6DTX5495PR",4,0,2,0,2022-01-07,5,Friday,5,6,0
1479330650813521921,2022-01-07 05:54:46,Dubes Arab Saudi untuk Lebanon menyatakan kelompok Hizbullah sebagai ancaman bagi keamanan Arab. https://t.co/hHxe13nIhN,19,4,3,2,2022-01-07,5,Friday,5,22,6
1479330334202384392,2022-01-07 05:53:30,Toyota Avanza telah menjadi model global yang dinikmati banyak negara. Mobil sejuta umat yang diproduksi di Indonesia itu diekspor ke berbagai negara di dunia.  https://t.co/RDHrAm7SEe,12,0,2,0,2022-01-07,5,Friday,5,14,0
1479329906282713090,2022-01-07 05:51:48,"""Terus terang saya shock banget, sampai sekarang pun saya masih merinding tak percaya,"" kata Daryanto. https://t.co/1R4OShBJob",4,0,1,2,2022-01-07,5,Friday,5,5,2
1479329894656000001,2022-01-07 05:51:46,"Keberadaan jaringan 5G membuat jaringan 4G bisa jadi ditinggalkan. Padahal, jaringan 4G juga masih memiliki kecepatan untuk berselancar di internet. https://t.co/KGCcOty9Dw",4,0,1,1,2022-01-07,5,Friday,5,5,1
1479329392824307712,2022-01-07 05:49:46,Polda Sulsel melimpahkan kasus cuitan 'Allahmu Lemah' Ferdinand Hutahaean ke Bareskrim. Perkara itu sebelumnya dilaporkan oleh BMI Sulsel. https://t.co/k7EgBBgAGO,16,5,1,0,2022-01-07,5,Friday,5,17,5
1479329373614485507,2022-01-07 05:49:41,"Manchester United masih tertahan di papan tengah Klasemen Liga Inggris. Suatu hal, yang sebenarnya tidak pernah Cristiano Ronaldo rasakan sepanjang kariernya!  https://t.co/dEU1UCzfxP",11,5,5,4,2022-01-07,5,Friday,5,16,9
1479328638550089731,2022-01-07 05:46:46,"Apabila kamu baru menjual mobil atau sepeda motor pribadi, pastikan untuk melakukan blokir STNK agar kamu tidak dikenakan aturan pajak progresif karena kepemilikan STNK lebih dari satu.  https://t.co/6e7FJhG5OC",31,1,13,0,2022-01-07,5,Friday,5,44,1
1479328367023431682,2022-01-07 05:45:41,Seorang pria paruh baya ditemukan tewas dengan luka tusuk di ruko miliknya di Surabaya. Kejadian ini diduga juga merupakan sebuah perampokan. https://t.co/4mXskAVlD5,3,0,2,0,2022-01-07,5,Friday,5,5,0
1479328105051348997,2022-01-07 05:44:39,Mahfud Md menjelaskan maksud ucapan Gus Dur tentang 'Allah tak perlu dibela'. Apa katanya? https://t.co/BTEc6MPF68,19,3,3,1,2022-01-07,5,Friday,5,22,4
1479327357500596227,2022-01-07 05:41:41,"Bagi gamer yang ingin memainkan Minecraft Pocket Edition di PC, sangat mudah caranya. Simak di sini penjelasannya:  https://t.co/DrJ3KZmNpu",4,0,1,3,2022-01-07,5,Friday,5,5,3
1479326808172646402,2022-01-07 05:39:30,Brand fashion Sejauh Mata Memandang berkolaborasi dengan Dian Sastrowardoyo meluncurkan koleksi busana bertajuk 'Tumbuh'. Ini koleksinya:  https://t.co/rfqGrjatil,10,1,1,1,2022-01-07,5,Friday,5,11,2
1479326560113020929,2022-01-07 05:38:31,"Untuk menghindari penggunaan pinjol ilegal, pemerintah telah mengeluarkan daftar pinjol resmi OJK 2022. https://t.co/QOiMX0nrfX",20,4,6,4,2022-01-07,5,Friday,5,26,8
1479325810016333824,2022-01-07 05:35:32,Satgas COVID-19 memastikan Ashanty positif virus Corona dalam tes PCR SGTF. Pemeriksaan ini merupakan salah satu deteksi awal varian Omicron. https://t.co/ZyZqfKs9RL,28,4,4,3,2022-01-07,5,Friday,5,32,7
1479325337616105474,2022-01-07 05:33:39,"""140 orang WNI yang berada di Republik Kazakhstan dan 3 orang WNI di Tajikistan dalam keadaan aman,"" kata Fadjroel. https://t.co/BmWIlmyxTz",6,1,2,3,2022-01-07,5,Friday,5,8,4
1479325322365607938,2022-01-07 05:33:36,Santriwati korban pemerkosaan Herry Wirawan mengajukan ganti rugi atas kasus perkosaan. Total biaya yang diajukan untuk 13 santriwati mencapai Rp 330 juta. https://t.co/xnylIsbKfr,36,64,4,4,2022-01-07,5,Friday,5,40,68
1479324805048451076,2022-01-07 05:31:32,"Para karyawan dan barista Starbucks di kota Buffalo, negara bagian New York, ramai-ramai melakukan aksi mogok kerja. Ada apa nih? https://t.co/RLZSawO0d3",9,1,2,0,2022-01-07,5,Friday,5,11,1
1479324508238626817,2022-01-07 05:30:21,Boyamin Saiman menyambangi Mahfud Md. Boyamin mengadukan sejumlah progres kasus pungli salah satunya kasus pungli Rachel Vennya. https://t.co/TXpAQ3kdcw,9,0,3,0,2022-01-07,5,Friday,5,12,0
1479324240713334791,2022-01-07 05:29:18,Lesti Kejora terus menangis ketika membicarakan Baby L. Rizky Billar siap berikan pelukan untuk menenangkan...  https://t.co/4AtazjR37i,8,9,1,1,2022-01-07,5,Friday,5,9,10
1479323522560401415,2022-01-07 05:26:26,"Giliran Amerika Serikat mencatat sejumlah kasus Flurona, atau infeksi ganda COVID-19 dan influenza. Begini gejala yang diceritakan pasien: https://t.co/aE2quY9Ha9",14,0,7,6,2022-01-07,5,Friday,5,21,6
1479323503354687488,2022-01-07 05:26:22,Seorang wanita mengungkap curhatnya karena punya wajah cantik dan awet muda. Banyak pria berusaha kencan dengannya tapi mundur saat tahu umur sebenarnya. https://t.co/eBTFZpPNFy,9,0,2,0,2022-01-07,5,Friday,5,11,0
1479322773998739456,2022-01-07 05:23:28,"Kecelakaan mengerikan terjadi di flyover Pesing, Jakarta Barat. Seorang pengendara motor jatuh dari atas flyover setelah tertabrak mobil. https://t.co/tyYYb8I9WO",10,4,8,2,2022-01-07,5,Friday,5,18,6
1479322755061456899,2022-01-07 05:23:23,Instagram mulai menguji versi baru feed yang akan memungkinkan pengguna beralih antara feed yang diurutkan secara kronologi dan algoritmik. https://t.co/2UhyFQVebk,6,0,2,0,2022-01-07,5,Friday,5,8,0
1479322232413466628,2022-01-07 05:21:19,Anang Hermansyah mengikuti jejak Kevin Aprilio melakukan transplantasi rambut di Turki. Segini kisaran biaya transplantasi rambut:  https://t.co/kpF2TUNsI7,18,12,5,2,2022-01-07,5,Friday,5,23,14
1479321687120302083,2022-01-07 05:19:09,"Jembatan Jugosari Lumajang putus diterjang banjir lahar dingin Gunung Semeru. Akibatnya, ada 42 siswa SDN Jugosari 03 yang terisolasi dan tidak bisa sekolah. https://t.co/DQpb2RJkUZ",1,0,1,0,2022-01-07,5,Friday,5,2,0
1479320938495815681,2022-01-07 05:16:10,"Wali Kota Bekasi Rahmat Effendi terjerat kasus korupsi. Perkara ini terkait penetapan APBD Perubahan 2021 berkenaan dengan belanja modal ganti rugi tanah dengan nilai anggaran Rp 286,5 miliar. Kini, Pepen ditahan Komisi Pemberantasan Korupsi. https://t.co/AKXsZHAjTI",10,2,2,0,2022-01-07,5,Friday,5,12,2
1479320468985425921,2022-01-07 05:14:18,Ketua Umum PSI Giring Ganesha kejeblos lumpur di bakal venue Formula E di Ancol. Seperti apa lokasinya? https://t.co/t98Ir28tgV,9,10,1,2,2022-01-07,5,Friday,5,10,12
1479320449192497153,2022-01-07 05:14:14,"Komnas PA minta Doddy Sudrajat dan Faisal tak lagi meributkan Gala Sky. Sebagai kakek, mereka harusnya bisa duduk bersama. https://t.co/rkeugTQIRP",8,2,1,0,2022-01-07,5,Friday,5,9,2
1479319949814423558,2022-01-07 05:12:15,Ini kisah lengkap tentang cinta guru dan murid beda usia 11 tahun yang kini menikah setelah bertemu di acara reuni sekolah. https://t.co/KDhhEq70Xk,7,0,1,0,2022-01-07,5,Friday,5,8,0
1479319456711118848,2022-01-07 05:10:17,Ardhito Pramono main Dear Nathan: Thank You Salma. Ada jasa Jefri Nichol di balik keterlibatannya. https://t.co/obdeHr0LQi,5,0,1,0,2022-01-07,5,Friday,5,6,0
1479318408596443138,2022-01-07 05:06:07,"Universitas Muhammadiyah Yogyakarta (UMY) mengambil tindakan tegas dengan mengeluarkan mahasiswanya, MKA alias OCD, dari kampus usai mengakui telah melakukan pemerkosaan terhadap mahasiswi.  https://t.co/boEenESdra",19,0,1,1,2022-01-07,5,Friday,5,20,1
1479317819829403650,2022-01-07 05:03:47,"Tak mau ketinggalan dengan restoran mewah, beberapa penjual makanan kaki lima ini juga punya cara jualan canggih. Penasaran? https://t.co/tM9uwHtyzO",6,0,0,0,2022-01-07,5,Friday,5,6,0
1479317341284483077,2022-01-07 05:01:53,Jembatan Pulau Balang menjadi salah satu akses penghubung menuju ibu kota negara (IKN) baru. Begini kondisinya sekarang? https://t.co/TTTVlA1bmk,2,0,0,0,2022-01-07,5,Friday,5,2,0
1479316752215519232,2022-01-07 04:59:32,Kapal selam Rusia itu dilaporkan menabrak bagian sonar pada kapal perang Inggris tersebut. https://t.co/08IkV3ow5F,6,0,0,0,2022-01-07,4,Friday,5,6,0
1479316245916889089,2022-01-07 04:57:32,"Ketua Umum PSI Giring Ganesha datang ke lokasi venue Formula E. Saat mengkritik venue itu, sepatu giring terbenam lumpur.

Aksi Giring pun tuai kontroversi. Gimana pendapatmu? #Komik https://t.co/rWouWqh1dE",16,9,1,1,2022-01-07,4,Friday,5,17,10
1479315750317928448,2022-01-07 04:55:33,Satgas COVID-19 memastikan Ashanty positif Corona melalui tes SGTF. Tes SGTF digunakan sebagai deteksi awal varian Omicron. https://t.co/R0cIVRLdbn,15,4,1,5,2022-01-07,4,Friday,5,16,9
1479315288403419138,2022-01-07 04:53:43,Barcelona bisa merekrut Erling Haaland di musim panas nanti. Namun ada penyesuaian yang perlu dilakukan demi memudahkan kedatangan penyerang asal Norwegia itu.  https://t.co/mZN3qw5V0l,3,1,0,1,2022-01-07,4,Friday,5,3,2
1479315266131668994,2022-01-07 04:53:38,Transplantasi rambut jadi solusi para selebriti pria untuk mengatasi kebotakan. Mulai dari artis Indonesia hingga Salman Khan. Ini kondisi artis setelah transplantasi rambut:  https://t.co/1cIFmx8Lm4,3,1,0,1,2022-01-07,4,Friday,5,3,2
1479314212199538690,2022-01-07 04:49:27,"Diam-diam, banyak yang 'curi start' disuntik booster vaksin COVID-19. Bahkan ada yang rela bayar ratusan ribu rupiah, padahal tidak tercatat di PeduliLindungi! https://t.co/aP9tHGQEVP",10,2,7,10,2022-01-07,4,Friday,5,17,12
1479313724875890688,2022-01-07 04:47:30,"Menyoal tes DNA yang diramaikan Doddy Sudrajat, Komnas PA melihat itu salah satu bentuk kekerasan pada anak. Komnas PA menentang adanya tes tersebut! https://t.co/F6dAZDnhOL",21,5,1,1,2022-01-07,4,Friday,5,22,6
1479313232565346308,2022-01-07 04:45:33,Presenter sekaligus YouTuber Aurel Valen disebut penyebar ilmu sesat dan nabi palsu. Ternyata hal itu terjadi gegara ini:  https://t.co/cgEU1gw0F2,2,1,1,1,2022-01-07,4,Friday,5,3,2
1479312978759589889,2022-01-07 04:44:33,"Dear Pisces, tetap fokus dengan segala rencana penting yang ada saat ini. Simak ramalan zodiak hari ini: https://t.co/qwFThZTkel",3,0,0,1,2022-01-07,4,Friday,5,3,1
1479312487103217666,2022-01-07 04:42:35,"Korban tewas akibat banjir di Jayapura, Papua bertambah menjadi enam orang. Keenam korban tewas telah dievakuasi. https://t.co/M9mRJF8S2Z",1,0,2,1,2022-01-07,4,Friday,5,3,1
1479312232366456832,2022-01-07 04:41:35,"""Sangat jauh berbeda antara cuitan Ferdinand dengan perkataan Gus Dur. Dan karenanya, janganlah disamakan antar keduanya!"" ujar Luqman. https://t.co/XDH5wBlJ9O",9,9,0,3,2022-01-07,4,Friday,5,9,12
1479311670468132867,2022-01-07 04:39:21,Kisah cinta bedua usia 11 tahun antara guru dan murid ini viral di media sosial. Ini kisahnya:  https://t.co/AkraTanDzG,8,3,0,2,2022-01-07,4,Friday,5,8,5
1479311443912806401,2022-01-07 04:38:27,"Klasemen Liga Italia setelah Tahun Baru terus panas. Inter Milan masih di puncak, tapi terus dibuntuti AC Milan. Sedangkan Napoli, lagi kesandung.  https://t.co/URMwjKW1As",5,0,0,0,2022-01-07,4,Friday,5,5,0
1479311419309010948,2022-01-07 04:38:21,"Adhie Massardi cs melaporkan Ganjar Pranowo ke KPK dalam dugaan terlibat korupsi proyek e-KTP. Namun, santai saja Ganjar menanggapinya. https://t.co/BLca5laf4k",48,21,6,5,2022-01-07,4,Friday,5,54,26
1479311184042115073,2022-01-07 04:37:25,"Bursa Pilgub DKI Jakarta 2024 makin seru setelah nama-nama baru muncul. Terkini, ada Grace Natalie yang disiapkan PSI. Ini daftarnya: https://t.co/1J5cjWrUGe",6,1,0,0,2022-01-07,4,Friday,5,6,1
1479311165197103111,2022-01-07 04:37:20,"Dikabarkan kena Omicron, Ashanty dipastikan positif COVID-19 sepulang dari Turki. Bagaimana kondisi Anang, Aurel, Atta Halilintar dan lainnya? https://t.co/T3fPTUEK6H",43,41,5,11,2022-01-07,4,Friday,5,48,52
1479310879636303875,2022-01-07 04:36:12,Duel AC Milan vs AS Roma tadi malam dimenangi oleh Rossoneri dengan skor 3-1. Berikut ini delapan catatan menarik dari kemenangan Milan.  https://t.co/b4m75p7kcs,3,0,1,0,2022-01-07,4,Friday,5,4,0
1479310853862264839,2022-01-07 04:36:06,Sejumlah titik di Jayapura mengalami banjir sejak Kamis (6/2) pukul 22.50 WIT. Hingga saat ini ada 1 korban jiwa dan sejumlah fasilitas umum yang terdampak akibat insiden ini. https://t.co/0E0tQLWGxr https://t.co/m6ilPzdHNf,8,0,2,0,2022-01-07,4,Friday,5,10,0
1479310019418013698,2022-01-07 04:32:47,"Bekerja keras bisa membuat orang punya banyak uang. Tapi untuk menjadi kaya, kadang dibutuhkan lebih dari sekadar kegigihan usaha. Ini bisa jadi pertimbangan:  https://t.co/DVpMAk0yug",4,0,2,0,2022-01-07,4,Friday,5,6,0
1479309458195066883,2022-01-07 04:30:33,Sri Mulyani Indrawati berbicara mengenai wajah APBN di 2024 pada akhir masa jabatan Presiden Jokowi. Seperti apa? https://t.co/5HGzDQyUH2,6,0,0,1,2022-01-07,4,Friday,5,6,1
1479308458268758019,2022-01-07 04:26:35,Kazakhstan memanas dipicu kenaikan harga BBM. Dubes RI untuk Kazakhstan Fadjroel Rachman memberi imbauan untuk para WNI di negara tersebut. https://t.co/A5Ab46rLlm,3,0,0,1,2022-01-07,4,Friday,5,3,1
1479308217276641282,2022-01-07 04:25:37,Menteri Perindustrian mengusulkan 'mobil rakyat' dengan harga di bawah Rp 250 juta tidak dikenakan PPnBM.  https://t.co/cAeTOeO44k,5,2,1,2,2022-01-07,4,Friday,5,6,4
1479308212369334273,2022-01-07 04:25:36,"Ashanty dikabarkan terpapar Omicron. Belum ada penjelasan, Ashanty justru memperlihatkan tempat karantinanya. #Ashanty  https://t.co/PzTcQDn2QD",6,0,0,1,2022-01-07,4,Friday,5,6,1
1479307988980535296,2022-01-07 04:24:43,Video relawan erupsi gunung Semeru yang ditertawakan warga viral di media sosial. Perekam video yang merupakan pemilik akun YouTube ‘bang iOne’ ini kemudian meminta maaf atas perbuatannya. https://t.co/Igo81Ykfwh,5,0,0,1,2022-01-07,4,Friday,5,5,1
1479307970303434754,2022-01-07 04:24:38,"Terdapat sejumlah aturan terkait mobilitas masyarakat di PPKM Level 2 ini, termasuk untuk jam operasional Transjakarta.  https://t.co/wVBiwXmZkc",3,0,0,0,2022-01-07,4,Friday,5,3,0
1479307476050882561,2022-01-07 04:22:41,Ashanty disebut-sebut kena Covid-19 varian Omicron. Kemenkes pun menjawab soal hal ini. https://t.co/qhOmXPGJPc,1,0,0,0,2022-01-07,4,Friday,5,1,0
1479307270366371850,2022-01-07 04:21:52,Joko Anwar mengkonfirmasi sequel Pengabdi Setan akan ditayangkan tahun ini. Sang produser menyebut saat ini film sudah di tahap finishing. #PengabdiSetan2  https://t.co/ZzPi8PEKY3,5,1,5,0,2022-01-07,4,Friday,5,10,1
1479307078812549122,2022-01-07 04:21:06,Daihatsu Rocky menjadi salah satu mobil di kelas SUV kecil yang banyak diincar konsumen.  https://t.co/DFNhYXkJba,3,0,0,1,2022-01-07,4,Friday,5,3,1
1479306683449069568,2022-01-07 04:19:32,"Apabila kamu baru menjual mobil atau sepeda motor pribadi, pastikan untuk melakukan blokir Surat Tanda Nomor Kendaraan (STNK). Hal ini bertujuan agar kamu tidak dikenakan aturan pajak progresif karena kepemilikan STNK lebih dari satu. https://t.co/jWfLB7SERE",9,0,3,1,2022-01-07,4,Friday,5,12,1
1479305942374260738,2022-01-07 04:16:35,"Adhie Massardi melaporkan eks Gubernur DKI Jakarta, Basuki Tjahaja Purnama ke KPK. Pelaporan berkaitan dengan kasus dugaan korupsi semasa Ahok menjabat di Pemprov DKI. Tak cuma Ahok, sejumlah nama juga turut dilaporkan. Begini komentar mereka setelah di... https://t.co/J0UdB261rz",21,10,5,0,2022-01-07,4,Friday,5,26,10
1479305194290692104,2022-01-07 04:13:37,Gaya pemeran Amanda Manopo selalu menarik untuk dibahas. Kali ini Amanda Manopo mencuri perhatian dengan gelang yang digunakannya. https://t.co/wJc067GHq6,128,1,10,2,2022-01-07,4,Friday,5,138,3
1479304695164321802,2022-01-07 04:11:38,Dani Alves tampaknya memang sedemikian cinta dengan Barcelona. Sampai lambang Barca di atas lapangan pun tidak mau diinjaknya. Adegan itu pun viral.  https://t.co/f7rOKpAzE6,6,0,0,0,2022-01-07,4,Friday,5,6,0
1479304456785301506,2022-01-07 04:10:41,Dear Aries penghasilan sedapat mungkin ditingkatkan dan paling tidak dipertahankan. Simak ramalan zodiak hari ini: https://t.co/EksVAW1KMy,3,0,0,1,2022-01-07,4,Friday,5,3,1
1479303931880685568,2022-01-07 04:08:36,"""Tetapi izin-izin yang disalahgunakan pasti akan kami cabut,"" ujarnya. https://t.co/tqxTZGw5Wn",10,5,3,1,2022-01-07,4,Friday,5,13,6
1479303462810759169,2022-01-07 04:06:44,Pernah lihat orang yang kerjanya ogah-ogahan? Nih ada contohnya kalau belum lihat. Wk. https://t.co/yb5kCQsUdr,2,0,1,0,2022-01-07,4,Friday,5,3,0
1479303198393479177,2022-01-07 04:05:41,Atletico Madrid menang telak 5-0 atas Rayo Majadahonda dalam partai babak 32 besar Copa del Rey. Simak video highlight-nya.  https://t.co/4GFMmAu9N8,2,0,0,0,2022-01-07,4,Friday,5,2,0
1479302703536914435,2022-01-07 04:03:43,Pasukan asing yang dipimpin Rusia tiba di #Kazakhstan setelah berhari-hari unjuk rasa yang diwarnai kekerasan dan menimbulkan korban. https://t.co/JlhQPIYoL0,9,0,6,0,2022-01-07,4,Friday,5,15,0
1479301941490593794,2022-01-07 04:00:41,"Model asal Bosnia ngaku sempat 'disekap' di sebuah apartemen di Indonesia. Ia pun merasa trauma dan bilang ini pengalaman menyeramkan. Simak, yuk! #detikNetwork  https://t.co/kkY54Mgyqq",6,2,1,0,2022-01-07,4,Friday,5,7,2
1479301446285807616,2022-01-07 03:58:43,Saul Niguez bermain baik saat Chelsea mengandaskan Tottenham Hotspur. Tapi itu dinilai belum akan cukup untuk membuatnya jadi pilihan utama.  https://t.co/Ec0bX9KBmz,2,0,1,0,2022-01-07,3,Friday,5,3,0
1479300458451718144,2022-01-07 03:54:48,"Wali Kota Bekasi, Rahmat Effendi menerima suap dari sejumlah pihak. Salah satunya transaksi suap ganti rugi tanah pada tahun 2021. Saat meminta uang tersebut, Pepen sapaan akrabnya, menggunakan kode untuk sumbangan masjid. https://t.co/TjjDblwXsd",4,0,1,3,2022-01-07,3,Friday,5,5,3
1479299474459705346,2022-01-07 03:50:53,BPJT menetapkan pemenang pelelangan pengusahaan jalan tol Gedebage-Tasikmalaya-Cilacap. Jalan tol ini memiliki nilai investasi Rp 56 triliun. Ini 3 faktanya. https://t.co/1TdkU5wbsU,5,0,3,0,2022-01-07,3,Friday,5,8,0
1479298726237773827,2022-01-07 03:47:55,"Gading Marten bertemu Gisel di Bali dan dikabarkan rujuk. Namun, hal itu dibantah oleh Gading Marten. https://t.co/ZCwGON5jlm",6,4,0,1,2022-01-07,3,Friday,5,6,5
1479297485222916102,2022-01-07 03:42:59,"Wali Kota Bekasi, Rahmat Effendi meninggalkan gedung merah putih KPK, Kamis 6/1/2022 malam usai ditetapkan sebagai tersangka dugaan korupsi pengadaan dan jual-beli jabatan. Pepen bungkam saat diserbu awak media. https://t.co/ZVqNJVqHHm",3,2,0,0,2022-01-07,3,Friday,5,3,2
1479295761900834817,2022-01-07 03:36:08,Kazakhstan sedang mengalami kekacauan karena ribuan pengunjuk rasa turun ke jalan. Bitcoin kena getahnya. https://t.co/KWFHIr9OFQ,3,2,2,1,2022-01-07,3,Friday,5,5,3
1479294130631102464,2022-01-07 03:29:39,Netizen meyakini drama Korea Snowdrop terkena 'kutukan' karena menemui lika-liku sebelum penayangannya. #Snowdrop  https://t.co/kaaC83vgJO,11,2,2,2,2022-01-07,3,Friday,5,13,4
1479293643525664771,2022-01-07 03:27:43,"Jose Mourinho mengakui penampilan AS Roma jelek saat dikalahkan oleh AC Milan. Namun, Mourinho juga mengeluhkan kinerja wasit.  https://t.co/C66w0Kmn0Q",0,0,2,1,2022-01-07,3,Friday,5,2,1
1479293097599291398,2022-01-07 03:25:33,Pepen diduga meminta sejumlah uang ke pihak yang lahanya diganti rugi Pemkot Bekasi dengan alibi 'sumbangan masjid'. https://t.co/nD7fx0M5lf,7,2,7,4,2022-01-07,3,Friday,5,14,6
1479292355492691977,2022-01-07 03:22:36,Zinedine Zidane dikabarkan akan jadi pelatih Paris Saint-Germain. Laporan dari Prancis menyebutkan bahwa PSG akhirnya berhasil meyakinkan Zidane.  https://t.co/JxMIYHsswk,6,0,2,1,2022-01-07,3,Friday,5,8,1
1479292354146312192,2022-01-07 03:22:35,"Manchester City menghadapi tim divisi empat Inggris di Piala FA. Dalam kondisi pincang, Citizens mewaspadai potensi kejutan dari lawan.  https://t.co/PtfrD9qMge",5,0,0,0,2022-01-07,3,Friday,5,5,0
1479292076327981059,2022-01-07 03:21:29,"Untuk informasi lebih lanjut, silahkan ikuti Huawei melalui:
https://t.co/pe4cU9hSXP
https://t.co/xNZsUHFYFD https://t.co/jJ1GL3NGDS",3,0,1,0,2022-01-07,3,Friday,5,4,0
1479291859025473548,2022-01-07 03:20:37,Harga emas Antam hari ini kembali turun. Cek rincian harganya hari ini. https://t.co/gDDTREwTJi,5,0,3,1,2022-01-07,3,Friday,5,8,1
1479291631463542788,2022-01-07 03:19:43,Para pesohor dunia mulai menggandrungi Metaverse dengan membeli tanah maupun properti di dalamnya. Seperti apa fakta-fakta tanah virtual? https://t.co/LUbt3znIbF,16,2,3,3,2022-01-07,3,Friday,5,19,5
1479291611498561538,2022-01-07 03:19:38,Tiket MotoGP Mandalika kategori Premiere Class telah habis terjual. Tiket kategori tersebut habis hanya selang beberapa jam setelah resmi dijual. https://t.co/CegnpVS5sI,28,6,4,1,2022-01-07,3,Friday,5,32,7
1479290627699494912,2022-01-07 03:15:44,Jeff Bezos Founder Amazon dan Blue Origin punya empat orang anak. Tiga di antaranya masih misterius identitasnya. #JeffBezos  https://t.co/D8Yhm9AR1I,5,0,2,0,2022-01-07,3,Friday,5,7,0
1479289364425453568,2022-01-07 03:10:43,Instagram mulai menguji versi baru feed yang akan memungkinkan pengguna beralih antara feed yang diurutkan secara kronologi dan algoritmik. #Instagram  https://t.co/WzPQuaZFc5,14,1,3,1,2022-01-07,3,Friday,5,17,2
1479288398087086081,2022-01-07 03:06:52,"Intel memboyong 22 prosesor Alder Lake untuk desktop ke CES 2022, mulai dari Core i9-12900 yang harganya USD 489 sampai Celeron G6900 yang harganya USD 42. #CES2022  https://t.co/cH38wJWWa7",5,0,5,0,2022-01-07,3,Friday,5,10,0
1479287401667252226,2022-01-07 03:02:55,Bagian dari roket Rusia yang gagal dan terdampar di orbit akan jatuh ke Bumi dalam waktu dekat. Berbahaya? https://t.co/wUlkmDjT4u,8,1,3,0,2022-01-07,3,Friday,5,11,1
1479286520318152706,2022-01-07 02:59:24,"Pergantian warna TNKB bakal dilakukan tahun ini, apakah menambah biaya yang harus dibayarkan masyarakat?   https://t.co/b16O8BcQZl",7,0,3,2,2022-01-07,2,Friday,5,10,2
1479286029471436804,2022-01-07 02:57:27,"Kondisi kesehatan terdakwa kasus dugaan penistaan agama, Muhammad Kace sudah membaik. Pria tersebut kini sudah tidak dirawat di RSUD Ciamis. https://t.co/vfC7GA26wg",2,0,0,0,2022-01-07,2,Friday,5,2,0
1479285783307689991,2022-01-07 02:56:29,"Sony mengungkap spesifikasi headset virtual reality untuk PS5, yang diberi nama PlayStation VR 2 (PSVR 2). Ini spesifikasinya:  https://t.co/qlSUfCvOf1",3,0,1,0,2022-01-07,2,Friday,5,4,0
1479285497696509953,2022-01-07 02:55:21,Menunggangi Bugatti seharga puluhan miliar rupiah yang menjadi impian banyak orang menjadi aktivitas sehari-hari Jenny!  https://t.co/e93bhsZ4f1,4,0,0,0,2022-01-07,2,Friday,5,4,0
1479285475647135751,2022-01-07 02:55:15,Berikut ini cara atau gambaran melakukan pembayaran pajak 5 tahunan. https://t.co/Xb7dLU3ToC,10,0,4,1,2022-01-07,2,Friday,5,14,1
1479285222210482179,2022-01-07 02:54:15,Raffi Ahmad cerita soal momen berharga pada kedua anaknya. Rafathar kini sudah tak cemburu lagi pada Rayyanza. https://t.co/hPjkp7CgXz,12,1,1,0,2022-01-07,2,Friday,5,13,1
1479284985219665926,2022-01-07 02:53:18,"Perkembangan energi alternatif tidak hanya menyasar segmen roda empat saja, namun kini sudah banyak merambah sepeda motor.  https://t.co/j8838CqLqK",4,0,0,0,2022-01-07,2,Friday,5,4,0
1479284739563470849,2022-01-07 02:52:20,"Pernah bermimpi menemukan uang mudah yang hanya tergeletak di lantai atau di jalanan? Kalau kamu pernah bermimpi demikian, ini arti mimpi dapat uang: https://t.co/s0jFiGo2wb",4,0,1,0,2022-01-07,2,Friday,5,5,0
1479284716482310151,2022-01-07 02:52:14,YouTuber Farida Nurhan mengungkap kisah hidupnya ketika lewati masa sulit saat hamil di luar nikah. Begini kisahnya:  https://t.co/GS5F2AYSq2,6,0,1,0,2022-01-07,2,Friday,5,7,0
1479283980348362760,2022-01-07 02:49:19,Anne Ardina dibilang muka filter-an oleh netizen. Ia tak masalah karena justru banyak endorse menghampirinya.  https://t.co/vqq9GlohDm,4,0,0,0,2022-01-07,2,Friday,5,4,0
1479283225235279872,2022-01-07 02:46:19,Shin Tae-yong tak memanggil pemain klub luar negeri di Piala AFF U-23 2022. Asnawi Mangkualam Cs diberikan kesempatan berkonsentrasi buat klubnya masing-masing.  https://t.co/Yv2fePPwfB,10,0,0,1,2022-01-07,2,Friday,5,10,1
1479283208067899394,2022-01-07 02:46:15,PT Honda Prospect Motor (HPM) beberapa waktu lalu telah meluncurkan generasi terbaru Honda BR-V.  https://t.co/mdQrieeQa2,1,0,0,0,2022-01-07,2,Friday,5,1,0
1479282956766167043,2022-01-07 02:45:15,"Kini, fasilitas uji emisi diperbanyak. Bahkan kini kamu bisa melakukan uji emisi kendaraan di kantor Walikota.  https://t.co/TkvAdeGO1f",0,1,0,0,2022-01-07,2,Friday,5,0,1
1479281961000747014,2022-01-07 02:41:17,Berikut ini cara membuat SIM C dan perpanjang online.  https://t.co/eNe9bLejCJ,55,6,31,0,2022-01-07,2,Friday,5,86,6
1479281345188843538,2022-01-07 02:38:51,"Selain merilis RTX 3090 Ti, Nvidia juga merilis kartu grafis RTX 3000 paling murah di CES 2022, yaitu RTX 3050. https://t.co/CvZrIvm7H5",3,1,0,3,2022-01-07,2,Friday,5,3,4
1479280842983809027,2022-01-07 02:36:51,"Gempa magnitudo 4.9 mengguncang wilayah Jember, Jawa Timur. Gempa ini dirasakan hingga Malang. https://t.co/nXCIyur5uY",43,4,16,3,2022-01-07,2,Friday,5,59,7
1479280352430538752,2022-01-07 02:34:54,#FOTO Aktris Lily Collins punya tubuh mungil yang membuatnya terlihat muda dan menggemaskan. Begini aksi kocak pemeran Emily In Paris itu di dunia nyata:  https://t.co/mL4L1ptSik,3,0,0,0,2022-01-07,2,Friday,5,3,0
1479279305851117575,2022-01-07 02:30:44,"Perempuan adalah sosok pemilik hati lembut. Kata Ustaz Hilman Fauzi, perempuan diciptakan dari tulang rusuk kiri dekat hati karena untuk dihormati dan dicintai. https://t.co/oI0UTf5QA7",14,6,5,4,2022-01-07,2,Friday,5,19,10
1479278814547087360,2022-01-07 02:28:47,"Setelah menjajal New Xpander Sport yang hadir dengan pelek lebih kecil dan profil ban lebih tebal, menurut kami bantingannya lebih istimewa daripada Ultimate.  https://t.co/TT5k5jQPqn",5,0,2,0,2022-01-07,2,Friday,5,7,0
1479277830756352001,2022-01-07 02:24:53,"Sebelum isu antisemitisme menyeruak, JK Rowling sudah berkali-kali menuai pro dan kontra. Ini deretan kontroversi JK Rowling:  https://t.co/qiDjcFB0uS",5,0,1,2,2022-01-07,2,Friday,5,6,2
1479277009255682054,2022-01-07 02:21:37,Park Min Young dan Song Kang akan memiliki kisah romantis yang berlatar tempat di BMKG Korea. Ini fakta drama terbaru mereka:  https://t.co/awmB8lrQv3,18,0,7,3,2022-01-07,2,Friday,5,25,3
1479276761775063041,2022-01-07 02:20:38,"Banjir melanda sejumlah titik di Jayapura, Papua. Satu orang warga meninggal dunia akibat peristiwa tersebut. #Jayapura #Banjir https://t.co/ipn3oc6LPo",7,1,3,0,2022-01-07,2,Friday,5,10,1
1479276269212737537,2022-01-07 02:18:40,Cosplayer Clarissa Punipun bicara soal bayaran. Ternyata ia pernah tak dibayar saat event luar negeri. https://t.co/2TpO4xrDCz,6,0,2,1,2022-01-07,2,Friday,5,8,1
1479275489768493062,2022-01-07 02:15:35,Kolaborasi Maudy Ayunda dan Danilla Riyadi dalam Semakin Jauh dan Sayangnya. Mereka begitu senang saat kerja bareng. https://t.co/U2TL2RL1Qc,11,0,4,0,2022-01-07,2,Friday,5,15,0
1479274664526557188,2022-01-07 02:12:18,Raffi Ahmad menyunat Rayyanza Malik Ahmad saat masih bayi. Ini alasan Raffi Ahmad melakukan hal itu:  https://t.co/MO5DfWbmPj,17,6,3,0,2022-01-07,2,Friday,5,20,6
1479273229353201670,2022-01-07 02:06:36,"Segmen motor gede (moge) kini tak hanya menyasar motor dengan kopling saja. Belakangan ini, sudah banyak motor matic yang mengusung kapasitas mesin besar.  https://t.co/rtaJUAb5Dd",2,0,1,0,2022-01-07,2,Friday,5,3,0
1479273055012675584,2022-01-07 02:05:54,Di media sosial beredar informasi palsu soal biaya pembuatan smart SIM online. Dalam informasi yang beredar disebutkan biaya tinggi dalam pembuatan smart SIM.  https://t.co/x02cRsiw2m,1,0,3,0,2022-01-07,2,Friday,5,4,0
1479272995260706816,2022-01-07 02:05:40,"BMW meluncurkan sebuah mobil konsep yang cukup unik dan canggih. Bayangkan, body mobil ini bisa berubah warnanya secara otomatis.  https://t.co/YO5iJHA7Yp",11,2,2,1,2022-01-07,2,Friday,5,13,3
1479272417881206787,2022-01-07 02:03:22,Kim Mi Soo meninggal dunia di usia 31 tahun. Sang mendiang akan dimakamkan hari ini. #KimMiSoo  https://t.co/pxlSrG809l,7,0,3,0,2022-01-07,2,Friday,5,10,0
1479272174846414848,2022-01-07 02:02:24,"Pergantian warna TNKB bakal dilakukan tahun ini, apakah menambah biaya yang harus dibayarkan masyarakat?  https://t.co/ayyGeyJLk8",15,8,8,2,2022-01-07,2,Friday,5,23,10
1479271819844665344,2022-01-07 02:01:00,Penyerang Liverpool Divock Origi mendapat tawaran dari tiga klub Liga Italia. Namun pemain asal Belgia itu lebih suka bertahan di Premier League.  https://t.co/AB3YEkiHfy,0,0,0,1,2022-01-07,2,Friday,5,0,1
1479271384006148100,2022-01-07 01:59:16,Maverick Vinales mengutarakan penyesalannya pernah meninggalkan tim MotoGP Suzuki. Ini pernyataannya.  https://t.co/fNaJ7OyCRz,8,4,1,0,2022-01-07,1,Friday,5,9,4
1479270578200666114,2022-01-07 01:56:04,"Massimiliano Allegri mensyukuri satu poin dari laga lawan Napoli. Ia mengakui Juve butuh banyak perbaikan, salah satunya soal ketenangan.  https://t.co/JWanjqsA5w",8,0,0,0,2022-01-07,1,Friday,5,8,0
1479270568725729283,2022-01-07 01:56:01,"Napoli gagal membawa tiga poin meski unggul dulu atas Juventus. Satu poin dari tempat yang sulit tetap bikin bangga Luciano Spalletti, di tengah krisis pemain.  https://t.co/1psKGFV8Gw",2,0,0,0,2022-01-07,1,Friday,5,2,0
1479269922228228096,2022-01-07 01:53:27,"Baca artikel detiknews, ""Haru Perbincangan Pasutri Pengamen Keroncong Suara Merdu dengan Addie MS"" selengkapnya di sini. https://t.co/ucphSnjRGX

--",6,0,0,0,2022-01-07,1,Friday,5,6,0
1479269731462909952,2022-01-07 01:52:42,"""Mukjizat bagi saya kalau bisa ketemu. Tapi masih pandemi, tapi sudah di-video call saya sudah senang,"" ujarnya.",6,1,1,0,2022-01-07,1,Friday,5,7,1
1479269628857573381,2022-01-07 01:52:17,"Eno mengaku juga sangat ingin bertemu Addie MS, namun kondisi belum memungkinkan. Menurut Eno, video call dari Addie MS juga sudah membuatnya senang.",3,1,0,0,2022-01-07,1,Friday,5,3,1
1479269502525140992,2022-01-07 01:51:47,"Sambungnya, ""... saya akhirnya saya tetap saya balas, lama-lama kok aku kayak nggak enak, khawatir, terus nggak saya bales, eh ada orang yang peduli dengan saya, orang kampung, 'Kok nggak bales kenapa', loh itu betul-betul Mas Addie ya, akhirnya saya WA lagi minta maaf,""",3,1,0,0,2022-01-07,1,Friday,5,3,1
1479269376435965953,2022-01-07 01:51:17,"Eno awalnya tidak terlalu menanggapi pesan WhatsApp dari Addie MS. Hingga kemudian ada yang menyampaikan bahwa pengirim pesan itu benar @addiems 

""Saya nggak pernah tahu kalau Mas Addie WA, saya tahunya mungkin orang iseng atau gimana,"" katanya.",7,1,1,0,2022-01-07,1,Friday,5,8,1
1479268729229697026,2022-01-07 01:48:43,"@addiems ""Alhamdulillah, saya senang sekali. Waktu itu diviralkan itu, saya sama Ibu langsung menangis kok, terharu. Sampai semalam itu nggak bisa tidur, saya cuma ngamen, viral, sampai ke seorang komposer,"" kata Eno.",7,1,2,0,2022-01-07,1,Friday,5,9,1
1479268145122537474,2022-01-07 01:46:23,"#detiktif Pasangan suami-istri pengamen keroncong yang viral bersuara merdu senang bertemu dengan musisi @addiems meski baru lewat panggilan video.

Pasutri bernama Pak Eno dan Ibu Im itu tak menyangka videonya ditonton musisi pendiri Twilite Orchestra itu.

#THREAD https://t.co/P3QSxZkEEt",79,10,20,3,2022-01-07,1,Friday,5,99,13
1479268097118900225,2022-01-07 01:46:12,Ustaz Yusuf Mansur dalam belenggu 3 gugatan. Ia menanggapinya dengan santai. #UstazYusufMansur  https://t.co/61DThvdiQ6,0,3,1,0,2022-01-07,1,Friday,5,1,3
1479267106470387712,2022-01-07 01:42:16,Anne Ardina bicara soal kehidupan asmara. Model yang pernah membintangi sinetron Ikatan Cinta itu mengaku sangat menjaga untuk hal tersebut.  https://t.co/yW3SceFbOj,5,0,1,0,2022-01-07,1,Friday,5,6,0
1479265863790379008,2022-01-07 01:37:20,Sederet drama makjang ini menyuguhkan plot cerita yang siap buat penonton hilang kesabaran. Ini daftarnya:  https://t.co/mygltQFazW,5,0,2,3,2022-01-07,1,Friday,5,7,3
1479264834386542595,2022-01-07 01:33:14,"Jutaan data pasien COVID-19 diduga bocor. Hal ini mulanya diungkap dalam sebuah akun di Raid Forums dengan ID ""Astarte"". Ia disebut menjual 720 GB data. https://t.co/NZ2UP6JZnL",9,1,7,5,2022-01-07,1,Friday,5,16,6
1479264248601657346,2022-01-07 01:30:54,PBSI disebut-sebut telah mencoret Praveen Jordan/Melati Daeva Oktavianti dari Pelatnas. Induk organisasi bulutangkis nasional itu pun memberi komentarnya.   https://t.co/wCxKVMwMiM,3,1,1,0,2022-01-07,1,Friday,5,4,1
1479263247912079367,2022-01-07 01:26:56,Ustaz Yusuf Mansur tidak datang dalam sidang gugatan wanprestasi. Begini tanggapan Ustaz Yusuf Mansur soal sidang perdananya:  https://t.co/c448xFWaqw,2,8,1,2,2022-01-07,1,Friday,5,3,10
1479263015048556550,2022-01-07 01:26:00,Arsenal menerima dakwaan Federasi Sepakbola Inggris (FA) karena kekacauan di laga lawan Manchester City. The Gunners pun dijatuhi denda.  https://t.co/pFZ7JOfPE8,4,0,0,1,2022-01-07,1,Friday,5,4,1
1479263004793397250,2022-01-07 01:25:58,Atletico Madrid meraih kemenangan telak atas Rayo Majadahonda di babak 32 besar Copa del Rey. Los Colchoneros menang 5-0 atas tim divisi tiga itu.  https://t.co/7aSxhABGLc,4,0,0,0,2022-01-07,1,Friday,5,4,0
1479262717399687168,2022-01-07 01:24:49,"Antonio Conte mengalami kebotakan dini semasa karier bermain sepakbola. Kini saat menjadi pelatih, rambutnya bisa gondrong lagi berkat transplantasi!  https://t.co/17syZSbyoh",3,0,0,0,2022-01-07,1,Friday,5,3,0
1479261956297089025,2022-01-07 01:21:48,"Tak ada pemenang dalam duel Juventus Vs Napoli di lanjutan Liga Italia tengah pekan ini. Napoli unggul duluan dan dibalas Juventus, skor akhir 1-1.  https://t.co/cj9a95HM9I",0,0,1,0,2022-01-07,1,Friday,5,1,0
1479261722976591873,2022-01-07 01:20:52,"Pep Guardiola jadi salah satu yang positif di tengah badai COVID-19 di Manchester City. Kondisinya baik-baik saja, tapi Man City krisis pemain.  https://t.co/7nNSmpKMPS",3,0,1,0,2022-01-07,1,Friday,5,4,0
1479261529522556932,2022-01-07 01:20:06,"Laga Juventus vs Napoli selesai imbang 1-1. Napoli cetak gol lebih dulu lewat Dries Mertens, lalu dibalas Federico Chiesa usai turun minum.  https://t.co/2juseit0Br",1,0,2,0,2022-01-07,1,Friday,5,3,0
1479260952600231939,2022-01-07 01:17:49,"Milan menang berkat gol-gol dari Giroud (8'), Junior Messias (17'), dan Rafael Leao (82'). Hasil ini membuat Milan tempel ketat Inter di puncak klasemen.  https://t.co/u1EkUnC1jH",2,1,0,0,2022-01-07,1,Friday,5,2,1
1479260480338337795,2022-01-07 01:15:56,"Buat fans Park So Dam di Indonesia, Special Delivery bisa disaksikan di jaringan bioskop CGV mulai 19 Januari 2022!  https://t.co/wGmwSHxljM",4,0,3,0,2022-01-07,1,Friday,5,7,0
1479260453519953924,2022-01-07 01:15:50,"Safin Futsal Club jadi pendatang baru di kompetisi Pro Futsal League. Tim asal Pati, Jawa Tengah, itu menjadi kontestan baru usai mengakuisisi SKN FC Kebumen.  https://t.co/yX4tdRoHox",3,1,0,0,2022-01-07,1,Friday,5,3,1
1479259127415070721,2022-01-07 01:10:33,"AC Milan meraih kemenangan perdana di tahun 2022. Menjamu AS Roma di pekan ke-20 Serie A, Rossoneri menang 3-1.  https://t.co/GOkkPfvTIy",7,0,1,0,2022-01-07,1,Friday,5,8,0
1479258702406471681,2022-01-07 01:08:52,Ada masanya Scarlett Bordeaux jadi bintang gulat di arena WWE. Tapi semua berubah akibat 'kecelakaan' implan payudara. Ia pun merambah situs dewasa.  https://t.co/SF6lyX23mi,3,0,2,0,2022-01-07,1,Friday,5,5,0
1479258449968091140,2022-01-07 01:07:52,"Manchester United resmi menunjuk Richard Arnold sebagai CEO baru, menggantikan Ed Woodward. Pria 51 tahun itu akan mulai bekerja pada 1 Februari mendatang.  https://t.co/EKh2fP2mgt",4,0,0,1,2022-01-07,1,Friday,5,4,1
1479257939412148225,2022-01-07 01:05:50,"Setelah memastikan Rans Cilegon FC promosi ke Liga 1, Raffi Ahmad kini berkomitmen untuk meraih prestasi tinggi di kompetisi bola basket IBL 2022.  https://t.co/nC72EApiRo",8,0,1,0,2022-01-07,1,Friday,5,9,0
1479257697153437697,2022-01-07 01:04:52,Indonesia Basketball League (IBL) 2022 telah dipastikan dihadiri penonton. Panitia penyelenggara selanjutnya berencana mulai menjual tiket.  https://t.co/OHxg4B7l4H,5,0,2,0,2022-01-07,1,Friday,5,7,0
1479256688125485066,2022-01-07 01:00:52,"Rafael Nadal bicara soal pencekalan Novak Djokovic di Australia Terbuka 2022. Menurutnya, ini adalah konsekuensi yang harus diambil petenis Serbia itu.  https://t.co/55pKIXzzZv",2,0,1,1,2022-01-07,1,Friday,5,3,1
1479256687001452548,2022-01-07 01:00:52,Danpuspomad menjelaskan alasan Kolonel Priyanto dan dua anggota TNI lainnya mengubah cat mobil setelah membuang mayat Handi Saputra (18) dan Salsabila (14). https://t.co/9ZCZamgTND,8,5,7,2,2022-01-07,1,Friday,5,15,7
1479256438321078276,2022-01-07 00:59:52,WHO menyampaikan kabar terbaru terkait efektivitas vaksin Sinovac melawan varian Omicron. Seperti apa perkembangannya? Berikut penjelasannya. https://t.co/UpwESVWdZn,5,1,7,1,2022-01-07,0,Friday,5,12,2
1479255915962540035,2022-01-07 00:57:48,"Fakta miris mengenai pembunuhan asisten rumah tangga (ART) warga keturunan asal Kabupaten Bulukumba, Nur Afiah, di Malaysia tersingkap. https://t.co/CPwUQhgUZf",4,0,3,1,2022-01-07,0,Friday,5,7,1
1479255667143852034,2022-01-07 00:56:48,AS melaporkan hampir 1 juta kasus infeksi virus Corona baru pada Selasa (4/1). Ini adalah angka penghitungan harian tertinggi dari semua negara di dunia. https://t.co/k5bsXiUQXJ,9,0,3,1,2022-01-07,0,Friday,5,12,1
1479255416798392323,2022-01-07 00:55:49,"Seorang nelayan di Aceh, Nazaruddin Razali mengajukan permohonan suntik mati ke pengadilan negeri (PN) setempat karena tertekan kebijakan pemerintah. https://t.co/G9tULyCxwV",25,5,7,4,2022-01-07,0,Friday,5,32,9
1479254924726788101,2022-01-07 00:53:51,"Belakangan, sejumlah partai mulai menyebut nama-nama politikus yang akan diusung di Pilkada 2024. Lantas, siapa jagoan PSI? https://t.co/8FpBgFwdtS",8,8,3,2,2022-01-07,0,Friday,5,11,10
1479254906443812865,2022-01-07 00:53:47,"Sama halnya dengan pria, wanita juga bisa mengalami orgasme. Namun orgasme pada wanita cenderung sulit dipahami. Simak 11 hal ini tentang orgasme wanita! https://t.co/zNN1KyUsgF",4,0,1,1,2022-01-07,0,Friday,5,5,1
1479254664235343874,2022-01-07 00:52:49,"Lima orang sekeluarga di Cipinang Melayu, Jakarta Timur dikeroyok tujuh pemuda mabuk. Pengeroyokan terjadi gegara masalah sepele lantaran serempetan motor. https://t.co/7IVjdAyX4H",7,2,3,0,2022-01-07,0,Friday,5,10,2
1479254417526435848,2022-01-07 00:51:51,"Sudah tahu Amlodipine? Obat yang biasa digunakan sebagai obat hipertensi ini juga bisa mengobati beberapa penyakit lain, lho. Simak selengkapnya berikut. https://t.co/abrWyUqHkf",9,0,3,1,2022-01-07,0,Friday,5,12,1
1479254399969112071,2022-01-07 00:51:46,Polisi memastikan kasus dugaan pemerkosaan oleh anak anggota DPRD Pekanbaru yang sudah berdamai Rp 80 juta terus berlanjut. Keluarga pasrah terkait nasib pelaku https://t.co/ATjYqtOVVA,3,2,4,0,2022-01-07,0,Friday,5,7,2
1479254155877400577,2022-01-07 00:50:48,Saul Niguez bermain baik saat Chelsea mengandaskan Tottenham Hotspur. Tapi itu dinilai belum akan cukup untuk membuatnya jadi pilihan utama. https://t.co/fWsPTZWRHM,5,1,1,0,2022-01-07,0,Friday,5,6,1
1479253644210057216,2022-01-07 00:48:46,"Belum beres urusan Omicron, kemunculan varian Corona baru di Prancis yakni varian 'IHU'. Kemenkes turut memantau kemungkinan masuknya ke Indonesia. https://t.co/X5P4uHIz5h",30,24,10,17,2022-01-07,0,Friday,5,40,41
1479253149873541120,2022-01-07 00:46:48,"Rafael Nadal bicara soal pencekalan Novak Djokovic di Australia Terbuka 2022. Menurutnya, ini adalah konsekuensi yang harus diambil petenis Serbia itu. https://t.co/OedVqmEfZQ",3,0,2,1,2022-01-07,0,Friday,5,5,1
1479251393588469765,2022-01-07 00:39:50,"Gempa berkekuatan magnitudo (M) 4,9 terjadi di Jember, Jawa Timur. Gempa tersebut terjadi di kedalaman 10 kilometer. https://t.co/rZ0w1w90nL",31,0,7,2,2022-01-07,0,Friday,5,38,2
1479250058105208836,2022-01-07 00:34:31,Antonio Conte menyebut Tottenham Hotspur butuh waktu lama untuk mengatasi masalah. Tottenham perlu lebih dari satu bursa transfer untuk memperbaiki skuad. https://t.co/vtHRMefKNP,4,0,1,0,2022-01-07,0,Friday,5,5,0
1479249834657857536,2022-01-07 00:33:38,Jembatan penyebrangan orang (JPO) berkonsep Kapal Pinisi saat ini progresnya sudah mencapai 98 persen. Kini JPO memasuki tahap penyelesaian akhir. https://t.co/y25i6xYEzM,7,1,2,1,2022-01-07,0,Friday,5,9,2
1479249339729989633,2022-01-07 00:31:40,Bareskrim telah menaikkan kasus Ferdinand Hutahaean yang menulis cuitan 'Allahmu lemah' dari penyelidikan ke penyidikan. Ada 10 saksi yang sudah diperiksa. https://t.co/awr5GGJRwd,14,5,2,4,2022-01-07,0,Friday,5,16,9
1479248575838265350,2022-01-07 00:28:38,"Seorang wanita berinisial S (35) ditemukan tewas di sebuah hotel di Teluk Naga, Kabupaten Tangerang. Seorang terduga pelaku terkait kematian korban diamankan. https://t.co/r3RIKbG0Bl",2,0,0,0,2022-01-07,0,Friday,5,2,0
1479248330089762826,2022-01-07 00:27:39,"Ketua Komnas Perlindungan Anak, Arist Merdeka Sirait, hari ini menyambangi kediaman H Faisal. Ini hasilnya:  https://t.co/jxVv9DMofr",6,0,0,0,2022-01-07,0,Friday,5,6,0
1479248088619524100,2022-01-07 00:26:42,"Massimiliano Allegri mensyukuri satu poin dari laga lawan Napoli. Ia mengakui Juve butuh banyak perbaikan, salah satunya soal ketenangan. https://t.co/P6J9c9Yn2s",2,1,0,0,2022-01-07,0,Friday,5,2,1
1479247579435184133,2022-01-07 00:24:40,Wali Kota Bekasi Rahmat Effendi atau Pepen ditetapkan KPK sebagai tersangka kasus suap terkait ganti rugi tanah. https://t.co/zFNtPHHl5w,8,3,1,0,2022-01-07,0,Friday,5,9,3
1479247078823968774,2022-01-07 00:22:41,Arsenal menerima dakwaan Federasi Sepakbola Inggris (FA) karena kekacauan di laga lawan Manchester City. The Gunners pun dijatuhi denda. https://t.co/8i4khhpFU2,5,0,0,0,2022-01-07,0,Friday,5,5,0
1479246578003161091,2022-01-07 00:20:41,Ferdinand mempertimbangkan untuk melaporkan balik Haris Pertama karena merasa difitnah soal cuitan 'Allahmu lemah'. Haris mengatakan dirinya tidak takut. https://t.co/fnYSREu6aH,16,1,1,0,2022-01-07,0,Friday,5,17,1
1479246353171726342,2022-01-07 00:19:48,"Satas COVID-19 menyebut kasus positif dan penularan COVID-19 meningkat, tetapi kematian dan BOR cenderung turun. Dampak munculnya Omicron, atau vaksinasi? https://t.co/VNUT9Vff87",3,0,1,1,2022-01-07,0,Friday,5,4,1
1479246327783567366,2022-01-07 00:19:42,"PB Djarum Kudus, Jawa Tengah, berencana menggelar audisi umum beasiswa bulutangkis pada pertengahan tahun 2022. Terakhir, ajang ini digelar tahun 2019 silam. https://t.co/1oLQ4JxUUO",19,2,3,1,2022-01-07,0,Friday,5,22,3
1479245839071653889,2022-01-07 00:17:45,Pakar kebugaran mengungkapkan bahwa berbagai posisi hubungan intim dapat membakar kalori dalam jumlah yang berbeda. https://t.co/XbIJFsOb4y,11,0,2,0,2022-01-07,0,Friday,5,13,0
1479245099561332740,2022-01-07 00:14:49,Mulai hari ini RI tutup pintu bagi WNA dari 14 negara yang terdampak Omicron. Aturan terbaru lainnya adalah pejabat tidak boleh lagi karantina mandiri di rumah. https://t.co/DSid3ZRF1E,34,2,12,5,2022-01-07,0,Friday,5,46,7
1479244602221772802,2022-01-07 00:12:50,"Kemenag menyatakan penyelenggaraan ibadah umroh untuk jemaah asal Indonesia segera dibuka. Rencananya, jemaah umroh dari RI bisa berangkat 8 Januari. https://t.co/EO3EGQYo8T",16,1,3,0,2022-01-07,0,Friday,5,19,1
1479243859259445249,2022-01-07 00:09:53,"Pelajar SMP berinisial R (15) tewas dalam peristiwa tawuran maut di Cengkareng, Jakbar. Polisi menyebut R merupakan korban salah sasaran kelompok tawuran. https://t.co/ycEzwGU51k",29,10,5,6,2022-01-07,0,Friday,5,34,16
1479242576360312834,2022-01-07 00:04:47,Sejumlah kepala daerah hingga pejabat kelas menteri dilaporkan ke KPK terkait dugaan kasus korupsi. https://t.co/oqvbFwjZSu,5,1,2,2,2022-01-07,0,Friday,5,7,3
1484314374881771520,2022-01-20 23:58:18,"Seorang oknum polisi diduga diduga memeras beberapa keluarga tersangka. Kapolda NTB, Irjen Djoko Poerwanto, memastikan akan menindak tegas oknum tersebut. https://t.co/9vnI4Wt4YY",18,6,2,1,2022-01-20,23,Thursday,4,20,7
1484313615393976325,2022-01-20 23:55:17,"Elite kelompok Sunda Empire, Raden Rangga Sasana atau Lord Rangga, ingin menemui Arteria Dahlan di DPR RI. Tapi keinginannya pupus lantaran tak diizinkan masuk. https://t.co/GLgWP7Wej2",277,112,50,45,2022-01-20,23,Thursday,4,327,157
1484313323067756550,2022-01-20 23:54:08,AS kembali peringatkan Rusia soal invasi besar-besaran ke wilayah Ukraina. Presiden AS mengatakan Rusia akan merasakan konsekuensi bila nekat melakukan invasi https://t.co/ajXVffpCbB,8,0,1,1,2022-01-20,23,Thursday,4,9,1
1484312816928444418,2022-01-20 23:52:07,"Para pelaku pengeroyokan anggota TNI AD Pratu Sahdi yang sempat masuk daftar pencarian orang (DPO) Baharudin, Sapri dan Ardi telah diamankan. https://t.co/LiXUaNYIPy",10,4,1,0,2022-01-20,23,Thursday,4,11,4
1484310820142026757,2022-01-20 23:44:11,"Hakim Pengadilan Negeri (PN) Surabaya, Jawa Timur Itong Isnaeni Hidayat membantah omongan pimpinan KPK saat menggelar konferensi pers di Gedung KPK Jakarta. https://t.co/t1bO5y3l88",4,2,1,0,2022-01-20,23,Thursday,4,5,2
1484309764020457478,2022-01-20 23:39:59,Barcelona terdepak dari Copa del Rey 2021/2022. Blaugrana disingkirkan oleh Athletic Bilbao di 16 besar setelah kalah 2-3. https://t.co/4eLYjHqu44,6,0,0,0,2022-01-20,23,Thursday,4,6,0
1484309737965424640,2022-01-20 23:39:53,"Hakim PN Surabaya, Itong Isnaeni Hidayat tak terima ditetapkan sebagai tersangka setelah terjaring OTT oleh KPK. Itong menyebut KPK omong kosong https://t.co/qVNEXCqWFV",6,12,1,0,2022-01-20,23,Thursday,4,7,12
1484309260401926145,2022-01-20 23:37:59,Hakim Pengadilan Negeri (PN) Surabaya Itong Isnaeni Hidayat ditetapkan KPK sebagai tersangka kasus dugaan suap. Uang Rp 140 Juta ini jadi buktinya. https://t.co/7gTGpStFqo,9,3,3,1,2022-01-20,23,Thursday,4,12,4
1484308732846567427,2022-01-20 23:35:53,"Menurut Ade, aksesibilitas akses wilayah menjadi salah satu faktornya. Meski demikian, dia harus tetap menunggu hasil kajian tim ahli. https://t.co/HyI7DpY4cd",4,1,1,0,2022-01-20,23,Thursday,4,5,1
1484307841154383879,2022-01-20 23:32:21,Direktorat Narkoba Polda Riau menangkap 11 anggota sindikat pengedar sabu asal Malaysia di lima lokasi di Pekanbaru dan Dumai pada Sabtu (15/1). Sebanyak 80 kilogram sabu diamankan dari operasi tersebut. https://t.co/TFWMBFuLgT,10,0,2,0,2022-01-20,23,Thursday,4,12,0
1484306777931796482,2022-01-20 23:28:07,Barcelona lelah dengan Ousmane Dembele dan memintanya segera cabut. Sikap itu dikecam Asosiasi Pesepakbola Spanyol. https://t.co/AmdjZxOE9a,8,0,1,0,2022-01-20,23,Thursday,4,9,0
1484306033791029259,2022-01-20 23:25:10,"Ketua Fraksi PDIP di DPR, Utut Adianto enggan mempersoalkan figur yang akan dipilih Presiden Joko Widodo sebagai Kepala Otorita Ibu Kota Negara (IKN) baru, Nusantara. https://t.co/1imL9Q8l3z",10,2,3,0,2022-01-20,23,Thursday,4,13,2
1484305144850251776,2022-01-20 23:21:38,Direktorat Narkoba Polda Riau menangkap 11 anggota sindikat pengedar sabu asal Malaysia di lima lokasi di Pekanbaru dan Dumai pada Sabtu (15/1). https://t.co/HQz5XogsxS,7,0,0,0,2022-01-20,23,Thursday,4,7,0
1484304006239645697,2022-01-20 23:17:06,"Usai heboh tarif parkir bus Rp 350 ribu di kawasan Malioboro, Yogyakarta, polisi mendatangi lokasi parkir tersebut. Hasilnya, pengakuan pengelola parkir dijelaskan bahwa Rp 350 ribu merupakan permintaan dari kernet bus. https://t.co/vZyZtOMAZs",13,2,1,1,2022-01-20,23,Thursday,4,14,3
1484303538805440514,2022-01-20 23:15:15,Pembangunan Jalan Lingkar Selatan yang menghubungkan beberapa ruas jalan di Kota dan Kabupaten Sukabumi terkendala anggaran untuk pembebasan lahan. https://t.co/dPksLdzojF,5,0,2,0,2022-01-20,23,Thursday,4,7,0
1484302259735334916,2022-01-20 23:10:10,"Dorce Gamalama tengah terbaring sakit. Ia pun mendapatkan bantuan perawatan kesehatan dari sejumlah tokoh, salah satunya Megawati. Melalui akun media sosialnya, Dorce Gamalama pun mengungkapkan rasa terima kasihnya kepada Megawati. https://t.co/qn7jHxkpGG",32,6,1,0,2022-01-20,23,Thursday,4,33,6
1484300894065864704,2022-01-20 23:04:44,PPP mengapresiasi KPK yang melakukan OTT hakim dan panitera pengganti PN Surabaya. OTT itu dinilai sebagai langkah membersihkan lembaga peradilan di Indonesia. https://t.co/xr3GPkIxEg,8,2,2,0,2022-01-20,23,Thursday,4,10,2
1484300394813698061,2022-01-20 23:02:45,"Menko Polhukam, Mahfud Md mengatakan Satgas BLBI telah berhasil merampas sejumlah aset milik obligor BLBI dengan nilai total mencapai Rp 15,11 triliun. Penyitaan ini dilakukan dalam kurun waktu 7 bulan.  https://t.co/P6p68c4jA9",9,0,3,1,2022-01-20,23,Thursday,4,12,1
1484299409299066883,2022-01-20 22:58:50,Kuli bangunan yang diduga menjadi pelaku pencabulan anak di Tangsel ditetapkan sebagai tersangka. Pelaku yang berinisial S ini sudah dilakukan penahanan. https://t.co/qzfvexzzCe,19,4,6,6,2022-01-20,22,Thursday,4,25,10
1484298046267604992,2022-01-20 22:53:25,"Kemenkes memperbaharui panduan penanganan COVID-19 varian Omicron. Terbaru, pasien Omicron tidak harus dirawat di rumah sakit jika memenuhi kriteria tertentu. https://t.co/eNf4Fs1QSE",12,5,8,0,2022-01-20,22,Thursday,4,20,5
1484297154558582785,2022-01-20 22:49:53,"Kepala BSKAP Kemendikbudristek RI sampaikan sejumlah evaluasi K-13, contohnya ada gengsi peminatan siswa SMA dan beban guru terlalu banyak. https://t.co/WNDfNZVJc3",11,0,6,0,2022-01-20,22,Thursday,4,17,0
1484296331401351169,2022-01-20 22:46:36,"Pengacara korban, Judianto Simanjuntak, mengapresiasi putusan tersebut karena menghukum berat terdakwa Bruder Angelo 14 tahun penjara. https://t.co/IFuKPeWTJL",9,0,1,0,2022-01-20,22,Thursday,4,10,0
1484295272914169860,2022-01-20 22:42:24,"Hubungan Erling Haaland dengan Borussia Dortmund tampaknya sedang tidak baik-baik saja. Haaland pernah mengaku ditekan, namun pihak klub ramai-ramai membantah. https://t.co/1kz4sQo2qW",4,0,1,0,2022-01-20,22,Thursday,4,5,0
1484294324363960329,2022-01-20 22:38:38,"Iman belum bisa memastikan ganjil genap akan diterapkan secara permanen atau tidak. Sebab, lanjutnya, Polres Bogor mengikuti instruksi dari pemerintah pusat. https://t.co/vc5V3E0xXT",4,0,1,0,2022-01-20,22,Thursday,4,5,0
1484293017997651968,2022-01-20 22:33:26,AS Roma berhasil mengalahkan Lecce 3-1 di 16 besar Coppa Italia. Giallorossi di babak selanjutnya menantang Inter Milan. https://t.co/tOdWembR3O,5,0,1,0,2022-01-20,22,Thursday,4,6,0
1484292104142655488,2022-01-20 22:29:49,Ketua Umum PBB Yusril Ihza Mahendra bertemu dengan Ketua Umum PPP Suharso Monoarfa. Keduanya membahas kerja sama Pemilu 2024. https://t.co/tedbuXOznP,9,1,1,0,2022-01-20,22,Thursday,4,10,1
1484291458718912531,2022-01-20 22:27:15,"Sebelum memilih jurusan kuliah, siswa harus memahami jurusan yang diambil karena bisa berpengaruh di karier masa depan. Simak tipsnya berikut ini. https://t.co/pji2DWOLpO",6,0,0,0,2022-01-20,22,Thursday,4,6,0
1484290667748724740,2022-01-20 22:24:06,"Pihak kepolisian Israel menghancurkan sebuah rumah milk keluarga Palestina, Salhiya di Yersualem Timur. Tak hanya itu, setidaknya 18 orag juga ditangkap. https://t.co/CfxwlWh9Sc",9,2,1,0,2022-01-20,22,Thursday,4,10,2
1484288606164471814,2022-01-20 22:15:55,Hakim PN Surabaya Itong Isnaeni Hidayat ditetapkan KPK sebagai tersangka kasus dugaan suap. Itong menyebut suap yang disampaikan KPK hanyalah sebuah dongeng. https://t.co/uQy7Ff9jhZ,5,0,0,1,2022-01-20,22,Thursday,4,5,1
1484287882001059844,2022-01-20 22:13:02,"Wakil Presiden RI, Maruf Amin meninjau langsung korban gempa magnitudo 6.6 di Kabupaten Pandeglang, Banten. Maruf Amin menawarkan korban terdampak gempa bumi untuk direlokasi ke tempat yang lebih aman. https://t.co/zi8Kw8xgiL",4,0,0,0,2022-01-20,22,Thursday,4,4,0
1484286778580348928,2022-01-20 22:08:39,Anggota DPR menyampaikan rasa prihatinnya atas vonis bui untuk Nia Ramadhani dan Ardi Bakrie yang terjerat kasus penyalahgunaan narkotika. https://t.co/INHC55pjOu,8,5,1,1,2022-01-20,22,Thursday,4,9,6
1484284533549809665,2022-01-20 21:59:44,"Menko polhukam, Mahfud Md mengungkap keterlibatan satu oknum pegawai Ditjen Kekayaan Negara (DJKN) Kemenkeu dalam kasus pemalsuan aset BLBI. Kini oknum tersebut telah ditangkap dan ditahan. https://t.co/TfSpbdpDDF",14,3,2,1,2022-01-20,21,Thursday,4,16,4
1484281174029746176,2022-01-20 21:46:23,"MSAT, anak kiai di Jombang tersangka kasus dugaan pencabulan santriwati menjalani sidang praperadilan. Pada sidang perdana ini, pengacara tersangka menyampaikan 7 permohonan kepada hakim praperadilan. https://t.co/JKI1YpAORw",3,0,0,0,2022-01-20,21,Thursday,4,3,0
1484278314504179715,2022-01-20 21:35:01,Kejati DKI Jakarta menyelidiki kasus dugaan korupsi dalam kegiatan Pembebasan Lahan oleh Dinas Kehutanan Provinsi DKI Jakarta di Kecamatan Cipayung Tahun 2018. https://t.co/5WkMpBGMbM,18,2,1,3,2022-01-20,21,Thursday,4,19,5
1484276768110481417,2022-01-20 21:28:52,Majelis Hakim Pengadilan Tipikor Serang menilai ada pihak lain yang harus tanggung jawab di kasus korupsi hibah ponpes Banten. https://t.co/ZCJMYdKo6P,10,0,1,0,2022-01-20,21,Thursday,4,11,0
1484275555419795460,2022-01-20 21:24:03,"Apa kalian pernah membayangkan makan di kantin Hogwarts? Tenang saja, kalian bisa mencobanya di kantin kampus mewah berikut ini ya! https://t.co/ruh1ds4Bdt",19,0,1,1,2022-01-20,21,Thursday,4,20,1
1484274513714233344,2022-01-20 21:19:55,Pemerintah melaporkan kasus harian COVID-19 hari ini sebanyak 2.116 kasus. Provinsi yang melaporkan kasus tertinggi dalam 24 jam terakhir adalah DKI Jakarta. https://t.co/GO9REYkMtN,39,9,14,5,2022-01-20,21,Thursday,4,53,14
1484273251408826375,2022-01-20 21:14:54,"Kepolisian Polda Metro gelar vaksin untuk anak di seluruh wilayah hukum Polda Metro Jaya. Hingga hari terakhir, vaksinasi anak itu capai jumlah 96,23 persen. https://t.co/6z0pBsMDXH",3,0,1,0,2022-01-20,21,Thursday,4,4,0
1484272169429393409,2022-01-20 21:10:36,"Lima pemain Arema FC yang berlaga pada Liga 1 2021 di Bali terkonfirmasi positif COVID-19. Kabar tersebut diungkap oleh Gubernur Bali, Wayan Koster. https://t.co/EQOuikXhYH",4,0,1,1,2022-01-20,21,Thursday,4,5,1
1484270673572859910,2022-01-20 21:04:39,"Real Madrid mampu mengalahkan Elche 2-1 di laga Copa del Rey. Sempat tertinggal lebih dulu, El Real yang bermain dengan 10 pemain bangkit membalikkan keadaan. https://t.co/3MI8OESKvB",4,0,1,0,2022-01-20,21,Thursday,4,5,0
1484268957532139523,2022-01-20 20:57:50,Badai salju di Timur Tengah membuat banyak warga Lebanon dan Suriah berebut mencari cara untuk bertahan hidup. Banyak warga tak mampu beli minyak. https://t.co/QIY8z5Ov8z,7,0,2,0,2022-01-20,20,Thursday,4,9,0
1484266473430339588,2022-01-20 20:47:58,"Sebuah truk tronton bermuatan pasir menyeruduk bangunan SDN Cibeureum 4 di Desa Cibeureum Kulon, Kecamatan Cimalaka, Kabupaten Sumedang. https://t.co/zjsEkze2PB",6,0,1,1,2022-01-20,20,Thursday,4,7,1
1484264010782593031,2022-01-20 20:38:11,"Pria di Kota Balikpapan, Kaltim, tega memperkosa anak kandungnya sebanyak 2 kali. Pelaku memberi korban Rp 10 ribu untuk tutup mulut. https://t.co/NUCEYVKqjP",18,10,2,4,2022-01-20,20,Thursday,4,20,14
1484262649340833802,2022-01-20 20:32:46,DKI Jakarta masuk zona merah karena kasus Omicron. Wakil Gubernur Ahmad Riza Patria mengatakan DKI Jakarta menerapkan micro-lockdown di kawasan itu. https://t.co/dMGNROXWeb,11,8,8,2,2022-01-20,20,Thursday,4,19,10
1484261029299249154,2022-01-20 20:26:20,Kepolisian telah menangkap seluruh pelaku pengeroyokan anggota TNI AD di Jakut. Polis telah mengamankan senjata tajam (sajam) yang digunakan di kasus itu. https://t.co/TodTeQRJIe,3,0,0,1,2022-01-20,20,Thursday,4,3,1
1484259997139845128,2022-01-20 20:22:14,"Usai heboh tarif parkir bus Rp 350 ribu di kawasan Malioboro, polisi mendatangi lokasi parkir tersebut. Hasilnya, harga itu permintaan dari kernet bus. https://t.co/pHskwsPsVi",9,0,5,0,2022-01-20,20,Thursday,4,14,0
1484257619699195910,2022-01-20 20:12:47,Hakim PN Surabaya Itong Isnaeni terjarig OTT terkait suap perkara oleh KPK. KY menyebut provinsi Jatim tertinggi kedua terkait laporan etik hakim. https://t.co/Z8jg0BePO6,3,0,0,0,2022-01-20,20,Thursday,4,3,0
1484257350999543819,2022-01-20 20:11:43,"Rest Area umumnya jadi tempat peristirahatan dalam perjalanan darat. Tapi rasanya, rest area ini bisa juga buat wisata lho. https://t.co/lKLxOWBIFE",6,1,1,1,2022-01-20,20,Thursday,4,7,2
1484256317539860482,2022-01-20 20:07:36,Raden Ayu Utari Sandijayaningsih dianggap agen intelijen Kerajaan Mataram yang sukses membunuh Gubernur VOC Jan Pieterzoon Coen. https://t.co/irEbLhtYT8,98,2,29,1,2022-01-20,20,Thursday,4,127,3
1484254666733113346,2022-01-20 20:01:03,"Negara komunis di pojok timur Asia ini tak berhenti mengetes rudal balistik hingga nuklir, dua jenis benda gawat yang bisa bikin ribut antarnegara. https://t.co/DVciQITfFB",3,0,0,1,2022-01-20,20,Thursday,4,3,1
1484250817272160258,2022-01-20 19:45:45,"Tukang roti jadi korban begal di Kecamatan Mustikajaya, Bekasi. Pelaku diketahui berjumlah enam orang masih berusia remaja. https://t.co/gyh1EVe6a8",18,4,4,2,2022-01-20,19,Thursday,4,22,6
1484249234094403590,2022-01-20 19:39:28,"Bali memang menjadi magnet wisatawan karena segudang potensi wisatanya. Namun, fakta menyebut bahwa Pulau Dewata tak ramah bagi penyu bertelur. https://t.co/Cr1cI73qbG",11,0,0,1,2022-01-20,19,Thursday,4,11,1
1484247713868828673,2022-01-20 19:33:25,Seorang wanita bernama Bonita Melia tewas ditabrak KRL di perlintasan kereta api Stasiun Pondok Cina. Korban merupakan mahasiswa Universitas Indonesia. https://t.co/xitKmjEOK6,8,3,5,7,2022-01-20,19,Thursday,4,13,10
1484246836156194826,2022-01-20 19:29:56,"Menko Marves Luhut Binsar Pandjaitan meminta semua pihak, khususnya pimpinan daerah, bersiap untuk menghadapi gelombang COVID-19 varian Omicron. https://t.co/tw6lueZR6i",66,70,22,13,2022-01-20,19,Thursday,4,88,83
1484245160175226888,2022-01-20 19:23:16,Seekor kucing yang sudah 8 bulan hilang akhirnya kembali ke pelukan pemiliknya. Penemuannya sungguh tak terduga. https://t.co/8xyPSCwI03,21,2,4,1,2022-01-20,19,Thursday,4,25,3
1484244068792213509,2022-01-20 19:18:56,"Gurun Atacama di Chili merupakan gurun nonpolar terkering di Bumi. Begitu luas, Atacama terbentang di atas tanah seluas 1.000 km. https://t.co/XsMdN2dpyJ",9,0,0,1,2022-01-20,19,Thursday,4,9,1
1484242015110017032,2022-01-20 19:10:46,Jokowi ingin kepala daerah berlatar belakang arsitek memimpin Nusantara. Jokowi dinilai sedang menyiapkan Ridwan Kamil untuk pencapresan di 2024. https://t.co/bV9Dhe1900,43,33,11,8,2022-01-20,19,Thursday,4,54,41
1484239457284935680,2022-01-20 19:00:37,Kemlu mengimbau masyarakat menjauhi praktik perlintasan luar negeri ilegal. Hal ini disampaikan terkait 3 kasus kecelakaan kapal pengangkut WNI di Malaysia. https://t.co/zjmRwpr9In,8,1,1,0,2022-01-20,19,Thursday,4,9,1
1484239163780218882,2022-01-20 18:59:27,"DPR mengesahkan UU IKN. Rencana pemindahan serupa pernah digagas oleh Korsel untuk memindahkan Seoul, ibu kota yang telah berusia 600 tahun. Sukseskah? https://t.co/ND7Oe1Dl7L",10,2,4,1,2022-01-20,18,Thursday,4,14,3
1484233871696830471,2022-01-20 18:38:25,"Prajurit TNI ditembaki KKB hendak bekerja membangun infrastruktur setempat untuk membantu warga, yang juga melibatkan prajurit putra daerah Papua Barat. https://t.co/emAM4YaPFQ",18,1,3,3,2022-01-20,18,Thursday,4,21,4
1484231529106755588,2022-01-20 18:29:06,Arteria dinilai sudah melakukan penistaan terhadap masyarakat Sunda. https://t.co/HkInvTz9ld,47,4,3,1,2022-01-20,18,Thursday,4,50,5
1484229084808949760,2022-01-20 18:19:24,Hakim PN Surabaya Itong Isnaeni Hidayat ditetapkan tersangka kasus dugaan suap oleh KPK. KY akan pemeriksaan terhadap Itong atas dugaan adanya pelanggaran etik https://t.co/6msYNQ98qx,10,3,2,0,2022-01-20,18,Thursday,4,12,3
1484227158516113408,2022-01-20 18:11:44,"Atap sebuah masjid baru dibangun di Bima, Nusa Tenggara Barat terpaksa dibongkar gara-gara dinilai mirip gereja. Hal ini viral di media sosial. https://t.co/S5yGBeb96F",18,35,7,5,2022-01-20,18,Thursday,4,25,40
1484225012840153088,2022-01-20 18:03:13,"Ada satu maskapai di Selandia Baru yang tidak akan menanyakan status vaksin atau tes COVID-19 traveler. Tapi, itu hanya berlaku untuk penerbangan domestik saja. https://t.co/SniOZuGhL7",2,1,2,0,2022-01-20,18,Thursday,4,4,1
1484222095634612230,2022-01-20 17:51:37,"Saat diketahui positif Omicron, ketiganya langsung menjalani isolasi. Kini mereka masih dalam penanganan isolasi di Wisma Atlet. https://t.co/uyyeUrNPEM",1,0,1,2,2022-01-20,17,Thursday,4,2,2
1484220983514996742,2022-01-20 17:47:12,Partai NasDem Sumut menyoroti ditangkapnya Bupati Langkat Terbit Rencana Perangin Angin yang terjaring operasi tangkap tangan (OTT) KPK. https://t.co/sBAKh424jh,7,1,0,1,2022-01-20,17,Thursday,4,7,2
1484220161385246722,2022-01-20 17:43:56,Timnas Indonesia telah menggelar latihan perdana untuk melawan Timor Leste di laga uji coba. Pada tahap ini Shin Tae-yong cuma ingin lihat kebugaran pemain. https://t.co/mF6OG6JRhO,9,1,2,0,2022-01-20,17,Thursday,4,11,1
1484220141680406528,2022-01-20 17:43:51,Madura United mengumumkan sosok manajer baru untuk mengisi kursi kosong sejak seri kedua Liga 1 2021. Dia adalah Zainal Hudha yang merupakan pengusaha. https://t.co/thvghNXlaR,4,0,1,0,2022-01-20,17,Thursday,4,5,0
1484217792870195203,2022-01-20 17:34:31,PKS mengkritik Arteria Dahlan karena meminta Kajati yang bicara pakai bahasa Sunda diganti. PKS menilai Arteria berlebihan. https://t.co/iMhKjM3lmv,18,2,0,3,2022-01-20,17,Thursday,4,18,5
1484216432439316481,2022-01-20 17:29:07,Sang kakak tak tega melihat Rudy yang tak bisa berjalan karena sakit hingga rela menukar kaki... https://t.co/IVBJbnRlVy,11,1,3,0,2022-01-20,17,Thursday,4,14,1
1484213041491329027,2022-01-20 17:15:39,Wakil Ketua KPK Nawawi Pomolango membalas hakim Itong Isnaini Hidayat yang menyela dan menyebut omong kosong saat konferensi pers kasus OTT di PN Surabaya. https://t.co/0L2DbrNhxE,8,4,1,1,2022-01-20,17,Thursday,4,9,5
1484212775526227973,2022-01-20 17:14:35,"Ghozali, mahasiswa asal Semarang viral dan dapat cuan sekitar Rp 1,5 miliar dari menjual foto selfie NFT. Mau buat apa uangnya? Ini kata Ghozali:  https://t.co/dLQyFs7UVa",37,14,5,4,2022-01-20,17,Thursday,4,42,18
1484210569553063942,2022-01-20 17:05:49,Itong dan Hamdan diberhentikan sementara oleh Mahkamah Agung (MA). MA menunjukkan surat keputusan Ketua MA tentang pemberhentian Itong dan Hamdan ke awak media. https://t.co/Er3Xf4LmM9,6,0,3,0,2022-01-20,17,Thursday,4,9,0
1484209193435467794,2022-01-20 17:00:21,"Ucapan kontroversial Arteria Dahlan soal bahasa Sunda berbuntut panjang. Kini, ramai di Twitter tanda pagar (tagar) #SundaTanpaPDIP. https://t.co/IEMt7GfqRj",2516,420,767,147,2022-01-20,17,Thursday,4,3283,567
1484208392830922754,2022-01-20 16:57:10,Wakil Gubernur Uu Ruzhanul Ulum batal mengerahkan santri ke Senayan karena Arteria Dahlan telah mengucapkan permohonan maaf. https://t.co/WaIrddHs02,7,1,4,3,2022-01-20,16,Thursday,4,11,4
1484207626992988169,2022-01-20 16:54:08,"KPK menetapkan tiga tersangka dalam OTT hakim Pengadilan Negeri (PN) Surabaya, Itong Isnaini Hidayat. Bagaimana kronologi OTT ini? https://t.co/K1n9Kc65Ll",13,2,3,0,2022-01-20,16,Thursday,4,16,2
1484207235463012358,2022-01-20 16:52:34,"Viral di media sosial soal anak dicabuli oleh kuli bangunan, namun laporan sempat ditolak polisi. Ayah korban membantah narasi tersebut. https://t.co/0PlsFMdu6N",13,0,0,0,2022-01-20,16,Thursday,4,13,0
1484206288489885696,2022-01-20 16:48:49,"Keberadaan varian Omicron dan Delta tentunya membuat dunia khawatir. Yang lebih bikin cemas, bagaimana kalau keduanya menyerang bersamaan? Mungkinkah terjadi? https://t.co/OOsrSeRNyz",9,4,4,2,2022-01-20,16,Thursday,4,13,6
1484205883269734402,2022-01-20 16:47:12,"Hakim PN Surabaya, Itong Isnaeni Hidayat ditetapkan sebagai tersangka terkait kasus suap. Di tengah konferensi pers yang disampaikan KPK, Itong sempat menyela. https://t.co/VAFlTo90cR",6,1,3,2,2022-01-20,16,Thursday,4,9,3
1484205302123831296,2022-01-20 16:44:53,Menteri Pertahanan Prabowo Subianto mengungkap kabar terbaru soal rencana pembelian jet temput Dassault Rafale. https://t.co/HnuR2eueLT,9,2,2,0,2022-01-20,16,Thursday,4,11,2
1484204393893351426,2022-01-20 16:41:17,"Seorang bayi berusia 11 bulan tertembak peluru nyasar di bagian wajahnya saat berada di dalam mobil yang terparkir di Bronx, New York, AS. Kini bayi tersebut kondisinya kritis. https://t.co/ybtu8CCyjA",5,0,1,2,2022-01-20,16,Thursday,4,6,2
1484203098172268548,2022-01-20 16:36:08,"Gubernur Jawa Barat, Ridwan Kamil, menyatakan siap maju dalam Pilpres 2024. Wakil Ketua Umum PKB, Jazilul Fawaid, mengatakan pintu PKB terbuka untuk Ridwan Kamil. Namun PKB minta Kang Emil jangan dulu percaya diri diusung jadi capres. https://t.co/dhCSgGhPHp",17,5,2,3,2022-01-20,16,Thursday,4,19,8
1484203075816628232,2022-01-20 16:36:03,"KPK mengamankan dua orang lainnya, yakni Achmad Prihantoyo (Direktur PT SGP) dan Dewi (Sekretaris HK), namun mereka tak ditetapkan sebagai tersangka. https://t.co/zhHM33DTLF",4,1,1,0,2022-01-20,16,Thursday,4,5,1
1484202312642007044,2022-01-20 16:33:01,"Makam Upin Ipin di Palu viral. Kesamaan nama tokoh utama serial animasi buatan Malaysia yang juga populer di Indonesia, Upin dan Ipin jadi keunikan tersendiri. https://t.co/oTixmRaJjK",31,1,1,0,2022-01-20,16,Thursday,4,32,1
1484201292910276611,2022-01-20 16:28:58,Arteria Dahlan meminta maaf kepada masyarakat Jawa Barat karena meminta kajati berbahasa Sunda diganti. Begini pernyataan lengkap Arteria Dahlan. https://t.co/U1IqgaswzW,26,28,5,4,2022-01-20,16,Thursday,4,31,32
1484200680395005957,2022-01-20 16:26:31,Pelaku juga mengancam akan membunuh ibu korban jika korban buka suara. https://t.co/OdIx9oIEFt,13,0,1,1,2022-01-20,16,Thursday,4,14,1
1484199721472245765,2022-01-20 16:22:43,Gerakan seks yang bisa memuaskan wanita tentu sulit untuk mereka lupakan kenikmatannya. Cowgirl adalah salah satu posisi yang bisa bikin wanita ketagihan. https://t.co/v8tJ98QieO,4,1,2,1,2022-01-20,16,Thursday,4,6,2
1484198663291392002,2022-01-20 16:18:31,"Kasus COVID-19 RI naik kembali, diyakini akibat marak varian Omicron. Lantas jika RI belum pulih total dari Corona, kenapa buru-buru PTM? Ini kata Kemendikbud: https://t.co/ZsXNJ38B7F",34,11,11,2,2022-01-20,16,Thursday,4,45,13
1484198641472614401,2022-01-20 16:18:25,Epidemiolog Dicky Budiman turut merespons terkait DKI Jakarta yang kini berstatus PPKM level 2. Ia menilai bahwa pemberlakuan WFH perlu ditambah lagi proporsinya. Kenapa? https://t.co/ACkvwLmv6O,10,0,1,1,2022-01-20,16,Thursday,4,11,1
1484197243527876615,2022-01-20 16:12:52,"Video memperlihatkan aksi pemalakan sopir truk bikin heboh di Palembang, Sumatra Selatan. Polisi bakal turun tangan mengecek kasus di video tersebut. https://t.co/Yub2S3gCat",2,1,1,1,2022-01-20,16,Thursday,4,3,2
1484197242022080520,2022-01-20 16:12:52,KPK menggelar OTT terhadap Hakim Pengadilan Negeri (PN) Surabaya Itong Isnaeni Hidayat. Itong terlihat telah mengenakan rompi tahanan KPK dan segera ditahan. https://t.co/ROnJ5JBf3Y,10,0,2,0,2022-01-20,16,Thursday,4,12,0
1484195185294675977,2022-01-20 16:04:41,Masa depan Egy Maulana Vikri di FK Senica telah terjawab. Klub asal Slovakia itu memperpanjang kontrak winger Timnas Indonesia. https://t.co/K6oJ8SvjUw,7,0,1,0,2022-01-20,16,Thursday,4,8,0
1484194639108317195,2022-01-20 16:02:31,Menhan Prabowo Subianto angkat bicara terkait dugaan korupsi dibalik proyek pengadaan satelit slot orbit 123 derajat Bujur Timur di Kemhan pada 2015. Prabowo sebut kasus proyek satelit tengah diproses dan pihaknya telah mengaudit kementeriannya. https://t.co/zFwfmUyrap,29,5,1,1,2022-01-20,16,Thursday,4,30,6
1484193360667545610,2022-01-20 15:57:26,Cristiano Ronaldo ngambek saat ditarik keluar di laga lawan Brentford. Kejadian itu diyakini bikin Ralf Rangnick kapok. https://t.co/3Rk6DuojVM,3,1,0,0,2022-01-20,15,Thursday,4,3,1
1484192463698882563,2022-01-20 15:53:52,"Hari ini COVID-19 RI tembus 2 ribu, DKI menyumbang jumlah kasus terbanyak. DKI juga terbanyak menyumbang Omicron di Indonesia, ini 5 zona merah yang dimiliki. https://t.co/pYLwodDhoe",9,1,1,5,2022-01-20,15,Thursday,4,10,6
1484191181374246912,2022-01-20 15:48:47,"Pasca amandemen 1933, tiap tanggal 20 Januari, 4 tahun sekali, menjadi hari bersejarah bagi AS. Pada tanggal itu, presiden pemenang pemilu dilantik. https://t.co/GOBWer7K5k",5,0,0,0,2022-01-20,15,Thursday,4,5,0
1484190105703116813,2022-01-20 15:44:30,Apa itu KIPI? KIPI diketahui sebagai efek yang timbul pada seseorang setelah mengikuti vaksinasi. Apa penyebab dan gejala yang ditimbulkan dari KIPI? https://t.co/60FvnmiUaz,2,0,2,0,2022-01-20,15,Thursday,4,4,0
1484189400833527809,2022-01-20 15:41:42,Mazda secara mengejutkan mengajukan hak paten mereka dengan kembali menghidupkan mesin rotary mereka.  https://t.co/Usplj4cF6j,10,2,1,1,2022-01-20,15,Thursday,4,11,3
1484188299417640965,2022-01-20 15:37:20,Sejumlah maskapai penerbangan internasional membatalkan penerbangan ke Amerika Serikat (AS) akibat teknologi 5G. Teknologi 5G ini disebut dapat membuat gangguan dalam teknologi penerbangan. https://t.co/tm9ZI8ZELW,14,2,3,2,2022-01-20,15,Thursday,4,17,4
1484187703436398596,2022-01-20 15:34:58,"Di mana saja lokasi vaksin booster Tangerang? Cek di sini untuk mengetahui syarat, biaya, hingga cara mendaftarnya ya! https://t.co/C5x1mSBPq1",3,0,2,1,2022-01-20,15,Thursday,4,5,1
1484187064291659777,2022-01-20 15:32:25,Tarif parkir bus Rp 350 ribu di Yogyakarta jadi perbincangan hangat. Karena itu bakal ada aplikasi di mana traveler bisa menuliskan review dan komentarnya. https://t.co/yRzzDTWxh4,14,7,2,2,2022-01-20,15,Thursday,4,16,9
1484187028832997383,2022-01-20 15:32:17,"Kepala ilmuwan WHO, Soumya Swaminathan, memberikan jawaban terkait alasan SAGE tak merekomendasikan vaksinasi booster Covid-19 bagi anak dan remaja yang sehat. https://t.co/zAyoCPBjrB",8,2,3,1,2022-01-20,15,Thursday,4,11,3
1484186257986969613,2022-01-20 15:29:13,Dua asisten pelatih Timnas Indonesia yakni Sahari Gultom dan Alex Aldha tidak lanjut bersama Garuda dan Shin Tae-yong sendiri yang meminta keduanya tidak lanjut. https://t.co/q1Kid15kGa,15,0,1,1,2022-01-20,15,Thursday,4,16,1
1484185616577298436,2022-01-20 15:26:40,"Ekspor mobil buatan Indonesia meningkat! Tahun 2021 lalu, mobil rakitan dalam negeri yang dikirim ke luar negeri bertambah banyak. https://t.co/jRWkaV43YU",21,5,7,1,2022-01-20,15,Thursday,4,28,6
1484185603457519618,2022-01-20 15:26:37,Islam Makhachev dijadwalkan akan menghadapi Beneil Dariush di kelas ringan UFC.  https://t.co/8AwJIKLXHO,10,0,1,1,2022-01-20,15,Thursday,4,11,1
1484184885459755015,2022-01-20 15:23:46,"Pemerintah sudah memutuskan IKN akan dipindahkan dari Jakarta ke Kaltim, tepatnya di antara Kabupaten PPU dan Kabupaten Kutai Kartanegara.  https://t.co/NePsaKFu9e",18,4,4,0,2022-01-20,15,Thursday,4,22,4
1484184858754641932,2022-01-20 15:23:39,Thomas Tuchel menolak mengibarkan bendera putih yang artinya belum menyerah! https://t.co/zxvDPoVwcN,8,0,0,0,2022-01-20,15,Thursday,4,8,0
1484184129683873798,2022-01-20 15:20:45,Kebakaran pertama kali diketahui oleh pemilik rumah makan saat hendak memasak. Sumber api diduga dari kebocoran gas elpiji. https://t.co/suBPh4HW8k,4,0,1,0,2022-01-20,15,Thursday,4,5,0
1484183805967486982,2022-01-20 15:19:28,"Jae eks DAY6 sempat membuat kontroversi karena bicara tak pantas pada teman dekatnya, Jamie, saat melakukan siaran di Twitch. Lewat Twitternya, Jamie pun menjelaskan bahwa saat ini dirinya dan Jae sudah berbaikan. https://t.co/ItSeP1GdX9",4,1,0,1,2022-01-20,15,Thursday,4,4,2
1484183474063826946,2022-01-20 15:18:09,Bukan kali pertama atau kedua dari Ronaldo kelihatan bete diganti! https://t.co/XiGNzTP5cT,8,0,0,0,2022-01-20,15,Thursday,4,8,0
1484182117508530178,2022-01-20 15:12:46,"Polisi menangkap seorang pria yang juga anak anggota Dewan di Tapanuli Selatan, Sumut. Pria berinisial RSS (32) itu ditangkap karena miliki senpi ilegal. https://t.co/T0yQFHOhmt",22,1,6,0,2022-01-20,15,Thursday,4,28,1
1484180640983502848,2022-01-20 15:06:54,"Perekonomian keluarganya sedang memburuk, gadis kelas 3 SD ini tergerak ikut membantu ibunya jualan sup ubi. Aksinya sukses membuat netizen terharu.  https://t.co/4MH6K3CjPW",58,0,9,0,2022-01-20,15,Thursday,4,67,0
1484180621811351554,2022-01-20 15:06:49,Seorang netizen terinspirasi membuat menu makanan ala restoran Salt Bae yang banyak menggunakan lembaran emas (edible gold). Ada kopi hingga keripik kentang!  https://t.co/2mTk1Rifxk,8,0,2,0,2022-01-20,15,Thursday,4,10,0
1484180593457860610,2022-01-20 15:06:42,Apakah selamanya ibu kota negara harus menjadi pusat pemerintahan? Ada negara-negara yang memisahkan lokasi ibu kota dengan pusat pemerintahan. https://t.co/zy1PblAM6r,10,2,6,0,2022-01-20,15,Thursday,4,16,2
1484180591759163405,2022-01-20 15:06:42,"Saat tiba, Iskandar tak mengeluarkan sepatah kata. Dia langsung masuk ke dalam gedung KPK untuk melakukan pemeriksaan lebih lanjut. https://t.co/GlwxKlohUO",6,1,0,0,2022-01-20,15,Thursday,4,6,1
1484179857244262403,2022-01-20 15:03:47,Otoritas Jasa Keuangan (OJK) akan memberikan relaksasi agar masyarakat lebih mudah ketika mengajukan kredit kendaraan listrik.   https://t.co/aAYd9tpyyD,13,0,4,2,2022-01-20,15,Thursday,4,17,2
1484179372105895936,2022-01-20 15:01:51,"Belum dilepas klubnya Ipswich Town ke Timnas Indonesia, Elkan Baggott absen dalam uji coba melawan Timor Leste di Bali. https://t.co/WOph1nnWf4",18,0,0,0,2022-01-20,15,Thursday,4,18,0
1484178856164560899,2022-01-20 14:59:48,"Pemain 19 tahun itu sempat hampir hengkang, tapi batal karena video di Youtube. https://t.co/uwwilwZRV7",9,0,1,0,2022-01-20,14,Thursday,4,10,0
1484177887955603468,2022-01-20 14:55:57,Iskandar Perangin Angin yang sempat buron akhirnya ditangkap KPK. Iskandar adalah kakak kandung Bupati Langkat Terbit Rencana Perangin Angin. https://t.co/hQSvjCUjfu,8,4,2,2,2022-01-20,14,Thursday,4,10,6
1484176956912377856,2022-01-20 14:52:15,"Polisi menyelidiki kasus pencurian besi penutup saluran air salah satu masjid di Setu, Kabupaten Bekasi, Jawa Barat. Para pelaku masih dalam pengejaran. https://t.co/wsem4q65Hb",6,1,1,1,2022-01-20,14,Thursday,4,7,2
1484176002972487680,2022-01-20 14:48:28,LRT ditargetkan akan beroperasi pada Agustus 2022 nanti. Yuk intip fakta menarik seputar LRT yang perlu kamu tahu! https://t.co/nkbpoYoL6B,16,3,0,1,2022-01-20,14,Thursday,4,16,4
1484175788198928389,2022-01-20 14:47:37,Mitsubishi Xpander matic kini ditawarkan dengan transmisi CVT (Continous Variable Transmission) baru. Apa untungnya pakai transmisi CVT? https://t.co/qg5Z9W2swV,11,2,3,1,2022-01-20,14,Thursday,4,14,3
1484175559701991424,2022-01-20 14:46:42,Kamu kreatif? Berani tampil di depan kamera? Yuk ikutan audisi dVideoCasterHunt 2022 di Kota Solo. Menangkan hadiah senilai total 128 juta rupiah + dikontrak oleh detikcom. Segera daftarkan dirimu sebelum 4 Februari 2022 melalui link berikut https://t.co/fOGyUVLoAA https://t.co/ZSyFILcnKB,3,0,1,1,2022-01-20,14,Thursday,4,4,1
1484174967306481664,2022-01-20 14:44:21,"Dunia digital memudahkan masyarakat, tapi juga harus lebih hati-hati. Sebab sekali salah pencet, bisa salah kirim uang puluhan juta rupiah. Pernah mengalami? #detiksAdvocate https://t.co/myn817eG7i",29,5,10,5,2022-01-20,14,Thursday,4,39,10
1484173852535975938,2022-01-20 14:39:55,Video Assistant Referee (VAR) 'low budget' digunakan di Liga 3 2022. Berapa harga satu set VAR yang dipakai di Liga 3 Seri 2 Jabar itu? https://t.co/zs1EKorZAW,10,0,0,0,2022-01-20,14,Thursday,4,10,0
1484171664967360513,2022-01-20 14:31:14,Ousmane Dembele menolak tawaran perpanjangan kontrak baru di Barcelona. Pemain asal Prancis tersebut diminta untuk segera mencari klub baru. https://t.co/3zvK3BjWK9,9,1,0,1,2022-01-20,14,Thursday,4,9,2
1484170939289915395,2022-01-20 14:28:21,Taufik dan Carti tetap bertahan di rumah karena takut gerobak dagangan tersebut hanyut atau diambil orang. https://t.co/6ezWtp8utC,6,0,0,1,2022-01-20,14,Thursday,4,6,1
1484170208977866752,2022-01-20 14:25:27,"Asa Ayu Thalia bisa berdamai dengan putra Basuki Tjahaja Purnama (Ahok), Nicholas Sean Purnama, menemui titik buntu. Sean menolak damai dari Ayu Thalia. https://t.co/A0sVW80aPG",14,7,2,2,2022-01-20,14,Thursday,4,16,9
1484169432914092033,2022-01-20 14:22:21,"Islam Makhachev dijadwalkan akan menghadapi Beneil Dariush di kelas ringan UFC. Awas Islam, Beneil bukanlah lawan sembarangan! https://t.co/wM1gEJKj1c",12,0,1,0,2022-01-20,14,Thursday,4,13,0
1484169045490417667,2022-01-20 14:20:49,Video Assistant Referee (VAR) 'low budget' digunakan di Liga 3 2022. Berapa harga satu set VAR yang dipakai di Liga 3 Seri 2 Jabar itu? https://t.co/7ITXbr9MeA,2,0,0,0,2022-01-20,14,Thursday,4,2,0
1484169017065717764,2022-01-20 14:20:42,Taufik dan Carti tetap bertahan di rumah karena takut gerobak dagangan tersebut hanyut atau diambil orang. https://t.co/pp43kroN0l,3,0,1,0,2022-01-20,14,Thursday,4,4,0
1484168421499572232,2022-01-20 14:18:20,"Hakim dan panitera pengganti PN Surabaya, Itong Isnaeni dan Mohammad Hamdan, terjerat OTT KPK. Ini 10 fakta OTT hakim dan panitera pengganti PN Surabaya. https://t.co/KrRoMv2J3r",8,5,1,0,2022-01-20,14,Thursday,4,9,5
1484168135498473474,2022-01-20 14:17:12,Ketua Fraksi PDIP DPR Utut Adianto bicara mengenai bursa Kepala Otorita IKN Nusantara. Dia menyerahkan semua kepada Jokowi. https://t.co/vHSme8LP0e,6,2,1,2,2022-01-20,14,Thursday,4,7,4
1484168134219091968,2022-01-20 14:17:12,Taufik dan Carti tetap bertahan di rumah karena takut gerobak dagangan tersebut hanyut atau diambil orang. https://t.co/vAnFraEaxL,15,1,2,1,2022-01-20,14,Thursday,4,17,2
1484166868399280133,2022-01-20 14:12:10,Pria itu tampak membawa sebuah koper berwarna hitam. Dia juga diamankan bersama panitera PN Surabaya dan pengacara di OTT ini. https://t.co/YZP4VRzOhK,9,0,1,1,2022-01-20,14,Thursday,4,10,1
1484165414074601477,2022-01-20 14:06:23,Mutiara Sangaji harus menerima rasa pilu karena diselingkuhi sang suami saat tengah mengandung. Sang ayah selalu menguatkannya untuk terus bertahan hidup. https://t.co/lNldbwSn5N,16,1,2,2,2022-01-20,14,Thursday,4,18,3
1484165134138417154,2022-01-20 14:05:17,Elkan Baggott belum dilepas klubnya Ipswich Town ke Timnas Indonesia. Pemain jangkung tersebut pun absen dalam uji coba melawan Timor Leste di Bali. https://t.co/tmANS81L8L,16,0,0,0,2022-01-20,14,Thursday,4,16,0
1484165131789647879,2022-01-20 14:05:16,Hakim Pengadilan Negeri (PN) Surabaya Itong Isnaeni Hidayat tiba di gedung KPK Jakarta. Sebelumnya Itong terjaring OTT KPK terkait suap perkara di pengadilan. https://t.co/EVGKetJHEv,15,2,6,2,2022-01-20,14,Thursday,4,21,4
1484164506905452547,2022-01-20 14:02:47,"#Terpopuler Diketahui, peristiwa dalam video viral itu diketahui terjadi pada 13 Januari 2022. Pembongkaran dilakukan warga menggunakan kayu, besi, hingga sekop. https://t.co/5NDt7PsRu4",27,17,6,6,2022-01-20,14,Thursday,4,33,23
1484164147470340103,2022-01-20 14:01:21,"Pemerintah telah memutuskan untuk menurunkan harga minyak goreng demi memenuhi kebutuhan rumah tangga dan industri. Simak di video berikut ini, Bun! #detiknetwork https://t.co/0wwFhCZgCM",12,0,0,2,2022-01-20,14,Thursday,4,12,2
1484163155966275590,2022-01-20 13:57:25,#Terpopuler Adhisty Zara menceritakan jika momen yang paling sulit dilupakannya kala tampil di Virgin the Series yakni adegan bersama DJ Winky.  https://t.co/mytLiDqHvA,7,0,0,1,2022-01-20,13,Thursday,4,7,1
1484163131219845127,2022-01-20 13:57:19,"Gaga Muhammad divonis 4,5 tahun penjara terkait kasus kecelakaan yang menyebabkan Laura Anna lumpuh. Dirangkum 20Detik, berikut serba-serbi mengenai sidang vonis Gaga. https://t.co/o3PST9BaTD",4,0,0,0,2022-01-20,13,Thursday,4,4,0
1484162820811935747,2022-01-20 13:56:05,"Rumah tangganya sempat dikabarkan retak, Shandy Aulia terlihat bersama lagi dengan sang suami. Ini alasan Shandy soal kembali dengan sang suami:  https://t.co/d9Q7YdHz5O",6,0,2,1,2022-01-20,13,Thursday,4,8,1
1484162159198318600,2022-01-20 13:53:27,"Sebelum memilih prodi sesuai minat, yuk cek dulu jurusan dengan kuota terbanyak di seleksi masuk SPAN PTKIN 2022! Berikut daftarnya:

via: detikedu https://t.co/vPfyKDZnWo",5,0,2,0,2022-01-20,13,Thursday,4,7,0
1484161762249388033,2022-01-20 13:51:53,"Introvert bukanlah suatu kelemahan. Nah kira-kira apa ya jurusan kuliah yang cocok untuk introvert? Simak di sini penjelasannya ya:

via: detikedu https://t.co/kxmTOGiUv1",11,0,3,0,2022-01-20,13,Thursday,4,14,0
1484161119572971521,2022-01-20 13:49:19,"Pria tua bernama Malla (63), warga lingkungan Rangas Barat, Kelurahan Rangas, Kecamatan Banggae, viral lantaran memperbaiki jalan seorang diri. Ia mengaku sudah sepekan menghabiskan waktunya memperbaiki kerusakan jalan ini. https://t.co/OIajU0oOu8",29,2,5,0,2022-01-20,13,Thursday,4,34,2
1484161084466544642,2022-01-20 13:49:11,Andrew Garfield juga membohongi Emma Stone soal penampilannya di Spider-Man: No Way Home. Begini kisahnya:  https://t.co/3c5JGxHgCB,14,1,3,0,2022-01-20,13,Thursday,4,17,1
1484160703367893002,2022-01-20 13:47:40,"Erupsi gunung api bawah laut Tonga sudah berakhir. Terjadi bencana tsunami, bagaimana kabar WNI di sana? https://t.co/h9fbmCrxbB",16,0,1,0,2022-01-20,13,Thursday,4,17,0
1484160352820641800,2022-01-20 13:46:17,Saksi di sidang Munarman yang mengaku melihat mantan Sekum FPI itu berbaiat kepada ISIS. Munarman menepis. https://t.co/KDFnAX0vJj,6,0,0,1,2022-01-20,13,Thursday,4,6,1
1484160327281528835,2022-01-20 13:46:11,Gurita hidup termasuk salah satu makanan yang populer di Korea Selatan. Namun aksi makan gurita hidup ini mendapat kecaman banyak orang!  https://t.co/J8f9bn6cGL,4,2,0,1,2022-01-20,13,Thursday,4,4,3
1484158547042705412,2022-01-20 13:39:06,"KPK kembali melancarkan OTT terhadap Hakim PN Surabaya Itong Isnaeni Hidayat dan Panitera PN Surabaya, Hamdan. Keduanya langsung dibawa masuk KPK. https://t.co/gQ7ur7qQGW",33,4,5,0,2022-01-20,13,Thursday,4,38,4
1484157751039307781,2022-01-20 13:35:56,"Dalam OTT ini, KPK mengamankan 5 orang. Di antaranya hakim hingga pengacara. Ali mengatakan hakim PN Surabaya dan para pihak terkait masih dalam perjalanan. https://t.co/I0t8n18P8s",13,1,1,2,2022-01-20,13,Thursday,4,14,3
1484155885232525324,2022-01-20 13:28:31,Sejumlah artis Bollywood menjalani bedah plastik untuk mengubahkan penampilan wajah. Bagaimana ya penampilan wajah mereka? https://t.co/LjJeD7ILs8,6,1,0,1,2022-01-20,13,Thursday,4,6,2
1484155596664360968,2022-01-20 13:27:23,"Indonesia mencatat sebanyak 2.116 kasus baru COVID-19, Kamis (20/1/2022). DKI menyumbang kasus terbanyak dengan jumlah 1.155. https://t.co/UaQUo2Bfav",17,5,8,4,2022-01-20,13,Thursday,4,25,9
1484154889177640977,2022-01-20 13:24:34,Supangat mengatakan sampah kabel tersebut langsung dimasukan ke dalam truk milik Sudin Bina Marga Jakpus. Sampah kabel itu dibawa ke UPT Alkal Kemayoran. https://t.co/f5j6tXPVHP,26,7,4,2,2022-01-20,13,Thursday,4,30,9
1484154113751494658,2022-01-20 13:21:29,#Terpopuler Oki Setiana Dewi angkat bicara soal kabar Ria Ricis yang disebut sedang hamil. Ini kata Oki Setiana Dewi:  https://t.co/YOam16NZHt,5,0,1,1,2022-01-20,13,Thursday,4,6,1
1484153555074400257,2022-01-20 13:19:16,Bupati Langkat Sumatera Utara Terbit Rencana Perangin Angin terjaring operasi tangkap tangan (OTT) Komisi Pemberantasan Korupsi (KPK). Terbit Rencana diketahui sempat diduga mencoba menghindar dari kejaran KPK. https://t.co/CUEcoCqV0x,9,0,3,2,2022-01-20,13,Thursday,4,12,2
1484152952696754181,2022-01-20 13:16:52,"Anggota Komisi III DPR Fraksi PDI Perjuangan, Arteria Dahlan meminta maaf kepada seluruh masyarakat Sunda atas pernyataannya terkait copot kajati berbahasa Sunda. Arteria mengaku tidak ada niatan untuk melakukan rasis terhadap suku Sunda. https://t.co/w66ehY1fkF",13,34,3,7,2022-01-20,13,Thursday,4,16,41
1484152678846545925,2022-01-20 13:15:47,"Patah hati terhadap Indonesia? ""Iya, it broke my heart,"" kata Nadine Kaiser, sang pengawal Susi Air, putri Susi Pudjiastuti. Simak kisahnya di sini:  https://t.co/HfR8G9XFRk",18,1,3,1,2022-01-20,13,Thursday,4,21,2
1484151865122164741,2022-01-20 13:12:33,"Selain klik laman LTMPT atau PTN, ini saran lain bagi para peserta SNMPTN 2022. Simak yuk tips dan trik yang bisa diterapkan siswa:

via: detikedu https://t.co/gbYcuiCGGg",4,0,1,1,2022-01-20,13,Thursday,4,5,1
1484151511613689862,2022-01-20 13:11:09,"Jaksa menuntut dua polisi di Tanjungbalai, Sumatera Utara (Sumut), hukuman mati. Keduanya, yakni Tuharno dan Wariono, diyakini bersalah karena terlibat dalam menyisihkan barang bukti sabu hasil sitaan untuk dijual. https://t.co/huPq68ZI7b",39,2,9,3,2022-01-20,13,Thursday,4,48,5
1484151316431654915,2022-01-20 13:10:22,Program street race yang digagas Polda Metro Jaya terus dikembangkan. Ada tiga lokasi yang disiapkan menggelar ajang tersebut selain di Ancol. https://t.co/AykEXhKJLk,3,2,3,0,2022-01-20,13,Thursday,4,6,2
1484151283242184709,2022-01-20 13:10:14,"#Terpopuler Viral postingan bernarasi tarif parkir bus Rp 350 ribu di belakang Hotel Premium Zuri, kawasan Malioboro. Wakil Wali Kota Yogya minta proses hukum bagi pelaku. https://t.co/tbV96iXRgp",10,1,2,2,2022-01-20,13,Thursday,4,12,3
1484150727765336072,2022-01-20 13:08:02,"Pernyataan Arteria Dahlan soal ganti kajati berbahasa Sunda menjadi polemik. Akhirnya, Arteria menyampaikan permohonan maaf kepada masyarakat Sunda. https://t.co/yMQIGStTQS",9,5,2,1,2022-01-20,13,Thursday,4,11,6
1484149469868404736,2022-01-20 13:03:02,"Tebak-tebakan ini mudah dijawab apabila kamu fokus dan cermat, apalagi bagi orang yang ber-IQ tinggi. Mungkin ini soal sepele. Yuk selesaikan! https://t.co/EfWPMpXrT7",49,61,1,3,2022-01-20,13,Thursday,4,50,64
1484148534387654658,2022-01-20 12:59:19,#Terpopuler Koalisi Masyarakat Kalimantan Timur menolak pemindahan ibu kota. Mereka menilai RUU Ibu Kota Negara yang kini telah disahkan cacat secara prosedural. https://t.co/s5IuPa7EGF,69,9,16,1,2022-01-20,12,Thursday,4,85,10
1484147739365724175,2022-01-20 12:56:09,"Dalam tempo seminggu, anggota DPR RI sudah dua kali mengusir ‘tamu’ rapat. Berikut rangkumannya: https://t.co/CbtHNVVgVY",4,0,2,0,2022-01-20,12,Thursday,4,6,0
1484146991265460226,2022-01-20 12:53:11,"#FOTO Gempi menginjak usia 7 tahun. Momen pergantian usia itu dirayakan oleh orang tuanya, Gading Marten dan Gisel. Ini potretnya:  https://t.co/kOVVgMzLvU",9,2,1,1,2022-01-20,12,Thursday,4,10,3
1484146354670776320,2022-01-20 12:50:39,Anies Baswedan sempat dikritik tak kelihatan kerja soal penanganan banjir. Anies kemudian menyuarakan kerja senyap jajarannya menangani banjir cepat surut. https://t.co/q70qSMMaHd,115,97,16,11,2022-01-20,12,Thursday,4,131,108
1484145857922576388,2022-01-20 12:48:41,"Perajin perahu Abah Karun banyak terima order saat banjir melanda Kecamatan Baleendah, Kabupaten Bandung. Meski banjir telah reda, permintaan perahu tetap ada.  https://t.co/3MhaaNS9sW",18,0,2,2,2022-01-20,12,Thursday,4,20,2
1484145503730348037,2022-01-20 12:47:16,Hal yang memberatkan putusan tersebut adalah hakim menilai perbuatan terdakwa merupakan penyakit masyarakat. https://t.co/V7UVssn2pD,9,2,0,0,2022-01-20,12,Thursday,4,9,2
1484144796159647745,2022-01-20 12:44:28,#Terpopuler Tim arkeolog menemukan yang diklaim sebagai sumber kekayaan Nabi Sulaiman sekitar 3.000 tahun yang lalu berupa situs pemisahan bijih tembaga. https://t.co/ss1YODutB9,20,0,5,0,2022-01-20,12,Thursday,4,25,0
1484143875979624451,2022-01-20 12:40:48,"Untuk ketiga kalinya dalam sepekan terakhir, Indonesia mencatatkan lebih dari seribu kasus harian COVID-19. Berikut riwayat penambahan kasus dalam sepekan terakhir: https://t.co/NdFgQ5itFk",21,3,8,6,2022-01-20,12,Thursday,4,29,9
1484143853334675459,2022-01-20 12:40:43,"Token kripto milik Anang Hermansyah, ASIX mulai dijual melalui private sale. Penjualan ini dilakukan sebelum dijual secara resmi.  https://t.co/FcOYBhFroB",17,5,2,1,2022-01-20,12,Thursday,4,19,6
1484142875617243144,2022-01-20 12:36:50,Anggota Komisi III DPR RI prihatin dengan vonis bui Nia Ramadhani dan Ardi Bakrie terkait narkoba. Apa respons Kepala BNN? https://t.co/901rCev1iS,5,2,0,0,2022-01-20,12,Thursday,4,5,2
1484142088581263360,2022-01-20 12:33:42,"Hal yang perlu diperhatikan calon mahasiswa sebelum berkuliah adalah biaya. Apa biaya kuliah SNMPTN dan SBMPTN memiliki perbedaan? Cari tahu jawabannya:

via: detikedu https://t.co/o6mudDzFpR",9,0,2,1,2022-01-20,12,Thursday,4,11,1
1484141531799953412,2022-01-20 12:31:29,Bank Indonesia (BI) mencatat suku bunga kredit di perbankan nasional terus mengalami penurunan.  https://t.co/XyxlkUIKZI,15,6,0,1,2022-01-20,12,Thursday,4,15,7
1484140759859269633,2022-01-20 12:28:25,"Kasus COVID-19 varian Omicron mulai merebak di DKI Jakarta. Salah satu wilayah yang dikategorikan berwarna merah adalah Kalideres, Jakbar. https://t.co/6kBqbFrREB",18,4,14,6,2022-01-20,12,Thursday,4,32,10
1484140195352137730,2022-01-20 12:26:11,Komisi Pengawas Persaingan Usaha (KPPU) mengendus praktik kartel dalam fenomena naiknya harga minyak goreng!  https://t.co/QFvQevjjAQ,21,3,5,1,2022-01-20,12,Thursday,4,26,4
1484139943979016195,2022-01-20 12:25:11,"Pemerintah telah mematok harga minyak goreng Rp 14.000 per liter untuk semua merek kemasan. Ada pelanggaran harga, lapor ke sini! https://t.co/LRfVmYNmkd",58,10,27,4,2022-01-20,12,Thursday,4,85,14
1484139655159242752,2022-01-20 12:24:02,Pembeli dari proyek Apartemen 45 Antasari yang mangkrak terpecah. Ada yang tidak setuju dengan proposal perdamaian dalam PKPU atau juga yang menerimanya.  https://t.co/akqMixKc7r,9,1,0,0,2022-01-20,12,Thursday,4,9,1
1484139653930303493,2022-01-20 12:24:02,Ketua Eksekutif Forum Ekonomi Dunia Klaus Schwab menanyakan kepada Jokowi mengenai ketergantungan RI terhadap pembangkit listrik tenaga batu bara. Inilah jawabannya.  https://t.co/Px0m1O6PY4,3,0,0,0,2022-01-20,12,Thursday,4,3,0
1484139340657836039,2022-01-20 12:22:47,"Wagub DKI Jakarta, Ahmad Riza Patria merespons pemeriksaan terhadap Mantan Wamenlu, Dino Patti Djalal oleh KPK terkait Formula E. Ini kata dia. https://t.co/Mi16sJA833",10,4,2,2,2022-01-20,12,Thursday,4,12,6
1484139338514456582,2022-01-20 12:22:46,Ali menyayangkan Rahmat Effendi melakukan pertemuan daring dengan pihak lain. KPK mengaku akan melakukan evaluasi atas kejadian ini. https://t.co/xkjkGmbLbU,1,1,0,1,2022-01-20,12,Thursday,4,1,2
1484138762644901889,2022-01-20 12:20:29,"Ada klaim yang menyatakan bahwa kepribadian tertentu menandakan seseorang mempunyai IQ tinggi. Benar nggak ya? Begini penjelasannya.

via: detikedu https://t.co/4dO9E6ozqN",9,3,1,1,2022-01-20,12,Thursday,4,10,4
1484138256153423873,2022-01-20 12:18:28,Thariq Halilintar ngaku memang dekati Fuji. Thariq tegaskan sudah selesai dengan Chika Chandrika.  https://t.co/yXKaLcTe3n,11,5,0,2,2022-01-20,12,Thursday,4,11,7
1484137678748766208,2022-01-20 12:16:11,"Salah satu pertanyaan yang sering muncul adalah, apa urgensinya dari pemindahan IKN ini?  https://t.co/lkaZKVhFJb",33,29,7,6,2022-01-20,12,Thursday,4,40,35
1484137141076738051,2022-01-20 12:14:03,Isu miring soal Nagita Slavina yang dituding punya video syur berdurasi 61 detik mulai terang. Ada potongan gambar yang disebut berasal dari video aslinya. https://t.co/T7T5naEnpF,6,1,1,0,2022-01-20,12,Thursday,4,7,1
1484136622820052993,2022-01-20 12:11:59,"Perawatan terhadap eksterior body mobil sudah beragam, dari melakukan poles mobil hingga waxing cat mobil. Berikut perbedaannya! https://t.co/ZbNepyNIFD",9,0,2,0,2022-01-20,12,Thursday,4,11,0
1484136308197019652,2022-01-20 12:10:44,Mahfud MD menyatakan ada pegawai Ditjen Kekayaan Negara (DJKN) Kementerian Keuangan yang memalsukan aset tanah BLBI.  https://t.co/TNbaDNNanH,16,2,5,0,2022-01-20,12,Thursday,4,21,2
1484136306926137350,2022-01-20 12:10:44,"Sebuah mobil Pajero terperosok ke kali di Serpong, Tangerang Selatan, Banten. Pengendara Pajero berinisial B (54) dinyatakan tewas. https://t.co/PPTosn6xXD",7,0,0,0,2022-01-20,12,Thursday,4,7,0
1484135426969452552,2022-01-20 12:07:14,"Berlokasi di Stadio RAA Adiwijaya, Garut memiliki lintasan atletik berstandar internasional. Lihat yuk! https://t.co/ZwlTeUNHc5",14,0,1,2,2022-01-20,12,Thursday,4,15,2
1484135141421326341,2022-01-20 12:06:06,Rencana pemindahan ibu kota dari Jakarta ke Kalimantan Timur (Kaltim) kembali ramai menjadi perhatian publik.  https://t.co/OhdbCQ2wDC,30,8,4,0,2022-01-20,12,Thursday,4,34,8
1484135134613975041,2022-01-20 12:06:04,Kejagung mengusut kasus dugaan korupsi dana tabungan wajib perumahan angkatan darat tahun 2013-2020. Kejagung melakukan pengecekan 23 kavling di Gianyar. https://t.co/rloVlMEgIS,5,0,1,0,2022-01-20,12,Thursday,4,6,0
1484134795621851145,2022-01-20 12:04:43,Asuransi unit link tak berhenti memakan korban. Di mana peran Otoritas Jasa Keuangan (OJK) dalam mengatasi persoalan tersebut?  https://t.co/sFtLl2U90v,21,9,9,4,2022-01-20,12,Thursday,4,30,13
1484134565262376960,2022-01-20 12:03:48,"Meski sudah meminta maaf, Arteria sudah dilaporkan di Polda Jabar oleh Majelis Adat Sunda. Tetapi apakah ujaran Arteria ini bisa diproses hukum? https://t.co/o9ab212sSM",11,5,0,1,2022-01-20,12,Thursday,4,11,6
1484134304166944768,2022-01-20 12:02:46,Baim Wong dan Giovanni Tobing membuka rumah makan gratis bernama Silahkan Makan Gratis yang diperuntukkan orang-orang yang membutuhkan. https://t.co/fHBRuravcK,26,2,1,1,2022-01-20,12,Thursday,4,27,3
1484133731417919489,2022-01-20 12:00:30,"Sebuah akun Facebook mengunggah curhatan berisikan keluhan soal mahalnya tarif parkir bus di salah satu kawasan di Kota Yogyakarta, yakni Rp350 ribu hanya untuk beberapa jam saja. #CNNIndonesia #detiknetwork https://t.co/n3y11aPQDB",20,3,2,3,2022-01-20,12,Thursday,4,22,6
1484133489373069319,2022-01-20 11:59:32,Premier League ingin mengubah aturan mengenai penundaan laga setelah mendapat kritik tajam. Hal ini agar tak disalahgunakan oleh klub-klub. https://t.co/K0nsMkKwyf,4,1,0,0,2022-01-20,11,Thursday,4,4,1
1484132914208124930,2022-01-20 11:57:15,"Sebanyak 3,2 juta unit set top box gratis TV digital akan disalurkan ke rumah tangga miskin. STB ini membantu masyarakat mendapatkan siaran TV digital ketika TV analog dimatikan. https://t.co/CuZPKnllCA",19,9,6,1,2022-01-20,11,Thursday,4,25,10
1484132417397006336,2022-01-20 11:55:16,"Seleksi masuk PTKIN segera dibuka nih. Cek jurusan dan kampus dengan peminat terbanyak di SPAN - UM PTKIN 2021 buat referensi kamu!

via: detikedu https://t.co/mHniOnekmW",8,0,1,0,2022-01-20,11,Thursday,4,9,0
1484132395578236930,2022-01-20 11:55:11,"Kepala BNN, Komjen Petrus Reinhard Golose, menepis stigma tersebut. https://t.co/Qttn6giGro",6,4,0,0,2022-01-20,11,Thursday,4,6,4
1484131849693810689,2022-01-20 11:53:01,"Polo air tidak dipertandingkan di SEA Games Hanoi 2022, PB PRSI membidik Asian Games sebagai target multievent pada tahun ini. https://t.co/holdhs6WR2",4,0,0,0,2022-01-20,11,Thursday,4,4,0
1484131348117962754,2022-01-20 11:51:01,"#Terpopuler Ghozali, mahasiswa asal Semarang viral dan dapat cuan sekitar Rp 1,5 miliar dari menjual foto selfie NFT. Mau buat apa uangnya? Ini kata Ghozali:  https://t.co/8oXOnFoUEy",19,9,4,1,2022-01-20,11,Thursday,4,23,10
1484130852401553410,2022-01-20 11:49:03,Seorang karyawan Raffi Ahmad dan Nagita Slavina yang bekerja di RANS Entertainment mengungkapkan biaya makan sehari:  https://t.co/draciprpDS,22,3,0,0,2022-01-20,11,Thursday,4,22,3
1484130598834913286,2022-01-20 11:48:03,"Viral sebuah video yang menampilkan aksi pencurian besi penutup saluran air di Setu, Kabupaten Bekasi. Polisi turun tangan menyelidiki kasus ini. https://t.co/AhtRdxnhVq",5,0,0,0,2022-01-20,11,Thursday,4,5,0
1484130043215372290,2022-01-20 11:45:50,PSSI memutuskan uji coba Timnas Indonesia melawan Timor Leste pada 27 dan 30 Januari. https://t.co/CHYF83kJVO,8,3,1,0,2022-01-20,11,Thursday,4,9,3
1484129822989242374,2022-01-20 11:44:58,Asuransi produk unit link sering makan korban. Nasabah kerap merasa tertipu dan terjebak dengan produk ini.  https://t.co/awgcKZZ5yW,7,0,3,1,2022-01-20,11,Thursday,4,10,1
1484127668023013376,2022-01-20 11:36:24,"Dengan adanya penambahan kasus tersebut, total kasus COVID-19 di Indonesia hingga hari ini sebanyak 4.277.644 kasus. https://t.co/VS9r4YPIwj",18,1,7,1,2022-01-20,11,Thursday,4,25,2
1484127177935368193,2022-01-20 11:34:27,Ratusan warga berdatangan ke sentra vaksinasi Stadion Patriot Candrabhaga di Bekasi. Mereka ramai-ramai mengantre demi mendapatkan vaksin booster. https://t.co/27daDfosES,17,3,2,0,2022-01-20,11,Thursday,4,19,3
1484126098501820417,2022-01-20 11:30:10,"Jumlah kasus COVID-19 di Indonesia bertambah 2.116, Kamis (20/1/2022). Total kasus positif menjadi 4.277.644, sembuh 4.121.117, dan meninggal 144.199. https://t.co/Jhq1YmlnIJ",16,2,7,2,2022-01-20,11,Thursday,4,23,4
1484125824689315842,2022-01-20 11:29:04,David De Gea tampil solid di gawang Manchester United dan layak disebut tembok! https://t.co/4hTW2T9Udk,9,2,3,1,2022-01-20,11,Thursday,4,12,3
1484125823439413258,2022-01-20 11:29:04,"Wajah pariwisata Yogyakarta dicoreng lagi dengan aksi getok harga tarif parkir bus. Kemarin, kejadian serupa dialami oleh traveler yang makan pecel lele. https://t.co/cPajToTDox",21,4,11,0,2022-01-20,11,Thursday,4,32,4
1484125799636742145,2022-01-20 11:28:59,"Mobil dinas milik Lapas Gobah, Pekanbaru, Riau, dibakar orang tak dikenal. Mobil dibakar dini hari tadi saat diparkirkan di rumah. https://t.co/sTPqAJDdfr",7,0,1,0,2022-01-20,11,Thursday,4,8,0
1484125323776212994,2022-01-20 11:27:05,"Saat menjamu Timnas Indonesia, Timor Leste wajib menjalani karantina dan menjalankan sistem bubble di Tanah Air. https://t.co/KBJZ8v3YhV",4,0,0,0,2022-01-20,11,Thursday,4,4,0
1484125304985735168,2022-01-20 11:27:01,"Kisah tersebut menceritakan Ilham Nugraha, seorang mahasiswa LPDP yang saat ini menimba ilmu Kebijakan Publik di Cornell University di Amerika Serikat.  https://t.co/JvEhBwodXJ",8,2,1,0,2022-01-20,11,Thursday,4,9,2
1484124760988696576,2022-01-20 11:24:51,Menhan Prabowo buka suara terkait kasus dugaan korupsi satelit slot orbit 123 derajat Bujur Timur yang ada di Kemhan. Apa katanya? https://t.co/OwDSqqDs4b,9,2,3,2,2022-01-20,11,Thursday,4,12,4
1484124198473809929,2022-01-20 11:22:37,"Objek wisata Situ Wangi di Ciamis telah selesai ditata. Kini kondisi Situ Wangi nampak lebih menarik dan indah, jauh berbeda dari sebelumnya. Begini potretnya: https://t.co/LQE0U7zU3T",6,0,2,1,2022-01-20,11,Thursday,4,8,1
1484123937952907270,2022-01-20 11:21:35,"Foto udara menunjukan kemajuan proyek pembangunan Jalan Tol Semarang - Demak seksi II di Kecamatan Sayung, Kabupaten Demak, Jawa Tengah, Rabu (19/1/2022).  https://t.co/vnf3YSuXwH",18,2,3,0,2022-01-20,11,Thursday,4,21,2
1484123684533149699,2022-01-20 11:20:34,Tak mudah buat Fabio Quartararo untuk langsung nyaman di Monster Energy Yamaha yang datang sebagai pengganti Valentino Rossi. https://t.co/4mBr96r6pY,7,0,0,0,2022-01-20,11,Thursday,4,7,0
1484123656989069315,2022-01-20 11:20:28,"Foto udara menunjukan kemajuan proyek pembangunan Jalan Tol Semarang - Demak seksi II di Kecamatan Sayung, Kabupaten Demak, Jawa Tengah, Rabu (19/1/2022).  https://t.co/gRl0ad7RfG",11,0,1,0,2022-01-20,11,Thursday,4,12,0
1484122639488946177,2022-01-20 11:16:25,"Banjir di Kelurahan Tegal Alur, Jakarta Barat, membuat sampah plastik berserakan di sungai. Sampah tersebut diangkut petugas UPK Badan Air. https://t.co/LvPABBtgya",6,0,2,0,2022-01-20,11,Thursday,4,8,0
1484122417828085765,2022-01-20 11:15:32,Sejumlah klub memantau perkembangan situasi dari Paulo Dybala yang habis masa kontrak di Juventus pada akhir musim ini. https://t.co/ocq7S23WU8,3,0,0,0,2022-01-20,11,Thursday,4,3,0
1484122174608879623,2022-01-20 11:14:34,Ketua Fraksi PDIP DPR Utut Adianto bicara mengenai pelat kendaraan Arteria Dahlan berlogo Polri. Utut mengaku tak memiliki pelat Polri seperti mobil Arteria. https://t.co/UWHgD23nHo,8,1,1,0,2022-01-20,11,Thursday,4,9,1
1484121860342222848,2022-01-20 11:13:19,"Ketua MUI Cholil Nafis menyebut M Kace izin beragama Kristen saat mau pulang kampung, walau berstatus Islam di KTP. Begini penjelasan pengacara M Kace. https://t.co/Egl3L0LVpr",9,4,1,2,2022-01-20,11,Thursday,4,10,6
1484120543355932673,2022-01-20 11:08:05,"Petrus berjanji akan menindak tegas jika anak buahnya yang 'main' kewenangan, baik dari pemeriksaan hingga pemidanaan. https://t.co/ecB0C7DBSp",3,1,0,0,2022-01-20,11,Thursday,4,3,1
1484120517909090305,2022-01-20 11:07:59,"Ibu Semiati, warga asal Depok, Jawa Barat, yang hilang selama 5 hari, telah ditemukan. Ibu Semiati ditemukan dalam keadaan meninggal dunia. https://t.co/sARmRXl05y",16,1,2,2,2022-01-20,11,Thursday,4,18,3
1484120282642239491,2022-01-20 11:07:03,"""Saya pasti patuh. Orang kemarin sama Rindu aja saya patuh, apalagi tokoh masyarakat,"" ujar Arteria. https://t.co/PvAP4MrdL7",8,0,0,3,2022-01-20,11,Thursday,4,8,3
1484120262203383808,2022-01-20 11:06:58,"Kanit Reskrim Polsek Belopa, Polres Luwu, Sulawesi Selatan (Sulsel), Bripka Irwan Said dicopot dari jabatannya atas kasus dugaan kepemilikan sabu. https://t.co/XUiQMn3pRv",2,1,0,1,2022-01-20,11,Thursday,4,2,2
1484120260840198146,2022-01-20 11:06:58,"Dinas SDA DKI Jakarta mengungkap penyebab banjir masih terjadi di Jakarta Barat. Selain soal cuaca ektrem, ada juga masalah Kali Semongol yang meluap. https://t.co/yRdO1oRvas",2,0,0,1,2022-01-20,11,Thursday,4,2,1
1484120259292454915,2022-01-20 11:06:58,"Gempa bumi magnitudo (M) 5,5 mengguncang Jayapura, Papua. Gempa tidak berpotensi menimbulkan gelombang tsunami. https://t.co/xPVmcYjAg2",13,0,1,1,2022-01-20,11,Thursday,4,14,1
1484119789744316421,2022-01-20 11:05:06,"Bersih-bersih klenteng dilakukan jelang perayaan tahun baru Imlek. Seperti terlihat pada altar rumah Dewa Bumi, di Jl Kemenangan VII, Pecinan Glodok, Jakarta. https://t.co/oJ0cFrb41H",3,0,0,1,2022-01-20,11,Thursday,4,3,1
1484119776368680961,2022-01-20 11:05:02,"CDC menyebut imunitas natural dari infeksi COVID-19 memberikan perlindungan dari virus Corona. Lantas jika dibandingkan vaksin COVID-19, yang mana lebih mempan? https://t.co/ympKDvjl2N",5,0,1,1,2022-01-20,11,Thursday,4,6,1
1484119224033419264,2022-01-20 11:02:51,"Presiden Jokowi optimistis pandemi COVID-19 bisa segera terkendali di tahun 2022 ini. Namun, ia meminta agar masyarakat tetap berhati-hati pada varian Omicron. https://t.co/oVqIrghXjv",9,2,1,0,2022-01-20,11,Thursday,4,10,2
1484118947570098177,2022-01-20 11:01:45,Transplantasi jantung babi ke manusia untuk pertama kalinya jadi terobosan di dunia medis. Ini Muhammad Mohiuddin sosok di balik itu:  https://t.co/F7A3aZhkvB,126,27,44,5,2022-01-20,11,Thursday,4,170,32
1484118336367644673,2022-01-20 10:59:19,#Foto Pemotretan kehamilan Lesti Kejora baru terekspos setelah Baby L lahir. Intip yuk gaya sang ibu baru saat masih mengandung putra pertamanya. https://t.co/10wy3wPJqk,3,0,0,0,2022-01-20,10,Thursday,4,3,0
1484117621737992192,2022-01-20 10:56:29,Sempat heboh seorang dokter berhasil mencangkokkan jantung babi ke manusia di Amerika Serikat. Ini kata Ustaz:  https://t.co/lkgdrEKgRp,9,0,1,0,2022-01-20,10,Thursday,4,10,0
1484117564745732104,2022-01-20 10:56:15,"Kasus Omicron melonjak di banyak negara, mayoritas bergejala ringan. Namun, pakar meyakini ada kelompok yang berisiko terpapar Omicron dua kali, siapa saja? https://t.co/urDNpzHL8L",5,2,0,0,2022-01-20,10,Thursday,4,5,2
1484117029116424193,2022-01-20 10:54:07,"Wisatawan curhat tarif parkir bus sampai Rp 350 ribu. Berapa harga resminya, ya? https://t.co/mNq3JPvBKl",3,0,0,1,2022-01-20,10,Thursday,4,3,1
1484116805442576387,2022-01-20 10:53:14,Arteta menekankan Arsenal tidak mengada-ada saat meminta laga ditunda. https://t.co/oLlAOY8Cyg,3,1,0,1,2022-01-20,10,Thursday,4,3,2
1484116244261449732,2022-01-20 10:51:00,"Pindah ibu kota negara bukan hal yang baru. Beberapa negara juga telah melakukannya. Meski demikian, tak semua negara yang pindah ibu kota mendulang kesuksesan.  https://t.co/85pfH7yDW4",10,1,2,1,2022-01-20,10,Thursday,4,12,2
1484115598380523524,2022-01-20 10:48:26,"Raffi Ahmad membuka lowongan kerja sebagai CPNS untuk bekerja di perusahaan BUMN. Eh, gimana?  https://t.co/vM2xFqBzAe",147,19,46,19,2022-01-20,10,Thursday,4,193,38
1484114902310604801,2022-01-20 10:45:40,"Jokowi ingin memilih sosok berlatar belakang arsitek untuk memimpin Nusantara, Ibu Kota Negara di Kalimantan Timur. Namun, keinginan Jokowi ini dipertanyakan. https://t.co/KHxuuxnKGJ",13,7,0,4,2022-01-20,10,Thursday,4,13,11
1484114640615399426,2022-01-20 10:44:38,Harga minyak goreng resmi diturunkan menjadi Rp 14 ribu per 19 Januari 2022. Namun warga yang panik harga naik lagi rela memborong minyak goreng di minimarket. https://t.co/3eaCNs3oGi,18,2,1,8,2022-01-20,10,Thursday,4,19,10
1484114439360155654,2022-01-20 10:43:50,Penggunaan Video Assistant Referee (VAR) di laga Liga 3 Jawa Barat menjadi perbincangan. Siapa yang memiliki ide? https://t.co/e7JTQDHsMy,12,2,1,0,2022-01-20,10,Thursday,4,13,2
1484114264356966400,2022-01-20 10:43:08,"Terdakwa kasus pelecehan seksual Bruder Angelo divonis 14 tahun penjara. Menanggapi vonis tersebut, Bruder Angelo langsung mengajukan banding. https://t.co/2uzXNDPi78",12,6,4,3,2022-01-20,10,Thursday,4,16,9
1484114039038959616,2022-01-20 10:42:15,Dishub DKI mengatakan penerapan ganjil genap di 13 ruas jalan akan terus diterapkan. Ini alasannya. https://t.co/5vzx3iRp7x,2,0,0,0,2022-01-20,10,Thursday,4,2,0
1484113439899500544,2022-01-20 10:39:52,Menhan Prabowo menyebut pembentukan Komcad akan dilakukan kembali tahun 2022 ini. Keputusan itu diambil setelah adanya evaluasi. https://t.co/ePwUWDuYDn,14,1,3,1,2022-01-20,10,Thursday,4,17,2
1484112917247442948,2022-01-20 10:37:47,Presiden Joko Widodo (Jokowi) berbicara mengenai kondisi ketahanan kesehatan global akibat krisis COVID-19. https://t.co/KsTnv3JnYe,6,0,1,0,2022-01-20,10,Thursday,4,7,0
1484112915288530944,2022-01-20 10:37:47,"Kota Makassar terus diguyur hujan sejak 3 hari terakhir, yang membuat Kolam Regulasi Nipa-nipa yang difungsikan sebagai penahan banjir nyaris penuh. https://t.co/K8ylqI8nnb",10,0,1,1,2022-01-20,10,Thursday,4,11,1
1484112424424906754,2022-01-20 10:35:50,"Anggaran pembangunan kembali bakal dibebankan kepada APBN, seperti anggaran awal pembangunan masjid tersebut. https://t.co/tIvTdpZMP5",6,4,2,2,2022-01-20,10,Thursday,4,8,6
1484112408712859652,2022-01-20 10:35:46,Wali Kota Bekasi Rahmat Effendi atau Pepen melakukan zoom meeting dari rutan KPK. Seperti apa kondisinya? https://t.co/qz4TZzbmON,2,0,0,0,2022-01-20,10,Thursday,4,2,0
1484111768272130050,2022-01-20 10:33:13,Indonesia menambah daftar negara yang memutuskan pindah ibu kota. Sejumlah negara yang telah lebih dulu memutuskan pindah ibu kota di antaranya sebagai berikut: https://t.co/WrLbFOBxlk,19,0,3,0,2022-01-20,10,Thursday,4,22,0
1484111112127848449,2022-01-20 10:30:37,Viral di media sosial bendera merah putih dengan lis kuning emas pada acara HUT organisasi sayap Partai Golkar. Golkar Sulsel lantas buka suara https://t.co/htR7iLmD3j,3,2,0,0,2022-01-20,10,Thursday,4,3,2
1484110115682893825,2022-01-20 10:26:39,"Toyota masih sebagai rajanya otomotif dunia, meski banyak halangan di tahun lalu. https://t.co/lwwZYfhYXG",10,0,1,0,2022-01-20,10,Thursday,4,11,0
1484109587196350468,2022-01-20 10:24:33,"Ratusan rumah di wilayah pesisir Pandeglang, Banten tepatnya di Desa Citeureup, Kecamatan Panimbang sempat terendam banjir. https://t.co/NMPbzz4lXe",4,0,0,0,2022-01-20,10,Thursday,4,4,0
1484109122681421825,2022-01-20 10:22:42,Manchester United harus berhati-hati untuk tidak membuang kesempatan untuk finis empat besar di Liga Inggris. https://t.co/MpLU8PD0tO,5,1,0,0,2022-01-20,10,Thursday,4,5,1
1484108357065752576,2022-01-20 10:19:40,Arteria Dahlan akhirnya menyampaikan permintaan maafnya kepada masyarakat Jawa Barat khususnya Sunda. Berbagi reaksi datang usai permintaan maaf itu. https://t.co/kXfl24Cfjv,13,13,3,3,2022-01-20,10,Thursday,4,16,16
1484107847029989378,2022-01-20 10:17:38,"Harga minyak goreng yang mendadak turun membuat pasukan emak-emak rela ngantri untuk membeli, mengakibatkan rak-rak minyak goreng di supermarket kosong. https://t.co/jCEQAonBEH",13,2,0,2,2022-01-20,10,Thursday,4,13,4
1484107830722539520,2022-01-20 10:17:34,Itong Isnaeni Hidayat merupakan seorang hakim senior di Pengadilan Negeri (PN) Surabaya. Itong terjaring Operasi Tangkap Tangan (OTT) KPK pagi tadi. https://t.co/FMbGaQJ6Ey,6,0,4,1,2022-01-20,10,Thursday,4,10,1
1484107101014212615,2022-01-20 10:14:40,"Mendengar keinginan calon suaminya, Venna Melinda memberi dukungan. Venna sangat mendukung apa pun yang akan Ferry Irawan lakukan apalagi pekerjaan. https://t.co/RIE3cp5144",7,2,0,1,2022-01-20,10,Thursday,4,7,3
1484106826916544516,2022-01-20 10:13:35,Permintaan perahu kayu di Baleendah terus menurun seiring dengan cepat surutnya banjir di wilayah selatan Kabupaten Bandung. Seiring cepat menyusutnya banjir. https://t.co/Rm8FCprhwR,2,0,2,0,2022-01-20,10,Thursday,4,4,0
1484105900331782145,2022-01-20 10:09:54,Terbit Rencana Perangin Angin ditetapkan sebagai tersangka dalam kasus suap oleh KPK. https://t.co/joRXFQCEN7,4,1,1,2,2022-01-20,10,Thursday,4,5,3
1484105899039936514,2022-01-20 10:09:54,"Sebuah kabel listrik terbakar di Jalan Jati Bunder, Kelurahan Kampung Bali, Tanah Abang, Jakarta Pusat. Kebakaran terjadi diduga karena korsleting listrik. https://t.co/ZBFjxEaNH7",6,1,3,0,2022-01-20,10,Thursday,4,9,1
1484105671989682177,2022-01-20 10:09:00,"Atap masjid di Bima, NTB dibongkar oleh sejumlah orang. Padahal masjid tersebut baru saja dibangun. Ada apa? https://t.co/e1u5u13KrC",1,5,2,1,2022-01-20,10,Thursday,4,3,6
1484104920236240897,2022-01-20 10:06:00,"Aksi seorang pria di Aceh Utara, AR mengaku sebagai Imam Mahdi dan anak Nabi Muhammad menghebohkan warga. Polisi menduga AR mengalami gangguan jiwa. https://t.co/OPRC4BpzyC",7,2,5,1,2022-01-20,10,Thursday,4,12,3
1484104441771012100,2022-01-20 10:04:06,"Nasib Praveen Jordan/Melati Daeva Oktavianti di Pelatnas PBSI masih terus jadi pertanyaan. Jika benar dicoret, apa plus-minusnya? https://t.co/e3dSIIokW7",63,0,10,8,2022-01-20,10,Thursday,4,73,8
1484104412524126212,2022-01-20 10:03:59,Anggota DPR F-PDIP Arteria Dahlan mengaku mendapat pelajaran dari polemik kritik ke Kajati Jawa Barat terkait penggunaan bahasa Sunda saat rapat. https://t.co/B8xNHCFwEe,16,14,3,3,2022-01-20,10,Thursday,4,19,17
1484104252851163143,2022-01-20 10:03:21,Mikel Arteta menanggapi kritik untuk Arsenal menyusul penundaan laga derby London Utara. Arteta menekankan Arsenal tidak mengada-ada saat meminta laga ditunda. https://t.co/k6FvTAncWo,2,0,0,0,2022-01-20,10,Thursday,4,2,0
1484104232533999620,2022-01-20 10:03:17,"Arteria Dahlan sudah meminta maaf soal ucapan 'Kajari Bicara Sunda', Majelis Adat Sunda tetap lanjutkan laporan. https://t.co/IntiYZcsUX",72,25,5,3,2022-01-20,10,Thursday,4,77,28
1484103910042353671,2022-01-20 10:02:00,"Dalam kunjungan tersebut, ia memberi pengarahan kepada jajaran pengurus DPC PDIP Boyolali. https://t.co/D2xmhih8pL",2,0,0,0,2022-01-20,10,Thursday,4,2,0
1484103881776939009,2022-01-20 10:01:53,Ralf Rangnick menegaskan bahwa dia tidak punya masalah dengan Cristiano Ronaldo. https://t.co/PqWlScFDo2,3,0,0,0,2022-01-20,10,Thursday,4,3,0
1484103265692307457,2022-01-20 09:59:26,"Seiring merebaknya varian Omicron kini di sejumlah negara, Moderna dan Pfizer merencanakan pembuatan vaksin COVID dan flu sekali suntik. Bakal seperti apa? https://t.co/d2ahvoRBof",10,1,3,0,2022-01-20,9,Thursday,4,13,1
1484102525062197251,2022-01-20 09:56:29,Manchester United beruntung bisa pulang dengan poin penuh. Padahal The Red Devils memang masih mengkhawatirkan. https://t.co/fuoC010yMf,6,0,3,0,2022-01-20,9,Thursday,4,9,0
1484101912777605121,2022-01-20 09:54:03,"Bagi kamu yang sedang cari ide untuk model baju kondangan, penampilan para artis di pernikahan Vidi Aldiano boleh dilirik sebagai inspirasi nih. Mana pilihanmu? https://t.co/rXY6iQuJ4a",25,4,5,1,2022-01-20,9,Thursday,4,30,5
1484101889855733763,2022-01-20 09:53:58,"Obrolan antara pelanggan dengan pengemudi ojol seringkali ada-ada saja dan memicu tawa. Sedang antre menunggu makanan, deretan percakapan ojol ini bikin ngakak.  https://t.co/DmWbRBfGY9",4,1,2,0,2022-01-20,9,Thursday,4,6,1
1484101664512655360,2022-01-20 09:53:04,"Jantung pisang biasanya dipotong setelah pisang berbuah. Meskipun sederhana, jantung pisang rasanya empuk enak dimasak dengan santan berbumbu.  https://t.co/y06IS55HdN",4,0,5,0,2022-01-20,9,Thursday,4,9,0
1484101407703814145,2022-01-20 09:52:03,Barcelona begitu melempem bikin gol. Bahkan total gol dari delapan pemain depannya masih kalah dari Karim Benzema! https://t.co/SEUll8Ppt7,8,0,3,0,2022-01-20,9,Thursday,4,11,0
1484099840732798977,2022-01-20 09:45:49,Badan Siber dan Sandi Negara (BSSN) membenarkan adanya kebocoran data di Bank Indonesia (BI). Namun yang bocor dipastikan bukan data kritikal.  https://t.co/ec7VR6z49I,16,1,5,4,2022-01-20,9,Thursday,4,21,5
1484099068804673537,2022-01-20 09:42:45,"Paulo Dybala habis masa kontrak di Juventus pada akhir musim ini. Sejumlah klub memantau perkembangan situasinya, termasuk Inter Milan. https://t.co/CrmEA02rJg",4,0,1,0,2022-01-20,9,Thursday,4,5,0
1484097626606043137,2022-01-20 09:37:02,"Namanya Fitriani, Ia lahir tidak sempurna. Tangannya sebatas pergelangan, kaki kanan tak memiliki telapak, dan kaki kiri sebatas lutut. Fitri butuh kaki palsu untuk berjalan.

#sahabatbaik bisa bantu Fitri melalui platform @berbuatbaik_id atau klik link https://t.co/RCYTQJZc07. https://t.co/MvMup89Mv6",16,0,10,0,2022-01-20,9,Thursday,4,26,0
1484096407011266562,2022-01-20 09:32:11,17 pekerja migran illegal dari berbagai daerah kembali ditemukan tim Fleet 1Quick Respon (F1QR) Pangkalan TNI AL Tanjungbalai Asahan di atas sampan nelayan. https://t.co/iEtINVCd5L,6,0,0,0,2022-01-20,9,Thursday,4,6,0
1484095645430472704,2022-01-20 09:29:09,"Menurut Elanga, Setan Merah menampilkan performa terbaik di babak kedua di kandang The Bees. https://t.co/4qeqLBSKDc",9,0,0,0,2022-01-20,9,Thursday,4,9,0
1484094829390872579,2022-01-20 09:25:55,"Penembakan terjadi pagi tadi, sekitar pukul 08.00 WIT di Distrik Aifat Timur Tengah, Maybrat. KKB menembaki kendaraan milik TNI AD dari ketinggian. https://t.co/aj2lA79XVR",58,23,14,7,2022-01-20,9,Thursday,4,72,30
1484094053826367491,2022-01-20 09:22:50,Liga 1 2021/2022 saat ini sedang jeda. Para pemain Persib Bandung diingatkan untuk menjaga protokol kesehatan di tengah pandemi. https://t.co/LhgkG3Xgbj,6,0,1,0,2022-01-20,9,Thursday,4,7,0
1484094039003746306,2022-01-20 09:22:46,"Bruder Angelo dinyatakan terbukti bersalah melakukan tindak pidana pencabulan terhadap anak di panti asuhan yang dikelolanya di Depok, Jawa Barat. https://t.co/qkbcGH1raE",12,6,1,2,2022-01-20,9,Thursday,4,13,8
1484093518041788417,2022-01-20 09:20:42,Kedekatan antara Jonathan Frizzy dengan Ririn Dwi Ariyanti disebut dalam batas yang wajar. Ini kata saksi dari pihak Ijonk. https://t.co/wONv4Spqv7,5,1,0,0,2022-01-20,9,Thursday,4,5,1
1484093281243963394,2022-01-20 09:19:46,Luna Maya melakukan prosedur pembekuan sel telur atau egg freezing. Prosedur ini masih terdengar asing di kalangan sebagian orang. Apa itu pembekuan sel telur?  https://t.co/LMjFA1ctHe,7,1,1,1,2022-01-20,9,Thursday,4,8,2
1484092757761306625,2022-01-20 09:17:41,"Vaksinasi booster COVID-19 dimulai hari ini. Khusus wilayah Jakarta Barat, ini daftar lokasi vaksin booster COVID-19. Yuk merapat biar Omicron cepat tamat! https://t.co/dXrDR9xz6A",5,1,1,1,2022-01-20,9,Thursday,4,6,2
1484092098991243269,2022-01-20 09:15:04,"Mobil dinas milik Lapas Gobah Pekanbaru, Riau dibakar orang tak dikenal. Mobil dibakar dini hari tadi saat diparkirkan di rumah. https://t.co/o3TrHO76XL",6,0,1,0,2022-01-20,9,Thursday,4,7,0
1484091119059320833,2022-01-20 09:11:10,"Kemenangan Manchester United atas Brentford tak mengurangi rasa kagum Ralf Rangnick terhadap lawan, justru berharap MU bisa meniru cara bermain Brentford. https://t.co/8wgSFVZ2hM",4,0,0,0,2022-01-20,9,Thursday,4,4,0
1484089781197983744,2022-01-20 09:05:51,"Permohonan rehabilitasi untuk Fico Fachriza sudah disetujui oleh pihak kepolisian. Saat ini, Fico sudah dititipkan di RSKO Cibubur. https://t.co/Cu2JoxTTRG",46,14,8,4,2022-01-20,9,Thursday,4,54,18
1484089765683023875,2022-01-20 09:05:47,"Banjir masih melanda RW 02 di Tegal Alur, Kalideres, (20/1). Meski perlahan surut, namun tinggi air masih mencapai sekitar 40 cm akibat hujan pada Selasa (18/1) https://t.co/otNQyTQS9n",7,8,1,2,2022-01-20,9,Thursday,4,8,10
1484089517967654913,2022-01-20 09:04:48,Seorang pria berusia 57 tahun di Tonga mengaku dirinya selamat dari terjangan tsunami dengan berenang selama 27 jam pada Sabtu (15/1) lalu. https://t.co/phZBqHyr4U,17,1,11,1,2022-01-20,9,Thursday,4,28,2
1484089290107887616,2022-01-20 09:03:54,"Beragam pernak-pernik menyambut tahun baru Imlek menghiasi kawasan Pecinan-Pancoran Glodok, Jakarta. Beragam pernak-pernik itu dijual dengan harga bervariasi.  https://t.co/e4MI9nQqsc",2,0,3,0,2022-01-20,9,Thursday,4,5,0
1484088484671508481,2022-01-20 09:00:42,Ratna Sari Dewi merupakan wanita Jepang yang kemudian dikenal sebagai istri ke-5 Presiden Sukarno. Intip potret menawan ketika dirinya masih muda di sini! #detiknetwork https://t.co/RfvpTuVtkt,25,1,3,4,2022-01-20,9,Thursday,4,28,5
1484088003521884160,2022-01-20 08:58:47,"Inilah langkah langkah yang dibutuhkan untuk membuat halaman di word dengan cara yang mudah, termasuk membuat halaman berbeda. Mahasiswa, simak ya!

via: detikedu https://t.co/C5nZH6qmDC",21,0,4,0,2022-01-20,8,Thursday,4,25,0
1484087480269873155,2022-01-20 08:56:42,Rencana pembangunan jalur sepeda ini masuk dalam kegiatan strategis daerah. Jalur sepeda akan dibangun sepanjang 190 Km. https://t.co/bqukNQdu5Q,14,5,4,5,2022-01-20,8,Thursday,4,18,10
1484087185653608452,2022-01-20 08:55:32,"Data Bank Indonesia (BI) diduga diretas atau dihack, siapa pelakunya?  https://t.co/SICfLneNnq",7,4,5,0,2022-01-20,8,Thursday,4,12,4
1484086976869552130,2022-01-20 08:54:42,PDIP telah membuat keputusan terkait polemik Arteria Dahlan meminta kajati berbahasa Sunda diganti. PDIP memberi sanksi peringatan kepada Arteria. https://t.co/pIsx6kPCyY,7,6,1,1,2022-01-20,8,Thursday,4,8,7
1484086759466192898,2022-01-20 08:53:51,Narasi Institute bersama Aliansi Anak Bangsa Peduli Riset meminta Presiden Jokowi mengembalikan lembaga-lembaga riset yang dileburkan ke BRIN. https://t.co/ki8ICGvGJE,6,1,4,0,2022-01-20,8,Thursday,4,10,1
1484086732098347009,2022-01-20 08:53:44,Zainudin Amali mengatakan tidak semua stadion pelaksanaan Liga 1 dapat dihadiri penonton. Alasannya adalah lantaran banyak stadion yang belum memiliki kursi perorangan. https://t.co/80UxBWzLU2,2,0,0,0,2022-01-20,8,Thursday,4,2,0
1484086241356394496,2022-01-20 08:51:47,Menhan Prabowo Subianto menerangkan bahwa ancaman militer masih berpotensi terjadi. Hal itu disampaikan Prabowo dalam sambutan di rapim Kemhan. https://t.co/MMbRHF1dqR,4,3,1,1,2022-01-20,8,Thursday,4,5,4
1484085983326973952,2022-01-20 08:50:46,Arteria menegaskan tak bermaksud mendiskreditkan bahasa ataupun suku Sunda. https://t.co/X4ZmCzbqqK,11,17,1,5,2022-01-20,8,Thursday,4,12,22
1484085491431579649,2022-01-20 08:48:48,"Mahfud MD mengatakan Satgas BLBI yang sudah beroperasi selama 7 bulan telah berhasil mengumpulkan dan merampas Rp 15,11 triliun.  https://t.co/Ap4ZbobxaE",4,0,1,1,2022-01-20,8,Thursday,4,5,1
1484084730375118848,2022-01-20 08:45:47,Pemerintah telah mengumumkan nama ibu kota baru dengan nama Nusantara. Ma'ruf Amin minta nama itu didoakan. https://t.co/xwbS5ZIIwv,12,2,3,1,2022-01-20,8,Thursday,4,15,3
1484083958874783744,2022-01-20 08:42:43,"Beredar keluhan viral wisatawan tentang tarif parkir bus di Malioboro, Yogyakarta sebesar Rp 350 ribu untuk 2 jam. Menparekraf Sandiaga pun geram. https://t.co/HfIHKznHBd",100,35,24,8,2022-01-20,8,Thursday,4,124,43
1484083434360381440,2022-01-20 08:40:38,Kementerian Keuangan (Kemenkeu) membatalkan salah satu rangkaian acara G20 jalur keuangan (Finance Track) di Bali dan dipindahkan ke Jakarta.  https://t.co/tUKQGOWPI8,4,0,1,1,2022-01-20,8,Thursday,4,5,1
1484082871828729856,2022-01-20 08:38:24,"Banyak pihak meragukan penampilan Dovizioso bakal berakhir seperti Valentino Rossi, Razlan Razali menepis anggapan tersebut. https://t.co/sLDbpnYmFM",1,0,2,0,2022-01-20,8,Thursday,4,3,0
1484082350866804736,2022-01-20 08:36:20,"Pep Guardiola membuat Manchester City mendominasi Liga Inggris. Padahal, Guardiola nggak niat merusak tatanan permainan Premier League. https://t.co/BzOyd2iDcH",10,1,0,2,2022-01-20,8,Thursday,4,10,3
1484081852566720512,2022-01-20 08:34:21,"Selain Istana Negara, ada empat kementerian yang pindah pada 2024. Apa saja? https://t.co/dy39UKMrRF",15,1,6,2,2022-01-20,8,Thursday,4,21,3
1484080867928588303,2022-01-20 08:30:26,"Di Jepang, brosur kendaraan dapat membantu petugas polisi mengungkap kasus kriminal. https://t.co/csy1xVTB38",16,1,5,1,2022-01-20,8,Thursday,4,21,2
1484080140187541505,2022-01-20 08:27:32,Paris Saint-Germain (PSG) siap datangkan Zinedine Zidane agar membuat pemain muda itu bertahan lebih lama lagi. https://t.co/zHlpLwLlTc,7,0,1,0,2022-01-20,8,Thursday,4,8,0
1484079370880880641,2022-01-20 08:24:29,"""Bahasa Sunda bukan kriminal, bukan tindak korupsi atau pidana, kenapa orang bicara Sunda harus dicopot."" https://t.co/ZnxEGYEUBW",59,10,14,3,2022-01-20,8,Thursday,4,73,13
1484078304495820802,2022-01-20 08:20:15,Apakah mata dan otak kamu masih sinkron? Coba cek dulu dengan deretan teka-teki gambar hewan berikut: https://t.co/dB3TdGyir2,11,3,5,0,2022-01-20,8,Thursday,4,16,3
1484077308742885386,2022-01-20 08:16:17,"Saat melihat refleksi di cermin kamu akan lihat sesuatu yang sudah dikenali. Tapi terkadang refleksi tampilkan sesuatu yang bikin mata terkecoh, bahkan tertipu!  https://t.co/rSoOjvg8Jq",2,0,2,0,2022-01-20,8,Thursday,4,4,0
1484076820433674241,2022-01-20 08:14:21,Taman Mini Indonesia Indah (TMII) mendadak menjadi perbincangan netizen di Twitter. Ini bermula dari video yang memperlihatkan kondisi terkini TMII. https://t.co/5MYMB38eD0,50,18,7,4,2022-01-20,8,Thursday,4,57,22
1484076065605754881,2022-01-20 08:11:21,Telihat kesal saat ditarik keluar oleh Ralf Rangnick di laga melawan Brentford. Ini yang diucapkan Rangnick kepada Ronaldo. https://t.co/n2m2wfz01h,0,1,1,0,2022-01-20,8,Thursday,4,1,1
1484075003591237632,2022-01-20 08:07:08,Beredar viral seorang pria membawa kucing naik pesawat. Apa saja syarat membawa hewan peliharaan naik pesawat ya? https://t.co/XxIpI3wRNv,16,2,4,0,2022-01-20,8,Thursday,4,20,2
1484074257831403521,2022-01-20 08:04:10,Artis Luna Maya membekukan sel telurnya (egg freezing). Sebagian orang mungkin khawatir apakah calon anak dari sel telur yang dibekukan lebih berisiko cacat. https://t.co/ZepN0bEm1Z,12,2,3,0,2022-01-20,8,Thursday,4,15,2
1484073565129424897,2022-01-20 08:01:25,Artis Luna Maya dikabarkan membekukan sel telurnya (egg freezing) sebagai persiapan hari tua. Berapa sih biaya melakukan prosedur ini? Berikut jawabannya: https://t.co/lP5qriQ9hN,34,18,5,3,2022-01-20,8,Thursday,4,39,21
1484072754412404736,2022-01-20 07:58:12,Direktorat Narkoba Polda Riau menangkap 11 pengedar sabu jaringan internasional. Dari para pelaku diamankan 80 kilogram sabu yang dikemas dalam 80 paket. https://t.co/puvLjGaD7u,4,1,2,0,2022-01-20,7,Thursday,4,6,1
1484072229725949962,2022-01-20 07:56:06,Fraksi PDIP DPR menjadwalkan pemanggilan kepada Arteria Dahlan. Arteria akan diklarifikasi perihal bahasa Sunda hingga soal mobil berpelat sama. https://t.co/Qheolvcr9A,74,19,11,1,2022-01-20,7,Thursday,4,85,20
1484071739558612995,2022-01-20 07:54:10,Pemilik kendaraan harus lebih telaten merawat mobil di musim hujan. Berikut beberapa permasalahan yang mungkin terjadi. https://t.co/ZgTVnF0AVI,14,0,2,0,2022-01-20,7,Thursday,4,16,0
1484071240159612931,2022-01-20 07:52:11,"Inilah destinasi terpopuler di dunia untuk tahun 2022. Bali masuk 10 besar, yakni berada di urutan ke-4. https://t.co/LUOWIhWG2k",15,0,0,0,2022-01-20,7,Thursday,4,15,0
1484070632807710721,2022-01-20 07:49:46,Anggota DPR Arteria Dahlan minta maaf usai membuat marah masyarakat etnis Sunda. Netizen pun menanggapinya beragam.  https://t.co/9oWLBkrjiA,25,9,6,2,2022-01-20,7,Thursday,4,31,11
1484070132204904448,2022-01-20 07:47:46,Sebuah cuitan menyebutkan adanya aksi pencabulan kepada seorang anak berumur 5 tahun di Tangsel. Pelaku diketahui berprofesi sebagai kuli. https://t.co/Fa4MreYYbr,12,3,2,1,2022-01-20,7,Thursday,4,14,4
1484069607199711233,2022-01-20 07:45:41,Kemenkes melaporkan peningkatan kasus aktif dan rawat inap RS signifikan sejak kemunculan pertamanya pada 16 Desember lalu. Perlukah untuk tarik rem darurat? https://t.co/ocNJXmFkKU,11,6,1,0,2022-01-20,7,Thursday,4,12,6
1484068608116465665,2022-01-20 07:41:43,"Luhut memperkirakan kasus Omicron di Indonesia sudah lebih dari seribu. Tren harian COVID-19 terus merangkak naik, Luhut minta semua orang patuhi aturan. https://t.co/UwVGy2UQvt",30,22,12,7,2022-01-20,7,Thursday,4,42,29
1484067493232664579,2022-01-20 07:37:17,Itong Isnaeni Hidayat terjerat operasi tangkap tangan (OTT) KPK. Ini satu-satunya mobil yang terdaftar milik Itong. https://t.co/VNzZM5u5Ja,5,1,2,1,2022-01-20,7,Thursday,4,7,2
1484067000200704004,2022-01-20 07:35:20,"Ma'ruf Amin meninjau korban gempa Banten di Kecamatan Munjul, Kabupaten Pandeglang. Dalam kunjungannya dia menawarkan relokasi ke warga. https://t.co/BJQd9vu8PW",6,0,1,1,2022-01-20,7,Thursday,4,7,1
1484066250246524938,2022-01-20 07:32:21,"Pria ini bisa menjadi contoh bagi penggila otomotif lainnya nih, dengan tangan dinginnya Yamaha RX-Z kelahiran 1994 miliknya masih terawat dengan baik. https://t.co/6J7fbYdURE",17,0,3,1,2022-01-20,7,Thursday,4,20,1
1484065744509939716,2022-01-20 07:30:20,Kini mobil-mobil itu sudah berganti pelat nomor aslinya. https://t.co/aZ3tdxbrbH,62,58,15,13,2022-01-20,7,Thursday,4,77,71
1484065743281008640,2022-01-20 07:30:20,Pemindahan ibu kota bukanlah sebuah fenomena baru. Beberapa kota dibangun pemerintah di berbagai negara dengan sengaja untuk diangkat sebagai ibu kota baru. https://t.co/0V27c3HKJc,8,2,1,1,2022-01-20,7,Thursday,4,9,3
1484064999647633408,2022-01-20 07:27:23,"Chelsea susah menang dan terus kesandung, hilangnya Tuchel Effect? https://t.co/hF5wZxOV2Q",5,1,0,1,2022-01-20,7,Thursday,4,5,2
1484064011448733697,2022-01-20 07:23:27,"Bupati Langkat, Terbit Rencana Perangin-angin, selesai menjalani pemeriksaan. Begitu juga keempat tersangka lainnya dalam kasus suap proyek infrastruktur di wilayah Langkat. Terbit Rencana digiring ke Rutan Pomdam Jaya Guntur untuk penahanan. https://t.co/iDlAZtryyM",3,1,0,0,2022-01-20,7,Thursday,4,3,1
1484062902873169923,2022-01-20 07:19:03,"""Saya dengan sungguh-sungguh menyatakan permohonan maaf kepada masyarakat Jawa Barat, khususnya masyarakat Sunda, atas pernyataan saya beberapa waktu lalu,"" ujar Arteria. https://t.co/aTG41KsEiQ",304,385,60,82,2022-01-20,7,Thursday,4,364,467
1484062518209396739,2022-01-20 07:17:31,"Jozef Zwierzycki adalah seorang geolog yang berjasa di Nusantara pada abad 20. Ia berkontribusi dalam membuat geologi pertama Kepulauan Indonesia. Simak kisahnya yuk.

via: detikedu https://t.co/8nG481nJjW",8,0,2,0,2022-01-20,7,Thursday,4,10,0
1484061513497387008,2022-01-20 07:13:32,"Viral di media sosial atap masjid yang baru dibangun di Kabupaten Bima, Nusa Tenggara Barat dibongkar warga. Pembongkaran itu terjadi lantaran warga menilai masjid mirip gereja. https://t.co/Y3QF796yXC",10,0,2,4,2022-01-20,7,Thursday,4,12,4
1484060775853572104,2022-01-20 07:10:36,"Bagi Rasyid, cinta adalah sepenuh-penuhnya anugerah terbesar dari Tuhan untuk setiap manusia. Atas dasar itu juga, ia menyimpan dan siap mengejar mimpinya kini. #hotquestions https://t.co/MgZFap70Lb",7,0,1,0,2022-01-20,7,Thursday,4,8,0
1484060013811453955,2022-01-20 07:07:34,"West Ham, Spurs, Arsenal, dan MU terus panas rebutkan peringkat keempat Klasemen Liga Inggris. https://t.co/bjDZEIqodb",7,1,0,1,2022-01-20,7,Thursday,4,7,2
1484059452575789058,2022-01-20 07:05:20,Kemenkeu memindahkan agenda finance track (jalur keuangan) G20 dari Bali ke Jakarta karena alasan kesehatan. Pelaku pariwisata Bali pun kecewa.  https://t.co/ts0GDCbhWf,7,1,2,0,2022-01-20,7,Thursday,4,9,1
1484059206672076807,2022-01-20 07:04:22,"Saat ditanya soal keputusan berhijab, Tya Ariestya berikan jawabannya kepada sang buah hati. Jawabannya pun bikin hati adem. https://t.co/39zwch6WJx",2,0,1,0,2022-01-20,7,Thursday,4,3,0
1484058335745880070,2022-01-20 07:00:54,Kementerian Keuangan memindahkan agenda finance track G20 dari Bali ke Jakarta karena alasan kesehatan di tengah penyebaran COVID-19 varian Omicron.  https://t.co/cFC2sNqYnc,3,0,0,0,2022-01-20,7,Thursday,4,3,0
1484058325352435713,2022-01-20 07:00:51,"""Video itu dia berkata bahwa di salib ada jin. Jin itu adalah jin kafir. Dia seolah-olah mengolok-ngolok agama kristiani,"" ucap Maruli. #CNNIndonesia #detiknetwork  https://t.co/Id3Umfm9kP",273,173,38,25,2022-01-20,7,Thursday,4,311,198
1484057993830453249,2022-01-20 06:59:32,"Setelah lelah berbelanja dan tawar-menawar dengan pedagang di Thamrin City, enaknya isi tenaga dengan mencicipi berbagai kuliner di area food courtnya.  https://t.co/Nb8Fdl4rb7",4,0,2,0,2022-01-20,6,Thursday,4,6,0
1484057242508959746,2022-01-20 06:56:33,"Menyusul ledakan kasus Omicron, Pemerintah Amerika Serikat akan menyediakan 400 juta masker N95 gratis di ribuan lokasi di seluruh negeri. https://t.co/KZOEy6B2R3",12,1,2,1,2022-01-20,6,Thursday,4,14,2
1484057222120419328,2022-01-20 06:56:28,"#Terpopuler ""Itu pelat-pelat nomor mobil itu, kalau gue pake tuh, gue pake pelat DPR. Itu kan pelat dasar, bukan pelat asli,"" kata Arteria. https://t.co/4UqY4mN4jI",4,3,2,4,2022-01-20,6,Thursday,4,6,7
1484056732410261508,2022-01-20 06:54:32,"Manchester United menorehkan catatan spesial lewat kemenangan di markas Brentford, yaitu membukukan 300 kemenangan di Premier League. https://t.co/9lU5WRRlHc",4,0,0,0,2022-01-20,6,Thursday,4,4,0
1484056256100933633,2022-01-20 06:52:38,"Hakim di Pengadilan Negeri Surabaya, Itong Isnaeni, terjaring OTT KPK. Itong Isnaeni diketahui memiliki kekayaan Rp 2 miliar. https://t.co/3w0E5kONJo",9,1,0,0,2022-01-20,6,Thursday,4,9,1
1484056230528270340,2022-01-20 06:52:32,"Manchester United merasa beruntung bisa pulang dengan poin penuh. Jika melihat catatan, 'Setan Merah' memang masih mengkhawatirkan. https://t.co/lxX4vAZl9L",2,0,0,0,2022-01-20,6,Thursday,4,2,0
1484055976756060163,2022-01-20 06:51:31,"Umumnya kreasi dessert box bercita rasa manis. Namun, pemilik dessert box ternama di Indonesia ini pernah membuat rasa sate padang hingga ayam geprek!  https://t.co/mnssxY97DD",1,0,0,0,2022-01-20,6,Thursday,4,1,0
1484055975598469121,2022-01-20 06:51:31,Pesepakbola Lionel Messi merambah dunia kuliner dengan meluncurkan menu Messi Burger. Ia bekerja sama dengan Hard Rock Cafes dalam membuat menu burger ini.  https://t.co/LaBcg8el03,5,1,0,1,2022-01-20,6,Thursday,4,5,2
1484055337548320769,2022-01-20 06:48:59,"Seorang wanita asal Queensland, Evelyn Miller, menceritakan kisah hidupnya yang memiliki dua vagina dan dua rahim. https://t.co/dhBjcUG6IH",13,1,7,2,2022-01-20,6,Thursday,4,20,3
1484054870785245185,2022-01-20 06:47:08,"WHO bawa kabar melegakan, status darurat kesehatan masyarakat punya peluang berakhir di tahun 2022, dengan sejumlah catatan. Begini penjelasan WHO: https://t.co/XqFziRVZu1",5,1,2,0,2022-01-20,6,Thursday,4,7,1
1484054680049274881,2022-01-20 06:46:22,"Pemain muda Persib Bandung, Bayu Mohammad Fiqri, mendapatkan panggilan Timnas Indonesia. Ia merasa bangga bisa menembus skuad Tim Merah-Putih. https://t.co/LNMYIQg34a",7,0,0,0,2022-01-20,6,Thursday,4,7,0
1484054378034118661,2022-01-20 06:45:10,Polandia tengah hadapi gelombang kelima Corona. Kondisi itu terjadi imbas penyebaran varian Omicron yang membuat jumlah kasus naik lebih tinggi dari sebelumnya. https://t.co/nf786gikUR,3,0,0,0,2022-01-20,6,Thursday,4,3,0
1484054133766332421,2022-01-20 06:44:12,"Rest Area umumnya jadi tempat peristirahatan dalam perjalanan darat. Tapi rasanya, rest area ini bisa disebut yang paling unik. https://t.co/h8y6Y5HvUl",27,1,7,3,2022-01-20,6,Thursday,4,34,4
1484053633264148480,2022-01-20 06:42:13,"Garena Free Fire mengumumkan, telah melakukan maintenance berkala pada Januari 2022. Tujuannya untuk mendatangkan update bertemakan Illuminate. Ini daftarnya:  https://t.co/i8ZO7nFGy1",4,1,1,0,2022-01-20,6,Thursday,4,5,1
1484053632144322560,2022-01-20 06:42:12,"Indosat Ooredoo Hutchison jalin kemitraan dengan QNB Indonesia, menghadirkan platform pinjaman digital bernama UCan. https://t.co/knFK8XXZaw",5,0,2,0,2022-01-20,6,Thursday,4,7,0
1484053104111022080,2022-01-20 06:40:07,"Pemerintah kembali menyita aset Grup Texmaco terkait dengan hak tagih dana BLBI. Kini nilainya mencapai Rp 1,9 triliun!  https://t.co/oDsdK6jTEu",13,0,3,0,2022-01-20,6,Thursday,4,16,0
1484053084431175680,2022-01-20 06:40:02,Pemilihan direksi PT Bursa Efek Indonesia (BEI) periode 2022-2026 akan segera terselenggara. Sejumlah nama pun muncul sebagai calon direksi BEI.  https://t.co/mXuRfqYm8F,2,1,0,0,2022-01-20,6,Thursday,4,2,1
1484052351593951235,2022-01-20 06:37:07,Menteri Komunikasi dan Informatika Johnny G. Plate memastikan keberadaan sinyal 5G di Indonesia tidak mengganggu penerbangan. https://t.co/HAQfkrMTQW,4,1,4,0,2022-01-20,6,Thursday,4,8,1
1484052103907745793,2022-01-20 06:36:08,Johan Budi mendapat laporan ada aparat BNN yang 'memainkan' kewenangan. Johan Budi juga mencontohkan modus yang digunakan. https://t.co/GYJ9R1HELd,4,0,1,2,2022-01-20,6,Thursday,4,5,2
1484052081724071938,2022-01-20 06:36:03,Sri Mulyani Indrawati menerbitkan Peraturan Menteri Keuangan Nomor 227/PMK.09/2021 tentang Pengendalian Gratifikasi di Lingkungan Kementerian Keuangan yang salah satunya mengatur mengenai amplop nikah!  https://t.co/wfWfFIu20W,18,10,5,8,2022-01-20,6,Thursday,4,23,18
1484051836113936385,2022-01-20 06:35:04,"Pemerintah telah menurunkan harga minyak goreng menjadi Rp 14.000 per liter. Meski begitu, harga minyak di pasar tradisional Purwakarta, Jawa Barat ternyata masih tinggi!  https://t.co/bAbKTOJdtB",2,0,0,0,2022-01-20,6,Thursday,4,2,0
1484051822650085378,2022-01-20 06:35:01,Xiaomi 12 Pro akan segera hadir di Indonesia seiring sudah lolosnya TKDN dan pengujian Ditjen SDPPI. Berikut keunggulan yang dimiliki ponsel ini:  https://t.co/7Tq1SQHOIr,6,1,0,0,2022-01-20,6,Thursday,4,6,1
1484051306255945729,2022-01-20 06:32:58,Penggeledahan ini dilakukan dalam rangka pengusutan kasus dugaan suap proyek infrastruktur tahun 2011-2016. https://t.co/EyaQUe2ogF,1,0,0,0,2022-01-20,6,Thursday,4,1,0
1484051278112174080,2022-01-20 06:32:51,"Setelah sejumlah perangkat Mac yang dirilis memakai chip Apple M1, kini tinggal Mac Pro yang belum memakai Apple Silicon. https://t.co/XkwBjcUyxL",0,0,0,0,2022-01-20,6,Thursday,4,0,0
1484050979020492803,2022-01-20 06:31:40,"""Dalam sejarah, saya sudah 35 tahun lebih di industri keuangan, sebenarnya ada kompleksitas dan dispute nasabah dengan industri jasa keuangan itu hal biasa,"" papar Ketua Dewan Komisioner Otoritas Jasa Keuangan (OJK), Wimboh Santoso
  https://t.co/43yjbnZb0P",3,0,0,1,2022-01-20,6,Thursday,4,3,1
1484050966848720898,2022-01-20 06:31:37,Ruang damai telah ditutup anak Ahok tersebut. https://t.co/qgUw7f1949,18,3,3,3,2022-01-20,6,Thursday,4,21,6
1484050362474639360,2022-01-20 06:29:13,"Sering dapat teguran karena sering menggunakan filter, bagaimana ya wajah asli Celine Evangelista? https://t.co/KcHB5jysl4",16,1,3,0,2022-01-20,6,Thursday,4,19,1
1484050022798925824,2022-01-20 06:27:52,"Toge Productions, developer game Indonesia, Ulang Tahun ke-13. Mereka telah menyuguhkan kabar gembira untuk para gamer PC, dengan diskon hingga 90% di Steam.  https://t.co/ErIGZSeCzv",7,0,2,0,2022-01-20,6,Thursday,4,9,0
1484049724860735489,2022-01-20 06:26:41,Urusan Formula E ini awalnya dari laporan masyarakat yang ditindaklanjuti KPK. Simak pembahasannya: https://t.co/ctawtd9JkN,3,3,0,0,2022-01-20,6,Thursday,4,3,3
1484049713531863041,2022-01-20 06:26:38,"Banjir masih merendam kawasan Pakuhaji, Kabupaten Tangerang. Banjir akibat luapan air sungai pembuangan. https://t.co/D8IXAdpLHP",3,0,0,0,2022-01-20,6,Thursday,4,3,0
1484049449177554948,2022-01-20 06:25:35,Herry Wirawan melakukan pembelaan usai dituntut hukuman mati oleh Jaksa. Herry menyesal dan meminta pengurangan hukuman. https://t.co/NABhivLc9r,10,5,0,3,2022-01-20,6,Thursday,4,10,8
1484049430668095490,2022-01-20 06:25:31,Pemerintah di tahun ini hanya akan merekrut Pegawai Pemerintah dengan Perjanjian Kerja (PPPK). Lalu apa itu PPPK? Apa perbedaan antara PNS dengan PPPK?  https://t.co/ukoqMBDpLE,6,0,2,0,2022-01-20,6,Thursday,4,8,0
1484048927515197443,2022-01-20 06:23:31,"Kabar baik dari Pulau Sumatera, yang saat ini terkenal dengan salah satu salamnya yakni salam dari Binjai.  https://t.co/iXRkZVcKjz",4,0,2,0,2022-01-20,6,Thursday,4,6,0
1484048900801671170,2022-01-20 06:23:24,Habis vaksin boleh minum kopi? Beberapa orang yang akan atau sudah divaksin mungkin terpikir menanyakan hal ini. Begini jawaban ahli:  https://t.co/YCocHMDJWo,2,0,2,1,2022-01-20,6,Thursday,4,4,1
1484048338978758662,2022-01-20 06:21:10,"Bupati Langkat, Sumatera Utara, Terbit Rencana Perangin Angin terjaring dalam operasi tangkap tangan (OTT) Komisi Pemberantasan Korupsi (KPK). Segini hartanya.  https://t.co/IaaN5TcxfQ",6,0,2,0,2022-01-20,6,Thursday,4,8,0
1484048173127671808,2022-01-20 06:20:31,Para pegawai PT KAI (Persero) menjadi korban investasi bodong. Diketahui investasi bodong yang terjadi bermodus tebus murah mobil mewah.   https://t.co/UxKd7p6S0H,4,1,3,0,2022-01-20,6,Thursday,4,7,1
1484047853471383552,2022-01-20 06:19:15,"""Di perbankan saya lihat juga masih belum berubah, masih ada di kisaran 20%, sekali lagi ini mungkin sudah 3 - 4 kali saya sampaikan, masih di 20% saja,""  https://t.co/QDTpZcCVvQ",4,1,1,2,2022-01-20,6,Thursday,4,5,3
1484047852313718784,2022-01-20 06:19:14,"BukuKas mengumumkan pendanaan series-C sebesar Rp 1,1 triliun. Mereka juga mengumumkan nama baru untuk brand induknya yaitu Lummo. https://t.co/pToE8WbzO2",3,0,1,1,2022-01-20,6,Thursday,4,4,1
1484047602190536706,2022-01-20 06:18:15,"""Jika tidak akan berpotensi munculnya skema ponzi, munculnya investasi bodong dan penipuan investasi yang sangat merugikan masyarakat,"" ujar Jokowi  https://t.co/tUdk9Jk7vW",2,0,0,1,2022-01-20,6,Thursday,4,2,1
1484047580090839041,2022-01-20 06:18:10,Pembangunan Ibu Kota Negara (IKN) baru bernama Nusantara akan menggunakan Anggaran Pendapatan dan Belanja Negara (APBN). Ini rinciannya.  https://t.co/u9Azz3hwwY,6,1,3,0,2022-01-20,6,Thursday,4,9,1
1484047265509646343,2022-01-20 06:16:55,"Mengenai isu KDRT yang ada dalam rumah tangga Ijonk dan Dhena, saksi membantah dan menyebutkan hanya ada keributan-keributan. https://t.co/gILoml5zDW",2,0,1,0,2022-01-20,6,Thursday,4,3,0
1484046952656474112,2022-01-20 06:15:40,Kurs dolar Amerika Serikat (AS) terhadap rupiah pagi ini kembali melemah.  https://t.co/xRTIEczxtm,2,0,0,0,2022-01-20,6,Thursday,4,2,0
1484046940925042695,2022-01-20 06:15:37,Harga emas Antam hari ini kembali turun. Hari ini harga emas batangan 24 karat terkoreksi Rp 4.000 ke level Rp 948.000.  https://t.co/O83D92GXH8,4,0,1,0,2022-01-20,6,Thursday,4,5,0
1484045859394359297,2022-01-20 06:11:19,Penerimaan CPNS 2022 secara resmi tidak akan dibuka. Tahun ini pemerintah hanya hanya akan merekrut Pegawai Pemerintah dengan Perjanjian Kerja (PPPK).  https://t.co/HN0EkaOJM4,42,2,20,7,2022-01-20,6,Thursday,4,62,9
1484045609308930048,2022-01-20 06:10:20,"Browser Safari di iPhone, iPad, dan Mac memiliki bug yang jika dieksploitasi bisa membocorkan riwayat browsing dan informasi pribadi pengguna. https://t.co/DF1ESK0pPw",5,0,4,0,2022-01-20,6,Thursday,4,9,0
1484045585439145986,2022-01-20 06:10:14,"Kenaikan inflasi besar-besaran tidak hanya dialami Amerika Serikat (AS), tetapi juga Inggris. Inflasi tercatat mencapai rekor dalam 30 tahun terakhir!  https://t.co/ZpKq8raPMn",3,0,2,0,2022-01-20,6,Thursday,4,5,0
1484044857064755205,2022-01-20 06:07:20,KPK mengamankan seorang hakim Pengadilan Negeri (PN) Surabaya dalam operasi tangkap tangan (OTT).  https://t.co/qP8yyDtFSm,8,0,2,1,2022-01-20,6,Thursday,4,10,1
1484044846717362179,2022-01-20 06:07:18,Vishal Garg sudah mulai kerja lagi setelah mengambil cuti. Ia sebelumnya viral karena memecat 900 karyawan melalui Zoom!  https://t.co/2K9ntLAwhB,1,0,2,0,2022-01-20,6,Thursday,4,3,0
1484044359557427200,2022-01-20 06:05:22,Ronaldo ngambek diganti. Berikut alasan Ralf Rangnick menarik keluar Ronaldo lebih awal. https://t.co/q7VDYk1GKK,3,0,1,0,2022-01-20,6,Thursday,4,4,0
1484043753530834944,2022-01-20 06:02:57,"Kalina Oktarani tunggu kedatangan Vicky Prasetyo di rumah orang tuanya. Bagaimana nih, Vicky? https://t.co/HuA5I7lty5",6,6,1,1,2022-01-20,6,Thursday,4,7,7
1484043161907441664,2022-01-20 06:00:36,Manchester United menang 3-1 atas Brentford dalam lanjutan Liga Inggris. Netizen mengelu-elukan David De Gea yang kembali menjadi pahlawan bagi MU.  https://t.co/VMbqLDbDRc,9,0,3,0,2022-01-20,6,Thursday,4,12,0
1484042270072623110,2022-01-20 05:57:04,"Suntikan modal senilai US$ 5 juta atau setara Rp 71 miliar dari Alpha JWC Ventures ke startup Goola yang didirikan oleh Gibran Rakabuming, kini jadi sorotan. Siapakah sosok dibalik investor tersebut?  https://t.co/nBUNvmMfSG",10,11,0,2,2022-01-20,5,Thursday,4,10,13
1484042101486755843,2022-01-20 05:56:23,"Indonesia tidak akan menggunakan pita frekuensi jaringan 5G yang mengganggu penerbangan, seperti yang saat ini terjadi di bandara AS.  https://t.co/6jc5lArSP3",7,1,4,1,2022-01-20,5,Thursday,4,11,2
1484041861090230272,2022-01-20 05:55:26,Google resmi menghentikan program YouTube Originals. Divisi ini bertugas mengeluarkan konten original dan eksklusif untuk layanan berlangganan YouTube Premium.  https://t.co/LVEBb81h4q,10,0,2,4,2022-01-20,5,Thursday,4,12,4
1484041859953532939,2022-01-20 05:55:26,Leap dihadirkan sebagai inovator digital yang menyajikan solusi serta produk untuk mendukung peningkatan sosial dan ekonomi Indonesia. https://t.co/79FwGs96X0,4,0,0,1,2022-01-20,5,Thursday,4,4,1
1484041623868743681,2022-01-20 05:54:29,Para ilmuwan cemas karena kesulitan memantau gunung berapi bawah laut Hunga Tonga-Hunga Ha'apai yang meletus akhir pekan lalu.  https://t.co/bwYkNfgJ4w,4,0,2,0,2022-01-20,5,Thursday,4,6,0
1484041280363577346,2022-01-20 05:53:08,David de Gea menjadi sosok krusial yang mengantarkan MU menang atas Brentford. https://t.co/wtogOiloBj,9,0,0,0,2022-01-20,5,Thursday,4,9,0
1484040958534729729,2022-01-20 05:51:51,Epy akan mencari guru Bahasa Sunda untuk Arteria. https://t.co/6ixNHHz7Ix,40,4,0,0,2022-01-20,5,Thursday,4,40,4
1484040939450548225,2022-01-20 05:51:46,"Tottenham Hotspur menang secara dramatis atas Leicester City, Antonio Conte memuji semangat juang timnya. https://t.co/InS1CIiSJ7",4,0,0,0,2022-01-20,5,Thursday,4,4,0
1484040600617893889,2022-01-20 05:50:25,"Tak hanya Xiaomi 12 dan 12 Pro yang bakal hadir di Indonesia. Xiaomi akan pula merilis dua handphone murahnya di Tanah Air, yakni Redmi Note 11S dan Redmi 10A.  https://t.co/2ELnfZR3LE",12,1,2,0,2022-01-20,5,Thursday,4,14,1
1484040593605017601,2022-01-20 05:50:24,Ucapan Arteria Dahlan soal copot Kajati berbahasa Sunda berbuntut panjang. Arteria dilaporkan ke Polda Jabar atas ucapannya tersebut. https://t.co/LWWYmj5gK5,90,23,24,9,2022-01-20,5,Thursday,4,114,32
1484040101483139072,2022-01-20 05:48:26,Newcastle United  tertarik meminjam Jesse Lingard dan bersedia membayar penuh gaji Lord Lingard. https://t.co/mI4m7Bc1bz,5,0,1,0,2022-01-20,5,Thursday,4,6,0
1484039854476439553,2022-01-20 05:47:28,WHO melaporkan bahwa jumlah kasus baru virus Corona (COVID-19) secara global mengalami kenaikan 20 persen dalam sepakan terakhir. https://t.co/e7Po0N6DtV,7,0,1,1,2022-01-20,5,Thursday,4,8,1
1484039343656386562,2022-01-20 05:45:26,"Ibunda Gaga Muhammad, Janariah, mengklarifikasi tudingan yang menyebut dirinya tidak pernah meminta maaf ke keluarga mendiang Laura Anna. Janariah mengaku sudah berbicara dengan ayah Laura sejak hari kejadian kecelakaan. https://t.co/COIywPZJUh",2,0,1,0,2022-01-20,5,Thursday,4,3,0
1484039321518841857,2022-01-20 05:45:21,Xiaomi 12 Pro akan segera hadir di Indonesia seiring sudah lolosnya TKDN dan pengujian Ditjen SDPPI. Berikut keunggulan yang dimiliki ponsel ini:   https://t.co/FLLkjUYB5j,5,0,0,2,2022-01-20,5,Thursday,4,5,2
1484039100323749892,2022-01-20 05:44:28,"Selama masa pandemi, drama Korea jadi salah satu hiburan terfavorit bagi masyarakat luas. Dari beragam genre itu, apa saja drama Korea terbaik 2021 ya? https://t.co/GqNKyCaAWL",4,0,3,2,2022-01-20,5,Thursday,4,7,2
1484039079314563078,2022-01-20 05:44:23,Peneliti di Jepang kembangkan filter yang dapat membuat masker bersinar jika terpapar dengan virus COVID-19. Canggih dan penting nih!  https://t.co/dctbYBik9H,14,2,12,0,2022-01-20,5,Thursday,4,26,2
1484038847948333060,2022-01-20 05:43:28,"Indonesia dianggap jadi salah satu lokasi yang potensial untuk ekspansi bisnis data center di Asia, setelah Singapura dan Hong Kong. https://t.co/vBRU4cz7gc",12,0,6,0,2022-01-20,5,Thursday,4,18,0
1484038827404582912,2022-01-20 05:43:23,"Mobil Arteria Dahlan mejeng di gedung Nusantara II DPR RI, Senayan, Jakarta Pusat. Bagaimana penjelasannya? https://t.co/slFzNCMYCM",2,1,3,2,2022-01-20,5,Thursday,4,5,3
1484038216571396096,2022-01-20 05:40:57,Wajah Ferdi Ali memang sering terlihat di layar kaca. Banyak judul sinetron yang dibintangi pria yang memulai kariernya sejak 2005 ini. https://t.co/oaSwi60HSq,4,0,2,0,2022-01-20,5,Thursday,4,6,0
1484038003651756033,2022-01-20 05:40:06,Pendiri marketplace NFT OpenSea masuk ke dalam daftar orang terkaya dunia versi Forbes. Hal ini terjadi seiring dengan meningkatnya tren penjualan aset NFT.  https://t.co/fq33SjFuWa,13,1,5,2,2022-01-20,5,Thursday,4,18,3
1484037978112540674,2022-01-20 05:40:00,"Gaga Muhammad resmi divonis 4,5 tahun penjara. Tidak merasa bersalah jadi salah satu pertimbangan yang memberatkan putusan Gaga. Mendengar hal tersebut, ini kata ibunda Gaga, Janariah. https://t.co/S6lKyrm1RW",3,0,1,0,2022-01-20,5,Thursday,4,4,0
1484037429124374529,2022-01-20 05:37:49,KPK mengawali tahun 2022 dengan 4 OTT sejauh ini. Total sampai akhir bulan Januari 2022 sudah ada 3 kepala daerah dan seorang hakim. https://t.co/t7gpYcioNd,3,3,1,1,2022-01-20,5,Thursday,4,4,4
1484037142129094657,2022-01-20 05:36:41,"DKI Jakarta menjadi provinsi paling banyak yang menyumbang kasus Omicron. Dinkes DKI Jakarta mencatat kasus Omicron di ibu kota mencapai 988 orang, 663 di antaranya pelaku perjalanan luar negeri (PPLN) dan 325 lainnya transmisi lokal. https://t.co/yZRDeg271G",5,3,1,2,2022-01-20,5,Thursday,4,6,5
1484036846166413316,2022-01-20 05:35:30,Daerah banjir Jakarta hari ini sudah berangsur surut. Kini tersisa 9 RT di kawasan Jakarta Barat yang masih tergenang banjir. https://t.co/t53KmrPIP1,2,1,3,0,2022-01-20,5,Thursday,4,5,1
1484036604217937923,2022-01-20 05:34:33,"Nama Kaws mendunia berkat patung ciptaannya. Di Serpentine North, Inggris, sebuah pameran seni diselenggarakan untuk merayakan Kaws. Ini potretnya:  https://t.co/RO3Z9sW5lz",4,0,2,0,2022-01-20,5,Thursday,4,6,0
1484036109726359554,2022-01-20 05:32:35,Dalam waktu dekat ini bakal meluncur lagi satu layanan transportasi bus dari Sumatra Barat menuju ke Jakarta atau sebaliknya. Berikut bocoran harga tiketnya. https://t.co/VOUYJv0f2D,12,1,4,0,2022-01-20,5,Thursday,4,16,1
1484035557235826689,2022-01-20 05:30:23,Leicester City hancur di injury time hingga akhirnya kalah secara dramatis dari Tottenham Hotspur.  https://t.co/vi8MVVGLGC,4,0,0,1,2022-01-20,5,Thursday,4,4,1
1484035052619153413,2022-01-20 05:28:23,Pemerintah telah menyerahkan daftar calon anggota Komisi Informasi Pusat kepada DPR RI. Ini daftar calon 21 anggota KIP periode 2021-2025:  https://t.co/SfkRkTeWPQ,6,0,1,0,2022-01-20,5,Thursday,4,7,0
1484034806178627586,2022-01-20 05:27:24,"Fred menjadi salah satu penentu kemenangan Manchester United di kandang Brentford. Lagi dan lagi, Pemain Brasil membuat assist untuk Setan Merah. https://t.co/R4FhEurhWk",7,0,1,0,2022-01-20,5,Thursday,4,8,0
1484034550577741824,2022-01-20 05:26:23,"Tak hanya pada orang yang belum divaksin, varian Omicron ini juga bisa menginfeksi orang yang sudah divaksinasi. Berikut 9 gejalanya yang perlu diwaspadai. https://t.co/uJreeWVpdx",4,0,4,0,2022-01-20,5,Thursday,4,8,0
1484033785368924164,2022-01-20 05:23:21,Ayu Thalia mengaku sakit dan meminta waktu agar pemeriksaan dijadwal ulang. https://t.co/zerrwccOR5,2,1,1,0,2022-01-20,5,Thursday,4,3,1
1484033235071995904,2022-01-20 05:21:09,Selebrasi Cristiano Ronaldo terdengar di ajang Grand Slam Australian Open 2022. Banyak petenis yang jengkel mendengarnya. https://t.co/FXa19dgSeS,3,0,2,1,2022-01-20,5,Thursday,4,5,1
1484032729058529281,2022-01-20 05:19:09,Gojek melalui layanan GoFood jadi pelopor teknologi otomasi di layanan pesan-antar makanan Indonesia dengan memperkenalkan penggunaan robot. https://t.co/klwq8XC7hQ,11,0,3,1,2022-01-20,5,Thursday,4,14,1
1484032490994122753,2022-01-20 05:18:12,"Luhut mengungkapkan ada 1 kelompok baru pulang dari luar negeri. Di kelompok itu, 44 persennya positif COVID-19 varian Omicron. https://t.co/9NQ5UTkAaI",13,13,5,6,2022-01-20,5,Thursday,4,18,19
1484032245413388297,2022-01-20 05:17:13,Sonia Ben Ammar ikut dalam deretan bintang muda yang main di film Scream (2022). Ia memerankan karakter Liv McKenzie. Ini potret Sonia:  https://t.co/pN9Ao0V8UC,5,0,2,0,2022-01-20,5,Thursday,4,7,0
1484031750925922304,2022-01-20 05:15:16,"Unit terbaru SM Entertainment, GOT the beat, resmi merilis lagu berjudul Step Back pada 3 Januari 2022.  https://t.co/26e5Zi9H9x",11,0,1,0,2022-01-20,5,Thursday,4,12,0
1484031237887078402,2022-01-20 05:13:13,Real Madrid akan bertandang ke markas Elche untuk melakoni lanjutan Copa del Rey. Saatnya Bale comeback? https://t.co/MT5sJMXeE9,2,0,0,0,2022-01-20,5,Thursday,4,2,0
1484031210284331011,2022-01-20 05:13:07,"Ilmu fisika memegang peranan penting dalam kehidupan sehari-hari. Apa saja alasannya? Simak penjelasan ini yang bisa memperluas wawasan kamu yuk!

via: detikedu https://t.co/ReIDqmpZK7",2,0,2,0,2022-01-20,5,Thursday,4,4,0
1484030615230070791,2022-01-20 05:10:45,"Corona di Indonesia melonjak, tembus 1.745 kasus. Kemenkes melaporkan peningkatan kasus aktif dan rawat inap RS signifikan sejak RI mencatat Omicron. https://t.co/YhnB5FmUvo",4,0,3,0,2022-01-20,5,Thursday,4,7,0
1484030142250991617,2022-01-20 05:08:52,"Pasca mengikuti sidang putusan kasus anaknya, ibunda Gaga Muhammad, Janariah memberikan pesan ke keluarga Laura Anna. Janariah meminta kepada keluarga Laura untuk tidak perlu mengungkit lagi kasus yang menimpa anaknya. https://t.co/4w33b9DSlK",7,14,3,1,2022-01-20,5,Thursday,4,10,15
1484030119471685632,2022-01-20 05:08:47,"Erupsi dahsyat yang baru-baru ini terjadi di Pulau Tonga tak hanya memakan korban jiwa. Namun, juga menghancurkan pulau-pulau terluar Tonga. https://t.co/cEsA4kxuWa",2,0,2,0,2022-01-20,5,Thursday,4,4,0
1484029866798419971,2022-01-20 05:07:46,Ayu Thalia mengaku syok ketika mendapat kabar tersebut. Ia kecewa ditetapkan sebagai tersangka oleh pihak kepolisian. https://t.co/4eKHPfnDA0,5,3,1,0,2022-01-20,5,Thursday,4,6,3
1484029377469980673,2022-01-20 05:05:50,Pemerintah memutuskan untuk tidak akan lagi menggunakan tenaga honorer di setiap instansi mulai 2023. Cleaning service hingga satpam pakai outsourcing!  https://t.co/OBTIhckaDX,40,21,15,9,2022-01-20,5,Thursday,4,55,30
1484029115313369089,2022-01-20 05:04:47,Pemerintah kembali memberlakukan diskon PPnBM untuk mobil baru. Namun tercatat hanya lima mobil LCGC yang berhak mendapatkan insentif ini. Berikut daftar harga lengkapnya: https://t.co/MemzfQI07x,1,0,0,0,2022-01-20,5,Thursday,4,1,0
1484029101962895360,2022-01-20 05:04:44,Honda memperkenalkan All New Honda BR-V di Indonesia dengan banderol mulai Rp 278.900.000-Rp 342.900.000. Ada yang minat? https://t.co/jSirlyH9sx,3,0,0,0,2022-01-20,5,Thursday,4,3,0
1484028201827454976,2022-01-20 05:01:09,Bupati Langkat Terbit Rencana Perangin Angin bungkam saat ditahan KPK. Tersangka suap terkait proyek infrastruktur itu ditahan di rutan Pomdam Jaya Guntur. https://t.co/9QAx0tKw7b,5,0,2,2,2022-01-20,5,Thursday,4,7,2
1484028159897083906,2022-01-20 05:00:59,"Microsoft semakin memantapkan langkahnya dalam membangun metaverse. Hal ini diungkapkan, melalui pengumuman akuisisinya terhadap Activision Blizzard. https://t.co/VyizNK1ImO",6,0,1,0,2022-01-20,5,Thursday,4,7,0
1484027883941158914,2022-01-20 04:59:54,"Ucapan Anggota Komisi III DPR RI Fraksi PDIP Arteria Dahlan saat rapat dengan Jaksa Agung, Senin (17/1) lalu tuai kontroversi. Arteria saat itu menyinggung ada Kejaksaan Tinggi berbicara bahasa Sunda saat rapat kerja. https://t.co/ZVKmXK4MMD",7,5,2,1,2022-01-20,4,Thursday,4,9,6
1484027867054985217,2022-01-20 04:59:50,"BPK Bengkulu menemukan adanya pengeluaran besar kunjungan kerja luar daerah DPRD Bengkulu selama 2020. Pengeluarannya mencapai Rp 28,9 miliar. https://t.co/pDNBQGARih",4,1,0,1,2022-01-20,4,Thursday,4,4,2
1484027614616559617,2022-01-20 04:58:49,"Bak keajaiban, pria yang lumpuh dan tak bisa bicara mendadak sembuh usai menerima satu dosis vaksin COVID-19. Benar ada kaitan dengan vaksin? Ini kisahnya: https://t.co/3aoDb5eZOW",11,2,8,3,2022-01-20,4,Thursday,4,19,5
1484027352627744770,2022-01-20 04:57:47,Bupati Langkat Terbit Rencana Perangin terjaring OTT KPK. Terbit diduga menerima suap terkait pengadaan barang dan jasa di Kabupaten Langkat pada periode 2020-2022. Uang senilai Rp 786 juta menjadi barang bukti. https://t.co/ULU0vfCrjr,3,0,1,0,2022-01-20,4,Thursday,4,4,0
1484027104895422466,2022-01-20 04:56:48,"""Pandemi yang berkepanjangan betul-betul menimbulkan luka yang dalam bagi sektor-sektor tertentu,"" kata Jokowi. https://t.co/LS0q8RoyBc",6,11,0,1,2022-01-20,4,Thursday,4,6,12
1484026833159000066,2022-01-20 04:55:43,Luhut menyebut warga harus ikuti aturan kalau ingin hidup. https://t.co/foRlYFkiQe,59,85,15,23,2022-01-20,4,Thursday,4,74,108
1484026821016530944,2022-01-20 04:55:40,"Indonesia tidak akan menggunakan pita frekuensi jaringan 5G yang mengganggu penerbangan, seperti yang saat ini terjadi di bandara AS. https://t.co/SUHaxHt8aI",3,2,2,0,2022-01-20,4,Thursday,4,5,2
1484026591177023489,2022-01-20 04:54:45,Bupati Langkat berkongkalikong dengan kakaknya dalam kasus suap proyek infrastruktur. Kasus ini menambah daftar korupsi yang dilakukan oleh kakak-adik. https://t.co/0ODjcmpvZZ,4,0,0,1,2022-01-20,4,Thursday,4,4,1
1484026576945790977,2022-01-20 04:54:42,Ada lima mobil yang menggunakan pelat nomor berlogo Polri yang sama. Empat di antaranya ada stiker Arteria Dahlan. Berikut koleksi kendaraan arteria Dahlan. https://t.co/T4bdjqOXKF,10,1,2,0,2022-01-20,4,Thursday,4,12,1
1484026303665876993,2022-01-20 04:53:37,detikcom meraih anugerah Diktiristek 2021. detikcom mendapatkan anugerah sebagai media terbaik dalam kategori media daring. https://t.co/FhxauhwQRy,5,0,0,0,2022-01-20,4,Thursday,4,5,0
1484025368885534724,2022-01-20 04:49:54,Cristiano Ronaldo kesal usai digantikan Harry Maguire di laga Brentford vs Manchester United.  https://t.co/wf0IKUGRWE,4,1,0,0,2022-01-20,4,Thursday,4,4,1
1484024551696740354,2022-01-20 04:46:39,Yamaha tengah berbahagia sebab motor barunya mendapat respon positif dari masyarakat Indonesia. https://t.co/kwVKzIGH5o,20,0,6,3,2022-01-20,4,Thursday,4,26,3
1484023803390971905,2022-01-20 04:43:41,"Lima mobil Arteria Dahlan yang terparkir di DPR bernopol sama. Dari lima pelat itu, tak satu pun pelat asli. https://t.co/wezgJ7QKaU",349,169,131,49,2022-01-20,4,Thursday,4,480,218
1484021731966676993,2022-01-20 04:35:27,"Netizen Indonesia memang suka latah. Usai kesuksesan Ghozali Everyday, foto KTP sampai foto koruptor dijual jadi NFT di OpenSea. https://t.co/dalh4Rn3Lw",29,6,3,6,2022-01-20,4,Thursday,4,32,12
1484020987813322753,2022-01-20 04:32:29,"Tahun 2022, Netflix kembali menayangkan sejumlah konten Korea. Ada All of Us Are Dead hingga Money Heist Korea. Ini daftarnya:   https://t.co/TG8DIT4St5",11,1,0,0,2022-01-20,4,Thursday,4,11,1
1484020432974106630,2022-01-20 04:30:17,Menurunkan berat badan tidak sulit asal tahu triknya. Ahli gizi mengungkap enam tips ampuh untuk turunkan berat badan dengan mudah dan cepat.  https://t.co/MULws03KZj,7,2,3,0,2022-01-20,4,Thursday,4,10,2
1484019939791024130,2022-01-20 04:28:20,"Hwang In Yeop akan jadi pemeran utama di drama Why Oh Soo Jae? Di drama ini, ia melepas citra sad boy yang selama ini disematkan.  https://t.co/UuID33zRgP",10,1,1,1,2022-01-20,4,Thursday,4,11,2
1484019196400910337,2022-01-20 04:25:22,"Untuk para orangtua, yang anaknya sudah divaksin, ini cara cek sertifikat vaksin COVID-19 untuk anak-anak di PeduliLindungi:  https://t.co/6l5guhJCwi",8,3,1,0,2022-01-20,4,Thursday,4,9,3
1484018966205014020,2022-01-20 04:24:27,"Kementerian BUMN akan membentuk holding dan subholding di PT PLN (Persero). Erick Thohir menyebut, pembentukan tersebut ditargetkan dapat memberikan subsidi listrik yang lebih tepat sasaran di masyarakat sekaligus dapat menghindari daerah yang dapat dim... https://t.co/Gj9hiszSS8",3,1,2,0,2022-01-20,4,Thursday,4,5,1
1484017909781434370,2022-01-20 04:20:16,"Ayu Thalia hari ini, Kamis (20/1) dijadwalkan menjalani pemeriksaan di Polres Metro Jakarta Utara terkait laporan anak Ahok, Nicholas Sean Purnama. Namun undangan tersebut batal dipenuhi lantaran Ayu sedang tidak enak badan. https://t.co/FMwEZH20tc",2,1,1,0,2022-01-20,4,Thursday,4,3,1
1484017174318653444,2022-01-20 04:17:20,Moonbyul MAMAMOO merilis single terbaru berjudul Lunatic. Ia mengajak dancer Hook untuk tampil di MV tersebut.  https://t.co/FEkht0M4P1,6,2,1,0,2022-01-20,4,Thursday,4,7,2
1484016916519960580,2022-01-20 04:16:19,Jessie J kini telah bangkit kembali usai keguguran pada tahun lalu. Ia yang buat Jessie J bangkit dan move on:  https://t.co/p3D6zQGRP1,4,1,2,0,2022-01-20,4,Thursday,4,6,1
1484016160286945280,2022-01-20 04:13:18,"Pencipta lagu Susis yang dinyanyikan oleh Sule, Dose Hudaya, meninggal dunia pada Rabu (19/1). Kabar duka ini disampaikan oleh Wahana Musik Indonesia. https://t.co/sskMZFFiEE",10,0,1,1,2022-01-20,4,Thursday,4,11,1
1484016138556260355,2022-01-20 04:13:13,"Inter Milan susah payah menaklukkan Empoli di babak 16 besar Coppa Italia,  berikut ini 11 fakta kemenangan Nerazzurri atas Azzurri. https://t.co/vwbx71VgKw",5,1,0,0,2022-01-20,4,Thursday,4,5,1
1484015905013219330,2022-01-20 04:12:18,"Dokter spesialis kebidanan dan kandungan mengungkapkan pengertian, proses dan syarat jika ingin membekukan sel telur. Berikut penjelasannya: https://t.co/YY1WRP4Xb9",5,1,0,0,2022-01-20,4,Thursday,4,5,1
1484014865639432195,2022-01-20 04:08:10,"Sejumlah peristiwa gempa yang terjadi belakangan ini, mengingatkan kita pada beberapa gempa terbesar di dunia, salah satunya terjadi di Indonesia. https://t.co/eaXYBNOO24",2,0,0,0,2022-01-20,4,Thursday,4,2,0
1484014371365867521,2022-01-20 04:06:12,"Bappenas mengumumkan nama Ibu Kota Negara (IKN) baru Nusantara. Lalu, di ya mana letak titik koordinat ibu kota baru ini?

via: detikedu https://t.co/JUJymWwa32",13,1,1,0,2022-01-20,4,Thursday,4,14,1
1484013941030334466,2022-01-20 04:04:29,Film keenam Final Destination akan diarahkan oleh Jon Watts. Naskahnya digarap penulis Ready or Not dan Scream (2022). https://t.co/99Ls2mAFfu,38,3,13,9,2022-01-20,4,Thursday,4,51,12
1484013917332545536,2022-01-20 04:04:24,"Kabar bahagia bagi penggemar Dilan! Pidi Taman Dilan baru saja diresmikan oleh Bupati Bandung Barat, Hengky Kurniawan. Intip yuk cerita proses pembangunannya.  https://t.co/Oj7rKlfMGa",3,1,2,0,2022-01-20,4,Thursday,4,5,1
1484012991033008131,2022-01-20 04:00:43,"Bukan hanya saya, tentu ada banyak Bunda lain yang juga masih tinggal seatap dengan orang tua. Salah satu risikonya, anak saya pun jadi lebih dekat ke neneknya. #detiknetwork  https://t.co/uBuNjxkXM7",2,0,0,1,2022-01-20,4,Thursday,4,2,1
1484012544075382787,2022-01-20 03:58:56,"Real Sociedad melaju ke perempatfinal Copa del Rey, setelah menyingkirkan Atletico Madrid lewat kemenangan 2-0 di babak 16 besar. https://t.co/pMJMDFEvBq",7,0,0,1,2022-01-20,3,Thursday,4,7,1
1484012523116539904,2022-01-20 03:58:51,"""Ini juga menyangkut harga diri masyarakat Sunda, kami mendesak Arteria Dahlan segera meminta maaf secara terbuka,"" ucap Ketua JPP Bogor Saleh Nurangga. https://t.co/KLrlffjFy6",26,12,5,2,2022-01-20,3,Thursday,4,31,14
1484011935855173632,2022-01-20 03:56:31,"Hakim PN Surabaya, Itong Isnaeni Hidayat terjaring OTT KPK subuh ini. Selain itu, PP M Hamdan juga ikut terjaring. Siapakah Itong? https://t.co/5Evqz3ZAW1",63,17,24,6,2022-01-20,3,Thursday,4,87,23
1484010057964699652,2022-01-20 03:49:04,"Bambang Pamungkas beberapa kali mangkir dari panggilan pihak kepolisian, Amalia Fujiawati beri pesan ini pada Bepe. https://t.co/ON562hBLxx",6,0,0,1,2022-01-20,3,Thursday,4,6,1
1484009300922146817,2022-01-20 03:46:03,"Manchester United menang 3-1 atas Brentford. Tiga golnya dicetak oleh Anthony Elanga, Mason Greenwood, dan Marcus Rashford. https://t.co/UVcmiBbNlm",3,0,0,2,2022-01-20,3,Thursday,4,3,2
1484009279799635973,2022-01-20 03:45:58,Bintang Marvel itu dirawat di rumah sakit setelah mengalami kecelakaan ski di Pegunungan Alpen. Ia meninggal setelah mengalami luka yang cukup serius. #GaspardUlliel https://t.co/QaUBF6tjJL,66,4,30,0,2022-01-20,3,Thursday,4,96,4
1484008409733210119,2022-01-20 03:42:31,"Rasyid Rajasa berbicara soal keluarga, hubunganya dengan sang ayah dan keikhlasannya atas kepergian sang istri, Adara Taista. Selengkapnya bisa ditonton di HotQuestions berikut ini! https://t.co/8RpTjMheV6",0,0,1,0,2022-01-20,3,Thursday,4,1,0
1484006770309840901,2022-01-20 03:36:00,"Salah satu aktor Moon Knight, Gaspard Ulliel, meninggal dunia karena kecelakaan saat main ski di Perancis. #GaspardUlliel https://t.co/XJNBLqQyMS",20,1,1,2,2022-01-20,3,Thursday,4,21,3
1484006361197383683,2022-01-20 03:34:22,"Beberapa band terkenal di era 2000-an akan manggung di festival musik When We Were Young. Wah, nostalgia! https://t.co/ORNihfUeMH",72,12,19,4,2022-01-20,3,Thursday,4,91,16
1484005294074118146,2022-01-20 03:30:08,Carlo Ancelotti membantah bermasalah dengan Eden Hazard dan Gareth Bale. https://t.co/3c0T3x1pxS,7,0,0,0,2022-01-20,3,Thursday,4,7,0
1484004552051466242,2022-01-20 03:27:11,"Ustaz Maulana bicara hubungannya antara kerja dan doa yang keras. Tidak ada rezeki yang datang dengan sendiri, meski memang sudah diatur oleh Allah SWT. https://t.co/usO2wNIVrp",38,4,2,0,2022-01-20,3,Thursday,4,40,4
1484003560060821505,2022-01-20 03:23:14,"Tara Basro unggah video sang suami, Daniel Adnan ketika membeli makanan di warteg. Outfitnya bikin salfok yaa... https://t.co/G1x6yVltxE",4,1,0,0,2022-01-20,3,Thursday,4,4,1
1484002758759960578,2022-01-20 03:20:03,"Seorang wanita dilarikan ke RS usai makan all you can eat di sebuah restoran sushi. Ia merasakan nyeri perut dan dada yang parah, ini awal mulanya. https://t.co/t2AdVNLTCE",17,1,3,2,2022-01-20,3,Thursday,4,20,3
1484002020793147393,2022-01-20 03:17:07,"Jumlah kabupaten dan kota Indonesia yang masuk zona hijau bertambah banyak di pekan ini. Ada beberapa wilayah di Jawa Bali, cek daftarnya di sini: https://t.co/d44vweUXLH",1,0,0,0,2022-01-20,3,Thursday,4,1,0
1484001439219343361,2022-01-20 03:14:49,Bagi kamu yang memiliki budget Rp 20 jutaan dan sedang menimbang antara Honda Scoopy atau Yamaha Fazzio? berikut ini komparasinya. https://t.co/eiHHujOOLf,21,17,3,6,2022-01-20,3,Thursday,4,24,23
1484000688715751425,2022-01-20 03:11:50,Lagi! Cristiano Ronaldo ngambek saat diganti di laga Manchester United kontra Brentford. https://t.co/xJr49Zl2KF,15,5,1,2,2022-01-20,3,Thursday,4,16,7
1484000205615898625,2022-01-20 03:09:55,"Tahun 2018 jadi tahun yang paling berat bagi Rasyid Rajasa. Pada 5 bulan usia pernikahannya, ia kehilangan istri tercinta. Ini cerita tentang keikhlasan Rasyid. #hotquestions https://t.co/Q4LpG0EdTG",6,2,0,0,2022-01-20,3,Thursday,4,6,2
1483999459839070208,2022-01-20 03:06:57,"Nggak gengsi! Modal Rp 2 jutaan, pernikahan pasangan yang menikah di KUA ini bikin warganet kagum. Gimana ya kisahnya https://t.co/7QxcLVIA18",1266,263,295,217,2022-01-20,3,Thursday,4,1561,480
1483998631728459779,2022-01-20 03:03:39,"Harapan Nadiem, para guru yang sudah lolos passing grade bisa langsung mendapat formasi bila sudah tersedia dan tidak perlu ikut Seleksi PPPK Guru lagi.

via: detikedu https://t.co/wnq9TlX0at",18,0,1,0,2022-01-20,3,Thursday,4,19,0
1483998001966329856,2022-01-20 03:01:09,"Doyan makan banyak, DJ Katty Butterfly punya rahasia diet andalan. Dengan menjalani pola makan ini, ia bahkan bisa turun berat badan hingga 30 kg!  https://t.co/ZbzlRn9725",7,0,1,1,2022-01-20,3,Thursday,4,8,1
1483996949497929730,2022-01-20 02:56:58,Suharso Monoarfa mengumumkan nama untuk calon ibu kota baru yakni 'Nusantara' yang terletak di Kalimantan Timur. Berapa populasi kendaraan disana? https://t.co/evIYn1gy4V,8,0,1,1,2022-01-20,2,Thursday,4,9,1
1483996918367854594,2022-01-20 02:56:51,Kayak ada yang janggal gitu di foto ini. Tapi bagian mana ya... https://t.co/TjcDHu8Wvr,112,115,11,12,2022-01-20,2,Thursday,4,123,127
1483996665908506626,2022-01-20 02:55:51,"Dengan alasan kesehatan, banyak orang yang menjalani diet vegetarian. Lantas, bagaimana pandangan Islam dan medis mengenai diet ini?  https://t.co/IjqjojZ9DX",3,0,1,0,2022-01-20,2,Thursday,4,4,0
1483995909167923200,2022-01-20 02:52:50,Pasar Karangawen Demak terbakar hebat. Api melahap sejumlah kios atau bangunan di pasar tersebut seluas sekitar 200 meter. https://t.co/peS8XDIiQ1,7,0,1,0,2022-01-20,2,Thursday,4,8,0
1483995659128786946,2022-01-20 02:51:51,Mereka diduga bertransaksi suap terkait perkara di pengadilan. https://t.co/doTQVK8LZO,6,2,1,0,2022-01-20,2,Thursday,4,7,2
1483995441037557762,2022-01-20 02:50:59,"Indosat Ooredoo &amp; Tri Indonesia resmi merger. Visinya Menjadi Perusahaan Telekomunikasi Digital yang Paling Dipilih di Indonesia
@indosat #BersatuUntukndonesia #IndosatOoredooHutchison
https://t.co/KuomKAFNU8",8,1,2,0,2022-01-20,2,Thursday,4,10,1
1483995345491218434,2022-01-20 02:50:36,Banjir di kawasan Jakarta berangsur surut. Kini tersisa 9 RT di kawasan Jakarta Barat yang masih tergenang. https://t.co/Rg5jmzKr5H,10,9,4,1,2022-01-20,2,Thursday,4,14,10
1483995329183813632,2022-01-20 02:50:32,"Selain menggelar OTT dengan mengangkut hakim PN Surabaya, KPK juga mengangkut panitera pengganti (PP) PN Surabaya. https://t.co/Fh6kEPERIr",4,0,0,0,2022-01-20,2,Thursday,4,4,0
1483994027859062787,2022-01-20 02:45:22,Brenford membuat Manchester United kesulitan di babak pertama meski akhirnya kalah dengan skor 1-3. Thomas Frank menyebut MU sangat beruntung. https://t.co/0jo2YxE7lU,6,0,1,0,2022-01-20,2,Thursday,4,7,0
1483993330639945738,2022-01-20 02:42:35,"Bupati Langkat Terbit Rencana Perangin Angin yang terjaring OTT tiba di gedung KPK. Saat tiba, Terbit tak berkomentar sedikit pun. https://t.co/f2s1BR1ycy",3,0,0,0,2022-01-20,2,Thursday,4,3,0
1483992800807067649,2022-01-20 02:40:29,"Hai Cancer, apapun yang terjadi hati harus selalu tenang dan jangan panik sendiri ya. Ingin tahu apa kata zodiak kamu hari ini? #RamalanZodiak https://t.co/HySTjPufBQ",3,0,0,0,2022-01-20,2,Thursday,4,3,0
1483992060550123521,2022-01-20 02:37:33,Pernyataan kontroversial Arteria Dahlan yang meminta Kajati dicopot gegara berbahasa Sunda berbuntut panjang. Masyarakat Sunda mengecam di media sosial.  https://t.co/tAYN72GFZT,146,84,17,24,2022-01-20,2,Thursday,4,163,108
1483990967447433216,2022-01-20 02:33:12,"Bagi pengguna pelat nomor palsu, akan dikenakan sanksi berupa kurungan atau denda uang! https://t.co/yFZok4mqSp",31,24,1,1,2022-01-20,2,Thursday,4,32,25
1483990284128112650,2022-01-20 02:30:29,Antonio Conte meminta Tottenham Hotspur untuk mendatangkan pemain baru. https://t.co/TKDfhuWJbr,1,0,2,0,2022-01-20,2,Thursday,4,3,0
1483989223380340736,2022-01-20 02:26:16,Seorang pemain Arsenal diselidiki FA terkait aktivitas taruhan yang mencurigakan. https://t.co/1ZA20IOUqa,5,0,1,0,2022-01-20,2,Thursday,4,6,0
1483988432842022922,2022-01-20 02:23:08,"Robinho bakal menjalani hukuman penjara selama 9 tahun, terkait kasus pemerkosaan. Sebab, bandingnya baru saja ditolak pengadilan. https://t.co/0bWvGR8HlV",9,0,1,1,2022-01-20,2,Thursday,4,10,1
1483988176725237765,2022-01-20 02:22:07,Berikut pemain Liga Inggris yang paling hobi nutmeg alias ngolongin lawan. Bisa tebak siapa? https://t.co/ePE0UhciUc,3,0,0,1,2022-01-20,2,Thursday,4,3,1
1483987159015120897,2022-01-20 02:18:04,Bupati Langkat Terbit Rencana Perangin Angin terjaring OTT KPK. Ia pun telah ditetapkan sebagai tersangka dan kini ditahan KPK. Begini penampakannya: https://t.co/gmkmZZ3Viv,13,0,1,2,2022-01-20,2,Thursday,4,14,2
1483986163010572288,2022-01-20 02:14:07,Bupati Langkat Terbit Rencana ditetapkan tersangka KPK atas dugaan suap dari proyek infrastruktur di wilayah Langkat. Simak fakta-fakta dari penangkapan ini. https://t.co/yt3xzhgz40,6,1,1,1,2022-01-20,2,Thursday,4,7,2
1483984728323727362,2022-01-20 02:08:24,"Kabar duka datang dari komedian Sule. Ia mengabarkan jika pencipta lagu Susis yang dibawakan Sule, Dose Hudaya meninggal dunia. https://t.co/THRyz7P0Tb",16,0,2,0,2022-01-20,2,Thursday,4,18,0
1483984483774783489,2022-01-20 02:07:26,Inter Milan nyaris tersingkir dari ajang Coppa Italia. Gol akrobatik Andrea Ranocchia pada menit injury time menyelamatkan Nerazzurri. https://t.co/aGfj3Afmng,2,0,0,0,2022-01-20,2,Thursday,4,2,0
1483984054177390592,2022-01-20 02:05:44,Megawati akhirnya beri bantuan kepada Dorce Gamalama. Dorce mengucapkan terima kasih karena sudah mendapatkan perhatian dari Megawati. https://t.co/llDfERo9QX,49,9,4,0,2022-01-20,2,Thursday,4,53,9
1483984052499714054,2022-01-20 02:05:43,Cristiano Ronaldo tak cukup oke saat Manchester United menang melawan Brentford 3-1 dan ngamuk ketika ditarik keluar! https://t.co/mBtjSJXpR2,4,0,0,0,2022-01-20,2,Thursday,4,4,0
1483983475162157062,2022-01-20 02:03:26,"Biden menyatakan Kamala Harris bersedia kembali maju Pilpres 2024. Jika Biden mencalonkan lagi sebagai Capres, Harris akan digandeng sebagai pasangannya. https://t.co/457nezuPpq",4,0,1,0,2022-01-20,2,Thursday,4,5,0
1483982967093485570,2022-01-20 02:01:25,BMKG mengeluarkan seruan waspada terkait cuaca ekstrem di DKI Jakarta selama periode 19 hingga 21 Januari 2022 mendatang. https://t.co/GZbrlMoxG6,5,2,5,0,2022-01-20,2,Thursday,4,10,2
1483982877700370433,2022-01-20 02:01:03,Xi Jinping memperingatkan dunia bahwa konfrontasi dengan negaranya hanya akan menimbulkan konsekuensi malapetaka. #CNNIndonesia #detiknetwork  https://t.co/plAqtwx50p,3,2,2,1,2022-01-20,2,Thursday,4,5,3
1483982238001815553,2022-01-20 01:58:31,Risti Pouran sedang kesulitan dapat pasangan yang tulus. Lantaran terlalu banyak laki-laki hanya meliriknya dari ukuran fisik saja. https://t.co/vEgrrxWvrf,14,9,3,1,2022-01-20,1,Thursday,4,17,10
1483981738703478786,2022-01-20 01:56:32,Thomas Tuchel bicara soal Mason Mount dan tidak mau bikin drama berkepanjangan! https://t.co/4K7yumiI8s,4,0,0,0,2022-01-20,1,Thursday,4,4,0
1483981730688163844,2022-01-20 01:56:30,"Neymar segera merilis serial dokumenter di Netflix, yang bertujuan untuk membungkam kritik yang ada cara tersebut. https://t.co/vGercUSRSj",4,0,0,0,2022-01-20,1,Thursday,4,4,0
1483981070810992640,2022-01-20 01:53:52,Harga minyak goreng di Malaysia hanya Rp 8.500 per liter. Kok bisa?  https://t.co/rFNuPYy1pw,175,47,41,10,2022-01-20,1,Thursday,4,216,57
1483979332565573632,2022-01-20 01:46:58,"Alasan dari Thomas Tuchel yang menyebut Chelsea kelelahan sehingga gagal menang atas Brighton &amp; Hove Albion,  dipertanyakan oleh Alan Shearer. https://t.co/ag6Ee2xkpg",3,0,0,0,2022-01-20,1,Thursday,4,3,0
1483979004604473344,2022-01-20 01:45:40,Para pembeli Apartemen 45 Antasari tengah gigit jari. Nasib mereka tak jelas karena proyek tersebut mangkrak bertahun-tahun!  https://t.co/oJQSGQxWTG,9,0,3,1,2022-01-20,1,Thursday,4,12,1
1483978729173012481,2022-01-20 01:44:34,"Di tengah kondisinya yang sakit, Dorce Gamalama meminta bantuan kepada Megawati hingga Presiden Jokowi yang disambut positif. https://t.co/yYlIFD0s4p",7,0,1,0,2022-01-20,1,Thursday,4,8,0
1483976874489528322,2022-01-20 01:37:12,"Isyana Sarasvati dan Raisa dikenal sebagai musisi perempuan Indonesia yang berbakat. Siapa sangka, dahulu penggemar Raisa dan Isyana pernah bertengkar. Ini isi pesan chat pertama Raisa ke Isyana:  https://t.co/DeNllK6OoR",1,1,6,0,2022-01-20,1,Thursday,4,7,1
1483972001739988992,2022-01-20 01:17:50,Holly Hagan buat pernyataan jika dirinya kerap dilecehkan saat melakukan kunjungan ke kelab malam di acara MTV yakni Geordie Shore. Ini sosok Holly Hagan:  https://t.co/ktYEH9KhUe,5,0,2,0,2022-01-20,1,Thursday,4,7,0
1483970818463965191,2022-01-20 01:13:08,Tyna Kanna ungkap respons anak usai tahu orang tuanya cerai. Ia tak akan batasi mereka bertemu Kenang Mirdad. https://t.co/R6NKqes9ZQ,10,1,1,0,2022-01-20,1,Thursday,4,11,1
1483969249009938438,2022-01-20 01:06:54,NFT Ghozali Everyday jadi fenomena Indonesia di awal 2022. Ini alasan yang menyebabkan foto-foto selfie Ghozali jadi hits:  https://t.co/gu5CoYoAOT,9,2,1,1,2022-01-20,1,Thursday,4,10,3
1483967796484653063,2022-01-20 01:01:08,"Menurutnya, pondasi Kemnaker Corpu yang kuat adalah pola tata kelola implementasi Kemnaker Corpu dan strategi pengembangan kompetensi sumber daya manusia. https://t.co/RG1rXwqFfg",3,0,0,0,2022-01-20,1,Thursday,4,3,0
1483967269294247937,2022-01-20 00:59:02,Segel Tempat Hiburan Malam di Bogor yang dilakukan Bima Arya dibuka tanpa izin. Bima Arya meminta Kasatpol PP bertindak. https://t.co/mply2GADHB,11,2,0,1,2022-01-20,0,Thursday,4,11,3
1483966736680505345,2022-01-20 00:56:55,Koalisi Masyarakat Kalimantan Timur menolak pemindahan ibu kota. Mereka menilai RUU Ibu Kota Negara yang kini telah disahkan cacat secara prosedural. https://t.co/yq5jXzEzhm,935,149,257,55,2022-01-20,0,Thursday,4,1192,204
1483966719429431297,2022-01-20 00:56:51,"Selama ini Honda dituding membangun motornya hanya untuk Marc Marquez. Rekan setim Marquez, Pol Espargaro, menepis anggapan itu. https://t.co/hJThrouBDg",3,0,0,0,2022-01-20,0,Thursday,4,3,0
1483966040153509893,2022-01-20 00:54:09,Hakim Ziyech dingin usai mencetak gol ke gawang Brighton &amp; Hove Albion. Fans Chelsea merasa ada yang tidak beres dengan winger Maroko tersebut. https://t.co/akC5MenV9H,6,0,1,0,2022-01-20,0,Thursday,4,7,0
1483965786100219906,2022-01-20 00:53:08,"Manchester United menang 3-1 atas Brentford. Tiga golnya dicetak oleh Anthony Elanga, Mason Greenwood, dan Marcus Rashford. https://t.co/QorF7hVjjq",7,0,0,1,2022-01-20,0,Thursday,4,7,1
1483965529278889985,2022-01-20 00:52:07,Kritikan Arteria soal Kajati dipecat karena bicara Sunda saat rapat berbuntut panjang. Arteria tak masalah jika dirinya dilaporkan di MKD DPR. https://t.co/9MTWvDD0QN,12,36,4,5,2022-01-20,0,Thursday,4,16,41
1483964991246155778,2022-01-20 00:49:59,Kebiasaan olahraga perlu ditanamkan sejak dini. Salah seorang legenda sepakbola Indonesia Ponaryo Astaman membagikan tips agar rajin olahraga sejak masih belia. https://t.co/Q6p3zw610k,10,0,0,0,2022-01-20,0,Thursday,4,10,0
1483964166381649920,2022-01-20 00:46:42,Kalina Oktarani tidak hanya mengatakan Vicky Prasetyo berkali-kali minta cerai. Kalina juga jelaskan tidak ada nafkah yang pernah diterimanya. https://t.co/r6m9s7JTFk,9,14,1,0,2022-01-20,0,Thursday,4,10,14
1483963601358815232,2022-01-20 00:44:27,Kemenkes RI melaporkan DKI Jakarta menjadi penyumbang kasus Omicron terbanyak di Tanah Air. Ada beberapa wilayah yang masuk 'zona merah Omicron'. https://t.co/0zSdLVzk7w,16,11,9,2,2022-01-20,0,Thursday,4,25,13
1483963346286256134,2022-01-20 00:43:27,"Di tengah pengusutan video 61 detik, netizen ramai menyebut Miss Kay adalah sosok asli pemeran video tersebut. https://t.co/QS6VygQlaT",2,1,0,0,2022-01-20,0,Thursday,4,2,1
1483962037982183426,2022-01-20 00:38:15,"Pengajian Maulid Nabi di Jaksel diwarnai dengan aksi pencurian HP milik seorang ustaz. Pelaku berjumlah dua orang, 1 pelaku tertangkap sedangkan 1 lainnya DPO. https://t.co/2HI0dYszsh",5,0,0,0,2022-01-20,0,Thursday,4,5,0
1483962019556569091,2022-01-20 00:38:10,"Di Pasar Legi, Puan Maharani diagendakan akan memberikan sambutan. Dia juga akan menandatangani prasasti peresmian pasar induk Kota Solo itu. https://t.co/Cuo5TRTjgB",4,10,0,2,2022-01-20,0,Thursday,4,4,12
1483961487018409985,2022-01-20 00:36:03,Inter Milan menang 3-2 atas Empoli dan berhak maju ke delapan besar Coppa Italia. Laga berjalan sengit dan harus dituntaskan hingga babak tambahan. https://t.co/QXncWHEoc1,3,0,0,0,2022-01-20,0,Thursday,4,3,0
1483960961123954688,2022-01-20 00:33:58,"Drama pengusiran Sekjen Kemensos Harry Hikmat dari rapat Komisi VIII DPR, berakhir dalam hitungan jam. Meski demikian, hal itu tetap menarik perhatian. https://t.co/pgk1jGtWBD",5,1,1,0,2022-01-20,0,Thursday,4,6,1
1483960691027546114,2022-01-20 00:32:54,BMKG memperkirakan sejumlah wilayah di Sulawesi Selatan dalam kondisi berawan pagi ini. Kemudian hujan ringan bakal turun sejak siang hingga malam hari. https://t.co/4zUZTQhVYL,7,0,0,1,2022-01-20,0,Thursday,4,7,1
1483960453084684289,2022-01-20 00:31:57,Ayu Thalia ditetapkan sebagai tersangka atas laporan pencemaran nama baik Nicholas Sean Purnama. https://t.co/BWnGPU3USW,13,5,1,1,2022-01-20,0,Thursday,4,14,6
1483960137555525635,2022-01-20 00:30:42,"Dalam tempo seminggu, anggota DPR RI sudah dua kali mengusir 'tamu' rapat. Pertama, anggota Komnas Perempuan. Kedua, Sekjen Kementerian Sosial, Harry Hikmat. https://t.co/rvZv7ufQMp",9,5,3,3,2022-01-20,0,Thursday,4,12,8
1483960116294602752,2022-01-20 00:30:37,"Kapolres Pekalongan bersama awak media, tim Gabung Siaga Bencana terjebak longsor susulan selama berjam-jam, di Jalur Jalan Petungkriyono, Pekalongan, Jateng. https://t.co/7aIkTbXPyz",3,0,1,0,2022-01-20,0,Thursday,4,4,0
1483959640274653187,2022-01-20 00:28:43,"Salat Dhuha menjadi salah satu ibadah sunnah yang memiliki banyak keutamaan. Yuk simak penjelasannya, semoga bisa membantu kita rajin salat dhuha. https://t.co/1n6d2xjJaO",103,0,22,1,2022-01-20,0,Thursday,4,125,1
1483959090946744321,2022-01-20 00:26:32,Susan Sameh lagi kasmaran. Ia dikabarkan sedang dekat dengan seorang pria yang ternyata adalah atlet bulutangkis.  https://t.co/VmibIoNVMk,12,0,0,2,2022-01-20,0,Thursday,4,12,2
1483958546001797122,2022-01-20 00:24:22,"BPOM RI telah memberikan izin darurat penggunaan 5 vaksin COVID-19 sebagai booster. Meski begitu, Kemenkes RI baru punya 4 kombinasi vaksin booster COVID-19. https://t.co/XT9upKAfDR",7,1,1,1,2022-01-20,0,Thursday,4,8,2
1483957097062707202,2022-01-20 00:18:37,Inter Milan nyaris tersingkir dari ajang Coppa Italia saat bersua Empoli. Gol akrobatik Andrea Ranocchia pada menit injury time menyelamatkan Nerazzurri. https://t.co/vWcPL9UNPT,8,1,1,0,2022-01-20,0,Thursday,4,9,1
1483957095884111885,2022-01-20 00:18:36,"Pasar tradisional di Desa Brambang, Kecamatan Karangawen, Kabupaten Demak, Jawa Tengah terbakar pada dini hari. Ketinggian api terlihat hingga sekitar 4 meter. https://t.co/vEC1grgdaZ",7,1,0,1,2022-01-20,0,Thursday,4,7,2
1483956288145002496,2022-01-20 00:15:24,Kondisi sastrawan Remy Sylado kini sudah membaik setelah jalani operasi hernia di RSUD Tarakan. Begini kondisinya:   https://t.co/jQqk8T4uyu,6,0,1,1,2022-01-20,0,Thursday,4,7,1
1483955772761550855,2022-01-20 00:13:21,"Adik kandung Bupati Langkat, Iskandar juga ditetapkan tersangka oleh KPK. Iskandar berperan mengatur pake proyek infrastruktur. https://t.co/DmTQlX4aTE",10,2,2,1,2022-01-20,0,Thursday,4,12,3
1483955029769863168,2022-01-20 00:10:24,Stadion RAA Adiwijaya Garut diproyeksikan rampung dibangun tahun ini. Stadion dengan rumput impor ini diklaim mampu menggelar pertandingan Liga 1. https://t.co/ikvzJ7v7C4,6,2,0,2,2022-01-20,0,Thursday,4,6,4
1483954523131596808,2022-01-20 00:08:23,"Kejagung mengungkap terdapat ratusan laporan terkait mafia tanah, salah satunya diduga ada keterlibatan oknum jaksa. https://t.co/dMJJGSFhQM",10,2,1,2,2022-01-20,0,Thursday,4,11,4
1483952743559610372,2022-01-20 00:01:19,"TPU Kober yang berlokasi di Pendongkelan, Cengkareng Timur, tergenang banjir. Pemkot Jakata Barat mengatakan hal ini dikarenakan posisi rendah. https://t.co/xd8o1vffPS",4,1,0,1,2022-01-20,0,Thursday,4,4,2
1483952243212697604,2022-01-19 23:59:19,"Ketua DPR RI Puan Maharani membagikan kaus bertuliskan Mbak Puan kepada warga saat meninjau vaksinasi anak di Boyolali, Jawa Tengah.  https://t.co/M43K27cYVM",16,35,3,5,2022-01-19,23,Wednesday,3,19,40
1483951009986711553,2022-01-19 23:54:25,"Tanda-tanda kiamat kubra banyak disebutkan dalam Al Quran hingga hadits. Tanda ini kemudian dikumpulkan secara berurut oleh salah satu ulama fiqih, Al Banjari. https://t.co/TVaYVMOgLM",26,2,6,1,2022-01-19,23,Wednesday,3,32,3
1483950231444201472,2022-01-19 23:51:20,"Ridwan Saidi setuju dengan nama pilihan Jokowi untuk ibu kota negara di Kalimantan Timur, yakni Nusantara. Soalnya, nama itu sudah sesuai dengan sejarah. https://t.co/AEfqOsJMSY",137,41,15,7,2022-01-19,23,Wednesday,3,152,48
1483949486066053121,2022-01-19 23:48:22,Pernyataan Arteria Dahlan yang meminta Kajati yang bicara bahasa Sunda saat rapat diganti memantik kritikan dari berbagai pihak. https://t.co/wstrkVCFwX,17,18,2,3,2022-01-19,23,Wednesday,3,19,21
1483948938373828613,2022-01-19 23:46:12,Polemik chat di WhatsApp antara Sekjen Kemensos Harry Hikmat dan pimpinan Komisi VIII DPR Ace Hasan Syadzily berakhir damai. https://t.co/aaXcvJzsP6,1,0,1,1,2022-01-19,23,Wednesday,3,2,1
1483948334473781251,2022-01-19 23:43:48,"Puluhan pegawai di Kantor Kelurahan Gondangdia, Jakarta, positif COVID-19. Akibatnya Kantor Kelurahan Gondangdia ditutup sementara. https://t.co/j4Vj6TN9fG",10,0,3,2,2022-01-19,23,Wednesday,3,13,2
1483947313261338624,2022-01-19 23:39:44,Inter Milan melaju ke delapan besar Coppa Italia 2021/2022 usai menaklukkan Empoli. Nerazzurri menang 3-2 dalam laga yang berjalan 120 menit. https://t.co/IOYi1PPR7e,6,0,2,0,2022-01-19,23,Wednesday,3,8,0
1483947069400363010,2022-01-19 23:38:46,Ibunda Gaga Muhammad membantah pernyataan kakak Laura Anna soal tak adanya permintaan maaf. #GagaMuhammad  https://t.co/GjlRDwigTX,2,1,0,1,2022-01-19,23,Wednesday,3,2,2
1483946240626896898,2022-01-19 23:35:28,Efektivitas vaksin booster menjadi salah satu pertimbangan saat memutuskan untuk menerima dosis ketiga. Berbagai penelitian telah dilakukan untuk mengungkapnya. https://t.co/X9xJIP5xaY,8,1,3,0,2022-01-19,23,Wednesday,3,11,1
1483945746902704131,2022-01-19 23:33:31,"Wakil Ketua DPRD DKI dari Fraksi PKS, Abdurrahman Suhaimi tak setuju jika Ibu Kota Negara dipindah. PDIP DKI menyebut pengesahan UU IKN sudah jadi keputusan. https://t.co/zuDChTBDPs",10,11,0,0,2022-01-19,23,Wednesday,3,10,11
1483944907542777857,2022-01-19 23:30:10,KPK menduga Bupati Langkat Terbit Rencana juga menerima suap lewat adik kandungnya dari pemenang tender lain. KPK masih mendalami dugaan itu. https://t.co/ZCL3EkPkzD,9,0,1,0,2022-01-19,23,Wednesday,3,10,0
1483943904194052096,2022-01-19 23:26:11,Pengacara Munarman mengungkap reaksi Munarman saat diberi saran oleh salah satu saksi yang merupakan narapidana terorisme untuk sabar dan beristikamah. https://t.co/TOhNWZBoM6,3,1,0,0,2022-01-19,23,Wednesday,3,3,1
1483942826777927686,2022-01-19 23:21:54,"Konon, wanita cenderung lebih sulit orgasme. Hal ini biasanya disebabkan oleh beberapa faktor. Sebuah penelitian mengungkapkan 11 alasan wanita sulit orgasme. https://t.co/8vkSSAqSz2",3,3,0,0,2022-01-19,23,Wednesday,3,3,3
1483941719246880769,2022-01-19 23:17:30,"Kali ini, Brigjen Tumilaar tidak sedang membela Bintara Pembina Desa (Babinsa), tapi membela warga Bojong Koneng yang bersengketa dengan Sentul City. https://t.co/kwdWFifnzt",23,1,2,0,2022-01-19,23,Wednesday,3,25,1
1483940776358912001,2022-01-19 23:13:46,Polisi telah menyelidiki mobil sedan berpelat merah yang melawan arah di Bekasi. Pengemudi mobil pelat merah itu telah dikenai sanksi. https://t.co/6hHD83hPM0,2,1,0,0,2022-01-19,23,Wednesday,3,2,1
1483939242355085312,2022-01-19 23:07:40,"Leicester City vs Tottenham berjalan ketat, dalam lanjutan kompetisi Premier League. The Lilywhites bisa menang 3-2 di laga itu. https://t.co/yO6DogQOLP",7,0,0,0,2022-01-19,23,Wednesday,3,7,0
1483938729282654208,2022-01-19 23:05:37,"Leicester City vs Tottenham berjalan ketat, dalam lanjutan kompetisi Premier League. The Lilywhites bisa menang 3-2 di laga itu. https://t.co/wvKj20RYso",3,0,0,0,2022-01-19,23,Wednesday,3,3,0
1483938252264558595,2022-01-19 23:03:44,Mantan presenter Dunia Lain Harry Pantja dikabarkan mengidap hipertensi sebelum terserang stroke. Kenali tanda-tanda hipertensi yang dialami Harry Pantja. https://t.co/lFuhfyWH9j,15,0,2,0,2022-01-19,23,Wednesday,3,17,0
1483936646970105864,2022-01-19 22:57:21,Pasangan di China yang terjebak pada kencan tanpa akhir karena lockdown akhirnya mantap untuk melanjutkan hubungan mereka ke jenjang yang lebih serius. https://t.co/aLVlf9ZATM,2,1,0,0,2022-01-19,22,Wednesday,3,2,1
1483936329536872450,2022-01-19 22:56:05,"Pertandingan babak pertama antara Brentford vs Manchester United masih sama kuat 0-0. Namun, MU dibuat kerepotan dengan serangan-serangan tim tuan rumah. https://t.co/mzdushslLG",3,2,0,0,2022-01-19,22,Wednesday,3,3,2
1483935288179277824,2022-01-19 22:51:57,Ibu kota negara (IKN) Nusantara akan terhubung dengan jalan tol baru. Begini rutenya.  https://t.co/RFHejdPSoC,16,8,7,6,2022-01-19,22,Wednesday,3,23,14
1483934448785805319,2022-01-19 22:48:37,"Manchester United kembali ke jalur kemenangan di Liga Inggris. Bertandang ke markas Brentford, MU mendulang angka penuh usai menang dengan skor 3-1. https://t.co/oipRAbxYsn",9,0,0,0,2022-01-19,22,Wednesday,3,9,0
1483933890679029765,2022-01-19 22:46:24,Mesir berhasil mengalahkan Sudan 1-0 untuk lolos ke Piala Afrika 2021. Mesir menyandang status runner-up Grup D di bawah Nigeria. https://t.co/S6NGcTdUCE,16,0,0,0,2022-01-19,22,Wednesday,3,16,0
1483932632845111303,2022-01-19 22:41:24,Laga seru terjadi di Coppa Italia antara Inter Milan kontra Empoli. Kedua tim bermain imbang 2-2 hingga waktu normal dan dilanjutkan ke babak extra time. https://t.co/hFVWnHZoQs,4,0,0,0,2022-01-19,22,Wednesday,3,4,0
1483931292630716416,2022-01-19 22:36:04,"Bingung cara cek sertifikat vaksin COVID-19 untuk anak? Yuk merapat, ada infonya di sini. Lengkap kok, nggak njelimet. https://t.co/l6sf8Ofeis",5,1,2,0,2022-01-19,22,Wednesday,3,7,1
1483930818649206785,2022-01-19 22:34:11,Yogyakarta memiliki beragam kuliner enak dan bikin nagih. Jangan lewatkan untuk mencoba mangut lele hingga rujak es krim yang menyegarkan. Ini daftarnya!  https://t.co/UXbPg1ZF3O,14,1,4,0,2022-01-19,22,Wednesday,3,18,1
1483929233105862668,2022-01-19 22:27:53,Menurunnya gairah seksual bisa jadi sumber masalah dalam rumah tangga. 7 makanan ini bisa membantu untuk meningkatkan gairah seksual pasutri. https://t.co/PR5Ay1RJIJ,9,2,3,1,2022-01-19,22,Wednesday,3,12,3
1483927517656461312,2022-01-19 22:21:04,"Kontrak Paul Pogba di Manchester United akan segera habis. Selanjutnya, gelandang Prancis itu akan cabut ke Real Madrid? https://t.co/mHDRvslcbJ",2,0,1,0,2022-01-19,22,Wednesday,3,3,0
1483926163265396745,2022-01-19 22:15:41,"Gaga Muhammad divonis 4,5 tahun penjara. Greta Irene berharap semoga Laura Anna tenang...   https://t.co/KPvtazadjt",20,0,2,0,2022-01-19,22,Wednesday,3,22,0
1483925130560655360,2022-01-19 22:11:35,"Pembekuan sel telur atau egg freezing seperti dilakukan Luna Maya sebenarnya bukan barang baru. Banyak yang melakukannya, ini fakta-fakta penting tentangnya. https://t.co/NCd0XxSFeT",4,0,2,0,2022-01-19,22,Wednesday,3,6,0
1483922282837954562,2022-01-19 22:00:16,"Meski bisa menghilangkan warna rambut asli, bleaching rambut juga punya sejumlah risiko berbahaya. Kenali cara bleaching rambut yang benar. https://t.co/aPpQGbGWpJ",6,0,1,0,2022-01-19,22,Wednesday,3,7,0
1483920992028307457,2022-01-19 21:55:09,Beberapa orang mungkin merasa penasaran apakah habis vaksin boleh minum kopi? Dan jika diminum apakah ada efek samping? Simak informasinya di sini: https://t.co/iiWf7t52UJ,6,0,3,0,2022-01-19,21,Wednesday,3,9,0
1483920001698512896,2022-01-19 21:51:12,Nusantara diputuskan menjadi nama ibu kota negara baru. Suara pro kontra menghiasi ruang publik masyarakat Indonesia bahkan jadi perhatian media mancanegara. https://t.co/CCWQbL8sIk,29,11,11,2,2022-01-19,21,Wednesday,3,40,13
1483918708040941571,2022-01-19 21:46:04,Keputusan Gubernur Sulut Olly Dondokambey resmi menunjuk 34 staf khusus. Plus minus staf khusus itu dinilai perlu ditakar matang karena jumlahnya tak sedikit. https://t.co/YoTGZGdfpC,5,2,1,2,2022-01-19,21,Wednesday,3,6,4
1483917475154735106,2022-01-19 21:41:10,"Ikan-ikan di Situ Citongtut, Bogor, Jawa Barat, mati mengambang. Warga di sekitar lokasi menduga hal tersebut lantaran tercemar limbah pabrik. https://t.co/kuUKK8g0jy",4,3,1,1,2022-01-19,21,Wednesday,3,5,4
1483916472535629826,2022-01-19 21:37:11,Tyna Kanna bicara bebankan nafkah Kenang Mirdad terhadap anak-anaknya usai cerai. Ini kata Tyna:   https://t.co/aHprn19TwL,5,0,0,0,2022-01-19,21,Wednesday,3,5,0
1483915395748749325,2022-01-19 21:32:54,Wali Kota Makassar Moh Ramadhan 'Danny' Pomanto marah setelah ditipu oleh sejumlah aparatur sipil negara (ASN) terkait vaksinasi lansia. https://t.co/n7zBQQvmG5,4,0,0,0,2022-01-19,21,Wednesday,3,4,0
1483914374356127744,2022-01-19 21:28:51,"Produser sekaligus aktor dari film Ben &amp; Jody, Chicco Jerikho, menyebut film ini merupakan sajian hiburan yang penuh pesan moral. https://t.co/k03HO2GmN4",7,0,2,3,2022-01-19,21,Wednesday,3,9,3
1483913082623647749,2022-01-19 21:23:43,Tyna Kanna resmi bercerai dari Kenang Mirdad. Ia merasa lega dan bantah adanya isu KDRT Kenang Mirdad. https://t.co/L70Sum1nPZ,5,1,0,0,2022-01-19,21,Wednesday,3,5,1
1483912102062563333,2022-01-19 21:19:49,"Sejumlah selebriti menganggap tubuh mereka adalah aset penting dan berharga. Untuk melindunginya, tujuh artis ini mengasuransikan bagian tubuhnya:  https://t.co/NkqTt6oRWI",4,0,0,0,2022-01-19,21,Wednesday,3,4,0
1483910697801158658,2022-01-19 21:14:14,Musik Isyana Sarasvati dan Rara Sekar sejak dulu memang sudah dikenal sangat berbeda. Meskipun keduanya adalah seorang kakak beradik. https://t.co/TtkfXWn5t3,9,0,1,0,2022-01-19,21,Wednesday,3,10,0
1483909604065038336,2022-01-19 21:09:53,"Ayu Thalia ditetapkan jadi tersangka. Anak Ahok, Nicholas Sean Purnama mengucap syukur akan hal itu. https://t.co/xHKbok4bKo",8,2,1,0,2022-01-19,21,Wednesday,3,9,2
1483907797020467200,2022-01-19 21:02:43,"OTT terhadap Terbit ini jadi yang ketiga dilakukan KPK pada bulan ini. Sebelumnya ada Walkot Bekasi Rahmat Effendi, disusul Bupati Penajam Paser Utara. https://t.co/8BPuFlko0e",9,3,1,1,2022-01-19,21,Wednesday,3,10,4
1483907475422208007,2022-01-19 21:01:26,"Siap-siap, kasus DBD di Kulonprogo, DIY, diprediksi melonjak di 2022. Kenaikan kasus merupakan bagian dari siklus 6 tahunan. https://t.co/V0kDU1n6Zq",4,0,0,0,2022-01-19,21,Wednesday,3,4,0
1483906195203239936,2022-01-19 20:56:21,Britney Spears kini menyerang sang ibu dengan mengungkit momen ketika dirinya putus dari Justin Timberlake. https://t.co/kDrtRpHPB0,5,0,0,0,2022-01-19,20,Wednesday,3,5,0
1483904951705387017,2022-01-19 20:51:24,"Bintang Geordie Shore, Holly Hagan, ngaku kerap jadi korban pelecehan seksual di kelab-kelab malam. Ini kisahnya:  https://t.co/vJflaUrcCZ",1,1,0,0,2022-01-19,20,Wednesday,3,1,1
1483903652926570496,2022-01-19 20:46:15,Keluarga ini siapkan ratusan makanan untuk sambut keluarga calon menantu. Banyak yang memuji aksi keluarga mertua ini yang rela memasak seharian penuh. https://t.co/dWF96pXun6,9,0,2,0,2022-01-19,20,Wednesday,3,11,0
1483902662777135107,2022-01-19 20:42:19,Kasus 11 terdakwa mantan polisi yang jual sabu di Sumut memasuki babak tuntutan. Dua orang dituntut hukuman mati dan sembilan orang dipenjara seumur hidup. https://t.co/oSWheYZIPw,14,2,1,0,2022-01-19,20,Wednesday,3,15,2
1483900751047016451,2022-01-19 20:34:43,Ashanty telah sembuh dari COVID-19. Istri Anang Hermansyah itu menceritakan detik-detik dirinya dinyatakan positif usai pulang dari Turki:  https://t.co/JcmMwKR8s2,9,0,0,0,2022-01-19,20,Wednesday,3,9,0
1483899574951587842,2022-01-19 20:30:02,Robert Galbraith alias JK Rowling akhirnya mengumumkan penerbitan seri keenam dari novel detektif Cormoran Strike pada Agustus 2022. https://t.co/9Q5C1dlD5r,2,0,0,0,2022-01-19,20,Wednesday,3,2,0
1483898057964019715,2022-01-19 20:24:01,Bupati Langkat Terbit Rencana disebut sempat kabur saat hendak ditangkap KPK. Apakah ada informasi bocor terkait penangkapan? https://t.co/CHG3A6svOg,4,1,1,2,2022-01-19,20,Wednesday,3,5,3
1483897517955764224,2022-01-19 20:21:52,"Seekor penyu hijau ditemukan mati di pinggir Pantai Cangkring, Kabupaten Bantul. Saat ditemukan kondisi mulut penyu penuh sampah plastik. Hiks... https://t.co/aWp4D9Cc2R",99,7,41,12,2022-01-19,20,Wednesday,3,140,19
1483895795573211137,2022-01-19 20:15:01,"Bayern Munich ingin memberikan kontrak baru yang terbilang spesial untuk Robert Lewandowski. Tapi, konsekuensinya adalah Lewandowski harus mau dipotong gaji. https://t.co/XhCnd2R8sx",3,0,0,0,2022-01-19,20,Wednesday,3,3,0
1483894039518846981,2022-01-19 20:08:03,Ashanty dihujat karena positif COVID-19 untuk yang ketiga kalinya. Ia dianggap membawa bencana ke Indonesia usai pulang berlibur dari Turki. Begini respons Ashanty:   https://t.co/Vgmtn5vAyu,9,3,0,1,2022-01-19,20,Wednesday,3,9,4
1483892065868128271,2022-01-19 20:00:12,Bintang Scream (2022) Jasmin Savoy Brown membeberkan sosok yang paling diva di lokasi syuting. Kira-kira siapa ya? Simak wawancara eksklusifnya di detikcom!  https://t.co/gHIkpqx91i,1,0,0,0,2022-01-19,20,Wednesday,3,1,0
1483890798710210560,2022-01-19 19:55:10,"Olahraga lari sudah jadi gaya hidup masyarakat di kota besar saat ini. Salah satu produsen sepatu ternama, ASICS, pun mengeluarkan ""senjata"" terbarunya. https://t.co/MpugCHy5Bl",5,0,1,0,2022-01-19,19,Wednesday,3,6,0
1483889761848901641,2022-01-19 19:51:03,"Di balik kesuksesan industri manga, ada satu momok menakutkan yang masih merajai yakni pembajakan yang membuat rugi sampai Rp 148 triliun. https://t.co/WeN0oPtENH",0,0,1,0,2022-01-19,19,Wednesday,3,1,0
1483887738663444485,2022-01-19 19:43:00,KPK menetapkan Bupati Langkat Terbit Rencana Perangin Angin sebagai tersangka kasus suap proyek infrastruktur. Begini konstruksi perkara suap tersebut. https://t.co/Q7loeLsDUT,1,1,0,0,2022-01-19,19,Wednesday,3,1,1
1483886897617420290,2022-01-19 19:39:40,Dorce Gamalama dapat perhatian dari presiden Joko Widodo. Ia sangat senang akan hal itu. Ini yang didapat Dorce:  https://t.co/yCJ4lyrdbR,8,0,1,0,2022-01-19,19,Wednesday,3,9,0
1483885656447361028,2022-01-19 19:34:44,detikcom cari host. Ayo ikutan d'Videocaster Hunt 2022! https://t.co/TK3vsoq0bb,1,0,0,0,2022-01-19,19,Wednesday,3,1,0
1483884353386123265,2022-01-19 19:29:33,"Stadion sepak bola RAA Adiwijaya, Garut, diproyeksikan rampung tahun ini. Stadion dengan rumput impor ini diklaim akan mampu menggelar pertandingan kelas Liga 1 https://t.co/p8eOrSPwth",2,0,0,0,2022-01-19,19,Wednesday,3,2,0
1483883087842971657,2022-01-19 19:24:32,Kevin Sanjaya Sukamuljo cs dipanggil untuk menjalani serangkaian tes kesehatan di Pelatnas Cipayung. Bagaimana dengan Praveen/Melati dan Hafiz/Gloria? https://t.co/xigjcmzSYT,1,0,0,0,2022-01-19,19,Wednesday,3,1,0
1483881956299452419,2022-01-19 19:20:02,Aksi tak biasa dilakukan seorang wanita asal Australia yang hendak menikah. Ia sengaja dugem dan bertukar minuman agar dirinya terkena COVID-19. https://t.co/tJgfUhjdIr,2,0,0,0,2022-01-19,19,Wednesday,3,2,0
1483880407657586692,2022-01-19 19:13:53,KPK menetapkan Bupati Langkat Terbit Rencana Perangin Angin sebagai tersangka kasus suap. Terbit disebut sempat kabur dari rumah saat akan ditangkap KPK. https://t.co/lpwmTANFCl,5,0,1,1,2022-01-19,19,Wednesday,3,6,1
1483880406357262339,2022-01-19 19:13:52,KPK menetapkan Bupati Langkat sebagai tersangka kasus suap proyek infrastruktur. KPK menyita uang Rp 786 juta. https://t.co/6A1CbelK8R,4,1,2,0,2022-01-19,19,Wednesday,3,6,1
1483879387036622855,2022-01-19 19:09:49,Polisi Israel mengusir warga Palestina dari kediamannya di Yerusalem dan menghancurkan bangunan pada Rabu (19/1) dini hari. Polisi juga menangkap 18 orang dengan tuduhan menentang perintah pengadilan dan mengganggu ketertiban umum. https://t.co/gzbWbuSSAQ,4,1,1,0,2022-01-19,19,Wednesday,3,5,1
1483878530459086852,2022-01-19 19:06:25,"""Saat kejadian, pelaku ini meminta uang ke korban namun tidak digubris oleh korban, sehingga terjadilah peristiwa tersebut,"" kata Dedi. https://t.co/BF3yxjqYNZ",0,0,0,0,2022-01-19,19,Wednesday,3,0,0
1483877531401039875,2022-01-19 19:02:27,"""Mudah-mudahan tetap ramai. Pemerintah tetap turun tanganlah kalau suasana nanti tidak sesuai harapan."" #Malioboro https://t.co/77vrBUSVFq",3,2,0,0,2022-01-19,19,Wednesday,3,3,2
1483876137474396162,2022-01-19 18:56:54,"Gaga Muhammad divonis 4,5 tahun penjara karena dianggap tidak konsisten dengan rasa berasalahnya. Termasuk menyebut Laura Anna lalai.  https://t.co/E1P6Cqqm1G",3,1,1,1,2022-01-19,18,Wednesday,3,4,2
1483875056476430338,2022-01-19 18:52:37,"Gaga Muhammad divonis oleh majelis hakim 4,5 tahun penjara atas kasus kecelakaan lalu lintas bersama Laura Anna. Ibunda Gaga ingin banding. https://t.co/VlN8ox3Lof",4,0,1,1,2022-01-19,18,Wednesday,3,5,1
1483873561555177475,2022-01-19 18:46:40,"Secara teori, Elche bukan lawan sepadan bagi Real Madrid. Meski begitu, Madrid akan menganggap pertandingan itu bak laga final. https://t.co/6MHXUachpz",3,0,0,1,2022-01-19,18,Wednesday,3,3,1
1483873530467041284,2022-01-19 18:46:33,KPK menetapkan Bupati Langkat Terbit Rencana Perangin Angin sebagai tersangka kasus suap. https://t.co/jfGUP4zFtP,5,1,1,2,2022-01-19,18,Wednesday,3,6,3
1483872745263972352,2022-01-19 18:43:26,Jawa Barat memiliki stadion khusus untuk cabang olahraga atletik berstandar internasional IAAF. Stadion ini bernama Prabu Linggabuana. https://t.co/E5UG6ukAdR,7,0,1,0,2022-01-19,18,Wednesday,3,8,0
1483871889969790978,2022-01-19 18:40:02,Mabes Polri mengungkap peruntukan nopol yang sebenarnya. Arteria pun mengakui bahwa pelat-pelat tersebut bukan pelat asli. https://t.co/DkMHxqXdcZ,316,269,114,65,2022-01-19,18,Wednesday,3,430,334
1483870126197858309,2022-01-19 18:33:01,Para pegawai PT KAI (Persero) menjadi korban investasi bodong. Diketahui investasi bodong yang terjadi bermodus tebus murah mobil mewah.  https://t.co/88iLyhbd58,11,4,1,2,2022-01-19,18,Wednesday,3,12,6
1483869299194400768,2022-01-19 18:29:44,Teka-teki berikut tidak membutuhkan kemampuan berhitung yang tinggi. Hanya saja kamu mungkin perlu fokus untuk menjawabnya dengan benar. https://t.co/x40BUQVAtF,21,28,4,3,2022-01-19,18,Wednesday,3,25,31
1483868677183262722,2022-01-19 18:27:16,Jarak vaksin kedua dan ketiga sudah diatur oleh Kementerian Kesehatan yang menjadi syarat penerima vaksin booster. Simak aturannya di sini: https://t.co/621NTera41,5,1,4,1,2022-01-19,18,Wednesday,3,9,2
1483867574601457664,2022-01-19 18:22:53,"Kamar anak di rumah para seleb ternama Indonesia ini nggak tanggung-tanggung, dilengkapi dengan barang-barang berharga fantastis. Ini potretnya:  https://t.co/5gDuLb2tRg",7,1,0,0,2022-01-19,18,Wednesday,3,7,1
1483866250363215872,2022-01-19 18:17:37,KPK menetapkan Bupati Langkat Terbit Rencana Perangin Angin sebagai tersangka usai terjaring OTT. Terbit Rencana terlihat telah mengenakan rompi tahanan KPK. https://t.co/9jUMwW3s1J,1,0,0,0,2022-01-19,18,Wednesday,3,1,0
1483865487465406469,2022-01-19 18:14:35,"Indonesia harus semakin waspada, Kemenkes kini melaporkan total kasus varian Omicron mencapai 882 oramg. Ada 174 di antaranya transmisi lokal. https://t.co/xK3SZlIOS0",8,0,6,1,2022-01-19,18,Wednesday,3,14,1
1483863869672013831,2022-01-19 18:08:10,"Wanita ini sempat saat tahu harga es puter yang dibelinya Rp 20 ribuan. Awalnya ia mengira menjadi korban ketok harga, padahal harga es puter ini memang mahal.  https://t.co/tIo4MfLcLE",3,1,0,1,2022-01-19,18,Wednesday,3,3,2
1483862254080638980,2022-01-19 18:01:44,"Bupati Langkat Terbit Rencana Perangin Angin yang terjaring OTT tiba di gedung KPK. Saat tiba, Terbit tak berkomentar sedikit pun. https://t.co/og1hZnVWIv",5,0,1,1,2022-01-19,18,Wednesday,3,6,1
1483860847453745169,2022-01-19 17:56:09,Harga minyak goreng sedang mengalami kenaikan sejak tahun 2021 yang lalu. Pemerintah kini mengeluarkan kebijakan minyak goreng satu harga Rp 14 ribu per liter. Tetapi....  https://t.co/mSfqCE13TV,11,4,3,2,2022-01-19,17,Wednesday,3,14,6
1483859818855256068,2022-01-19 17:52:04,Meisya Siregar mengkau tidak menduga seller tersebut akan menipu karena responnya tampak terpercaya apalagi akunnya sering muncul di Instagram Ads. https://t.co/c5LS41pXK7,3,2,0,0,2022-01-19,17,Wednesday,3,3,2
1483858808334127106,2022-01-19 17:48:03,Liverpool mendapat kabar buruk jelang duel leg kedua semifinal Piala Liga Inggris kontra Arsenal. Alex-Oxlade Chamberlain harus absen karena cedera. https://t.co/CnY0xLZVzb,0,0,0,0,2022-01-19,17,Wednesday,3,0,0
1483857499514150919,2022-01-19 17:42:51,Desakan itu untuk menghindari polemik yang lebih besar. https://t.co/iiOjBGghIT,19,5,3,0,2022-01-19,17,Wednesday,3,22,5
1483855079308414981,2022-01-19 17:33:14,"Istri Chen EXO disebut sudah melahirkan. Kini, Chen resmi menjadi ayah dari dua anak. Chukahae Chen!  https://t.co/yEMIpvQ1LZ",45,0,6,1,2022-01-19,17,Wednesday,3,51,1
1483853616775639041,2022-01-19 17:27:25,Polri resmi menggelar Operasi Damai Cartenz 2022 di wilayah Papua. Kapolda Papua Irjen Mathius D Fakhiri meminta personel yang bertugas menghindari terjadinya kontak tembak saat menghadapi KKB di Papua. https://t.co/mamoogoNEo,13,12,2,2,2022-01-19,17,Wednesday,3,15,14
1483852269716230153,2022-01-19 17:22:04,"Hilangnya Muhammad Hasbi (7) di kaki gunung Sendawar, Samarinda di lokasi tukang bakso hilang misterius hingga kini belum menemui titik terang. #detiktif https://t.co/vXmJApBZbw",16,2,5,0,2022-01-19,17,Wednesday,3,21,2
1483850769195581443,2022-01-19 17:16:06,Model Paulina Porizkova usianya tidak muda lagi. Namun dalam foto terbarunya di media sosial model pakaian renang itu terlihat begitu awet muda. https://t.co/qeoWVVe46g,6,0,1,0,2022-01-19,17,Wednesday,3,7,0
1483848632012972033,2022-01-19 17:07:37,"KPK melakukan OTT terhadap Bupati Langkat Terbit Rencana Perangin Angin. Kini, Terbit Rencana telah tiba di Gedung Merah Putih KPK, Jakarta Selatan. https://t.co/TH0N5AQcSB",50,8,16,7,2022-01-19,17,Wednesday,3,66,15
1483848138943254533,2022-01-19 17:05:39,"Mengikuti tren yang tengah viral di media sosial, Wolipop ikut mencoba bedak yang banyak direkomendasikan oleh netizen di TikTok.  https://t.co/poNNA19zYv",7,0,0,0,2022-01-19,17,Wednesday,3,7,0
1483846785105813509,2022-01-19 17:00:16,Penelitian terbaru menunjukkan perempuan merasa pria yang pakai masker terlihat lebih menarik. Tapi tidak semua jenis masker meningkatkan daya tarik. https://t.co/uSFZuMSdVa,22,9,3,5,2022-01-19,17,Wednesday,3,25,14
1483845429469097994,2022-01-19 16:54:53,Han So Hee dan Park Hyung Sik dipasangkan dalam drama Korea Soundtrack #1. Ini potret manis keduanya yang dikisahkan sebagai sahabat dekat:  https://t.co/Ye39EN8Mxo,24,0,0,0,2022-01-19,16,Wednesday,3,24,0
1483844538515050499,2022-01-19 16:51:21,Amalia Fujiawati diperiksa terkait adanya laporan atas dugaan pencemaran nama baik di Polres Depok. https://t.co/xnUwZ0tqPd,1,0,0,0,2022-01-19,16,Wednesday,3,1,0
1483844190903861249,2022-01-19 16:49:58,"Direktur Kerjasama Keimigrasian, Agus Wijaya menyebut pihaknya tak lagi berwenang menentukan buka-tutup akses ke luar negeri. Yang berwenang kini Satgas COVID. https://t.co/61ZcTwhzDx",5,0,1,0,2022-01-19,16,Wednesday,3,6,0
1483841932149338114,2022-01-19 16:40:59,Ayu Thalia bakal diperiksa besok usai jadi tersangka yang libatkan anak Ahok. https://t.co/tU8CEv3eMe,5,0,0,0,2022-01-19,16,Wednesday,3,5,0
1483841617572339715,2022-01-19 16:39:44,Wanita berinisial R mendapat pelecehan verbal oleh Kasat Reksrim Boyolali AKP Eko Marudin saat lapor pelecehan seks yang dia alami. Begini kesaksian lengkap R. https://t.co/4OavwaCBqA,50,12,11,3,2022-01-19,16,Wednesday,3,61,15
1483840271766982658,2022-01-19 16:34:23,"Penanganan banjir disebut tidak bisa dilihat secara sporadis, dan butuh ahli untuk mengukur perbandingan penanganan banjir Jakarta. https://t.co/XdPemhk8P3",4,8,1,1,2022-01-19,16,Wednesday,3,5,9
1483839201338707972,2022-01-19 16:30:08,MIS-C COVID merupakan komplikasi dari COVID-19 alias virus Corona yang bisa menyerang anak-anak. Kenali penyebab dan gejalanya yang perlu diwaspadai. https://t.co/IirOgKLrjR,11,1,5,1,2022-01-19,16,Wednesday,3,16,2
1483838564723011590,2022-01-19 16:27:36,"Ketua DPR RI Puan Maharani meninjau pelaksanaan vaksinasi Covid-19 anak di SDN 1 Sawahan, Boyolali. Di kesempatan tersebut, Puan sempat menanyakan murid apakah mereka tahu dengan dirinya. https://t.co/qx4Ok7uYHX",29,58,4,8,2022-01-19,16,Wednesday,3,33,66
1483838552387506177,2022-01-19 16:27:33,"Anggota Komisi II DPR, Agung Widyantoro, menyinggung sejauh mana tim seleksi melakukan uji kesamaptaan Komisioner KPU. Agung berpendapat, dengan beban kerja yang berat, membuat kesehatan Komisioner KPU menurun sehingga harus menggunakan balsam. https://t.co/o4t4PeMfvV",2,1,0,0,2022-01-19,16,Wednesday,3,2,1
1483837844980445185,2022-01-19 16:24:45,"Ayu Thalia disebut akan menjalani pemeriksaan sebagai tersangka di Polres Metro Jakarta Utara terkait kasus pencemaran nama baik, besok Kamis (20/1). Hal tersebut disampaikan oleh kuasa hukum Nicholas Sean Purnama. https://t.co/CVR5R4fmjb",6,0,0,0,2022-01-19,16,Wednesday,3,6,0
1483837825460154369,2022-01-19 16:24:40,Pria asal Korea Selatan nekat membakar diri karena tidak bisa menikah dengan wanita pujaannya. Aksi ini dilakukan setelah berdebat dengan agensi perjodohan. https://t.co/1Lq2EzQa4q,8,0,2,0,2022-01-19,16,Wednesday,3,10,0
1483837480424116226,2022-01-19 16:23:18,Dua orang pemuda di Gorontalo nekat nyebur ke sawah dan berpura-pura mencabut rumput saat hendak ditilang polisi. Polisi menyebut aksi spontanitas keduanya lantaran takut ditilang. https://t.co/xc1i1K1LXm,16,2,1,0,2022-01-19,16,Wednesday,3,17,2
1483837466939379717,2022-01-19 16:23:15,Pengacara Nicholas Sean Purnama menyampaikan jika selebgram Ayu Thalia sudah ditetapkan sebagai tersangka oleh penyidik Polres Jakarta Utara atas laporan kliennya terkait pencemaran nama baik dan fitnah. https://t.co/2a7pbPqOK7,0,0,0,0,2022-01-19,16,Wednesday,3,0,0
1483837171442323459,2022-01-19 16:22:04,Stok vaksin Moderna di Magelang masih ada dua ribu dosis dan akan kedaluwarsa pada 23 Januari 2022 mendatang. Pihak Dinkes setempat pun berpacu dengan waktu agar stok vaksin bisa tersalurkan. https://t.co/CSXawqTdgt,4,2,3,1,2022-01-19,16,Wednesday,3,7,3
1483837147673243651,2022-01-19 16:21:59,"Tomat dianggap sebagai makanan sehat yang mengandung vitamin C dan antioksidan. Dengan segala kandungannya, ini manfaat tomat untuk wajah:  https://t.co/4eGAiccqHR",4,0,1,0,2022-01-19,16,Wednesday,3,5,0
1483836888171560962,2022-01-19 16:20:57,Drama Korea Snowdrop diduga berakhir tragis. Jung Hae In mengibarat kisah cintanya dan Jisoo BLACKPINK bak Romeo dan Juliet. #Snowdrop  https://t.co/cS7wTmvCiF,6,2,1,2,2022-01-19,16,Wednesday,3,7,4
1483836780428382210,2022-01-19 16:20:31,Jaksa penuntut umum (JPU) menghadirkan saksi dari narapidana terorisme berinisial K di sidang lanjutan kasus dugaan terorisme Eks Sekretaris Front Pembela Islam (FPI) Munarman. Saksi K mengaku pernah memberangkatkan anggota FPI ke ISIS. https://t.co/CHPw61Nmh3,11,0,1,1,2022-01-19,16,Wednesday,3,12,1
1483828452033761284,2022-01-19 15:47:25,"Saksi HF mengaku Munarman ikut baiat ke ISIS di UIN Syarif Hidayatullah, Ciputat, Tangerang pada tanggal 6 Juli 2014. Namun Munarman membantahnya. https://t.co/P2mAAn7VgX",8,3,0,1,2022-01-19,15,Wednesday,3,8,4
1483827679786901506,2022-01-19 15:44:21,"Waketum Partai Golkar, Erwin Aksa menyebut pihaknya bakal segera memulai persiapan Pilpres 2024. Infrastruktur partai hingga ke tingkat desa akan digerakkan. https://t.co/5kaTXWCjL0",7,2,0,3,2022-01-19,15,Wednesday,3,7,5
1483826925940482054,2022-01-19 15:41:21,"Luhut Pandjaitan meminta anak usaha PT PLN (Persero), PT PLN Batubara dibubarkan. Seperti apa fakta terbarunya?  https://t.co/nEbXx1sTQx",11,2,0,0,2022-01-19,15,Wednesday,3,11,2
1483826554123730951,2022-01-19 15:39:53,"Pasien Omicron umumnya mengeluhkan gejala ringan seperti pilek, tetapi virusnya menular lebih cepat. Hari ke berapa pasien Omicron berhenti menularkan virus? https://t.co/n21wNFK4gC",7,3,3,1,2022-01-19,15,Wednesday,3,10,4
1483825643565555713,2022-01-19 15:36:16,Pelaku begal payudara di Pasuruan dibekuk setelah aksinya terekam CCTV. Kini pelaku dijerat pasal 289 KUHP subsider pasal 281 KUHP dengan ancaman 9 tahun penjara. https://t.co/QpZrDJ2FUn,13,3,1,2,2022-01-19,15,Wednesday,3,14,5
1483824911080693763,2022-01-19 15:33:21,Heru Hidayat lolos dari vonis mati usai dijatuhi hukuman nihil oleh majelis hakim Pengadilan Tipikor Jakarta. Bagaimana penjelasan hakim dalam putusannya? https://t.co/phOyhaovoK,7,1,3,3,2022-01-19,15,Wednesday,3,10,4
1483824665919381505,2022-01-19 15:32:23,Putri Marino belakangan semakin dikenal dan banyak diperbincangkan usai dirinya membintangi serial Layangan Putus. Ini penampilannya:   https://t.co/8qtIeC8Gr5,9,3,0,0,2022-01-19,15,Wednesday,3,9,3
1483823184814252032,2022-01-19 15:26:30,"Rusun Ponpes Az-Zayadiyy dibangun 2018 dengan APBN senilai Rp 12,7 miliar atas usulan Puan Maharani yang saat itu masih menjabat Menko PMK. https://t.co/mh5DDnH83y",5,0,0,0,2022-01-19,15,Wednesday,3,5,0
1483822393600708608,2022-01-19 15:23:21,Kejagung mengusut proyek pengadaan satelit yang ada di Kemhan pada 2015-2021. Kejagung mengatakan saat ini pihaknya sedang mengusut pihak terkait kasus tersebut https://t.co/QOALbl1oaN,5,1,2,0,2022-01-19,15,Wednesday,3,7,1
1483821663439527946,2022-01-19 15:20:27,"Gempa bumi magnitudo (M) 4,5 mengguncang Bima, Nusa Tenggara Barat (NTB). Pusat gempa di laut. https://t.co/id8MTuywsH",10,0,7,1,2022-01-19,15,Wednesday,3,17,1
1483820091250814976,2022-01-19 15:14:12,Banjir yang melanda sejumlah titik di Jakarta pada 18 Januari 2022 memantik perdebatan sejumlah partai politik. https://t.co/Dj9Ht20h4D,11,4,1,1,2022-01-19,15,Wednesday,3,12,5
1483819537363795972,2022-01-19 15:12:00,"""Saya sebagai orang Sunda merasa terusik ketenangannya dengan statement saudara Arteria Dahlan,"" kata Uu. https://t.co/0TIsn4hejL",197,46,47,10,2022-01-19,15,Wednesday,3,244,56
1483818534220279809,2022-01-19 15:08:01,Kim Kardashian menyewa tim keamanan baru untuk menghadang Kanye West masuk ke rumahnya. Kim terganggu karena Kanye sering masuk ke rumahnya tanpa izin. https://t.co/2GPrjL5ZIW,11,2,0,0,2022-01-19,15,Wednesday,3,11,2
1483817508377448449,2022-01-19 15:03:56,"Sejumlah anak menangis histeris dan meronta-ronta saat akan divaksin di Polres Purwakarta, Jawa Barat. Petugas pun dibuat repot dan harus memegangi tubuh si anak hingga akhirnya si anak berhasil disuntik vaksin. https://t.co/zHv6dlVLEb",8,0,2,3,2022-01-19,15,Wednesday,3,10,3
1483816804275433474,2022-01-19 15:01:08,Jerinx menyebut Adam Deni sebagai orang yang tak sesuai fakta. Hal tersebut ia sampaikan usai mendengar keterangan dari saksi ahli di persidangan. Kenapa? https://t.co/S5GrcRM7a0,5,2,0,0,2022-01-19,15,Wednesday,3,5,2
1483815898574200833,2022-01-19 14:57:32,"Berdasarkan transkrip percakapan Jerinx dan Adam Deni yang dilihat saat BAP, ahli bahasa mengatakan bahwa kata-kata yang disampaikan Jerinx ke Adam Deni adalah pengancaman. https://t.co/bW7pEjqiZl",3,0,0,0,2022-01-19,14,Wednesday,3,3,0
1483815340706603013,2022-01-19 14:55:19,WHO tegas mengatakan anak dan remaja yang sehat belum membutuhkan booster. Booster harus diprioritaskan pada mereka yang rentan seperti lansia. https://t.co/3KTR24bbut,24,3,11,3,2022-01-19,14,Wednesday,3,35,6
1483813857382612992,2022-01-19 14:49:26,"Hujan lebat disertai angin menerjang Kota Semarang hingga membuat sejumlah pohon tumbang, hari ini. Hujan juga memicu longsor hingga melukai seorang warga. https://t.co/DPGSZxLzIY",12,1,3,0,2022-01-19,14,Wednesday,3,15,1
1483813856124227585,2022-01-19 14:49:25,"Gempa bumi magnitudo (M) 5,7 mengguncang Kabupaten Seram Bagian Timur, Provinsi Maluku. https://t.co/hoTUcO6Bls",17,2,14,0,2022-01-19,14,Wednesday,3,31,2
1483812856231567370,2022-01-19 14:45:27,"Antonio Conte menyadari bursa transfer Januari tidak selalu mudah. Meski demikian, dia tetap meminta Tottenham Hotspur untuk mendatangkan pemain baru. https://t.co/w34l7Xg50R",9,0,2,1,2022-01-19,14,Wednesday,3,11,1
1483811601916608513,2022-01-19 14:40:28,"Baliho bertulisan Arteria Dahlan Musuh Orang Sunda mejeng di Kota Bandung, tepatnya di pertigaan Jalan Diponegoro di dekat Gedung Sate pada Rabu (19/1/2022). Kehadiran baliho tersebut diduga terkait pernyataan Arteria. https://t.co/Q0do6xDYmR",41,6,11,3,2022-01-19,14,Wednesday,3,52,9
1483810545077735431,2022-01-19 14:36:16,Karoseri Adi Putro mulai melakukan uji coba bus monokok mediumnya. Uji coba ini dilakukan mulai 11 Januari 2022 hingga 10 Februari 2022 di Kota Solo. https://t.co/Z3EhIQBPku,7,0,1,0,2022-01-19,14,Wednesday,3,8,0
1483809990246809600,2022-01-19 14:34:04,Maia Estianty kembali mencuri perhatian melalui penampilan barunya yang disebut netizen mirip dengan Anya Geraldine.  https://t.co/jUl1zURfSC,7,0,2,0,2022-01-19,14,Wednesday,3,9,0
1483808891167195136,2022-01-19 14:29:42,"Mensos Tri Rismaharini, meminta maaf atas permasalahan antara Sekertaris Jenderal Kemensos, Harry Hikmat dengan Wakil Ketua Komisi VIII, Ace Hasan Syadzily. Risma bahkan mengatakan siap untuk duduk bersimpuh meminta maaf secara langsung ke Ace Hasan. https://t.co/5UwF1ywxxf",23,8,4,0,2022-01-19,14,Wednesday,3,27,8
1483808255117873162,2022-01-19 14:27:10,DPR sudah mengesahkan UU Ibu Kota Negara dengan memindahkan Jakarta ke Nusantara di Kalimantan. Lalu bagaimana dampaknya? https://t.co/wTJPFd1wtA,40,7,14,2,2022-01-19,14,Wednesday,3,54,9
1483807471852531719,2022-01-19 14:24:03,Tyna Kanna bersyukur sidang perceraiannya dengan Kenang Mirdad berjalan dengan lancar. Ia menegaskan kalau pernikahannya berakhir bukan karena KDRT. https://t.co/DXjlgBbTbA,1,0,1,0,2022-01-19,14,Wednesday,3,2,0
1483807082235281413,2022-01-19 14:22:30,"China membantu Sri Lanka membangun kota yang disebut akan menyaingi pusat-pusat ekonomi seperti Hong Kong, Dubai, Monako. Tetapi, siapa yang akan diuntungkan? https://t.co/Uf2NhHK3cg",9,2,3,0,2022-01-19,14,Wednesday,3,12,2
1483806371954970627,2022-01-19 14:19:41,"#FOTO Deretan nama-nama penerima undangan pernikahan ini bikin kamu melongo dan pengin baca dua kali, kocak abis. Ini potretnya:  https://t.co/AekaztkBlf",27,3,9,1,2022-01-19,14,Wednesday,3,36,4
1483805474474668038,2022-01-19 14:16:07,Pemindahan karyawan dari suatu perusahaan ke lainnya yang masih dalam 1 grup kerap terjadi. Lalu apakah pemindahan antar perusahaan ini bisa disebut 'PHK'? #detiksAdvocate https://t.co/TcFGEmd9tK,8,0,2,2,2022-01-19,14,Wednesday,3,10,2
1483804771182075907,2022-01-19 14:13:19,Park Shin Hye dan Choi Tae Joon akan melangsungkan pernikahan pada 22 Januari 2022. Ini potret cantik Park Shin Hye yang tengah hamil muda:  https://t.co/y08LEj9ets,13,4,3,1,2022-01-19,14,Wednesday,3,16,5
1483803430607065090,2022-01-19 14:08:00,Titik banjir di Jakarta mulai berkurang. Saat ini total ada 77 RT yang terdata masih tergenang banjir. https://t.co/KYWFFqJ8FX,22,4,5,0,2022-01-19,14,Wednesday,3,27,4
1483803427805319169,2022-01-19 14:07:59,"Seorang pria tua memperbaiki jalan rusak seorang diri di Kabupaten Majene, Sulawesi Barat. Aksi pria tua itu direkam oleh warga hingga viral di media sosial. https://t.co/EEK3ycNmak",23,0,4,2,2022-01-19,14,Wednesday,3,27,2
1483802500474015745,2022-01-19 14:04:18,Jarak vaksin ke 2 dan ke 3 berapa lama? Cari tahu dulu yuk sebelum booster. Ini ketentuannya! https://t.co/ozHzk2eG29,4,0,3,1,2022-01-19,14,Wednesday,3,7,1
1483801728466173954,2022-01-19 14:01:14,"Setelah harganya sempat melonjak tinggi, kini pemerintah menyesuaikan harga minyak goreng menjadi Rp14 ribu per liter. Simak faktanya di sini, yuk. #detikNetwork  https://t.co/kFu86NUQLB",7,0,3,2,2022-01-19,14,Wednesday,3,10,2
1483800878586937347,2022-01-19 13:57:51,Media internasional menyoroti langkah pemerintah menjadikan Nusantara sebagai nama ibu kota baru Indonesia di Kalimantan Timur. Apa kata mereka? https://t.co/6BGHll2tIT,24,3,5,0,2022-01-19,13,Wednesday,3,29,3
1483799949909405696,2022-01-19 13:54:10,Gubernur Jawa Barat Ridwan Kamil menyatakan telah berikhtiar dan siap lahir batin untuk maju di Pilpres 2024 mendatang. Dia masih memilih partai yang bakal mengusungnya. https://t.co/FmtObWCrsy,151,89,27,53,2022-01-19,13,Wednesday,3,178,142
1483797994852040705,2022-01-19 13:46:24,"Ketua DPR RI Puan Maharani dipastikan tidak hanya menghadiri peresmian Pasar Legi Solo, besok. Gibran memastikan Puan bakal meresmikan Pasar Legi. https://t.co/ai2nZUvZl7",16,9,0,1,2022-01-19,13,Wednesday,3,16,10
1483797677712281618,2022-01-19 13:45:08,Inilah pemain Liga Inggris yang paling hobi nutmeg alias ngolongin lawan. Ia masih muda dan pemain pinjaman dari Barcelona. Namanya Francisco Trincao! https://t.co/MDQVVP0JWA,12,0,0,0,2022-01-19,13,Wednesday,3,12,0
1483796787098005507,2022-01-19 13:41:36,"Tak masalah sesekali memberikan gombalan cinta lucu kepada pasangan. Tidak harus rayuan serius, kamu juga bisa bermain dengan gombalan cinta lucu ini:  https://t.co/UFNpPNa80Z",9,0,2,1,2022-01-19,13,Wednesday,3,11,1
1483795438205558787,2022-01-19 13:36:14,"KPK membawa tujuh orang ke gedung KPK dari operasi tangkap tangan (OTT) di Langkat, Sumatera Utara (Sumut). https://t.co/Gq6AAnmWf1",15,3,4,2,2022-01-19,13,Wednesday,3,19,5
1483794913644982272,2022-01-19 13:34:09,Perancang busana ini membuat gaun pengantin yang menikah dengan beda tiga agama viral di media sosial. Ini kisah selengkapnya:  https://t.co/AZ2SjoXV7l,6,1,3,1,2022-01-19,13,Wednesday,3,9,2
1483794000138100736,2022-01-19 13:30:31,"RUU IKN sudah diresmikan menjadi UU IKN. Akan tetapi, pemerintah wajib melakukan dua hal ini. https://t.co/3lIcK7Z2NA",9,0,6,0,2022-01-19,13,Wednesday,3,15,0
1483793676618899467,2022-01-19 13:29:14,Junimart menyebut seharusnya Fadli Zon dimasukan sebagai anggota atau salah satu pimpinan Pansus RUU IKN agar mengerti. https://t.co/GqvqFF0iBq,10,1,3,1,2022-01-19,13,Wednesday,3,13,2
1483793655785738242,2022-01-19 13:29:09,MIS-C atau Multisystem Inflammatory Syndrome atau sindrom inflamasi multisistem pada anak perlu diwaspadai sebagai komplikasi COVID-19. Kenali gejalanya:  https://t.co/XHZSBeRVoA,5,0,4,1,2022-01-19,13,Wednesday,3,9,1
1483793600458772486,2022-01-19 13:28:56,"Warga yang tinggal di pesisir Pandeglang, Banten saat ini mengkhawatirkan tempat evakuasi di kampung mereka yang kini malah rawan terjadi longsor. https://t.co/QBaKEXopgr",3,0,1,0,2022-01-19,13,Wednesday,3,4,0
1483793536747290631,2022-01-19 13:28:41,"Pria inisial YYS (39) dan FT (16) di Bolsel, Sulut ditangkap usai diduga memperkosa remaja berusia 14 tahun dengan cara mencekoki miras. https://t.co/PO3I8tMYhl",6,0,1,0,2022-01-19,13,Wednesday,3,7,0
1483791494901374980,2022-01-19 13:20:34,"Akbar Wicaksono telah jadi pengusaha digital sukses. Di balik itu, ia pernah dikecewakan teman baik, duitnya dibawa kabur Rp 100 juta. https://t.co/lE3ez1ScM1",23,2,4,1,2022-01-19,13,Wednesday,3,27,3
1483791463578226695,2022-01-19 13:20:27,"Cuaca kering yang tidak biasa memicu kebakaran di Asuncion, Paraguay. Kebakaran terjadi di ladang terbuka hingga peternakan. https://t.co/9Cp2pDoIlO",2,0,1,1,2022-01-19,13,Wednesday,3,3,1
1483790331510460417,2022-01-19 13:15:57,"Luis Suarez akan habis kontraknya di Atletico pada musim panas Juni nanti. Tak cuma klub-klub Eropa, Inter Miami klubnya David Beckham di AS juga meminatinya! https://t.co/ttTMcPSZQH",11,0,1,0,2022-01-19,13,Wednesday,3,12,0
1483790281933791236,2022-01-19 13:15:45,Wilayah Kabupaten Sleman hingga Kota Yogyakarta diprediksi hujan dengan intensitas lebat hingga tengah malam ini. https://t.co/JpFl0UvBDS,12,2,1,1,2022-01-19,13,Wednesday,3,13,3
1483789435439390723,2022-01-19 13:12:23,"Baliho bertuliskan 'ARTERIA DAHLAN MUSUH ORANG SUNDA' mejeng di Kota Bandung, tepatnya di pertigaan Jalan Diponegoro di dekat Gedung Sate pada Rabu (19/1/2021). https://t.co/ilc3mF9Jln",231,34,39,9,2022-01-19,13,Wednesday,3,270,43
1483788760991113217,2022-01-19 13:09:42,"Heru Hidayat telah menjalani dua vonis kasus korupsi. Di kasus Jiwasraya, Heru dipidana seumur hidup, sementara di kasus Asabri, Heru divonis nihil. https://t.co/kFyh8Wb4gx",16,2,1,2,2022-01-19,13,Wednesday,3,17,4
1483788456211927045,2022-01-19 13:08:30,"Pengacara menyebut Kenang Mirdad sudah ikhlas dan lega setelah dinyatakan resmi bercerai dari Tyna Kanna. Namun, pihak Kenang akan berdiskusi terlebih dahulu mengenai pengajuan banding. https://t.co/gtfkdLp8FU",9,0,0,1,2022-01-19,13,Wednesday,3,9,1
1483787826558910467,2022-01-19 13:05:59,"Legenda mode dan eks editor top Vogue, André Leon Talley, meninggal dunia dalam usia 73 tahun. Kepergiannya meninggalkan duka yang mendalam bagi para desainer. https://t.co/22m8pJf97W",20,1,5,0,2022-01-19,13,Wednesday,3,25,1
1483787290040283138,2022-01-19 13:03:52,Andy Shinhwa mengumumkan akan menikah dalam waktu dekat. Hal itu disampaikan langsung melalui surat yang ditulis untuk fans. https://t.co/G71gNuCc6J,11,1,1,0,2022-01-19,13,Wednesday,3,12,1
1483786088783224836,2022-01-19 12:59:05,"Terlepas dari berbagai macam masalahnya, pandemi COVID-19 membuka peluang usaha baru. Jenama mode lokal Lallua justru lahir di tengah kemelut wabah Corona. https://t.co/UHzERQjOiC",23,0,4,0,2022-01-19,12,Wednesday,3,27,0
1483785533474148353,2022-01-19 12:56:53,KPK menangkap tujuh orang dari operasi tangkap tangan (OTT) Bupati Langkat Terbit Rencana Perangin Angin. Ketujuh orang tersebut segera dibawa ke Jakarta. https://t.co/RZS0HfUfzM,20,2,5,1,2022-01-19,12,Wednesday,3,25,3
1483784581132308485,2022-01-19 12:53:06,Wilayah Jakarta Barat menjadi salah satu lokasi terparah yang terdampak banjir. Hingga saat ini ada empat kelurahan yang masih banjir. https://t.co/amIDilPQcO,11,1,3,1,2022-01-19,12,Wednesday,3,14,2
1483783802040246274,2022-01-19 12:50:00,Ustaz Khalid Basalamah dikabarkan ditolak berceramah di Palu. Ustaz Khalid Basalamah ditolak oleh sejumlah organisasi kemasyarakatan. https://t.co/WZ0usl762y,39,29,9,3,2022-01-19,12,Wednesday,3,48,32
1483782409749467136,2022-01-19 12:44:28,Mahfud Md mengoreksi pernyataannya terkait pengadaan satelit di Kementerian Pertahanan (Kemhan) pada 2015. Begini penjelasannya https://t.co/I1hG3A93Wj,11,0,1,2,2022-01-19,12,Wednesday,3,12,2
1483781572662812680,2022-01-19 12:41:08,Rumah milik komika Dodit Mulyanto ini ada di tengah hutan sendirian lho. Seperti apa penampakannya? Intip di sini yuk! #detikNetwork  https://t.co/AMMgxweGWQ,30,0,8,2,2022-01-19,12,Wednesday,3,38,2
1483781223751331842,2022-01-19 12:39:45,Candi Blandongan dan Jiwa di kawasan Percandian Batujaya Karawang terendam banjir akibat intensitas hujan tinggi dan luapan air irigasi. Begini penampakannya. https://t.co/XlLMR3MlLY,14,2,5,0,2022-01-19,12,Wednesday,3,19,2
1483780947514433539,2022-01-19 12:38:39,BNPB disebut mendukung usulan Komite Olimpiade Indonesia (KOI) memberi diskresi kepada pelaku olahraga terkait karantina. Tapi ada syaratnya. https://t.co/z5lMKmHHLP,9,1,2,1,2022-01-19,12,Wednesday,3,11,2
1483780567132946432,2022-01-19 12:37:09,"Tempias air hujan genangi Pasar Legi Solo. Selepas hujan, Wali Kota Solo Gibran Rakabuming cek pasar yang besok akan diresmikan Ketua DPR Puan Maharani itu. https://t.co/jEwzxk0G9H",9,3,1,1,2022-01-19,12,Wednesday,3,10,4
1483780565924986881,2022-01-19 12:37:08,"Wilayah RW 02, Tegal Alur, Kalideres, Jakbar masih terendam banjir. Diperkirakan 5.000 warga terdampak banjir. https://t.co/inoxITW9X3",12,4,6,1,2022-01-19,12,Wednesday,3,18,5
1483780564377341952,2022-01-19 12:37:08,PDIP mengkritik Gubernur DKI Jakarta Anies Baswedan tidak mengerjakan program penanggulangan banjir. Gerindra menilai tudingan PDIP ngawur. https://t.co/hSHphdKJ2D,21,8,7,3,2022-01-19,12,Wednesday,3,28,11
1483780562884210689,2022-01-19 12:37:08,"""Saya dan para ketua DPC se-Jatim percaya pada Mas Emil karena kami melihat sosok Mas AHY sebagai tokoh muda berprestasi pada diri beliau,"" katanya. https://t.co/Dvd25GzwRl",8,1,1,0,2022-01-19,12,Wednesday,3,9,1
1483780560900268032,2022-01-19 12:37:07,"Selain dilanda kekurangan air bersih selama 12 tahun, kini warga juga mendapatkan air yang keruh dan menguning dari tanki yang disediakan pengelola rusun. https://t.co/tjl619g03a",9,1,1,0,2022-01-19,12,Wednesday,3,10,1
1483780558849290241,2022-01-19 12:37:07,Dino Patti Djalal dimintai keterangan oleh KPK soal dirinya memperkenalkan pihak Formula E ke Gubernur DKI Anies Baswedan. https://t.co/fPSpudNGF1,19,7,5,1,2022-01-19,12,Wednesday,3,24,8
1483780557213515777,2022-01-19 12:37:06,Paguyuban Panglawungan Sastra Sunda (PP-SS) meminta DPP PDI Perjuangan agar memberi sanksi kepada Arteria Dahlan. https://t.co/g7Oih3StpF,63,30,18,3,2022-01-19,12,Wednesday,3,81,33
1483780287855214596,2022-01-19 12:36:02,"Gejala Omicron memang mirip pilek biasa, tapi jangan santai dulu. Justru ini yang dikhawatirkan Kemenkes walau mayoritas pasien Omicron 'cuma' batuk-pilek. https://t.co/nQnRKC1DKF",13,2,8,0,2022-01-19,12,Wednesday,3,21,2
1483779533111181312,2022-01-19 12:33:02,Deddy Corbuzier mengumumkan ada oknum yang mencatut namanya untuk menipu. Bahkan oknum tersebut nekat menargetkan menteri. Duh! https://t.co/JEOqnX7uRq,14,1,5,1,2022-01-19,12,Wednesday,3,19,2
1483779175324524546,2022-01-19 12:31:37,"Rohana Abdullah, gadis keturunan RI di Malaysia, tak lagi harus khawatir. Setelah ditinggal ibunya ketika masih bayi, kini ia mendapatkan kewarganegaraan Malaysia. #CNNIndonesia #detikNetwork  https://t.co/b6Yjs9cUhR",34,1,7,0,2022-01-19,12,Wednesday,3,41,1
1483778406831595525,2022-01-19 12:28:34,"Terbit Rencana Perangin Angon punya harta puluhan miliar, berikut isi garasinya. https://t.co/qs76AhOMWd",8,0,1,1,2022-01-19,12,Wednesday,3,9,1
1483778390066966530,2022-01-19 12:28:30,"Dirjen GTK mengatakan, seleksi satu juta guru PPPK Guru dilanjutkan 2022. Pemda didorong mengajukan jumlah formasi maksimal agar guru segera diangkat. https://t.co/nV0EVXseiy",7,0,4,0,2022-01-19,12,Wednesday,3,11,0
1483778125678923786,2022-01-19 12:27:27,"Ilham Nugraha, penerima LPDP untuk S2 di AS mempunyai kisah menarik untuk disimak. Terdapat lika-liku yang dilaluinya hingga sukses meraih mimpi tersebut. https://t.co/4uvulQ03T6",19,0,5,0,2022-01-19,12,Wednesday,3,24,0
1483778050705788932,2022-01-19 12:27:09,Manchester United kabarnya sudah siap menawarkan kontrak baru Bruno Fernandes. Sang pemain meminta gajinya digandakan. https://t.co/LpqYTyLude,9,0,2,0,2022-01-19,12,Wednesday,3,11,0
1483775794883276802,2022-01-19 12:18:11,"Imbang kontra Brighton di Liga Inggris, Thomas Tuchel menyatakan bahwa The Blues memang lagi banyak masalah! https://t.co/eKJiuvcrwS",4,3,0,0,2022-01-19,12,Wednesday,3,4,3
1483774742461140999,2022-01-19 12:14:00,Sistem transaksi tol tanpa berhenti bakal diterapkan di Indonesia. Berikut tiga cara bayar tol tanpa berhenti. https://t.co/elwIVVADZ8,5,1,6,1,2022-01-19,12,Wednesday,3,11,2
1483773144431304711,2022-01-19 12:07:39,"Sikap Hakim Ziyech usai mencetak gol buat Chelsea ke gawang Brighton mengundang tanda tanya. Bukan cuma tak melakukan selebrasi, wajahnya pun tanpa ekspresi. https://t.co/ydIM1gceKX",4,0,1,0,2022-01-19,12,Wednesday,3,5,0
1483772236813250563,2022-01-19 12:04:03,"Mie instan menjadi makanan instan favorit banyak orang. Tak hanya dinikmati dengan cara biasa, ternyata mie instan juga bisa dikreasikan menjadi lebih lezat.  https://t.co/3inczEkC6T",7,0,1,0,2022-01-19,12,Wednesday,3,8,0
1483771552978116617,2022-01-19 12:01:20,#Terpopuler Polisi mengungkapkan motif dari pengeroyokan tersebut ialah kesalahpahaman. Begini ceritanya: https://t.co/j9RwtkzCyq,6,0,1,0,2022-01-19,12,Wednesday,3,7,0
1483771108327403522,2022-01-19 11:59:34,#Terpopuler Polisi menangkap empat orang terduga pelaku pengeroyokan anggota TNI AD Pratu Sahdi (23) di Jakarta Utara hingga tewas. Begini tampang para terduga pelaku. https://t.co/ATix4io5YE,5,1,3,0,2022-01-19,11,Wednesday,3,8,1
1483770472781205506,2022-01-19 11:57:02,"Seorang warga Bengkulu Utara, Bengkulu ditemukan tewas di kebun miliknya. Warga bernama Pa'at (65) itu diduga tewas usai berduel dengan seekor babi. https://t.co/bVU2BD6l4y",13,5,4,1,2022-01-19,11,Wednesday,3,17,6
1483769836023029761,2022-01-19 11:54:30,"Tidak hanya pilihan barang yang lengkap, ITC Kuningan juga surganya tempat kuliner. Di sini kamu bisa mencicipi olahan babi lezat hingga masakan khas Makassar.  https://t.co/wrKw3hFyNW",22,9,5,2,2022-01-19,11,Wednesday,3,27,11
1483769794641997827,2022-01-19 11:54:20,Thomas Tuchel menyebut para pemain Chelsea lelah fisik dan mental sehingga gagal mengalahkan Brighton. Tuchel akan memberi libur dua hari kepada para pemainnya. https://t.co/1xIpFsAQxL,3,0,0,1,2022-01-19,11,Wednesday,3,3,1
1483769246333259781,2022-01-19 11:52:10,"Khabib Nurmagomedov kini mengurus Eagle FC, ajang MMA setelah pensiun dari UFC. https://t.co/1nfDvgXwlR",6,0,0,0,2022-01-19,11,Wednesday,3,6,0
1483768489206816774,2022-01-19 11:49:09,"Bulan Januari dikenal sebagai bulannya para pelaku vegan. Ikut ramaikan pekan vegan, Gordon Ramsay ciptakan steak khusus vegan.  https://t.co/aY1p7wzpkQ",12,1,0,1,2022-01-19,11,Wednesday,3,12,2
1483767740670300162,2022-01-19 11:46:11,Porsche Taycan Turbo S dipilih menjadi safety car untuk ajang balap mobil listrik Formula E tahun 2022. https://t.co/2HzFdC3Zky,9,1,3,0,2022-01-19,11,Wednesday,3,12,1
1483766895933370372,2022-01-19 11:42:49,Topik menyakiti diri sendiri dengan makan seblak yang sangat pedas menjadi topik di media sosial. Tentu saja hal ini menundang banyak komentar kocok netizen.  https://t.co/OKB884kFNW,18,3,4,4,2022-01-19,11,Wednesday,3,22,7
1483766859300278272,2022-01-19 11:42:40,Heni Anggraeni sempat jadi penyiar untuk beberapa waktu lama. Wanita yang akrab disapa Baba itu kini banting setir ke dunia manajemen event dengan membangun wedding organizer.  https://t.co/dQidUomZ3f,7,0,0,0,2022-01-19,11,Wednesday,3,7,0
1483765886326558724,2022-01-19 11:38:48,"Berdasarkan hasil survei Dapodikper hari ini, Rabu (19/1/2022), PTM telah dilakukan sebanyak 52,5 persen sekolah. Lalu, bagaimana nasib PTM di Jakarta? https://t.co/Ch9liprjPr",4,0,0,1,2022-01-19,11,Wednesday,3,4,1
1483765392451543040,2022-01-19 11:36:51,Polda Metro Jaya bakal memperketat permohonan pelat khusus setelah temuan banyaknya pelat 'RF' yang melanggar ganjil genap. https://t.co/z8cYVWYbdb,9,0,1,1,2022-01-19,11,Wednesday,3,10,1
1483765345760563204,2022-01-19 11:36:40,Musim hujan seperti ini enaknya menyantap semangkok ramen yang hangat. Kamu bisa mampir ke gerai ramen di Jakarta Barat ini yang mengusung konsep bar.  https://t.co/WhhvN7yzC3,1,0,0,1,2022-01-19,11,Wednesday,3,1,1
1483764851629604865,2022-01-19 11:34:42,Selain low MPVkini tengah digandrungi masyarakat Indonesia. Siapa raja low SUV di Indonesia? https://t.co/e5MnuB76cT,4,0,0,1,2022-01-19,11,Wednesday,3,4,1
1483764122043011075,2022-01-19 11:31:48,"Everton mendekati Jose Mourinho sebagai calon manajer barunya. Namun, Mourinho menolak karena masih terikat janji di AS Roma! https://t.co/Fh2iR4LDwO",3,0,0,0,2022-01-19,11,Wednesday,3,3,0
1483764071245791237,2022-01-19 11:31:36,"Whiskey istimewa, The Yamazaki 55 Year Old terjual seharga USD 559.200 atau sekitar Rp 8 miliar di bandara Turki.  https://t.co/gQbvT75aSw",4,0,1,2,2022-01-19,11,Wednesday,3,5,2
1483763346608431105,2022-01-19 11:28:43,TB Hasanuddin menegaskan ucapan Arteria Dahlan soal 'Kajari bicara Sunda' tak mewakili partai atau komunitas DPR https://t.co/axy3eWJ0wr,3,2,0,2,2022-01-19,11,Wednesday,3,3,4
1483762646692335624,2022-01-19 11:25:56,"Pakar memprediksi COVID-19 tak akan berakhir menjadi endemi. Disebut lebih mungkin seperti penyakit campak, bagaimana gambarannya? https://t.co/ekfT8iVSPu",5,1,2,1,2022-01-19,11,Wednesday,3,7,2
1483761578843545602,2022-01-19 11:21:42,"Setelah memecat Angelo Alessio, Persija Jakarta menunjuk Sudiman lagi untuk menjadi pelatih kepala. https://t.co/cnF7Mvz8nO",4,0,1,0,2022-01-19,11,Wednesday,3,5,0
1483760978911281152,2022-01-19 11:19:18,"Wasit laga Borneo FC vs Persib Bandung menjadi sorotan, lantaran David da Silva dianggap offside. https://t.co/mmA3R1BrcM",18,3,2,1,2022-01-19,11,Wednesday,3,20,4
1483760577243754498,2022-01-19 11:17:43,"Wasit laga Borneo FC vs Persib Bandung menjadi sorotan, lantaran David da Silva dianggap offside. https://t.co/voJnXNnV5h",11,15,3,3,2022-01-19,11,Wednesday,3,14,18
1483760156546641921,2022-01-19 11:16:02,Klaim Menteri Investasi Bahlil Lahadalia bahwa pengusaha meminta Pilpres 2024 diundur direspons dingin Jokowi. Sang Presiden menegaskan akan patuh konstitusi. https://t.co/y1rnSLPCF5,15,2,2,3,2022-01-19,11,Wednesday,3,17,5
1483759783723290624,2022-01-19 11:14:34,"Wasit laga Borneo FC vs Persib Bandung menjadi sorotan, lantaran David da Silva dianggap offside! https://t.co/Rwtk8vdrS0",17,11,2,1,2022-01-19,11,Wednesday,3,19,12
1483759069869531141,2022-01-19 11:11:43,"Viral postingan bernarasi tarif parkir bus Rp 350 ribu di belakang Hotel Premium Zuri, kawasan Malioboro. Wakil Wali Kota Yogya minta proses hukum bagi pelaku. https://t.co/uqVBkE8QSC",25,3,15,1,2022-01-19,11,Wednesday,3,40,4
1483756918888071170,2022-01-19 11:03:10,Presiden Jokowi mengungkap kriteria calon pemimpin Ibu Kota yang bernama Nusantara itu. Dia adalah kepala daerah berlatar belakang arsitek. https://t.co/I8xqHz1Tws,138,110,25,82,2022-01-19,11,Wednesday,3,163,192
1483756206162337793,2022-01-19 11:00:21,"Seorang buron kasus pembunuhan di Jepara, MY (46), ditangkap polisi setelah kabur ke Malaysia dan menjadi tenaga kerja Indonesia (TKI) sekitar 3,5 tahun. https://t.co/smgNONOOb9",2,1,0,0,2022-01-19,11,Wednesday,3,2,1
1483755692523761664,2022-01-19 10:58:18,KPK melakukan OTT terhadap Bupati Langkat Terbit Rencana Perangin Angin. Terbit Rencana tercatat sebagai kepala daerah terkaya nomor 7 di Indonesia. https://t.co/R2xWJmbjKM,32,5,9,4,2022-01-19,10,Wednesday,3,41,9
1483755181980659712,2022-01-19 10:56:16,Sejumlah kertas bergambar wajah Exco PSSI Haruna Soemitro dan Shin Tae Yong bertebaran di Jakarta. https://t.co/sD1O8VaILA,16,0,5,1,2022-01-19,10,Wednesday,3,21,1
1483754727376826376,2022-01-19 10:54:28,"JoMan menemui penyidik Polda Metro Jaya untuk gelar perkara. Dalam gelar perkara itu, dibahas soal pasal untuk Ubedillah Badrun. https://t.co/bhoe2i1c4D",10,17,2,4,2022-01-19,10,Wednesday,3,12,21
1483754215340187649,2022-01-19 10:52:26,"Alasan ditolak, PPGI dinilai belum melengkapi bukti lampiran. Namun Maruli yakin UAS telah memenuhi syarat sebagai bentuk tindak pidana ujaran kebencian. https://t.co/JjVZlJykJN",32,33,3,1,2022-01-19,10,Wednesday,3,35,34
1483754188635000832,2022-01-19 10:52:20,KPK telah memeriksa Dino Pati Djalal terkait kasus Formula E. Apa yang digali KPK dari pemeriksaan ini? https://t.co/jqOZWQYpkK,30,12,14,1,2022-01-19,10,Wednesday,3,44,13
1483753976227057668,2022-01-19 10:51:29,"Kuasa politikus Partai Gerindra Ferry Joko Yuliantono, Refly Harun, mengungkit sejarah presidential threshold, yaitu untuk menjegal SBY dalam capres 2009. https://t.co/mwAZpTlykV",4,0,2,1,2022-01-19,10,Wednesday,3,6,1
1483753952327970820,2022-01-19 10:51:23,"Bajigur Durian Asoy jadi dessert favorit warga Ciwidey, Bandung. Setelah gerainya sempat tutup 2019 lalu, kini Bajigur Durian Asoy sudah kembali bisa dinikmati.  https://t.co/mgW6fqoms8",13,0,3,1,2022-01-19,10,Wednesday,3,16,1
1483753449552498688,2022-01-19 10:49:23,Warga sipil bernama Baharudin ini diringkus polisi tanpa perlawanan. Begini sosoknya: https://t.co/jVv6DXGSwE,4,0,2,0,2022-01-19,10,Wednesday,3,6,0
1483753228969955335,2022-01-19 10:48:31,"Lebih dari 282.000 kasus virus Corona (COVID-19) terdeteksi dalam sehari di wilayah India, yang merupakan lonjakan tertinggi dalam 8 bulan terakhir. https://t.co/KjpwVIlj52",10,0,3,0,2022-01-19,10,Wednesday,3,13,0
1483753205037215744,2022-01-19 10:48:25,Layanan LRT Jabodebek yang operasinya berbasis listrik disebut memiliki cadangan power listrik untuk mengantisipasi pemadaman listrik.  https://t.co/Kre2LmRImP,3,1,2,0,2022-01-19,10,Wednesday,3,5,1
1483752956537229316,2022-01-19 10:47:26,"Andaikan dulu Cristiano Ronaldo tidak datang ke Real Madrid, mungkin Karim Benzema bisa lebih cepat memperlihatkan kesuburan. Tapi Benzema tak dendam. https://t.co/JAZDOMw8eY",8,1,1,0,2022-01-19,10,Wednesday,3,9,1
1483752652500619264,2022-01-19 10:46:13,Augie Fantinus sampai Asri Welas sambut baik kolaborasi IBL 2022 dengan NFT. Mereka mendapatkan NFT itu.  https://t.co/8a4YxZ8mxk,4,0,1,0,2022-01-19,10,Wednesday,3,5,0
1483752123384877063,2022-01-19 10:44:07,Jawaban Gilang Dirga usai kena nyinyir soal uang Rp 30 juta Fuji. Begini jawabannya:  https://t.co/WvXA3EWoiN,5,0,2,0,2022-01-19,10,Wednesday,3,7,0
1483751751828357121,2022-01-19 10:42:39,"Ketua Umum Kadin Arsjad Rasjid menjawab rumor dirinya masuk ke arena politik dan dia juga menjelaskan suara dukungan pengusaha terhadap perpanjangan masa jabatan presiden, hingga 3 periode. #blakblakan https://t.co/CGSxFpBXw9 https://t.co/42E02aaF5b",114,12,37,15,2022-01-19,10,Wednesday,3,151,27
1483751373376299008,2022-01-19 10:41:08,"Jumlah kasus COVID-19 di Indonesia bertambah 1.745, Rabu (19/1/2022). Total kasus positif menjadi 4.275.528, sembuh 4.120.540, dan meninggal 144.192. https://t.co/BRf4jci8zP",9,0,2,3,2022-01-19,10,Wednesday,3,11,3
1483751049047556098,2022-01-19 10:39:51,Mercy berkelir putih terlibat kecelakaan lalu lintas di Kota Bandung. Mobil tersebut menabrak pembatas jalan hingga menabrak angkot. https://t.co/aXTwIbwcgq,45,4,7,1,2022-01-19,10,Wednesday,3,52,5
1483749854291677184,2022-01-19 10:35:06,"Ratusan rumah di Kota Pekalongan, Jawa Tengah, kebanjiran. Air berasal dari guyuran hujan dan luapan sungai. https://t.co/0rRNu25ICd",5,2,3,0,2022-01-19,10,Wednesday,3,8,2
1483748643878457347,2022-01-19 10:30:18,"Ketua Umum Kamar Dagang Indonesia Arsjad Rasjid menjawab rumor dirinya masuk ke arena politik dan juga menjelaskan suara dukungan pengusaha terhadap perpanjangan masa jabatan presiden, hingga 3 periode! #blakblakan   https://t.co/iRNvYcgpZA",4,0,2,0,2022-01-19,10,Wednesday,3,6,0
1483748569345662977,2022-01-19 10:30:00,Akhirnya! Ralf Rangnick dikabarkan mempersilakan Paul Pogba pergi. https://t.co/kKzujZfnve,7,1,4,1,2022-01-19,10,Wednesday,3,11,2
1483747905198608385,2022-01-19 10:27:21,"Enam wanita Indonesia tewas tenggelam di perairan lepas pantai Malaysia setelah kapal mereka terbalik, saat diduga berusaha memasuki negara itu secara ilegal. https://t.co/l1GjitLlxs",8,1,3,1,2022-01-19,10,Wednesday,3,11,2
1483747683223445504,2022-01-19 10:26:29,"Seorang pria melaporkan nyeri penis yang menyiksa akibat infeksi COVID-19. Ternyata, ia mengalami pembekuan darah di penisnya. Kok bisa? https://t.co/JSrbF3oSks",7,2,5,0,2022-01-19,10,Wednesday,3,12,2
1483746583598571520,2022-01-19 10:22:06,Titik banjir di Jakarta sore ini bertambah. Total ada 102 RT yang terdata masih tergenang banjir. https://t.co/eoERtiY6c1,56,21,31,16,2022-01-19,10,Wednesday,3,87,37
1483746582306635778,2022-01-19 10:22:06,"Sebanyak 6.933 rumah dari 10 desa di Kecamatan Batujaya, Kabupaten Karawang terendam banjir akibat tingginya intensitas hujan dan luapan Kali Apur. https://t.co/muoKq4SH8A",3,0,1,0,2022-01-19,10,Wednesday,3,4,0
1483746350172971009,2022-01-19 10:21:11,"Anak yang lumpuh usai divaksin Covid-19 di Parepare, Muhammad Sahar, menjalani sejumlah pemeriksaan oleh dokter ahli saraf. Dari pemeriksaan diketahui Sahar menderita gangguan saraf tulang punggung. https://t.co/akzk7rZnrR",9,1,7,2,2022-01-19,10,Wednesday,3,16,3
1483744831604199426,2022-01-19 10:15:09,Perbedaan PPKM Level 1 2 3 dan 4 masih kerap dipertanyakan masyarakat. Ini penjelasan dan daftar daerah terkini. https://t.co/fsJan6R8Ne,4,0,4,0,2022-01-19,10,Wednesday,3,8,0
1483744043192434688,2022-01-19 10:12:01,Masyarakat sering mengeluhkan sudah vaksin tapi sertifikat tidak muncul. Apa sih penyebabnya dan bagaimana cara untuk mengatasinya? Berikut penjelasannya. https://t.co/doITelYiGb,12,1,3,0,2022-01-19,10,Wednesday,3,15,1
1483743460855271425,2022-01-19 10:09:42,Mahasiswa Kendari berinisial BYM ditangkap polisi usai diduga membuat replika kuburan Gubernur Sultra Ali Mazi. BYM digelandang ke Polda Sultra. https://t.co/FwvxngMUvK,3,1,1,1,2022-01-19,10,Wednesday,3,4,2
1483743459479592963,2022-01-19 10:09:42,Tim gabungan kejaksaan meringkus buronan kasus penganiayaan. Pria yang sudah buron sejak tahun 2019 itu ditangkap saat nongkrong di kafe Bandung. https://t.co/FGjP8paVSr,5,1,1,0,2022-01-19,10,Wednesday,3,6,1
1483743458040897540,2022-01-19 10:09:41,"Dinas Sumber Daya Air memperbaiki saluran air di Jalan HOS Cokroaminoto, Menteng, Jakarta Pusat. Perbaikan itu untuk mengantisipasi genangan maupun banjir. https://t.co/nDshNfcYV1",4,0,1,0,2022-01-19,10,Wednesday,3,5,0
1483742962844581888,2022-01-19 10:07:43,"Ilham Nugraha, penerima LPDP untuk S2 di AS mempunyai kisah menarik untuk disimak. Ada sejumlah lika-liku yang dilaluinya hingga sukses meraih mimpi tersebut. https://t.co/AVkWoutdG7",20,2,3,0,2022-01-19,10,Wednesday,3,23,2
1483742348974698497,2022-01-19 10:05:17,"Bupati Langkat Terbit Rencana Perangin Angin terjaring OTT KPK. Sebelum menjabat sebagai Bupati langkat, Terbit pernah menjadi Ketua DPRD Langkat. https://t.co/7Fctv3OioE",2,1,1,0,2022-01-19,10,Wednesday,3,3,1
1483741221566795776,2022-01-19 10:00:48,"Kisah nahas menimpa pria yang sukarela mendonorkan ginjal pada calon mertua. Sayangnya, hubungan ia dan pasangan berakhir kandas hingga ditinggal menikah. https://t.co/vrlGweKxVC",67,22,28,8,2022-01-19,10,Wednesday,3,95,30
1483740955157139462,2022-01-19 09:59:44,"Teroris bom Bali I, Zulkarnaen alias Arif Sunarso alias Daud, divonis 15 tahun penjara. Zulkarnaen dinyatakan bersalah melakukan tindakan teror. https://t.co/FCAkl7bVb1",4,4,1,0,2022-01-19,9,Wednesday,3,5,4
1483740953781456896,2022-01-19 09:59:44,Ada dua ribu dosis vaksin Moderna di Magelang yang akan kedaluwarsa pada 23 Januari 2022. Pihak Dinkes pun berpacu dengan waktu menghabiskan vaksin tersebut. https://t.co/ArLUgM6iNM,2,2,0,0,2022-01-19,9,Wednesday,3,2,2
1483740408521891840,2022-01-19 09:57:34,"Nia Ramadhani, Ardi Bakrie, dan sopir peribadi mereka divonis satu tahun penjara. Kini, muncul petisi mendukung mereka direhabilitasi. https://t.co/XYmwiABkAw",25,22,6,2,2022-01-19,9,Wednesday,3,31,24
1483739607976009730,2022-01-19 09:54:23,"Robert Lewandowski didaulat jadi pemain terbaik FIFA 2021. Lionel Messi, wajahnya happy banget melihat Lewandowski menerima penghargaan itu! https://t.co/m3mNXc4b51",12,0,1,0,2022-01-19,9,Wednesday,3,13,0
1483738798001381376,2022-01-19 09:51:10,"Sebelum diamankan, Ardhito Pramono sempat berdiskusi dan menyuarakan persoalan hak cipta dan royalti musik. #ArdhitoPramono  https://t.co/dmsJ6ybAZo",13,1,1,1,2022-01-19,9,Wednesday,3,14,2
1483736842323304448,2022-01-19 09:43:24,MCU kedatangan sosok baru dari Marvel Comics yakni Moon Knight. Begini awal ceritanya hingga dapat kekuatan dari dewa Mesir:  https://t.co/LaToqvLUfj,6,0,2,1,2022-01-19,9,Wednesday,3,8,1
1483734759901700099,2022-01-19 09:35:07,"dr Reisa Broto Asmoro, menyampaikan bahwa penambahan kasus Covid-19 harian per 18 Januari 2022 merupakan angka tertinggi sejak pertengahan Oktober 2021. https://t.co/MFHLX5c0S4",8,1,1,0,2022-01-19,9,Wednesday,3,9,1
1483734059293589504,2022-01-19 09:32:20,"Puan membagikan buku tulis ke anak-anak. Bukan buku tulis biasa, melainkan terdapat foto Puan Maharani bersama anak-anak di halaman depan buku itu. https://t.co/83pk6l6s75",1,1,1,1,2022-01-19,9,Wednesday,3,2,2
1483733716480446465,2022-01-19 09:30:59,"""Itu pelat-pelat nomor mobil itu, kalau gue pake tuh, gue pake pelat DPR. Itu kan pelat dasar, bukan pelat asli,"" kata Arteria. https://t.co/elYhn2s8E6",26,35,5,9,2022-01-19,9,Wednesday,3,31,44
1483733371599605767,2022-01-19 09:29:36,Jawa dan Sumatera ternyata merupakan wilayah rawan gempa tektonik. Berikut penjelasan dari Pakar Unpad! https://t.co/BnsVURxzJK,8,1,3,1,2022-01-19,9,Wednesday,3,11,2
1483733060252221442,2022-01-19 09:28:22,"Masalah besar mobil listrik adalah soal durasi pengisian baterai. Di China sudah diterapkan ganti baterai mobil listrik, cuma 2 menit. https://t.co/7AbH3ESdC9",6,1,1,0,2022-01-19,9,Wednesday,3,7,1
1483733030078451712,2022-01-19 09:28:15,Teks cerita inspiratif adalah cerita yang memuat nilai moral dalam peristiwa yang dialami oleh tokoh. Teks ini memaparkan kisah menarik dari seseorang. https://t.co/0kwnUibUZP,2,0,3,0,2022-01-19,9,Wednesday,3,5,0
1483732788125880322,2022-01-19 09:27:17,#FOTO Letusan gunung berapi di Tonga pada akhir pekan lalu menimbulkan kerusakan yang sangat parah sampai bisa dilihat oleh satelit di luar angkasa. Ini potretnya:  https://t.co/80SkYYfPOB,14,2,1,0,2022-01-19,9,Wednesday,3,15,2
1483732732165476352,2022-01-19 09:27:04,"Untuk menghindari asal pilih jurusan kuliah, siswa dapat mengetahui minat dan bakat yang dimiliki sejak di sekolah. Seperti ini caranya. https://t.co/0w2teyKyE5",2,0,0,0,2022-01-19,9,Wednesday,3,2,0
1483732020656230401,2022-01-19 09:24:14,Ingin menyaksikan langsung MotoGP Mandalika? Bisa memanfaatkan transportasi bus untuk menuju ke sana. Berikut pilihannya. https://t.co/TdEjDO87gS,3,0,0,0,2022-01-19,9,Wednesday,3,3,0
1483731990474113024,2022-01-19 09:24:07,"Dalam sidang Munarman di kasus terorisme, saksi yang dihadirkan jaksa penuntut umum memberi saran ke Munarman. Apa sarannya? https://t.co/g4eH6sHneT",1,0,0,0,2022-01-19,9,Wednesday,3,1,0
1483731662320160770,2022-01-19 09:22:49,Kerbau di Tana Toraja memiliki harga mencapai miliaran rupiah. Guru besar IPB mengungkapkan alasannya. https://t.co/9p7qtpvda0,5,0,0,1,2022-01-19,9,Wednesday,3,5,1
1483731622675558400,2022-01-19 09:22:39,Ada sebagian aset sitaan berupa kapal yang diminta majelis hakim untuk dikembalikan tapi beberapa di antaranya ternyata sudah telanjur laku dilelang. Duh! https://t.co/MRcKsLGKP9,1,0,0,0,2022-01-19,9,Wednesday,3,1,0
1483730993177677827,2022-01-19 09:20:09,Dishub memastikan bahwa tempat parkir itu ilegal. https://t.co/3mcLEVkCG8,0,0,0,0,2022-01-19,9,Wednesday,3,0,0
1483730956280373250,2022-01-19 09:20:01,"Bertemu dengan Gubernur Banten Wahidin Halim, Raffi Ahmad berniat mengelola Banten International Stadium (BIS). https://t.co/R89brUOiEH",2,0,0,0,2022-01-19,9,Wednesday,3,2,0
1483729088686837760,2022-01-19 09:12:35,Apa itu gempa bumi dan apa saja jenisnya? Cara menghadapinya juga perlu diketahui sebagai antisipasi. Simak informasi selengkapnya berikut ini. https://t.co/bZX5piEsPh,5,0,2,0,2022-01-19,9,Wednesday,3,7,0
1483728557981540358,2022-01-19 09:10:29,Sejumlah nasabah Prudential bermalam di depan kantor Prudential menuntut uang kembali. Ini bukan kali pertama kasus asuransi menghebohkan di Indonesia.  https://t.co/tUOK6YNQJf,9,0,3,2,2022-01-19,9,Wednesday,3,12,2
1483727811743555590,2022-01-19 09:07:31,"Sebuah rumah di Bronx, New York, Amerika Serikat (AS) meledak dan terbakar. Polisi sempat mengevakuasi seorang wanita di sebelah rumah yang terbakar tersebut.  https://t.co/hbR6FjwaAD",3,0,0,0,2022-01-19,9,Wednesday,3,3,0
1483727787789885448,2022-01-19 09:07:25,"Dalam kombinasi vaksin COVID-19 booster Kemenkes RI, belum ada jenis vaksin yang bisa diberikan bagi penerima vaksin primer Sinopharm. Inikah sebabnya? https://t.co/FJdU72A7I3",1,0,0,1,2022-01-19,9,Wednesday,3,1,1
1483727760266870784,2022-01-19 09:07:19,Gempa bumi Banten 2022 yang terjadi pada Jumat (14/1/2022) lalu menyebabkan banyak rumah warga rusak. Berikut kabar terbarunya. https://t.co/I4TTGQnVmQ,7,0,0,0,2022-01-19,9,Wednesday,3,7,0
1483727759071399948,2022-01-19 09:07:18,"Kawasan Jalan Kamal Raya, Tegal Alur, Cengkareng Barat masih banjir. Arus lalu lintas di lokasi macet hingga 2 kilometer. https://t.co/bvH0OPvf2S",4,0,2,3,2022-01-19,9,Wednesday,3,6,3
1483727594050699264,2022-01-19 09:06:39,"Unik! Dalam pertandingan Liga 3 Jawa Barat yang mempertemukan Persikabbar vs Bandung Barat United, wasit mendapat bantuan VAR. https://t.co/HnWO4J0Hju",11,0,4,1,2022-01-19,9,Wednesday,3,15,1
1483726654845317120,2022-01-19 09:02:55,"Gempa bumi magnitudo (M) 4,3 mengguncang Halmahera Utara, Maluku Utara. Pusat gempa di darat. https://t.co/3Bwku70D6x",11,0,1,1,2022-01-19,9,Wednesday,3,12,1
1483726614718566406,2022-01-19 09:02:45,"Kondisi kesehatan Dorce Gamalama kian membaik. Ia pun langsung berangkat ke Jawa Timur, untuk ziarah ke makam Gus Miek. #DorceGamalama  https://t.co/cBmcBvn2qv",10,0,0,0,2022-01-19,9,Wednesday,3,10,0
1483725981420511237,2022-01-19 09:00:14,"Hakim Ziyech menjadi sorotan setelah mencetak gol untuk Chelsea. Tetapi, mendapat kritikan karena tak melakukan selebrasi. https://t.co/IMw5J49as9",2,0,0,0,2022-01-19,9,Wednesday,3,2,0
1483725511289360384,2022-01-19 08:58:22,"Juventus berhasil meraih kemenangan beruntun. Menurut Danilo, Juventus ada di jalur yang tepat! https://t.co/tyytm0BD6h",2,0,1,0,2022-01-19,8,Wednesday,3,3,0
1483725477596610565,2022-01-19 08:58:14,"Gaga Muhammad divonis 4 tahun 6 bulan oleh hakim PN Jakarta Timur. Menurut hakim, hukuman tersebut dijatuhkan karena Gaga tak merasa bersalah selama persidangan. Berikut deretan pengakuan Gaga yang berujung kesakitan. https://t.co/cGsfjG0hen",5,5,2,2,2022-01-19,8,Wednesday,3,7,7
1483725158355513346,2022-01-19 08:56:58,Ada yang menarik perhatian di parkiran gedung DPR hari ini. Ada 5 mobil yang menggunakan pelat berlogo Polri bernomor sama. Punya siapa? https://t.co/haWHxkjEO1,224,78,86,25,2022-01-19,8,Wednesday,3,310,103
1483725135471382534,2022-01-19 08:56:53,Terdapat beberapa hal memberatkan Gaga yaitu tidak menunjukkan rasa bersalah dan tidak beriktikad baik membantu proses penyembuhan Laura. https://t.co/HKKSDGsByG,1,0,0,0,2022-01-19,8,Wednesday,3,1,0
1483724836589477893,2022-01-19 08:55:41,Mau Kuliah di Australia? Cek Beasiswa S1 &amp; S2 Ini https://t.co/2LjruKexmA,1,0,2,0,2022-01-19,8,Wednesday,3,3,0
1483724798295425024,2022-01-19 08:55:32,Sekjen Kemensos disebut berbicara yang tidak-tidak dan menuduh pimpinan Komisi VIII sinis. https://t.co/EYurmBbWFm,1,0,1,0,2022-01-19,8,Wednesday,3,2,0
1483724617399390209,2022-01-19 08:54:49,"Menurut data, Toyota Avanza dan Mitsubishi Xpander saling berebut hati masyarakat Indonesia dan menunjukkan persaingan yang cukup ketat. https://t.co/Dl80zeFmVp",6,0,1,0,2022-01-19,8,Wednesday,3,7,0
1483724582578184197,2022-01-19 08:54:41,"Akibat dari kecelakaan ini, RY mengalami luka dan dilarikan ke Rumah Sakit Sumber Waras. https://t.co/swW3hOP8RK",3,0,0,1,2022-01-19,8,Wednesday,3,3,1
1483724243468800001,2022-01-19 08:53:20,"""Jangan jadi kebiasaan promo gratis! Pak Anies juga kan ngurus JIS juga buat kepentingan rakyat, lah sono udah urus apa?"" https://t.co/GBoKeP4KWh",46,41,6,6,2022-01-19,8,Wednesday,3,52,47
1483723963775733761,2022-01-19 08:52:13,Anies Baswedan mengatakan sebagian titik banjir di Jakarta merupakan imbas curah hujan ekstrim. Bagaimana pantauan data BMKG? https://t.co/iM51KGmnP9,1,1,1,0,2022-01-19,8,Wednesday,3,2,1
1483723924236115969,2022-01-19 08:52:04,Puan Maharani mendorong agar Pemilu 2024 dijadwalkan sebelum bulan Ramadhan. Hal itu agar tidak menguras banyak energi. https://t.co/G7fXGaigdn,16,37,2,9,2022-01-19,8,Wednesday,3,18,46
1483723812432756736,2022-01-19 08:51:37,"Ayu Thalia telah ditetapkan sebagai tersangka atas laporan yang dilayangkan oleh Nicholas Sean Purnama. Lalu, bagaimana respons anak Ahok? https://t.co/HftAXjnzi0",2,0,1,0,2022-01-19,8,Wednesday,3,3,0
1483723764294692864,2022-01-19 08:51:26,Beberapa makanan memiliki ukuran yang tak biasa. Bahkan ada tujuh makanan yang tercatat dalam buku rekor dunia sebagai makanan terpanjang!  https://t.co/35Use8qD0z,3,0,2,0,2022-01-19,8,Wednesday,3,5,0
1483722657187119104,2022-01-19 08:47:02,"Banjir masih terjadi di sejumlah wilayah Jakarta Barat. Salah satunya di Jalan Kencana Timur, Cengkareng, Jakarta Barat. https://t.co/k14H2GCWff",5,1,1,0,2022-01-19,8,Wednesday,3,6,1
1483722454904229890,2022-01-19 08:46:14,"Pasangan selebriti Darius-Donna buat heboh publik soal isu rumah tangga. Tak sedikit netizen yang ikut kesal dengan prank tersebut, begini saran psikolog: https://t.co/TN2vNCK1Kf",4,0,1,1,2022-01-19,8,Wednesday,3,5,1
1483722407286390784,2022-01-19 08:46:02,"Kakak Laura Anna, Greta Irene, bongkar percakapan matre Gaga Muhammad ke media sosial. Greta mengaku ingin menujukkan betapa kejamnya Gaga terhadap mendiang Laura. https://t.co/bG4pp8WvYz",8,3,2,0,2022-01-19,8,Wednesday,3,10,3
1483722329100369921,2022-01-19 08:45:44,"Kedai makan di Bandung ini sukses mencuri perhatian karena didesain serba Hello Kitty. Mulai dari gerobak, peralatan makan hingga penampilan pemilik kedainya!  https://t.co/T8Jy2ohc3c",1,1,1,0,2022-01-19,8,Wednesday,3,2,1
1483721776592945153,2022-01-19 08:43:32,"Gaga Muhammad divonis 4,5 tahun penjara atas kasus kecelakaan Laura Anna. Gaga pun akan mengajukan banding dalam waktu 7 hari ke depan. https://t.co/j5gIgU6MRd",4,0,1,0,2022-01-19,8,Wednesday,3,5,0
1483721759119618051,2022-01-19 08:43:28,Harga minyak goreng hari ini telah dipatok satu harga menjadi Rp 14.000 per liter!  https://t.co/bY8Jx3b05e,102,21,26,14,2022-01-19,8,Wednesday,3,128,35
1483721530236448770,2022-01-19 08:42:33,"Diketahui, peristiwa dalam video viral itu diketahui terjadi pada 13 Januari 2022. Pembongkaran dilakukan warga menggunakan kayu, besi, hingga sekop. https://t.co/jJrZyDbQEm",109,144,24,46,2022-01-19,8,Wednesday,3,133,190
1483721509151645698,2022-01-19 08:42:28,Koordinator Korban Asuransi Maria Trihartanti mengungkapkan nasabah Prudential yang menjadi korban ini mengalami kerugian hingga miliaran.  https://t.co/5MgxsqpBOO,5,0,2,1,2022-01-19,8,Wednesday,3,7,1
1483721291098206211,2022-01-19 08:41:36,Berkas perkara kasus video syur Gisel hingga saat ini belum dinyatakan lengkap alias P-19. Kasus ini padahal telah berjalan sejak November 2020. https://t.co/kYVG7FsNfz,1,2,1,0,2022-01-19,8,Wednesday,3,2,2
1483721255652052995,2022-01-19 08:41:28,Wow! Ibu Kota Nusantara Bakal Tersambung Tol Bawah Laut  https://t.co/W8TuRWjQV5,73,68,10,6,2022-01-19,8,Wednesday,3,83,74
1483720898687512578,2022-01-19 08:40:03,Masyarakat diimbau untuk tidak memberikan laporan palsu kepada instansi pelayanan masyarakat. https://t.co/qL4iyKb1f6,4,2,5,1,2022-01-19,8,Wednesday,3,9,3
1483720885660004353,2022-01-19 08:39:59,RUU IKN resmi disahkan menjadi UU. RUU ini disahkan dalam rentang waktu beberapa bulan saja. https://t.co/Ha7vedOBUG,2,0,1,0,2022-01-19,8,Wednesday,3,3,0
1483720383664640000,2022-01-19 08:38:00,"Kondisi kesehatan Dorce Gamalama kian membaik. Ia langsung berangkat ke Jawa Timur, untuk ziarah ke makam Gus Miek. #DorceGamalama  https://t.co/sBk7RhxCtf",4,0,1,0,2022-01-19,8,Wednesday,3,5,0
1483720073516883971,2022-01-19 08:36:46,Erick Thohir mengingatkan bahwa PT PLN (Persero) tidak bisa terus-terusan menambah utang karena saat ini utangnya sudah mencapai Rp 500 triliun.  https://t.co/IjQqgF2aFQ,139,93,54,19,2022-01-19,8,Wednesday,3,193,112
1483720072216686592,2022-01-19 08:36:46,"PT PLN (Persero) buka-bukaan soal rencana pembubaran anak usahanya, PT PLN Batubara.  https://t.co/ac67maJoac",3,0,2,0,2022-01-19,8,Wednesday,3,5,0
1483719846982520833,2022-01-19 08:35:52,Truk pengangkut bahan galian C dari Gunung Merapi dilarang beroperasi besok. Ini terkait dengan kunjungan Ketua DPR RI Puan Maharani ke lereng Gunung Merapi. https://t.co/oLUzEjffqa,5,5,4,1,2022-01-19,8,Wednesday,3,9,6
1483719831207698436,2022-01-19 08:35:48,Nasabah Prudential yang tergabung dalam Komunitas Korban Asuransi sudah beberapa hari terakhir menginap di pekarangan kantor asuransi tersebut.  https://t.co/fKtme5Gb2l,10,0,6,3,2022-01-19,8,Wednesday,3,16,3
1483719576626077699,2022-01-19 08:34:47,"Belakangan ahli sejarah menjelaskan Nusantara merupakan nama asli Kutai di Kaltim, bukan Jawa. Jadi, nama Nusantara itu berasal dari Jawa atau Kalimantan? https://t.co/J4frkWPMKS",12,7,9,0,2022-01-19,8,Wednesday,3,21,7
1483719559832027136,2022-01-19 08:34:43,"""Jadi saya ingatkan Ibu (Sri Mulyani) jangan sampai kita terjerumus pada pelanggaran peraturan perundang-undangan yang sudah kita buat,"" kata Marwan.  https://t.co/6Wdm5TxQ7M",1,1,1,1,2022-01-19,8,Wednesday,3,2,2
1483719324460326913,2022-01-19 08:33:47,Pembangunan ibu kota negara (IKN) Nusantara di Kalimantan Timur akan segera dimulai. Apa infrastruktur pertama yang dibangun?  https://t.co/zVXU7rMCO9,8,0,1,1,2022-01-19,8,Wednesday,3,9,1
1483719073527644164,2022-01-19 08:32:47,"Lama tak terdengar kabarnya, ternyata presenter Harry Pantja tengah menjalani terapi berjalan. Ia sempat mengalami stroke, bukan cuma sekali tapi 3 kali. https://t.co/4pYhTbiRXZ",3,0,2,1,2022-01-19,8,Wednesday,3,5,1
1483718826713923586,2022-01-19 08:31:49,Ketua Komisi XI DPR RI Dito Ganinduto meminta 'orang terkaya' RI duduk di barisan depan saat rapat bersama Menteri Keuangan Sri Mulyani Indrawati.  https://t.co/Yfj6NrHI60,12,1,5,1,2022-01-19,8,Wednesday,3,17,2
1483718230908841985,2022-01-19 08:29:27,"Ibu Gaga Muhammad ngaku santai mendengar sang anak divonis 4,5 tahun penjara. Akan tetapi, dia juga lantang menyinggung Laura Anna. https://t.co/UBVFTTGHvh",13,2,2,2,2022-01-19,8,Wednesday,3,15,4
1483717737482436611,2022-01-19 08:27:29,Sekretaris DItjen GTK mengumumkan kabar terbaru terkait jadwal PPPK Guru tahap III. Berikut informasinya. https://t.co/5Ahz2sSp4Y,2,0,1,0,2022-01-19,8,Wednesday,3,3,0
1483717404962455553,2022-01-19 08:26:10,"Melayani dengan proteksi di tengah pandemi, Gojek tetap menjadi pilihan utama masyarakat dalam mendukung mobilitas sehari-hari
https://t.co/M6VuL2TyuV",4,1,1,1,2022-01-19,8,Wednesday,3,5,2
1483716951209873408,2022-01-19 08:24:21,Seleksi Masuk PTKIN dibuka mulai Februari 2022. Berikut selengkapnya. https://t.co/G06CHwh1vH,0,0,2,0,2022-01-19,8,Wednesday,3,2,0
1483716441379684354,2022-01-19 08:22:20,"""Menghormati dalam arti, apabila dirasa tidak puas dengan substansi dari putusan tersebut, maka jalur yang tersedia adalah upaya hukum,"" kata jubir KY Miko Ginting. https://t.co/X0y65Kh2ck",1,1,1,0,2022-01-19,8,Wednesday,3,2,1
1483716094061953026,2022-01-19 08:20:57,Beberapa orang mengeluh menjadi positif COVID-19 saat masa karantina akan selesai dan menduga tertular di tempat karantina. Begini jawaban Satgas: https://t.co/0yJWrnfH29,11,2,5,6,2022-01-19,8,Wednesday,3,16,8
1483715378513690626,2022-01-19 08:18:06,Ayu terjerat kasus ini usai sebelumnya melaporkan Sean atas dugaan penganiayaan. Begini perjalanan drama perseteruan keduanya. https://t.co/W76hDU90dE,64,14,11,7,2022-01-19,8,Wednesday,3,75,21
1483715207503433728,2022-01-19 08:17:26,Tajir! Paris Saint-Germain (PSG) mengeluarkan kocek Rp 95 miliar per pekan untuk membayar gaji seluruh pemainnya! https://t.co/ZRQHf7Nvii,4,2,0,0,2022-01-19,8,Wednesday,3,4,2
1483714825461149702,2022-01-19 08:15:55,Nama Luna Maya tengah heboh jadi perbincangan publik usai dirinya mengaku membekukan sel telur. Ternyata banyak artis top lain yang melakukan hal serupa. https://t.co/IgQXo0yV29,4,0,1,0,2022-01-19,8,Wednesday,3,5,0
1483714385612783619,2022-01-19 08:14:10,Suzuki New U-Enjoy 125 versi 2022 menawarkan keunggulan yang cukup mencengangkan dalam hal efisiensi bahan bakar. https://t.co/gAP1vkw2VP,7,0,3,3,2022-01-19,8,Wednesday,3,10,3
1483713690809638917,2022-01-19 08:11:24,Singgasana raja ponsel dunia yang sebelumnya diduduki Samsung kini berhasil direbut oleh Apple. Kesuksesan iPhone 13 jadi pemicu keberhasilan tersebut. https://t.co/gbGSx8qt3a,20,1,5,2,2022-01-19,8,Wednesday,3,25,3
1483713642554171397,2022-01-19 08:11:13,Video sejumlah rantis berkelir loreng dan speedboat berbaris di sekitar Monas viral di medsos. Ada apa? https://t.co/G1YyJSsCY4,6,0,2,0,2022-01-19,8,Wednesday,3,8,0
1483712965949931524,2022-01-19 08:08:31,"Polisi menyebut video 61 detik adalah hasil editing. Kini, nama Miss Kay kemudian heboh disebutkan sebagai sosok di video 61 detik itu. https://t.co/fkhwcPy5u3",7,1,2,0,2022-01-19,8,Wednesday,3,9,1
1483712301253468161,2022-01-19 08:05:53,"Berikut adalah daftar harga mobil listrik di Indonesia Januari 2022, termurah dibanderol mulai Rp 479 juta. Ada yang minat? https://t.co/ckWokGnAqZ",11,0,4,2,2022-01-19,8,Wednesday,3,15,2
1483712261705416709,2022-01-19 08:05:43,"Anggota holding BUMN asuransi dan penjaminan, PT Jamkrindo menjamin kredit usaha rakyat (KUR) Rp 130,3 triliun, naik dari tahun sebelumnya Rp 90,4 triliun.  https://t.co/5BSOMF2Nvf",5,0,1,0,2022-01-19,8,Wednesday,3,6,0
1483711579153707008,2022-01-19 08:03:01,Siapa Heru Hidayat? Namanya kembali menjadi sorotan setelah lolos dari tuntutan hukuman mati di kasus korupsi ASABRI. https://t.co/jenetD7fq3,10,1,1,0,2022-01-19,8,Wednesday,3,11,1
1483710882601439233,2022-01-19 08:00:15,We Don't Talk About Bruno kini jadi lagu Disney dengan peringkat tertinggi di chart Billboard. Maaf-maaf nih Let It Go...  https://t.co/sYR13LEzFL,18,1,5,3,2022-01-19,8,Wednesday,3,23,4
1483710253787144194,2022-01-19 07:57:45,Viral di media sosial aksi kocak dua pemuda di Gorontalo mendadak terjun menggarap sawah warga gara-gara takut ditilang. Bisa aja! https://t.co/ltvFmd192I,2,0,0,0,2022-01-19,7,Wednesday,3,2,0
1483709897879531520,2022-01-19 07:56:20,"KPK melakukan operasi tangkap tangan (OTT) di Kabupaten Langkat, Sumatera Utara (Sumut). Sejumlah pihak diamankan dalam operasi tersebut. https://t.co/hTdMFbqr3C",2,3,2,1,2022-01-19,7,Wednesday,3,4,4
1483709237259915268,2022-01-19 07:53:42,Munarman mengaku tidak pernah berbaiat ke pimpinan ISIS Abu Bakr al-Baghdadi. https://t.co/S1Np9HSPtC,11,3,2,1,2022-01-19,7,Wednesday,3,13,4
1483709207748780038,2022-01-19 07:53:35,Jadon Sancho belum juga bersinar sejak gabung Man United. Ralf Rangnick menilai Sancho kesulitan menghadapi ekspektasi yang lebih besar. https://t.co/DrXgQyYI4U,5,1,1,0,2022-01-19,7,Wednesday,3,6,1
1483708521774518275,2022-01-19 07:50:52,Heru Hidayat divonis nihil dalam skandal korupsi ASABRI. Namun sebenarnya vonis nihil pernah terjadi di Indonesia loh. https://t.co/VDSmRt9UNu,2,0,1,0,2022-01-19,7,Wednesday,3,3,0
1483708272850919475,2022-01-19 07:49:52,"Baliho bertuliskan 'ARTERIA DAHLAN MUSUH ORANG SUNDA' mejeng di Kota Bandung, tepatnya di pertigaan Jalan Diponegoro di dekat Gedung Sate. https://t.co/iZ6v12xf6M",42,7,8,5,2022-01-19,7,Wednesday,3,50,12
1483708003790503936,2022-01-19 07:48:48,Haruna Soemitro menerima pernyataan soal Shin Tae-yong menjadi polemik. Tapi ia meminta untuk jangan menyerang kehidupan pribadinya. https://t.co/R10Kv9QSpo,13,55,5,9,2022-01-19,7,Wednesday,3,18,64
1483707963231592449,2022-01-19 07:48:39,"Kalau disapa orang pakai bahasa Inggris, cara responnya kayak gini nih! https://t.co/OgprgPFvb7 https://t.co/ZkaoUokY2Z",7,1,2,0,2022-01-19,7,Wednesday,3,9,1
1483707293413920771,2022-01-19 07:45:59,Pertanyaan menggelitik terlontar dalam rapat Komisi II DPR dengan panitia seleksi calon anggota KPU-Bawaslu. Anggota DPR bertanya apa gunanya rapat hari ini. https://t.co/JRPlET6Tk8,5,0,2,1,2022-01-19,7,Wednesday,3,7,1
1483706637307236353,2022-01-19 07:43:22,"Inti Bumi, bagian dalam Bumi yang sangat panas, perlahan mendingin. Tapi seberapa cepat tepatnya inti Bumi mendingin, masih belum diketahui.  https://t.co/3wilQHiFxN",10,1,8,1,2022-01-19,7,Wednesday,3,18,2
1483706096153935877,2022-01-19 07:41:13,Menonton film di bioskop jadi salah satu kegiatan rekreasi yang umumnya kerap dilakukan masyarakat yang tinggal di perkotaan. Ada promo tiket bioskop nih...  https://t.co/9LE2Ngwub2,7,1,2,0,2022-01-19,7,Wednesday,3,9,1
1483705842771927044,2022-01-19 07:40:13,Komisi II DPR RI menggelar RDPU dengan panitia seleksi calon anggota KPU dan Bawaslu. Anggota DPR mengungkapkan isu timsel ditekan. https://t.co/nKVs8P3H8J,1,0,2,0,2022-01-19,7,Wednesday,3,3,0
1483705581059911682,2022-01-19 07:39:11,"Komponen alat pemantau aktivitas Gunung Api Sumbing, Temanggung, Jawa Tengah, sempat dicuri. Namun setelah mendapat perhatian dari Gubernur Jawa Tengah, Ganjar Pranowo, alat tersebut ternyata sudah dikembalikan ke tempatnya. https://t.co/IALXoDxx4G",7,0,2,0,2022-01-19,7,Wednesday,3,9,0
1483705297097183232,2022-01-19 07:38:03,Banyak orang tua melarang anak-anak main game karena takut jadi malas belajar. Peneliti justru menemukan main video game bisa bikin anak lebih pintar membaca. https://t.co/jSu8HdsJcK,17,12,8,3,2022-01-19,7,Wednesday,3,25,15
1483705042217713672,2022-01-19 07:37:02,"Real Madrid berencana melepas Eden Hazard pada Januari ini, karena Hazard tidak lagi jadi bagian dari rencana Carlo Ancelotti. https://t.co/0GsbaGax36",6,3,0,1,2022-01-19,7,Wednesday,3,6,4
1483704548480987141,2022-01-19 07:35:04,"Sekjen Kemensos, Harry Hikmat diminta keluar ruangan saat mengadakan rapat kerja dengan Komisi VIII DPR RI, Rabu (19/1). Harry sebelumnya menganggap sikap kritis Wakil Ketua Komisi VIII, Ace Hasan Syadzily sebagai tindakan sinis ke Kemensos. https://t.co/zuv2ljjrNV",5,1,1,0,2022-01-19,7,Wednesday,3,6,1
1483704076831449094,2022-01-19 07:33:12,"Ibu Semiati, warga asal Depok, Jawa Barat, dilaporkan sudah 4 hari hilang dan belum ada kabar. Yuk bantu cari! #detiktif https://t.co/oTCRfmNKdx",23,1,17,2,2022-01-19,7,Wednesday,3,40,3
1483703447002267652,2022-01-19 07:30:42,Mensos Risma minta maaf ke Komisi VIII DPR atas komunikasi Sekjen Kemensos Harry Hikmat. Bahkan Risma siap jika harus duduk di bawah untuk meminta maaf. https://t.co/APluAcRu2y,8,9,2,3,2022-01-19,7,Wednesday,3,10,12
1483702935443935232,2022-01-19 07:28:40,"Gaga Muhammad divonis 4,5 tahun penjara. Pihak keluarga Laura Anna pun angkat bicara terkait keputusan tersebut. Berikut respons kakak Laura, Greta Irene, saat ditanya terkait vonis Gaga. https://t.co/C1lyobXnPB",1,0,1,0,2022-01-19,7,Wednesday,3,2,0
1483702180058214406,2022-01-19 07:25:40,Anies Baswedan mengatakan sebagian titik banjir di Jakarta sudah surut. Anies menyebut jajarannya bekerja senyap hingga tuntas. https://t.co/fUH0aT6902,391,154,32,19,2022-01-19,7,Wednesday,3,423,173
1483701483094695938,2022-01-19 07:22:54,"Rafael Nadal menghentikan perlawanan wakil Jerman untuk lolos ke babak ketiga Australian Open 2022. Sementara itu, Ashleigh Barty cuma kehilangan dua gim. https://t.co/JaJr4pjnoY",6,1,0,0,2022-01-19,7,Wednesday,3,6,1
1483701197370441742,2022-01-19 07:21:45,Kamu bisa download video di TikTok tanpa watermark untuk disimpan jadi koleksi di HP. Begini caranya:  https://t.co/hBbJ4JvIJo,15,0,2,1,2022-01-19,7,Wednesday,3,17,1
1483701165317627909,2022-01-19 07:21:38,"Tempat pemakaman umum (TPU) Kober yang berlokasi di Pendongkelan, Cengkareng Timur, Jakarta Barat (Jakbar), tergenang banjir. Camat Cengkareng, Ahmad Faqih, meminta pompa penyedot air disediakan. https://t.co/a8B8BphiyY",0,2,1,0,2022-01-19,7,Wednesday,3,1,2
1483700519696801802,2022-01-19 07:19:04,"Ridley Scott hadir lagi dengan kemampuan berceritanya yang dahsyat. Dengan ending yang apik, The Last Duel adalah sebuah tayangan klasik yang wajib Anda tonton. Ini reviewnya:  https://t.co/7L0hD4cHZE",9,1,1,0,2022-01-19,7,Wednesday,3,10,1
1483699643515035648,2022-01-19 07:15:35,"Dari 840 kasus Omicron di Indonesia, tercatat 174 transmisi lokal. Kasus lokal tersebar di empat wilayah yakni DKI Jakarta, Jawa Barat, Banten dan Jawa Timur. https://t.co/BZlQLkQpyn",6,2,7,0,2022-01-19,7,Wednesday,3,13,2
1483699317315624962,2022-01-19 07:14:17,Pakar setuju WFH kembali disarankan di tengah melonjaknya Omicron. PTM atau sekolah tatap muka juga diusulkan disetop sementara hingga akhir Maret 2022. https://t.co/O0iuT56xUu,451,156,142,119,2022-01-19,7,Wednesday,3,593,275
1483698691328335875,2022-01-19 07:11:48,"Ralf Rangnick sebut tiga beknya tidak cukup bagus, yakni Maguire, Shaw, dan Wan-Bissaka! https://t.co/KbS6nhUePX",4,1,0,6,2022-01-19,7,Wednesday,3,4,7
1483697667599482880,2022-01-19 07:07:44,Hati-hati dalam necari calon suami yang akan jadi imam untuk keluarga. Jangan sampai terjebak dengan pria toxic. Ini kata ustaz:  https://t.co/ULOG4bxqrN,6,0,2,2,2022-01-19,7,Wednesday,3,8,2
1483697625388011521,2022-01-19 07:07:34,"Presenter Dunia Lain, Harry Pantja, mengalami stroke. Awalnya Harry mengalami hipertensi yang berujung pendarahan pada otak. https://t.co/TSjyL6p5NQ",6,0,1,1,2022-01-19,7,Wednesday,3,7,1
1483696816612945920,2022-01-19 07:04:21,Pernyataan kontroversi Arteria Dahlan yang minta Kajati dicopot gegara berbicara bahasa Sunda berbuntut panjang. Siapa sosok Kajati yang dimaksud ? https://t.co/4pttviSt1R,2,2,1,0,2022-01-19,7,Wednesday,3,3,2
1483696066335809539,2022-01-19 07:01:22,Terbit diketahui memiliki harta kekayaan Rp 85 miliar. https://t.co/ttsODKuRfe,3,2,2,0,2022-01-19,7,Wednesday,3,5,2
1483696013168693249,2022-01-19 07:01:09,"""Jika APBN tidak mampu kemudian investor tidak tertarik dengan pembiayaan IKN, maka proyek ini akan mangkrak dan menjadi museum pembangunan terbengkalai paling besar di Indonesia,"" ungkap Peneliti Indef Nailul Huda. #CNNIndonesia #detiknetwork  https://t.co/vcdk40mC0s",46,20,21,4,2022-01-19,7,Wednesday,3,67,24
1483695553364082690,2022-01-19 06:59:20,"Lama tak terlihat di layar kaca, deretan aktor ini akan comeback akting di 2022:  https://t.co/dBpGzDgv0n",8,1,4,2,2022-01-19,6,Wednesday,3,12,3
1483694698837512196,2022-01-19 06:55:56,Bintang mandarin Michelle Reis sempat kritis hingga dilarikan ke rumah sakit. Kini ia sudah pulih dan kembali ke rumah.  https://t.co/DD26ubv9HT,3,0,2,0,2022-01-19,6,Wednesday,3,5,0
1483694609368694787,2022-01-19 06:55:35,Sejumlah pengungsi Afghanistan yang hendak long march ke kantor Amnesty Internasional Indonesia terlibat kericuhan dengan polisi. https://t.co/Cx70pV7nqT,2,1,3,0,2022-01-19,6,Wednesday,3,5,1
1483694386236035073,2022-01-19 06:54:42,Hyundai gencar memasarkan mobil listrik di Indonesia. Akan seberapa lariskah penjualan mobil listrik Hyundai di Indonesia? https://t.co/k57BiAhqGE,5,1,3,0,2022-01-19,6,Wednesday,3,8,1
1483693876116398080,2022-01-19 06:52:40,Berikut rumus luas lingkaran beserta contoh soal dan pembahasan! https://t.co/4nxuAxRxNI,5,1,1,0,2022-01-19,6,Wednesday,3,6,1
1483693837222649856,2022-01-19 06:52:31,"Di 2019 Facebook memutuskan untuk mencoba masuk ke dalam pasar kencan online dengan merilis Sparked, sayang karena kurang peminat layanan ini dimatikan. https://t.co/1dxo4zK0O0",4,0,2,0,2022-01-19,6,Wednesday,3,6,0
1483692819994796032,2022-01-19 06:48:28,Perumusan UU IKN disebut sudah melalui proses diskusi yang matang dan komprehensif. https://t.co/CS9PzPF7uP,7,4,2,0,2022-01-19,6,Wednesday,3,9,4
1483692065661890560,2022-01-19 06:45:28,"Setelah True Beauty, Hwang In Yeop akan menampilkan peran yang lebih dewasa. Ini sinopsis drama Korea Why Oh Soo Jae:  https://t.co/yLj5waRa9N",10,0,1,2,2022-01-19,6,Wednesday,3,11,2
1483691515759276032,2022-01-19 06:43:17,Keberadaan iPhone SE dan iPad Air generasi terbaru sepertinya sudah terkonfirmasi. Keduanya baru saja muncul di database EEC di Rusia. https://t.co/P5MXngQ8Ey,7,0,3,0,2022-01-19,6,Wednesday,3,10,0
1483690670594441217,2022-01-19 06:39:56,"Aktor Nicholas Tse mulai terjun di pasar saham. Sebelumnya ia didapuk jadi brand ambassador XTEP, tapi kini ia jadi pemegang sahamnya. #NicholasTse  https://t.co/LhuXpPYI1v",2,0,3,0,2022-01-19,6,Wednesday,3,5,0
1483689818869714944,2022-01-19 06:36:33,Kenang Mirdad dan Tyna Kanna resmi bercerai. Hak asuh anak jatuh pada Tyna Kanna. #KenangMirdad #TynaKanna  https://t.co/rWDrliz799,2,0,2,2,2022-01-19,6,Wednesday,3,4,2
1483689612648321024,2022-01-19 06:35:43,"Dream High dibintangi sejumlah bintang kenamaan. Setelah 10 tahun, inilah kabar terbaru pemainnya:  https://t.co/GESYMs3sQk",6,0,4,0,2022-01-19,6,Wednesday,3,10,0
1483688985260171266,2022-01-19 06:33:14,Chelsea kini harus berjuang mengamankan tempat di empat besar Liga Inggris. Ada apa dengan The Blues? https://t.co/NjuRY5B99i,5,0,0,1,2022-01-19,6,Wednesday,3,5,1
1483687302564098049,2022-01-19 06:26:33,"SNMPTN dan SNMPN merupakan seleksi untuk masuk kuliah, keduanya terlihat sama namun ternyata berbeda. Simak penjelasan berikut ya! https://t.co/1ejx9aeUR1",11,0,3,0,2022-01-19,6,Wednesday,3,14,0
1483686594913751042,2022-01-19 06:23:44,Steven Gerrard disebut bakal menggaet Luis Suarez ke Aston Villa. Simak momen nostalgia mereka. https://t.co/UcO1Puyk4M,10,0,0,0,2022-01-19,6,Wednesday,3,10,0
1483685555355504640,2022-01-19 06:19:36,Ayu Thalia ditetapkan sebagai tersangka sejak pekan lalu. https://t.co/D1FSt7tm81,11,0,3,0,2022-01-19,6,Wednesday,3,14,0
1483684924200730628,2022-01-19 06:17:06,"Formula E Jakarta akan berlangsung dalam waktu kurang dari lima bulan lagi, sampai mana persiapannya? https://t.co/e0j7rJJFFU",11,4,5,1,2022-01-19,6,Wednesday,3,16,5
1483684422322987010,2022-01-19 06:15:06,"Chelsea kembali meraih hasil imbang di Liga Inggris, posisinya di 4 besar pun kini mulai terancam. https://t.co/X84NeJYpAa",7,1,0,0,2022-01-19,6,Wednesday,3,7,1
1483683670544334852,2022-01-19 06:12:07,Dokter Tirta pernah diminta pengacara Jerinx untuk jadi saksi di sidang kliennya. Namun permintaan tersebut langsung ditolak oleh dokter Tirta. Bagaimana respons pihak Jerinx? https://t.co/Q1uviUPxRa,5,0,2,0,2022-01-19,6,Wednesday,3,7,0
1483683517133434883,2022-01-19 06:11:30,Pemindahan Pegawai Negeri Sipil (PNS) ke ibu kota baru di Kalimantan Timur akan dimulai pada tahap pertama periode 2022-2024.  https://t.co/UPZEEPCcph,12,9,3,1,2022-01-19,6,Wednesday,3,15,10
1483683515933859840,2022-01-19 06:11:30,"Steven Gerrard kabarnya kembali membidik seorang eks-rekan satu timnya untuk direkrut, yaitu Luis Suarez. https://t.co/4IlClINu5B",3,2,0,0,2022-01-19,6,Wednesday,3,3,2
1483682539881570305,2022-01-19 06:07:37,Seorang pejabat Pemkab Pandeglang mendapatkan sanksi dengan dibebastugaskan dari jabatannya imbas hadiah Rp 95 ribu pada ajang Bupati Cup. https://t.co/5qi1GvZYu8,14,1,6,1,2022-01-19,6,Wednesday,3,20,2
1483682286533025796,2022-01-19 06:06:37,Berikut alasan Robert Lewandowski kenapa memilih Jorginho untuk bisa meraih penghargaan Pemain Terbaik FIFA 2021. https://t.co/MdKKYV5nsI,5,0,0,0,2022-01-19,6,Wednesday,3,5,0
1483681559899213836,2022-01-19 06:03:44,"Koalisi militer pimpinan Arab Saudi melancarkan serangan udara menargetkan kelompok pemberontak Houthi di Sanaa, Yaman, pada Selasa (18/1). Sedikitnya 14 orang dilaporkan tewas. https://t.co/ujb0FG72uY",7,2,3,0,2022-01-19,6,Wednesday,3,10,2
1483680993450119168,2022-01-19 06:01:28,Persija Jakarta memecat Angelo Alessio. Italiano itu dinilai belum mampu meningkatkan performa Macan Kemayoran. https://t.co/5xTJi9b9Iv,12,4,6,0,2022-01-19,6,Wednesday,3,18,4
1483680509976850432,2022-01-19 05:59:33,"Gaga Muhammad divonis 4,5 tahun penjara terkait kasus kecelakaan yang menyebabkan Laura Anna lumpuh. Hal itu juga menimbang dari Gaga yang tak menunjukkan rasa bersalahnya dan justru menyalahkan korban. https://t.co/lgPM2EqOnA",4,0,2,1,2022-01-19,5,Wednesday,3,6,1
1483680011978747904,2022-01-19 05:57:34,Lolosnya Heru Hidayat dari hukuman mati dalam skandal ASABRI tengah menjadi sorotan. Namun ada hal lain yang sepatutnya menjadi buah bibir. Apa itu? https://t.co/jnDXuEhHai,40,4,20,4,2022-01-19,5,Wednesday,3,60,8
1483679759355850752,2022-01-19 05:56:34,"Data diungkapkan oleh App Annie, pada laporan bertajuk State of Mobile 2022, masyarakat Asia Tenggara lebih banyak menghabiskan waktu dan uang di game. https://t.co/imc8b8Bz84",4,3,3,2,2022-01-19,5,Wednesday,3,7,5
1483679511531204610,2022-01-19 05:55:35,"Ancol dipilih menjadi lokasi sirkuit balap mobil listrik kelas dunia, Formula E Jakarta. https://t.co/p7My5KpgCK",5,2,2,0,2022-01-19,5,Wednesday,3,7,2
1483679037935558658,2022-01-19 05:53:42,Bukan tak mungkin Luis Suarez dan Philippe Coutinho akan satu tim lagi di Aston Villa. https://t.co/YdXFrqM65K,6,0,0,0,2022-01-19,5,Wednesday,3,6,0
1483679021141569537,2022-01-19 05:53:38,Berikut daftar harga mobil mewah terlaris di Indonesia. https://t.co/klgfduaQtA,5,0,3,0,2022-01-19,5,Wednesday,3,8,0
1483678758188068865,2022-01-19 05:52:36,"Barcelona membutuhkan uang, Gavi masuk dalam daftar jual? https://t.co/nLxQcNLiZl",1,0,0,0,2022-01-19,5,Wednesday,3,1,0
1483678642265899008,2022-01-19 05:52:08,"OTT yang dilancarkan KPK menjerat Bupati Langkat, Sumut, Terbit Rencana Perangin Angin. Dia diduga terlibat transaksi suap. https://t.co/v1f0qt4DSb",10,4,6,3,2022-01-19,5,Wednesday,3,16,7
1483678512275931146,2022-01-19 05:51:37,"Popularitas serial Layangan Putus berimbas pada penulis aslinya Mommy ASF. Impiannya untuk berlibur ke Capadoccia, Turki segera terwujud. https://t.co/wUft5whCEN",60,4,7,2,2022-01-19,5,Wednesday,3,67,6
1483678178904268809,2022-01-19 05:50:17,Motor listrik bongsor Yamaha jadi masuk Indonesia tahun ini? https://t.co/4v5VHEitzB,6,0,2,0,2022-01-19,5,Wednesday,3,8,0
1483678166237560833,2022-01-19 05:50:14,Gelombang tsunami terjadi usai gunung berapi di Tonga mengalami erupsi. Gelombang tsunami tersebut diklaim terdeteksi di Indonesia. https://t.co/jtZw1FtVz5,2,0,6,0,2022-01-19,5,Wednesday,3,8,0
1483677692197232640,2022-01-19 05:48:21,Sandiaga Uno tak terima dengan ucapan CEO Dorna Sports Carmelo Ezpeleta terkait ancaman pembatalan MotoGP Mandalika. Sandiaga menegaskan Indonesia menerapkan kebijakan pengendalian Covid-19. https://t.co/hPRA3vJ6HX,16,2,2,3,2022-01-19,5,Wednesday,3,18,5
1483677675348705282,2022-01-19 05:48:17,Sosok MPV yang diduga Hyundai Stargazer tertangkap kamera tim detikcom saat tengah wara-wiri di jalanan Kota Bandung belum lama ini. https://t.co/fTQywy7pH1,7,1,2,0,2022-01-19,5,Wednesday,3,9,1
1483677407206850560,2022-01-19 05:47:13,Inter Milan terus mengesankan meski sudah ditinggal Antonio Conte. Simone Inzaghi dinilai sudah mengantarkan Nerazzurri ke dimensi baru. https://t.co/s1VaHwWuYn,8,1,1,0,2022-01-19,5,Wednesday,3,9,1
1483677405558489088,2022-01-19 05:47:13,Berikut tips simpel untuk meningkatkan produktivitas dijelaskan konsultan bisnis Ivy Lee. https://t.co/0tLLhYWNgu,2,0,2,0,2022-01-19,5,Wednesday,3,4,0
1483677129996910594,2022-01-19 05:46:07,Puncak Omicron di Indonesia diperkirakan terjadi di pertengahan Februari-Maret 2022. Epidemiolog UGM mengingatkan 3 hal penting ini agar PTM terus berjalan. https://t.co/2pfHH4rMXB,7,1,2,0,2022-01-19,5,Wednesday,3,9,1
1483677111789498368,2022-01-19 05:46:03,"Han So Hee dan Park Hyung Sik dipersatukan dalam drama Korea terbaru, Soundtrack #1. Ini potret mereka:  https://t.co/z2bi2qKMDV",24,0,7,0,2022-01-19,5,Wednesday,3,31,0
1483676845476306946,2022-01-19 05:45:00,"#FOTO Kompetisi Ocean Art Underwater Photo 2021 telah diumumkan pemenangnya. Karya jawara begitu spektakuler, ternyata lokasi fotonya ada di Indonesia loh. https://t.co/tWBkq6xwJg",6,0,3,0,2022-01-19,5,Wednesday,3,9,0
1483676827130474498,2022-01-19 05:44:55,"Ramadhan tinggal beberapa bulan lagi! Yuk, simak perkiraan tanggal dimulainya puasa di sini. https://t.co/HJL88bcYe8",2,1,5,0,2022-01-19,5,Wednesday,3,7,1
1483676569042358274,2022-01-19 05:43:54,"Juventus menang telak atas Sampdoria di Coppa Italia. Semakin percaya diri, Juventus? https://t.co/9Xi23RKSFE",5,0,1,0,2022-01-19,5,Wednesday,3,6,0
1483676546971930625,2022-01-19 05:43:48,Sandiaga Uno tak terima dengan ucapan CEO Dorna Sports Carmelo Ezpeleta terkait ancaman pembatalan MotoGP Mandalika. Sandiaga menegaskan Indonesia menerapkan kebijakan pengendalian Covid-19. https://t.co/b0g46U5FCY https://t.co/bziKredzwc,7,0,1,0,2022-01-19,5,Wednesday,3,8,0
1483675937074036737,2022-01-19 05:41:23,Komisi VIII DPR mengusir Sekjen Kemensos Harry Hikmat dari rapat. Ada komunikasi Harry kepada pimpinan Komisi VIII yang dinilai tak pantas. https://t.co/OLSnMr9HH9,6,1,2,0,2022-01-19,5,Wednesday,3,8,1
1483675174281089026,2022-01-19 05:38:21,KPK kembali melakukan OTT. Penyelenggara negara yang dijerat disebut berasal dari Langkat Sumut. https://t.co/FqBSooaVla,9,0,4,1,2022-01-19,5,Wednesday,3,13,1
1483674611300634629,2022-01-19 05:36:07,"Teka-teki ini menguji konsentrasi kamu. Jika masih sangat fokus, harusnya bisa ketebak kurang dari satu menit. Kalau gagal, buruan makan siang dulu! https://t.co/E8odFOsCZN",1,0,2,0,2022-01-19,5,Wednesday,3,3,0
1483674139839848450,2022-01-19 05:34:14,"DPR RI telah menggelar rapat paripurna ke-13 masa sidang 2021-2022. Hasilnya, Rancangan Undang-undang Tindak Pidana Kekerasan Seksual (RUU TPKS) menjadi RUU inisiatif DPR disahkan. https://t.co/T1i27ps8m5",3,1,2,0,2022-01-19,5,Wednesday,3,5,1
1483673686343303169,2022-01-19 05:32:26,"Hyundai Staria setara sama seperti Alphard, seberapa laris penjualan Staria? https://t.co/BOSx0dtBPR",9,0,1,1,2022-01-19,5,Wednesday,3,10,1
1483673037375483904,2022-01-19 05:29:52,"Chelsea kini jauh tertinggal dari Manchester City di klasemen Liga Inggris, bahkan berpotensi tergusur dari empat besar. https://t.co/HqkdfMtPDU",7,1,0,2,2022-01-19,5,Wednesday,3,7,3
1483672537087332353,2022-01-19 05:27:52,RDPU Komisi II DPR dengan panitia seleksi calon anggota KPU dan Bawaslu diwarnai perdebatan tentang bau balsem. Bagaimana duduk perkaranya? https://t.co/ey7cMII3KD,3,0,2,0,2022-01-19,5,Wednesday,3,5,0
1483672520570122242,2022-01-19 05:27:48,Manchester United harus tampil konsisten dalam 90 menit kala jumpa Brentford. https://t.co/tzWxUmXjf5,6,1,0,0,2022-01-19,5,Wednesday,3,6,1
1483672157091770369,2022-01-19 05:26:22,Hal tersebut disebut dapat mengganggu ketertiban masyarakat. https://t.co/Y8A1wuuVbu,2,1,1,0,2022-01-19,5,Wednesday,3,3,1
1483672135503695876,2022-01-19 05:26:17,"Anak usaha PT PLN (Persero), yaitu PT PLN Batubara bakal dibubarkan tahun ini!  https://t.co/8pbTPeXs8H",7,0,2,2,2022-01-19,5,Wednesday,3,9,2
1483671891684597765,2022-01-19 05:25:18,"""Di dunia ini kan semua bisa dibolak-balik, jadi santai insya Allah Gaga akan siap kok menerimanya,"" kata Janariah, ibunda Gaga Muhammad. https://t.co/w3dDjUE2tW",22,11,4,5,2022-01-19,5,Wednesday,3,26,16
1483671877432365058,2022-01-19 05:25:15,Basuki Tjahaja Purnama atau Ahok masuk bursa calon Kepala Otorita Ibu Kota Nusantara di Kalimantan Timur. Apa tugasnya?  https://t.co/uiXRe505xt,15,2,1,1,2022-01-19,5,Wednesday,3,16,3
1483671119534112769,2022-01-19 05:22:14,China meminta bank sentral di negara barat untuk tidak mengerek suku bunga terburu-buru demi melawan inflasi.  https://t.co/TgsHO0cHIj,5,0,1,2,2022-01-19,5,Wednesday,3,6,2
1483670936939343881,2022-01-19 05:21:31,Direktur Utama PT Kereta Api Indonesia (KAI) Didiek Hartantyo mengatakan tarif LRT Jabodebek naik dari Rp 12.000 menjadi Rp 15.000.  https://t.co/VSzTF2zI6k,7,0,3,2,2022-01-19,5,Wednesday,3,10,2
1483670821113634818,2022-01-19 05:21:03,"Fatwa haram kripto kembali didengungkan. Bukan cuma kali ini aset kripto diharamkan, baik sebagai komoditas perdagangan, investasi, ataupun mata uang.  https://t.co/1TGN21bnyg",10,6,4,3,2022-01-19,5,Wednesday,3,14,9
1483670807415078912,2022-01-19 05:21:00,Luhut Pandjaitan meramal nasib mata uang Indonesia rupiah.  https://t.co/PKsbv7REdL,2,2,0,2,2022-01-19,5,Wednesday,3,2,4
1483670547930169344,2022-01-19 05:19:58,Kejaksaan Agung menggeledah dua kantor PT Dini Nusa Kusuma dan apartemen tim ahli Kementerian Pertahanan yang juga sebagai Direktur Utama PT DNK. Penggeledahan ini terkait dugaan korupsi pengadaan satelit. https://t.co/0b6ccXSQkl,3,0,1,0,2022-01-19,5,Wednesday,3,4,0
1483670535619944452,2022-01-19 05:19:55,Gubernur Jawa Barat Ridwan Kamil menyesalkan sikap anggota DPR RI Arteria Dahlan yang meminta Kajati yang memakai Bahasa Sunda saat rapat diganti. Menurutnya pernyataan Arteria berlebihan. https://t.co/P2Benk1EGk,6,0,1,0,2022-01-19,5,Wednesday,3,7,0
1483670040629190656,2022-01-19 05:17:57,"Barcelona membutuhkan uang, Gavi masuk dalam daftar jual? https://t.co/OKTBJCgVUG",4,0,0,0,2022-01-19,5,Wednesday,3,4,0
1483669188912762887,2022-01-19 05:14:34,Kalina Oktarani membongkar fakta jika Vicky Prasetyo ternyata pernah meminta pisah berkali-kali. #KalinaOktarani  https://t.co/XaQVT83Mst,6,0,0,0,2022-01-19,5,Wednesday,3,6,0
1483668668764639234,2022-01-19 05:12:30,PT Adaro Energy Tbk akan menggelar rapat umum pemegang saham luar biasa (RUPSLB) pada 9 Februari 2022. Agendanya perubahan nama hingga susunan pengurus.  https://t.co/XXxZhnqASm,6,0,0,0,2022-01-19,5,Wednesday,3,6,0
1483668654868901891,2022-01-19 05:12:27,Hari ini kebijakan tentang minyak goreng satu harga sudah berlaku. Sejumlah minimarket sudah menjual berbagai merek minyak goreng di harga Rp 14.000 per liter.  https://t.co/3Yzzdd3XzK,1671,230,418,345,2022-01-19,5,Wednesday,3,2089,575
1483668338609897472,2022-01-19 05:11:11,"Karoseri Adi Putro mulai melakukan uji coba, serta akan dilakukan mulai 11 Januari 2022 hingga 10 Februari 2022 di Kota Solo. https://t.co/C8TVtn0ver",3,0,1,1,2022-01-19,5,Wednesday,3,4,1
1483668280997031938,2022-01-19 05:10:58,Luhut Pandjaitan mengungkapkan ada sederet yayasan sosial milik orang-orang kaya dunia tiba-tiba berkirim surat kepada Jokowi!  https://t.co/uhKDGAr8DN,13,1,7,5,2022-01-19,5,Wednesday,3,20,6
1483667806008848385,2022-01-19 05:09:04,Pelanggan PLN sekarang ini sudah bisa cek tagihan listrik di mana pun dan kapan pun. Bagaimana caranya?  https://t.co/mpWSNfIDhD,7,0,1,1,2022-01-19,5,Wednesday,3,8,1
1483667789504262144,2022-01-19 05:09:00,"Omicron sudah menyebar ke sedikitnya empat wilayah Jawa Bali, di DKI Jakarta naik 5 kali lipat dalam dua pekan. Sudah menyebar ke mana saja? Simak di sini: https://t.co/ALrkrZRNwr",8,3,1,0,2022-01-19,5,Wednesday,3,9,3
1483667537648885761,2022-01-19 05:08:00,Luhut Pandjaitan kembali membanggakan penangan pandmei COVID-19 Indonesia yang dipandang sukses.  https://t.co/Lt8UpluH8V,28,29,3,7,2022-01-19,5,Wednesday,3,31,36
1483667033854259201,2022-01-19 05:06:00,"Indonesia tengah mengalami kenaikan kasus Covid-19 yang diakibatkan oleh varian Omicron. Meski varian Omicron lebih menular, namun gejalanya lebih ringan. Ada beberapa poin yang disoroti Presiden Jokowi terkait hal ini. https://t.co/gmVwRmHnLO",1,0,1,1,2022-01-19,5,Wednesday,3,2,1
1483667019287379970,2022-01-19 05:05:57,Nilai tukar dolar Amerika Serikat (AS) pagi ini tak bergerak terhadap rupiah. Mata uang Paman Sam berada di level Rp 14.293.  https://t.co/3SOoK8zrEz,1,0,0,0,2022-01-19,5,Wednesday,3,1,0
1483666532039331841,2022-01-19 05:04:01,"Nasabah yang tergabung dalam Komunitas Korban Asuransi menggeruduk kantor Prudential di Prudential Tower, di Jalan Jenderal Sudirman, Jakarta.  https://t.co/1XELcQdDM7",7,1,7,1,2022-01-19,5,Wednesday,3,14,2
1483666515194961922,2022-01-19 05:03:57,Polisi menegaskan tidak ada yang bisa lolos dari ganjil genap meski pelat khusus sekalipun. Selama 3 hari ini polisi telah menindak 124 mobil pelat khusus. https://t.co/YimIEpA2rC,10,4,2,2,2022-01-19,5,Wednesday,3,12,6
1483665945411395587,2022-01-19 05:01:41,Luna Maya menceritakan telah menjalani egg freeze (pembekuan sel telur). Luna menyebut sudah sejak 5 tahun ingin menjalani keinginannya tersebut. https://t.co/N3Lr9L46aS,18,7,2,3,2022-01-19,5,Wednesday,3,20,10
1483665658550366210,2022-01-19 05:00:32,Pemerintah punya target untuk terus meningkatkan ekspor. Kerja sama Kementerian dan Lembaga diperlukan guna mendorong peningkatan ekonomi khususnya ekspor.  https://t.co/fOg33MjbJN,5,0,1,0,2022-01-19,5,Wednesday,3,6,0
1483665336482381825,2022-01-19 04:59:16,"Basuki Tjahaja Purnama atau Ahok buka suara soal namanya masuk bursa kepala badan otorita ibu kota baru, Nusantara.  https://t.co/HjTLGsukxJ",4,1,1,1,2022-01-19,4,Wednesday,3,5,2
1483665327544229889,2022-01-19 04:59:13,Pemerintah menetapkan harga minyak goreng menjadi satu harga di Rp 14.000 per liter. Tapi ternyata masih ada perbedaan harga di lapangan!  https://t.co/R7frRMe1sm,5,5,2,3,2022-01-19,4,Wednesday,3,7,8
1483665070685048832,2022-01-19 04:58:12,"Pihak berwenang Hong Kong mengatakan akan membunuh sekitar 2.000 hewan kecil, termasuk hamster, setelah beberapa dinyatakan positif corona di toko hewan. https://t.co/cwyhSSgTYL",13,4,5,5,2022-01-19,4,Wednesday,3,18,9
1483665049512288257,2022-01-19 04:58:07,Jokowi punya waktu dua bulan menunjuk kepala badan otorita Ibu Kota Negara (IKN). Ini sejumlah nama yang beredar.  https://t.co/whKyRQwzjt,4,4,0,1,2022-01-19,4,Wednesday,3,4,5
1483664841445453830,2022-01-19 04:57:18,Pengadilan Negeri Tangerang menggelar sidang perdana kasus investasi tabung tanah yang melibatkan Ustaz Yusuf Mansur. ia digugat lebih dari Rp 500 juta. https://t.co/e7uzLOdJPL,7,4,2,1,2022-01-19,4,Wednesday,3,9,5
1483664820968820739,2022-01-19 04:57:13,Harga emas hari ini turun lagu. Harga emas Antam 24 karat hari ini turun Rp 3.000 per gram menjadi Rp 939.000 per gram.  https://t.co/cgdQDtWx9E,3,1,1,0,2022-01-19,4,Wednesday,3,4,1
1483664563535069188,2022-01-19 04:56:11,"Titik banjir di kawasan Jakarta bertambah lagi hari ini, tertinggi ada yang mencapai 100 cm. Data tersebut tercatat per pukul 09.00 WIB. https://t.co/Kgkg1Frww2",7,5,2,1,2022-01-19,4,Wednesday,3,9,6
1483664557524631553,2022-01-19 04:56:10,Siswa yang berencana kuliah tahun ini bisa mempersiapkan diri ikut jalur masuk SPAN-PTKIN dan UM-PTKIN 2022. Yuk cek jadwal dan syaratnya. https://t.co/OvLUxzSxiq,1,0,0,0,2022-01-19,4,Wednesday,3,1,0
1483663760715825155,2022-01-19 04:53:00,Rizky Billar menyampaikan kekesalannya di media sosial. Hal ini dikarenakan Lesti Kejora yang mendapat nyinyiran dari netizen soal rela begadang menyusui sang buah hati. https://t.co/1b3UnxpFNf,3,10,0,2,2022-01-19,4,Wednesday,3,3,12
1483663744194560003,2022-01-19 04:52:56,Platform pasar non-fungible token (NFT) OpenSea telah mengakuisisi perusahaan dompet kripto Dharma Labs.  https://t.co/BRj4M4sofU,3,1,2,1,2022-01-19,4,Wednesday,3,5,2
1483663445367140355,2022-01-19 04:51:45,Penyebabnya adalah karena investor mulai was-was dengan ketegangan politik yang terjadi antara negara penghasil minyak seperti Uni Emirat Arab dan Rusia.  https://t.co/9iQjZNcIQW,5,0,1,0,2022-01-19,4,Wednesday,3,6,0
1483663424252956673,2022-01-19 04:51:40,Genangan sempat muncul di kawasan depan JIS pagi tadi. Genangan itu disebutkan terjadi pukul 05.00 WIB. https://t.co/kQh53HHM8S,6,4,0,1,2022-01-19,4,Wednesday,3,6,5
1483662655135133704,2022-01-19 04:48:36,"Microsoft Corp. telah setuju untuk membeli Activision Blizzard Inc. dalam kesepakatan senilai US$ 68,7 miliar atau setara dengan Rp 982,4 triliun!  https://t.co/qaA8JKMrIQ",11,0,3,1,2022-01-19,4,Wednesday,3,14,1
1483662460448120832,2022-01-19 04:47:50,"Hati-hati! Menerobos banjir memiliki banyak risiko, mobil bisa mengalami water hammer yang perbaikannya tidak murah. https://t.co/0I46hO23Ok",11,1,2,0,2022-01-19,4,Wednesday,3,13,1
1483661496312012801,2022-01-19 04:44:00,"Siapa yang tak kenal Toyota Raize yang menggebrak segmen SUV crossover Indonesia di tahun 2021? Memiliki deretan fitur modern untuk kenyamanan dan keselamatan, Raize digadang bakal menjadi primadona di Indonesia. Tertarik memilikinya? https://t.co/Hz0x34k3zw",11,1,1,0,2022-01-19,4,Wednesday,3,12,1
1483661332423532552,2022-01-19 04:43:21,Harry Pantja jadi sorotan setelah dikabarkan terkena stroke 3 kali. Sang istri jelaskan kondisi terkini Harry Pantja:  https://t.co/jv5NczGprR,6,3,1,2,2022-01-19,4,Wednesday,3,7,5
1483660838883975168,2022-01-19 04:41:23,"Kasus pencurian lampu lalu lintas terjadi di DIY, Pelaku berhasil menggondiol tujuh lampu lalu lintas. Kok bisa? https://t.co/XmYVDX4zel",7,7,1,4,2022-01-19,4,Wednesday,3,8,11
1483660585854287873,2022-01-19 04:40:23,"Gaga Muhammad divonis hakim 4,5 tahun atas kasus kecelakaan lalu lintas yang melibatkan dirinya dan Laura Anna. Ini suasana sidang Gaga Muhammad:   https://t.co/Jq7k5mBrog",25,5,6,2,2022-01-19,4,Wednesday,3,31,7
1483659727909404672,2022-01-19 04:36:58,Kalina Oktarani berikan peringatan kepada Vicky Prasetyo untuk tidak berpura-pura jadi korban. Kalina ngaku berusaha mempertahankan rumah tangganya.  https://t.co/LXwWLc57Ua,7,0,0,0,2022-01-19,4,Wednesday,3,7,0
1483659003775365124,2022-01-19 04:34:06,"Paul Pogba masih belum bermain lagi sejak Oktober 2021 lalu, Ralf Rangnick menjelaskan kondisinya dan perkiraan kapan bermain. https://t.co/Hg2mP98Faj",6,0,0,0,2022-01-19,4,Wednesday,3,6,0
1483658206400454666,2022-01-19 04:30:56,Chelsea kian tertinggal jauh dari Manchester City di klasemen Liga Inggris dan terancam di posisi empat besar. https://t.co/Rv8PMUdbXx,7,1,0,0,2022-01-19,4,Wednesday,3,7,1
1483657867219677184,2022-01-19 04:29:35,Thomas Tuchel mengatakan Chelsea dilanda kelelahan fisik dan mental. Akibatnya The Blues tak tampil optimal saat menghadapi Brighton. https://t.co/8pCVKuQYnt,4,1,0,1,2022-01-19,4,Wednesday,3,4,2
1483657361147453440,2022-01-19 04:27:34,"Kisah kontrak Ousmane Dembele di Barcelona berlanjut, Agen Dembele malah menyebut Blaugrana mengancam Dembele. https://t.co/IglvrZTPaC",3,0,0,0,2022-01-19,4,Wednesday,3,3,0
1483656376979267586,2022-01-19 04:23:39,"Saat pandemi datang, Nur Ayunda memilih berhenti dari pekerjaannya agar fokus mengurus kebutuhan keluarga. Ini kisah selengkapnya.  https://t.co/Wbk65Qpeju",7,0,1,0,2022-01-19,4,Wednesday,3,8,0
1483655831879102464,2022-01-19 04:21:29,"Donna Agnesia dan Darius bikin heboh gegara postingan di media sosial. Rupanya, postingan soal Donna menghilang cuma prank. https://t.co/dbktmaVIe1",4,2,1,3,2022-01-19,4,Wednesday,3,5,5
1483655559526158337,2022-01-19 04:20:25,"Gaga Muhammad divonis 4,5 tahun penjara. Ibunda Gaga tanggapi santai, tapi tetap singgung Laura Anna yang sudah meninggal. #GagaMuhammad  https://t.co/bsGcKyjWqd",66,64,11,25,2022-01-19,4,Wednesday,3,77,89
1483655305389035520,2022-01-19 04:19:24,"Berikut ini daftar lokasi SIM keliling untuk wilayah DKI Jakarta, Rabu (19/1/2022). https://t.co/mavxGFhlOf",6,0,1,0,2022-01-19,4,Wednesday,3,7,0
1483655063474249735,2022-01-19 04:18:26,Pengacara Ina Rachman membuka pintu rumah mewahnya. Siapa sangka bila ia dibesarkan oleh ayah yang dulu bekerja sebagai sopir. Ini potret rumah mewahnya: https://t.co/DKySG99ik5,5,0,1,0,2022-01-19,4,Wednesday,3,6,0
1483654808938684417,2022-01-19 04:17:26,Luna Maya ngaku mengambil keputusan untuk membekukan sel telur. Menurut Luna hal itu adalah wajar dan biasa. #LunaMaya  https://t.co/2Q6Xwi4VEY,6,3,4,1,2022-01-19,4,Wednesday,3,10,4
1483654313683607559,2022-01-19 04:15:28,"Gaga Muhammad divonis 4,5 tahun penjara atas kecelakaan yang buat Laura Anna lumpuh. Pembelaan Gaga yang sebut Laura lalai, justru jadi bumerang. https://t.co/4h0hYT5p0i",9,1,2,3,2022-01-19,4,Wednesday,3,11,4
1483653823147266052,2022-01-19 04:13:31,Chelsea mengawali musim sebagai kandidat juara dan sempat melaju apik. Tapi sekarang mereka justru terancam posisinya di empat besar. https://t.co/Qm7asAblpi,1,2,2,0,2022-01-19,4,Wednesday,3,3,2
1483653082101727235,2022-01-19 04:10:34,"Ada dugaan penyuntikan booster setengah dosis dikaitkan dengan stok vaksin terbatas. BPOM buka suara, menegaskan alasan sebenarnya bukan itu. https://t.co/TKu4HvCPgC",8,1,3,1,2022-01-19,4,Wednesday,3,11,2
1483653067560177667,2022-01-19 04:10:30,"Melansir dari Reuters, Rabu (19/1/2022), gugatan ini bermula dari kasus kesepakatan akuisisi SolarCity pada 2016 lalu.  https://t.co/u2mj5FjPH6",5,2,1,1,2022-01-19,4,Wednesday,3,6,3
1483652573278224386,2022-01-19 04:08:33,Senegal dan Maroko memastikan diri lolos sebagai juara grup di Piala Afrika 2021. https://t.co/njj28PAqv8,8,0,0,0,2022-01-19,4,Wednesday,3,8,0
1483651780944801793,2022-01-19 04:05:24,"""Iya benar. Intinya sudah jadi tersangka. Saya dikabarin kemarin,"" kata pengacara Nicholas Sean, Ahmad Ramzy. https://t.co/HyjyLceLGV",86,15,18,2,2022-01-19,4,Wednesday,3,104,17
1483651269717893127,2022-01-19 04:03:22,Majelis Tarjih dan Tajdid Pimpinan Pusat Muhammadiyah mengeluarkan fatwa haram pemakaian uang kripto alias cryptocurrency sebagai alat tukar maupun investasi.  https://t.co/H4io2l26z9,158,38,48,22,2022-01-19,4,Wednesday,3,206,60
1483651012246265859,2022-01-19 04:02:20,"Massa tersebut nantinya akan demonstrasi di Amnesty Internasional, Menteng. https://t.co/P9er9Z0VVc",8,1,1,0,2022-01-19,4,Wednesday,3,9,1
1483650689733701632,2022-01-19 04:01:03,"Mantan personel Duo Maia, Mey Chan, sudah jarang tampil di dunia hiburan dan memutuskan menganti nama panggungnya lho. Intip yuk potretnya sekarang. #detiknetwork  https://t.co/vG8k3ZdOQU",5,1,3,0,2022-01-19,4,Wednesday,3,8,1
1483649921924354053,2022-01-19 03:58:00,"DPR RI mengesahkan Rancangan Undang-undang Ibu Kota Negara menjadi Undang-undang. Nantinya, ibu kota negara baru yang berlokasi di Kalimantan Timur itu akan diberi nama Nusantara. https://t.co/ArlWhmlQCl",10,3,4,1,2022-01-19,3,Wednesday,3,14,4
1483649163569115137,2022-01-19 03:55:00,"Meski sudah ada larangan, namun masih ada pengendara sepeda motor yang melintas di flyover Pesing, Jakarta Barat. Motor tersebut pun alami kecelakaan. https://t.co/WspRF5q5Zr",12,9,2,6,2022-01-19,3,Wednesday,3,14,15
1483647293857406977,2022-01-19 03:47:34,"Apple Watch 7 menawarkan sejumlah perbedaan dari pendahulunya, paling ketara, layarnya dibuat lebih luas yang bikin jam pintar ini makin menggoda. Ini potretnya: https://t.co/9ad38YTkwX",10,0,2,0,2022-01-19,3,Wednesday,3,12,0
1483646210070175746,2022-01-19 03:43:15,"Obesitas atau penumpukkan lemak dapat memicu sejumlah penyakit serius yang perlu kita waspadai. Bukan cuma berat badan, waspadai juga lingkar pinggang! https://t.co/2Y5b8OOgtd",6,2,1,1,2022-01-19,3,Wednesday,3,7,3
1483645390427729920,2022-01-19 03:40:00,"Pemerintah memperpanjang program diskon PPnBM, dengan program ini dipercaya dapat membantu membangkitkan industri otomotif. https://t.co/TP49Fn5GEq",9,2,1,2,2022-01-19,3,Wednesday,3,10,4
1483642919651356673,2022-01-19 03:30:11,"Majleis hakim Pengadilan Negeri Jakarta Timur, menjatuhkan vonis 4 tahun enam bulan penjara kepada Gaga Muhammad.  https://t.co/RcuPu6uHI9",58,5,22,8,2022-01-19,3,Wednesday,3,80,13
1483642851581997056,2022-01-19 03:29:55,"Kini, terduga pelaku pelemparan batu itu telah ditangkap polisi. https://t.co/QEBK9rmjdx",9,0,1,0,2022-01-19,3,Wednesday,3,10,0
1483642360303173639,2022-01-19 03:27:58,MAKI menilai putusan itu tidak mencerminkan rasa keadilan di masyarakat. https://t.co/hX0qfa8zYP,12,3,2,0,2022-01-19,3,Wednesday,3,14,3
1483641326990245889,2022-01-19 03:23:51,Persib Bandung ingin memerangi Online abuse demi kemaslahatan bersama. https://t.co/NtgsFGJC3g,2,0,0,0,2022-01-19,3,Wednesday,3,2,0
1483640794728779776,2022-01-19 03:21:44,"Bintang film Love and Leashes, Lee Jun Young jadi perbincangan. Ini deretan faktanya yang mengawali karier sebagai idol KPop: https://t.co/kE5fOtjVAW",4,1,0,0,2022-01-19,3,Wednesday,3,4,1
1483640025128570883,2022-01-19 03:18:41,Gareth Southgate namanya dicatut dalam penipuan mata uang kripto! https://t.co/isQiSeAli7,4,0,1,0,2022-01-19,3,Wednesday,3,5,0
1483639253942820866,2022-01-19 03:15:37,Tidak semua daerah di Indonesia kena suntik mati TV analog. Wilayah ini belum akan cicipi siaran TV digital: https://t.co/RX5mief3wd,5,1,1,0,2022-01-19,3,Wednesday,3,6,1
1483638842657845249,2022-01-19 03:13:59,"Penderita diabetes memiliki pantangan makanan tertentu untuk menjaga kestabilan gula darah. Beberapa menu sarapan enak berikut aman untuk dikonsumsi, apa saja?  https://t.co/0uVc5z9KjV",13,0,3,0,2022-01-19,3,Wednesday,3,16,0
1483638137045884930,2022-01-19 03:11:11,Gaga Muhammad hari ini jalani vonis sidang kasus kecelakaan yang buat Laura Anna lumpuh. Keluarga Laura Anna berharap Gaga divonis maksimal.  https://t.co/dvwPk5z2vG,78,4,7,1,2022-01-19,3,Wednesday,3,85,5
1483637147840266245,2022-01-19 03:07:15,"Ratusan rumah rata dengan tanah imbas gempa di Provinsi Badghis, Afghanistan. Tercatat, ada 26 orang tewas dalam bencana ini. https://t.co/NLsFKQEHMp",4,0,0,0,2022-01-19,3,Wednesday,3,4,0
1483636960782692362,2022-01-19 03:06:30,"Jelang vonis Gaga Muhammad, keluarga Laura Anna meminta doa. kakak Laura juga mengajak netizen spill kelakuan Gaga. https://t.co/DRI1VDIJTT",7,2,3,0,2022-01-19,3,Wednesday,3,10,2
1483636157007159296,2022-01-19 03:03:19,Pemerintah Hong Kong mengkhawatirkan penularan virus Corona dari hewan ke manusia. Rencana pemusnahan ribuan hewan pengerat seperti hamster pun akan dilakukan. https://t.co/a7Msu7eZ0w,15,3,12,3,2022-01-19,3,Wednesday,3,27,6
1483635284592164869,2022-01-19 02:59:51,Microsoft dikabarkan setuju memenuhi mahar sebesar USD 69 miliar atau hampir Rp 1.000 triliun untuk mengakuisisi perusahaan game Activision Blizzard. https://t.co/cLt3ttwJFC,8,1,1,1,2022-01-19,2,Wednesday,3,9,2
1483634783926239234,2022-01-19 02:57:51,Gubernur Jawa Barat Ridwan Kamil meminta politikus PDIP Arteria Dahlan meminta maaf kepada masyarakat Sunda. Hal itu terkait pernyataan Arteria Dahlan yang sempat menyinggung bahasa Sunda tidak boleh digunakan di sebuah rapat. https://t.co/XbqdshVg8O,55,11,18,2,2022-01-19,2,Wednesday,3,73,13
1483634297793921027,2022-01-19 02:55:55,Dani Alves optimistis Barcelona bakal kembali ke permainan terbaiknya di bawah Xavi Hernandez.  https://t.co/tOioRxDcy0,7,0,0,0,2022-01-19,2,Wednesday,3,7,0
1483633560208687125,2022-01-19 02:52:59,Rio Ferdinand mengecam Anthony Martial yang menolak bermain. Hal ini secara tak langsung memunculkan anggapan Ralf Rangnick berbohong. https://t.co/OvpZGYUmBo,5,0,0,0,2022-01-19,2,Wednesday,3,5,0
1483633065092161538,2022-01-19 02:51:01,Tindakan itu dilakukan karena yang bersangkutan diduga melecehkan secara verbal seorang wanita pelapor pelecehan seksual. https://t.co/KU1LI7wbwd,39,11,13,3,2022-01-19,2,Wednesday,3,52,14
1483632100498681857,2022-01-19 02:47:11,Luna Maya mengaku telah melakukan pembekuan sel telur. Secara medis hal ini sangat mungkin dilakukan dengan berbagai tujuan. Begini prosesnya: https://t.co/yFPPTUlvtM,10,0,2,1,2022-01-19,2,Wednesday,3,12,1
1483630807570952197,2022-01-19 02:42:03,Sebanyak 12% orangtua jadi subyek survei terkait transportasi online masih meminta bantuan anak atau cucu mereka untuk memesan ojol.  https://t.co/7Chkho99k3,11,1,4,1,2022-01-19,2,Wednesday,3,15,2
1483629962338971655,2022-01-19 02:38:42,"Racikan kopi unik ada di Desa Tetebatu, Lombok Timur, NTB. Warganya kerap mencampur biji kopi dengan beras dan kelapa yang membuat racikannya jadi lebih nikmat.  https://t.co/iTl3dRMHin",13,0,1,1,2022-01-19,2,Wednesday,3,14,1
1483628667658027011,2022-01-19 02:33:33,Kejati DKI meminta agar penyidik melengkapi berkas kasus video syur Gisella Anastasia dan Michael Yukinobu Defretes https://t.co/hEve34K7Px,5,0,1,1,2022-01-19,2,Wednesday,3,6,1
1483627924007882765,2022-01-19 02:30:36,"BPBD DKI Jakarta menyampaikan perkembangan genangan dan banjir di wilayahnya. Per pukul 06.00 WIB, masih ada 31 RT yang tergenang. https://t.co/RrTOF9BXxT",3,0,2,1,2022-01-19,2,Wednesday,3,5,1
1483627192768770048,2022-01-19 02:27:41,#Terpopuler Menurutnya nama Nusantara kurang cocok dan dia mengusulkan nama Jokowi. https://t.co/i7aZ2F6WfV,97,93,18,24,2022-01-19,2,Wednesday,3,115,117
1483626692241498114,2022-01-19 02:25:42,"Hingga kini, tercatat sebanyak 3.078 rumah rusak dengan rincian 395 unit rusak berat, 692 unit rusak sedang dan 1.991 unit rusak ringan. #Banten https://t.co/YgZtZzhK78",9,0,2,0,2022-01-19,2,Wednesday,3,11,0
1483625947681239054,2022-01-19 02:22:45,"Apapun yang berlebihan pastilah berdampak negatif, termasuk makan dan minum. Umat muslim dianjurkan tidak bersikap israf yakni berlebihan saat makan dan minum.  https://t.co/WdjSont9lG",15,2,2,0,2022-01-19,2,Wednesday,3,17,2
1483624710600638470,2022-01-19 02:17:50,#Terpopuler Puncak Omicron di Indonesia diprediksi pemerintah akan terjadi pada bulan Februari-Maret mendatang. Berikut informasi soal prediksinya. https://t.co/C7eqwhPrCR,16,20,9,9,2022-01-19,2,Wednesday,3,25,29
1483623468352647168,2022-01-19 02:12:53,"Haris Azhar dan Fatia Maulidiyanti menceritakan momen penjemputannya oleh pihak kepolisian pada Selasa (18/1) pagi. Haris Azhar mengaku tak ada upaya fisik dari pihak kepolisian saat menjemputnya, bahkan sikap polisi yang menjemput dinilai baik. https://t.co/3kf5l5nUmK",8,1,2,0,2022-01-19,2,Wednesday,3,10,1
1483622447303774210,2022-01-19 02:08:50,Pesawat militer Selandia Baru melakukan pengecekan kondisi terkini Tonga beberapa hari setelah letusan dahsyat gunung berapi bawah laut dan tsunami. Selandia Baru dan Australia juga mengirimkan bantuan ke negara di Pasifik Selatan tersebut. https://t.co/cUFrxYn52G,7,0,1,0,2022-01-19,2,Wednesday,3,8,0
1483621442516307970,2022-01-19 02:04:50,#Terpopuler Haris Azhar dan Fatia Maulidiyanti menceritakan momen penjemputannya oleh pihak kepolisian pada Selasa (18/1) pagi. Seperti apa? https://t.co/SCJKicLvlX,9,11,0,3,2022-01-19,2,Wednesday,3,9,14
1483620447279366144,2022-01-19 02:00:53,"""Menurut saya apa yang dilakukan Pak Anies sesuatu yang cerdas. Ini jelas dibaca secara metafora oleh publik maupun oleh Giring sendiri sebagai sebuah sindiran atau kritik balasan yang dilakukan Anies Baswedan,"" kata Kunto Adi Wibowo. #detiknetwork  https://t.co/DFboL10sry",32,16,2,2,2022-01-19,2,Wednesday,3,34,18
1483619453061505026,2022-01-19 01:56:56,#Terpopuler Ada kisah yang membuat keluarga menuliskan Upin dan Ipin. Seperti apa? https://t.co/Fo4Fl2Lg2j,19,1,2,0,2022-01-19,1,Wednesday,3,21,1
1483618711722463244,2022-01-19 01:53:59,"Anak yang menjadi korban kekerasan seksual umumnya mengalami banyak penderitaan. Untuk itu, penanganan terhadap para penyintas harus mampu memulihkan penderitaan yang mereka alami. https://t.co/KSfjKSsMYM",7,0,1,0,2022-01-19,1,Wednesday,3,8,0
1483617958597468160,2022-01-19 01:51:00,Indeks harga saham utama di Wall Street melorot karena imbal hasil surat utang pemerintah melejit ke level tertinggi.  https://t.co/UsuvZB3wvr,9,0,0,1,2022-01-19,1,Wednesday,3,9,1
1483617219728875523,2022-01-19 01:48:04,"Kota Beijing, China, melaporkan kasus pertama transmisi lokal varian Omicron. Temuan kasus terjadi beberapa minggu jelang dibukanya Olimpiade Musim Dingin. https://t.co/gjB9IrDOWG",4,0,0,0,2022-01-19,1,Wednesday,3,4,0
1483616204405288963,2022-01-19 01:44:02,Jaringan 5G akan jadi mainstream. Namun jaringan ini menimbulkan beberapa kekhawatiran terkait teknologi jaringan tersebut seperti pada pesawat terbang. #5G  https://t.co/40krQfrOwR,10,0,1,0,2022-01-19,1,Wednesday,3,11,0
1483615452475674624,2022-01-19 01:41:02,Elon Musk kembali berikan ramalan mengerikan tentang masa depan Bumi. Ia mengatakan semua spesies di Bumi bisa punah karena hal ini:  https://t.co/92fkA9QeEz,12,1,3,0,2022-01-19,1,Wednesday,3,15,1
1483614951575019525,2022-01-19 01:39:03,Viral video pernikahan yang menggunakan gaun pengantin untuk tiga beda agama. Begini kata desainer: https://t.co/6jRuutYYRE,11,0,1,1,2022-01-19,1,Wednesday,3,12,1
1483614217299234820,2022-01-19 01:36:08,"Di tempat yang sekarang menjadi Arab Saudi, para arkeolog menemukan jaringan jalan raya yang hilang. Jalan raya ini bisa mengungkap sejarah awal Timur Tengah. https://t.co/l5IVESiLfA",10,0,3,0,2022-01-19,1,Wednesday,3,13,0
1483613506171813894,2022-01-19 01:33:18,"Berbagai strategi dilakukan China dalam mencegah penularan varian Omicron. Salah satunya, melakukan disinfeksi terhadap paket yang dikirim dari luar negeri. https://t.co/tbCLK6jHDW",5,0,1,0,2022-01-19,1,Wednesday,3,6,0
1483612999449522176,2022-01-19 01:31:17,Baim Wong dan Giovanni Tobing membuka rumah makan gratis bernama Silahkan Makan Gratis yang diperuntukkan orang-orang yang membutuhkan. https://t.co/RW9CJZZeuR,81,1,13,2,2022-01-19,1,Wednesday,3,94,3
1483612978796716034,2022-01-19 01:31:12,"Produksi snack ini bukan hanya mencari keuntungan, melainkan juga ada misi mulia. Produsennya sengaja melibatkan para narapidana untuk mengemas snack.  https://t.co/3p5avIKSq0",7,1,1,0,2022-01-19,1,Wednesday,3,8,1
1483612237264785412,2022-01-19 01:28:16,"Sebanyak 3,2 juta unit set top box gratis TV digital akan disalurkan ke rumah tangga miskin. STB ini akan membantu masyarakat mendapatkan siaran TV digital ketika TV analog dimatikan. https://t.co/QMxOTTqAtP",15,5,8,2,2022-01-19,1,Wednesday,3,23,7
1483611240631083011,2022-01-19 01:24:18,BMKG memberikan peringatan dini potensi cuaca ekstrem di wilayah Bodebek dan Bandung Raya hari ini (19/1). https://t.co/Gj0AOK1IKM,10,0,1,0,2022-01-19,1,Wednesday,3,11,0
1483610262905176066,2022-01-19 01:20:25,Genangan air muncul di sejumlah titik di Jakarta Utara hingga Jakarta Timur. Genangan tersebut dengan ketinggian air mencapai 60 cm. https://t.co/7G79gdELTK,15,4,2,1,2022-01-19,1,Wednesday,3,17,5
1483610249844203525,2022-01-19 01:20:22,"Anggota Pansus RUU IKN Fraksi PKS, Suryadi JP, menyesalkan penggunaan nama Nusantara sebagai ibu kota baru di Kalimantan Timur. Salah satu alasannya, karena dinilai akan mempersempit makna Nusantara yang telah dikenal secara umum. https://t.co/opBJhVQsv9",20,48,2,1,2022-01-19,1,Wednesday,3,22,49
1483609514318438406,2022-01-19 01:17:27,"Awal tahun 2022, pencinta fenomena langit mendapat suguhan yang menakjubkan berupa fenomena Wolf Moon atau Bulan Purnama Serigala. Ini potretnya:  https://t.co/u0pnMp9M3n",16,0,1,0,2022-01-19,1,Wednesday,3,17,0
1483608027051831299,2022-01-19 01:11:32,Laki-laki ini menjadi satu satunya penumpang dalam penerbangan dari Inggris ke Amerika. Apa untung ruginya jadi satu-satunya penumpang di pesawat ya? https://t.co/6sOFSAaMMn,6,0,2,0,2022-01-19,1,Wednesday,3,8,0
1483607724524978178,2022-01-19 01:10:20,"Jus diet terdiri dari buah dan sayuran. Seperti racikan jus diet ala Geni Halilintar yang diklaim ampuh menuunkan berat badan. Hanya memakai 2 bahan, apa saja?  https://t.co/YbbbuA8lKr",15,3,3,1,2022-01-19,1,Wednesday,3,18,4
1483606488539176965,2022-01-19 01:05:25,Kementerian Komunikasi dan Informatika mengungkapkan data penerima set top box gratis tv digital sudah valid dan siap didistribusikan ke masyarakat. https://t.co/w7pekaOstv,9,1,2,0,2022-01-19,1,Wednesday,3,11,1
1483605543193350150,2022-01-19 01:01:40,Isyana Sarasvati menjadi sorotan karena mengakui kalau dirinya mengagumi sosok Nicholas Saputra. Sosok penyanyi cantik ini senang membagikan momen kulinernya.  https://t.co/xCwXSKZlqE,7,1,0,5,2022-01-19,1,Wednesday,3,7,6
1483605531214417921,2022-01-19 01:01:37,"Berwisata ke Pegunungan Sanggabuana, Irfan Hakim merasakan minum air jernih dari sungai dan tidur di batu besar. Ia juga ketagihan terubuk khas Karawang.  https://t.co/ARBWjFYBfY",4,0,0,0,2022-01-19,1,Wednesday,3,4,0
1483605038517952512,2022-01-19 00:59:39,Melonjaknya kasus Omicron berimbas ke pasokan bahan makanan di Amerika Serikat (AS). Rak-rak supermarket dilaporkan kosong gara-gara krisis pasokan itu. https://t.co/L10hOS6fUC,8,0,3,2,2022-01-19,0,Wednesday,3,11,2
1483605021455441921,2022-01-19 00:59:35,Hari ini ada 564 orang di Indonesia yang sembuh dari COVID-19. Jumlah total yang telah sembuh dari Corona sebanyak 4.120.036 orang. https://t.co/mJ2SRrYJEJ,6,2,1,3,2022-01-19,0,Wednesday,3,7,5
1483604704231890944,2022-01-19 00:58:20,"Arteria Dahlan kembali menuai kontroversi. Kali ini, dia meminta seorang Kajati diganti lantaran berbahasa Sunda saat rapat. Usulan Arteria mengundang kritikan. https://t.co/iaSz9IzeBu",7,13,1,4,2022-01-19,0,Wednesday,3,8,17
1483604686766854144,2022-01-19 00:58:16,PTM di Madrasah Aliyah Negeri (MAN) 2 Kota Malang terpaksa dihentikan sementara. Itu dilakukan setelah delapan pelajar diduga terpapar virus COVID-19. https://t.co/DtpSNa6rtx,7,0,2,0,2022-01-19,0,Wednesday,3,9,0
1483604420860461056,2022-01-19 00:57:12,Luna Maya ungkap dirinya menjalani prosedur pembekuan sel telur sejak tahun lalu. Apa sih alasan Luna membekukan sel telurnya? Simak selengkapnya. https://t.co/Q43L8c3Nsg,27,14,7,4,2022-01-19,0,Wednesday,3,34,18
1483604399041794056,2022-01-19 00:57:07,Ibu kota baru akan dipimpin oleh sebuah badan otorita yang dikepalai oleh seorang kepala otorita yang posisinya setara menteri. Siapa saja calonnya?  https://t.co/UADXcdpGkh,65,48,6,11,2022-01-19,0,Wednesday,3,71,59
1483604159827959809,2022-01-19 00:56:10,"Ahli ilmu kepolisian dari Universitas Bhayangkara, Warasman Marbun, mengungkap doktrin internasional yang menilai lebih baik penjahat mati daripada petugas. https://t.co/W3aJsUcyZL",15,5,2,11,2022-01-19,0,Wednesday,3,17,16
1483603919104323584,2022-01-19 00:55:12,"Seiring dengan pemindahan ibu kota negara (IKN) baru ke Kalimantan Timur, harga tanah kian meroket.  https://t.co/GeIRyBk9Uo",7,0,4,0,2022-01-19,0,Wednesday,3,11,0
1483603900481609728,2022-01-19 00:55:08,"Belum juga punya pasangan, aktris Luna Maya mengaku membekukan sel telur. Ada beberapa hal yang perlu diperhatikan sebelum melakukannya. https://t.co/F2XPHygKbb",3,1,0,0,2022-01-19,0,Wednesday,3,3,1
1483603678737092611,2022-01-19 00:54:15,Ridwan Kamil menyatakan telah berikhtiar dan siap lahir batin untuk maju di Pilpres 2024 mendatang. Dia masih memilih partai untuk berlabuh. https://t.co/1sw6U0oWfD,427,169,93,154,2022-01-19,0,Wednesday,3,520,323
1483603659770544135,2022-01-19 00:54:11,Nabi Muhammad SAW diyakini memiliki 9 pedang yang digunakan untuk berdakwah dan mereka yang memerangi Islam. Benarkah salah satunya dapat membunuh dajjal? https://t.co/uGK2jsrSYv,4,3,0,0,2022-01-19,0,Wednesday,3,4,3
1483603405700485120,2022-01-19 00:53:10,"Persentase penduduk miskin di Banten menurun dibanding pada awal pandemi, tetapi tren itu tak berlaku di daerah perkotaan. https://t.co/txXOZvIBEP",0,0,0,0,2022-01-19,0,Wednesday,3,0,0
1483603189060542466,2022-01-19 00:52:18,"Gejala Omicron memang mirip pilek biasa, tapi jangan santai dulu. Justru ini yang dikhawatirkan Kemenkes walau mayoritas pasien Omicron 'cuma' batuk-pilek. https://t.co/MQG2YCV8GC",8,0,8,0,2022-01-19,0,Wednesday,3,16,0
1483603165190705153,2022-01-19 00:52:13,Heru Hidayat (HH) divonis nihil oleh majelis hakim di kasus skandal korupsi ASABRI. Apa artinya? https://t.co/VEMuv6p9qt,1,2,1,0,2022-01-19,0,Wednesday,3,2,2
1483603069137002504,2022-01-19 00:51:50,"Setelah selesai makan, dua pengunjung ini tidak menyangka mendapatkan kejutan tak terduga. Mereka dihadapkan langsung dengan banteng yang menyeruduk!  https://t.co/nhUssp4dGp",5,0,2,0,2022-01-19,0,Wednesday,3,7,0
1483602910080638978,2022-01-19 00:51:12,Kasus positif Corona di DKI Jakarta kembali meningkat. Usulan agar ganjil genap dihentikan pun mengemuka. https://t.co/w2kIy01AvL,4,0,2,2,2022-01-19,0,Wednesday,3,6,2
1483602890019201027,2022-01-19 00:51:07,Aturan mengenai pelaksanaan pembangkit listrik tenaga surya alias PLTS atap dibekukan. Apa kata pengusaha?  https://t.co/lEMUdhdEsM,1,0,3,0,2022-01-19,0,Wednesday,3,4,0
1483602697265848324,2022-01-19 00:50:21,"Bagi pria yang khawatir volume air maninya tidak banyak, ada beberapa cara yang bisa dilakukan. Berikut empat tips dari ahli urolog. https://t.co/sWCD7gZxee",13,1,2,0,2022-01-19,0,Wednesday,3,15,1
1483602679943380992,2022-01-19 00:50:17,Komitmen Wali Kota Pasuruan Saifullah Yusuf (Gus Ipul) menutup celah korupsi mulai nampak. Ia menyebut potensi korupsi di Pemkot Pasuruan semakin kecil. https://t.co/mobb5eANuz,2,0,0,0,2022-01-19,0,Wednesday,3,2,0
1483602432802369541,2022-01-19 00:49:18,"Pengusaha yang menolak menjual menjual minyak goreng Rp 14.000/liter, siap-siap kena sanksi!  https://t.co/rmMJoBHB7Z",327,45,109,44,2022-01-19,0,Wednesday,3,436,89
1483602417388331014,2022-01-19 00:49:14,"Sebelum mendaftar SNMPTN 2022, siswa bisa mencari informasi tentang daftar perguruan tinggi yang memiliki kuota terbanyak pada tahun lalu. Apa saja ya? https://t.co/ZNgOGd2gax",0,0,0,0,2022-01-19,0,Wednesday,3,0,0
1483602188685434881,2022-01-19 00:48:20,"Nama Ghozali mendadak tenar karena foto selfie NFT-nya yang menjadi bahan perbincangan. Kini ia sedang mengkonsepkan karya NFT terbarunya, yaitu animasi 3D. https://t.co/PykulrAY3P",6,1,0,1,2022-01-19,0,Wednesday,3,6,2
1483602173065846789,2022-01-19 00:48:16,"Pemerintah berencana mengubah skema subsidi listrik. Nantinya, subsidi ini akan langsung diberikan kepada yang berhak menerima. Berikut poin pentingnya:  https://t.co/nue3yrOAqH",0,1,3,0,2022-01-19,0,Wednesday,3,3,1
1483601922162671621,2022-01-19 00:47:16,Australia tengah menghadapi kelangkaan alat tes antigen mandiri di tengah penyebaran cepat virus Corona (COVID-19) varian Omicron. https://t.co/qUxIoCZwih,5,1,2,1,2022-01-19,0,Wednesday,3,7,2
1483601898603270146,2022-01-19 00:47:11,"Kejagung menyampaikan akan melawan vonis nihil Heru Hidayat di kasus korupsi ASABRI. Kejagung, memerintahkan jaksa penuntut umum (JPU) untuk banding. https://t.co/c5K8LwiO4i",5,1,1,0,2022-01-19,0,Wednesday,3,6,1
1483601645686738944,2022-01-19 00:46:10,Online abuse atau kekerasan di dunia maya bisa menimpa siapapun di era digital. Persib Bandung ingin memerangi demi kemaslahatan bersama. https://t.co/IOMICS7hr7,1,0,0,1,2022-01-19,0,Wednesday,3,1,1
1483601393294397440,2022-01-19 00:45:10,"Sementara RI baru mulai vaksin booster COVID-19 atau dosis ke-3, beberapa negara sudah memberikan dosis ke-4. Kemenkes RI buka suara soal spekulasi dosis ke-4. https://t.co/QN5JjbUYnE",6,2,3,2,2022-01-19,0,Wednesday,3,9,4
1483601170153320454,2022-01-19 00:44:17,Bina Marga DKI akan segera memperbaiki permukaan Jl DI Panjaitan. Permukaan di sini tidak rata dan berakibat timbulnya 'genangan aneh'. https://t.co/LxgmeyyDT5,1,0,0,0,2022-01-19,0,Wednesday,3,1,0
1483601155859132427,2022-01-19 00:44:14,Para bos eksekutif maskapai AS mengingatkan adanya 'gangguan bencana' jika perusahaan telekomunikasi menggunakan teknologi 5G tanpa batasan di dekat bandara. https://t.co/tZ79hwIAxH,4,0,1,0,2022-01-19,0,Wednesday,3,5,0
1483600635794706441,2022-01-19 00:42:10,Para nasabah dan mantan nasabah ini meminta kepada perusahaan untuk mengembalikan uang mereka 100%  https://t.co/R4vztQSoRf,1,1,0,3,2022-01-19,0,Wednesday,3,1,4
1483600379203969028,2022-01-19 00:41:09,Nusantara resmi jadi nama Ibu Kota Baru Negara yang akan mulai berpindah dari Jakarta. Berikut sejumlah faktanya.  https://t.co/X9UDQuIPzt,34,7,6,3,2022-01-19,0,Wednesday,3,40,10
1483599766412013569,2022-01-19 00:38:42,Kebijakan minyak goreng satu harga berlaku mulai hari ini. Minyak goreng kemasan sederhana hingga premium dijual Rp 14 ribu per liter.  https://t.co/nab7DEqW0s,73,21,25,10,2022-01-19,0,Wednesday,3,98,31
1483598635279568896,2022-01-19 00:34:13,"Jumlah titik banjir dan genangan air di Ibu Kota bertambah. Anggota DPRD DKI Jakarta Fraksi PSI, Anggara Wicitra mengkritik Anies gegara terlalu sibuk urus JIS. https://t.co/drC4x7nGJJ",8,5,0,2,2022-01-19,0,Wednesday,3,8,7
1483598319242944530,2022-01-19 00:32:57,Budayawan Sunda Budi Dalton mengimbau agar Arteria Dahlan tidak membuat kegaduhan dan menyinggung orang Sunda. https://t.co/U1weuB28cr,35,24,1,3,2022-01-19,0,Wednesday,3,36,27
1483598069409144835,2022-01-19 00:31:58,"Presiden Komisaris PT TRAM, Heru Hidayat, divonis nihil oleh hakim di kasus korupsi ASABRI. Heru diminta untuk membayar uang pengganti sebesar Rp 12,6 triliun. https://t.co/3BbRQvKog8",6,6,1,2,2022-01-19,0,Wednesday,3,7,8
1483597510228725767,2022-01-19 00:29:45,Pemkab Mandailing Natal (Madina) kena damprat Gubernur Sumut (Gubsu) Edy Rahmayadi lantaran menetapkan status darurat bencana saat banjir. https://t.co/jJe2TmUv10,5,0,1,1,2022-01-19,0,Wednesday,3,6,1
1483597274013966342,2022-01-19 00:28:48,"Luna Maya mengaku melakukan pembekuan sel telur. Hal itu diungkapkan Luna Maya saat berbincang dengan Venna Melinda, beberapa waktu lalu. Ini faktanya:  https://t.co/ueK5cwBLF9",12,6,2,0,2022-01-19,0,Wednesday,3,14,6
1483596769313411074,2022-01-19 00:26:48,"Dipo Latief mengungkapkan kisah unik terkait hobinya menaiki motor gede. Rupanya, hobi itu tidak mendapatkan dukungan penuh dari orangtuanya. https://t.co/m1xglVePEa",5,0,0,1,2022-01-19,0,Wednesday,3,5,1
1483594498919874561,2022-01-19 00:17:47,"Puncak Omicron di beberapa negara mulai mereda, tetapi banyak pula yang masih mengalami lonjakan kasus. Kapan pandemi berakhir? Ini perkiraan WHO. https://t.co/0Lz3PI8Rjh",3,0,2,1,2022-01-19,0,Wednesday,3,5,1
1483593357754576896,2022-01-19 00:13:14,Presiden Joko Widodo (Jokowi) menyampaikan sejumlah arahan terkini menyusul kenaikan kasus Omicron di Indonesia. https://t.co/IIXOfv61o3,4,2,1,2,2022-01-19,0,Wednesday,3,5,4
1483592879473897475,2022-01-19 00:11:20,Chelsea mengawali musim sebagai kandidat juara dan sempat melaju apik. Tapi kini mereka justru terancam posisinya di empat besar. https://t.co/S1TGDTfd62,1,1,0,0,2022-01-19,0,Wednesday,3,1,1
1483592631649292289,2022-01-19 00:10:21,"Polisi menangkap beberapa pelaku pengeroyokan terhadap anggota TNI AD, Pratu Sahdi (23) hingga tewas. Ada beberapa fakta terungkap dalam peristiwa tersebut. https://t.co/V3DVEm1oOO",10,3,4,0,2022-01-19,0,Wednesday,3,14,3
1483591352592089089,2022-01-19 00:05:16,"Jokowi meminta pembatasan WFO, khususnya untuk pekerjaan yang bisa dilakukan dari rumah. Ada yang setuju, dan tentu saja ada yang tidak sependapat. Kamu gimana? https://t.co/a0d7qzoZne",153,138,51,77,2022-01-19,0,Wednesday,3,204,215
1483590874835607556,2022-01-19 00:03:23,"Hujan deras yang mengguyur Bekasi membuat sebagian wilayah terendam banjir. Salah satunya di Jalan Raya Pondok Ungu Permai, Babelan, Selasa (18/1/2022). https://t.co/960EisME5a",17,7,1,3,2022-01-19,0,Wednesday,3,18,10
1483590635835822080,2022-01-19 00:02:26,Cara dapat vaksin booster perlu diketahui masyarakat yang telah divaksinasi Covid-19 sebanyak dua dosis. Cek tiketnya di PeduliLindungi. https://t.co/1rKpZb46GF,6,0,1,1,2022-01-19,0,Wednesday,3,7,1
1483590145265876996,2022-01-19 00:00:29,Senegal dan Maroko memastikan diri lolos sebagai juara grup di Piala Afrika 2021. Guinea dan Gabon mendampingi masing-masing tim lolos ke babak 16 besar. https://t.co/HvqxX4GEXW,4,0,0,0,2022-01-19,0,Wednesday,3,4,0
1483588621177348105,2022-01-18 23:54:25,Makam Upin dan Ipin di Palu sempat dikira inspirasi serial animasi Upin dan Ipin di Malaysia juga populer di Indonesia.Keluarga mengungkap kisah di baliknya. https://t.co/3g7H4jwK7C,13,1,9,2,2022-01-18,23,Tuesday,2,22,3
1483587882694676485,2022-01-18 23:51:29,Fraksi NasDem menagih janji Mendes PDTT Abdul Halim Iskandar telah berjanji akan mengalokasikan 5 persen dana desa untuk operasional kepala desa (kades). https://t.co/uMEPfp3IAH,10,2,1,0,2022-01-18,23,Tuesday,2,11,2
1483587131352174593,2022-01-18 23:48:30,Tahukah kalian 10 Youtuber dengan pendapatan tertinggi di dunia selama 2021? Ada yang cuan hingga Rp 773 miliar. Ini daftarnya:  https://t.co/5JjzYHGaWm,8,1,2,1,2022-01-18,23,Tuesday,2,10,2
1483586400352096261,2022-01-18 23:45:36,"Pria berinisial MH (30) di Kabupaten Majene, Sulawesi Barat ditangkap karena kasus pemerkosaan anak di bawah umur. MH tega memerkosa adik iparnya sendiri. https://t.co/QuUg5fbVjQ",5,3,3,1,2022-01-18,23,Tuesday,2,8,4
1483585343135924226,2022-01-18 23:41:24,"Hakim tidak sependapat dengan jaksa terkait hukuman mati terhadap Presiden Komisaris PT TRAM, Heru Hidayat, di kasus skandal ASABRI. Apa alasan hakim? https://t.co/P77TOdqrVJ",8,3,3,2,2022-01-18,23,Tuesday,2,11,5
1483584594704281601,2022-01-18 23:38:25,Sebanyak 16 jiwa dari 5 Kepala Keluarga (KK) warga Kampung Rawa Kalong terkurung tembok beton yang dibangun Pertamina. https://t.co/wYqcIdI8s1,6,1,2,1,2022-01-18,23,Tuesday,2,8,2
1483584095200370692,2022-01-18 23:36:26,Pemprov DKI Jakarta melaporkan tingkat keterisian tempat tidur atau bed occupancy rate (BOR) di 140 rumah sakit rujukan COVID-19 DKI Jakarta. Ini hasilnya https://t.co/yVvfmxo3Cx,4,0,3,1,2022-01-18,23,Tuesday,2,7,1
1483583593939148804,2022-01-18 23:34:27,Kasus pembegalan terhadap Alex Yulihantoro di Balongbendo ternyata hanyalah rekayasa Alek. Alex merekayasan itu karena dia terlilit utang. https://t.co/RmB08M0JwM,11,0,2,1,2022-01-18,23,Tuesday,2,13,1
1483582566011711491,2022-01-18 23:30:22,Beasiswa Taiwan ICDF 2022 dibuka untuk calon mahasiswa S2 jurusan pendidikan. Beragam manfaat menanti di beasiswa penuh ini. https://t.co/ErxTcb86Jj,13,0,2,1,2022-01-18,23,Tuesday,2,15,1
1483581561605926916,2022-01-18 23:26:22,Foxconn kembali membuka pabriknya di India setelah lebih dari tiga minggu ditutup karena aksi protes para buruh yang jatuh sakit akibat keracunan makanan. https://t.co/Gs1BDstlb4,5,0,1,0,2022-01-18,23,Tuesday,2,6,0
1483581063486230533,2022-01-18 23:24:23,Penyelidikan polisi mengungkap 13 santriwati korban pencabulan oknum ulama pondok pesantren di Balikpapan diiming-imingi duit Rp 20-50 ribu. https://t.co/V5zXsV1g91,36,24,15,4,2022-01-18,23,Tuesday,2,51,28
1483579301895327744,2022-01-18 23:17:23,Jakarta dilanda banjir dan genangan usai diguyur hujan. PDIP DKI Jakarta mengkritik penanganan banjir yang dilakukan Gubernur Anies Baswedan. https://t.co/107AjpXIeD,309,256,64,45,2022-01-18,23,Tuesday,2,373,301
1483578537042980872,2022-01-18 23:14:21,"Hakim memutuskan vonis nihil bagi Presiden Komisaris PT TRAM, Heru Hidayat dalam kasus ASABRI. Namun, meminta jaksa untuk mengembalikan 18 kapal yang disita. https://t.co/37l5lIO6EZ",16,2,6,6,2022-01-18,23,Tuesday,2,22,8
1483577238025080839,2022-01-18 23:09:11,"Kemarin ada dua RUU, yakni RUU TPKS dan RUU IKN, yang disahkan DPR. Namun, tidak ada dukungan Fraksi PKS dalam pengesahan dua RUU itu. https://t.co/MUjpqchieR",30,16,5,1,2022-01-18,23,Tuesday,2,35,17
1483575740557893636,2022-01-18 23:03:14,Polantas di Makassar kini pasang badan mengawal ambulans usai viral bayi meninggal di ambulans gegara tak diberi jalan. https://t.co/WGOeSZp3Bf,42,15,6,5,2022-01-18,23,Tuesday,2,48,20
1483575265963950088,2022-01-18 23:01:21,Menkes Budi Gunadi Sadikin menyebutkan total vaksin Covid-19 yang kedaluwarsa di Indonesia menyentuh angka lebih dari 1 juta dosis. Ini penjelasan Menkes... https://t.co/wxjTHlfQAb,12,1,2,0,2022-01-18,23,Tuesday,2,14,1
1483573208703983619,2022-01-18 22:53:11,Christian Eriksen masih belum mendapatkan klub usai dilepas Inter Milan. Gelandang Denmark itu kini dikabarkan menjadi rebutan beberapa tim Premier League. https://t.co/A5Hp7EF3je,6,0,0,0,2022-01-18,22,Tuesday,2,6,0
1483572172031508483,2022-01-18 22:49:03,"Tak ada pemenang dalam laga Brighton &amp; Hove Albion vs Chelsea. The Blues unggul melalui Hakim Ziyech, namun dibalas Brighton lewat Adam Webster. Skor akhir 1-1. https://t.co/D6zATRKxkM",10,0,0,1,2022-01-18,22,Tuesday,2,10,1
1483571415118974978,2022-01-18 22:46:03,Maling motor ini benar-benar berani. Pelaku mencuri enam motor sekaligus dari satu rumah kos di Kota Blitar. https://t.co/kRQy4UeaoO,14,0,1,1,2022-01-18,22,Tuesday,2,15,1
1483571168107974666,2022-01-18 22:45:04,Song Jia terlibat kontroversi usai diduga mengenakan barang desainer KW. Ia pun mengakuinya dan meminta maaf. #SongJia  https://t.co/Gew0xRL5EZ,10,0,1,1,2022-01-18,22,Tuesday,2,11,1
1483570168487940096,2022-01-18 22:41:06,"Seiring perkembangannya, ada berbagai profesi yang dibutuhkan di Metaverse agar dapat meluas di masyarakat. Berikut jenis pekerjaan paling dicari di Metaverse. https://t.co/eSJaE15BFs",9,1,2,0,2022-01-18,22,Tuesday,2,11,1
1483569673769824258,2022-01-18 22:39:08,"Borussia Dortmund bertemu tim Bundesliga 2, ST. Pauli, di 16 besar DFB-Pokal. Secara mengejutkan Die Borussen tumbang 1-2. https://t.co/wxHH6nBmUP",5,0,0,0,2022-01-18,22,Tuesday,2,5,0
1483568154811023371,2022-01-18 22:33:06,"Kemenkes menyebut hingga saat ini sudah ada 840 kasus varian Omicron. Presiden Jokowi menyampaikan sejumlah pesan, termasuk untuk bekerja dari rumah atau WFH. https://t.co/BPbSUR5eBr",34,6,20,6,2022-01-18,22,Tuesday,2,54,12
1483567918398984194,2022-01-18 22:32:09,Celine Dion batal konser di Amerika Utara karena masih dalam tahap penyembuhan atas kejang otot. #CelineDion  https://t.co/qb0BhThBCX,5,2,0,1,2022-01-18,22,Tuesday,2,5,3
1483566649676550158,2022-01-18 22:27:07,Andrew Garfield juga membohongi Emma Stone soal penampilannya di Spider-Man: No Way Home. Begini kisahnya:  https://t.co/SK6TZV3hHe,6,1,0,0,2022-01-18,22,Tuesday,2,6,1
1483565614920781828,2022-01-18 22:23:00,WhatsApp sedang mengembangkan dua opsi baru untuk fitur edit foto dan videonya. Salah satunya bisa blur foto sebelum dikirimkan. #WhatsApp  https://t.co/n9FKnxxi8N,14,0,1,0,2022-01-18,22,Tuesday,2,15,0
1483564373914308616,2022-01-18 22:18:04,Seorang perempuan di Jember ditemukan tewas dengan leher tergorok. Seorang pria yang diduga pelaku pembunuhan ditangkap setelah sempat berduel dengan warga. https://t.co/YsNwxaWnM0,9,0,2,0,2022-01-18,22,Tuesday,2,11,0
1483563261048102916,2022-01-18 22:13:39,"Ibu Kota Negara (IKN) Indonesia yang baru adalah Nusantara, sesuai pilihan Presiden Joko Widodo yang ditetapkan dalam UU IKN. Berikut akar nama Nusantara. https://t.co/0ePWyX7Dnp",49,3,13,4,2022-01-18,22,Tuesday,2,62,7
1483562157711278091,2022-01-18 22:09:16,Money Heist Korea siap ditayangkan tahun ini. Netflix mengungkap teaser spesial sekaligus judul resmi serial tersebut. Ini bocorannya:  https://t.co/jqXahddttd,7,1,3,0,2022-01-18,22,Tuesday,2,10,1
1483560406287323141,2022-01-18 22:02:18,"BMKG memberikan peringatan dini untuk wilayah DKI Jakarta. Dalam prakiraan cuaca Jakarta, disebut ada potensi hujan sedang hingga lebat di wilayah DKI Jakarta https://t.co/sFks7Cxzfa",9,1,3,1,2022-01-18,22,Tuesday,2,12,2
1483560204637724673,2022-01-18 22:01:30,"Seorang pemuda di Blitar mengakhiri hidup dengan gantung diri. Lewat surat wasiat ia mengaku tidak kuat meneruskan hidup, setelah dinyatakan positif HIV/Aids. https://t.co/BTkiLD7qHk",25,10,10,4,2022-01-18,22,Tuesday,2,35,14
1483559135874588673,2022-01-18 21:57:15,"Sebelum Indonesia heboh dengan foto selfie Ghozali Everyday, sudah banyak seniman Tanah Air yang berbondong-bondong menjual karyanya di berbagai platform NFT.  https://t.co/PjcgmDfTNK",7,0,2,0,2022-01-18,21,Tuesday,2,9,0
1483557868842409994,2022-01-18 21:52:13,Universitas Gadjah Mada (UGM) siap menggelar KBM Bauran untuk seluruh mahasiswa UGM. Begini syarat untuk mahasiswanya. https://t.co/XRQUAMvMnW,3,0,1,1,2022-01-18,21,Tuesday,2,4,1
1483556870270955524,2022-01-18 21:48:15,"Rumah tangganya sempat dikabarkan retak, Shandy Aulia terlihat bersama lagi dengan sang suami. Ini alasan Shandy soal kembali dengan sang suami:  https://t.co/soYo9vwDEh",7,0,1,0,2022-01-18,21,Tuesday,2,8,0
1483554626351865856,2022-01-18 21:39:20,"Seorang mantan anggota DPRD Brebes, Jawa Tengah, RQ (80), dilaporkan ke polisi karena diduga menjual tanah warga tanpa sepengetahuan pemiliknya. https://t.co/mEiF2ESFxC",9,0,1,0,2022-01-18,21,Tuesday,2,10,0
1483553567705378825,2022-01-18 21:35:08,Ketum Partai Demokrat AHY beserta jajarannya mengunjungi Rumah Dinas Ketua DPD RI La Nyalla. Pertemuan itu disebut membahas presidential threshold 0%. https://t.co/TUyZ7SqYP4,9,5,1,2,2022-01-18,21,Tuesday,2,10,7
1483552485339971588,2022-01-18 21:30:50,"Anggota TNI AD tewas dikeroyok oleh delapan orang pemuda. Pengeroyokan itu terjadi Minggu (16/1) di Penjaringan, Jakarta Utara. https://t.co/xmBNNRhpOE",3,1,1,0,2022-01-18,21,Tuesday,2,4,1
1483551660219809805,2022-01-18 21:27:33,"Jokowi memilih Nusantara sebagai nama untuk ibu kota negara (IKN) di Kaltim nanti. Di negeri jiran Malaysia, Nusantara dipahami sebagai Kepulauan Melayu. https://t.co/5P57NN6UKV",46,19,5,3,2022-01-18,21,Tuesday,2,51,22
1483550639527452672,2022-01-18 21:23:30,"Petugas menyegel dua kafe di Jalan Flamboyan Raya Medan Selayang, Medan. Kedua kafe lapo itu ditutup karena dianggap mengganggu keamanan dan ketertiban umum. https://t.co/946YO54fZR",8,0,0,1,2022-01-18,21,Tuesday,2,8,1
1483549838696398850,2022-01-18 21:20:19,"Secara resmi, Hendry Saputra sudah tak lagi menjadi pelatih kepala sektor tunggal putra di Pelatnas PBSI. Ia ""geser"" selepas tujuh tahun d posisi itu. https://t.co/O34RKHkNhU",6,0,1,1,2022-01-18,21,Tuesday,2,7,1
1483549040088428548,2022-01-18 21:17:08,Pasha dan keluarganya sedang menikmati liburannya ke Turki. Pasha dapat peringatan dari netizen saat liburan ke Turki.  https://t.co/3rw2nkIeub,14,14,2,6,2022-01-18,21,Tuesday,2,16,20
1483547394692325380,2022-01-18 21:10:36,"Kecelakaan beruntun terjadi di Pangkalan 5, Bantargebang, Kota Bekasi. Akibatnya, 3 mobil ringsek. https://t.co/Wtv6Umr2G3",0,0,0,1,2022-01-18,21,Tuesday,2,0,1
1483546376592056321,2022-01-18 21:06:33,Pemerintah melaporkan kasus harian positif Corona selama 24 jam terakhir sebanyak 1.362 kasus. Provinsi DKI Jakarta melaporkan kasus paling banyak. https://t.co/B6Zor0cbxi,6,0,2,0,2022-01-18,21,Tuesday,2,8,0
1483545301994688512,2022-01-18 21:02:17,"Ayu Aulia kembali jadi sorotan, kali ini ia memperlihatkan liburannya bersama Zikri Daulay setelah heboh video mesra. Ini momen liburan mereka:  https://t.co/mecxvPF0p2",5,1,1,0,2022-01-18,21,Tuesday,2,6,1
1483544231788621834,2022-01-18 20:58:02,PPP merespons usulan anggota DPR Fadli Zon yang mengusulkan nama IKN baru dengan 'Jokowi'. PPP mengatakan Jokowi tak ingin pencitraan walau bisa saja terwujud. https://t.co/fXfChSlHRV,4,2,1,0,2022-01-18,20,Tuesday,2,5,2
1483542252748214272,2022-01-18 20:50:10,Tubuh Mawarni yang melawan penyakit kini tinggal kulit berbungkus tulang. Dia hanya bisa terbaring pasrah. Mari bantu Mawarni lewat https://t.co/gJZ8ovBbIQ https://t.co/PHGcxw3vu0,10,0,2,1,2022-01-18,20,Tuesday,2,12,1
1483540993056165891,2022-01-18 20:45:10,Puluhan warga Probolinggo mengaku menjadi korban penipuan investasi bodong senilai ratusan juta. Mereka ramai-ramai melaporkannya ke Polres Probolinggo. https://t.co/t5hBs0Lv1L,6,1,0,1,2022-01-18,20,Tuesday,2,6,2
1483539746039205890,2022-01-18 20:40:12,Soyeon eks T-ara mengumumkan pernikahan dengan pesepakbola Cho Yu Min. Keduanya berencana menikah pada November 2022. #Soyeon  https://t.co/iuyCqNm9d7,0,0,1,0,2022-01-18,20,Tuesday,2,1,0
1483538009094037511,2022-01-18 20:33:18,"Dengan adanya fitur baru tersebut, pelanggan GoFood tidak perlu lagi repot-repot menyiapkan uang receh untuk membayar ongkos parkir driver ojol. https://t.co/HBOilZwwlo",9,1,6,1,2022-01-18,20,Tuesday,2,15,2
1483536777017282563,2022-01-18 20:28:25,"Everton bergerak cepat mencari pengganti Rafael Benitez. Untuk manajer baru, The Toffees kini mendekati Frank Lampard dan Wayne Rooney. https://t.co/7rkwzrXHq9",1,0,0,0,2022-01-18,20,Tuesday,2,1,0
1483535775677521926,2022-01-18 20:24:26,"Ketua Pansus RUU Ibu Kota Negara (IKN), Ahmad Doli Kurnia, mengungkapkan ada warga nakal yang diam-diam membuat permukiman di tanah ibu kota baru. Doli mengingatkan agar hal ini bisa menjadi perhatian pemerintah. https://t.co/0y1xRASGtc",4,2,3,0,2022-01-18,20,Tuesday,2,7,2
1483533585298698243,2022-01-18 20:15:44,Novel Baswedan dan 43 eks pegawai KPK lainnya kini sudah mulai bekerja sebagai ASN Polri. Ini target yang diberikan Polri kepada Novel. https://t.co/JZHHeztHAl,3,3,1,0,2022-01-18,20,Tuesday,2,4,3
1483532492204388362,2022-01-18 20:11:23,"Kejagung menggeledah 3 lokasi terkait kasus dugaan korupsi proyek pengadaan satelit pada Kemhan. 3 lokasi itu adalah 2 kantor PT DNK, dan 1 apartemen. https://t.co/tw9fIHQTq5",6,0,0,0,2022-01-18,20,Tuesday,2,6,0
1483531505590755338,2022-01-18 20:07:28,"Pemda DIY menjadwalkan tahapan awal relokasi PKL Malioboro, yaitu undian tempat bagi PKL, dimulai pekan depan. Relokasi ditargetkan selesai pada Februari 2022. https://t.co/iWPgEqhyug",3,0,0,0,2022-01-18,20,Tuesday,2,3,0
1483529688488321036,2022-01-18 20:00:15,"Untuk meningkatkan kemampuan talenta digital para karyawannya, Telkom menggandeng Microsoft Indonesia. Sekitar 3.000 talenta Telkom siap upgrade skill digital. https://t.co/WucXCpQBr6",7,0,2,1,2022-01-18,20,Tuesday,2,9,1
1483528679493885955,2022-01-18 19:56:14,Xiaomi kabarnya sedang menyiapkan ponsel layar lipat pesaing Samsung Galaxy Z Flip 3. Ponsel ini diklaim akan hadir dengan harga yang lebih terjangkau. https://t.co/JhPQyXFmy2,8,2,2,1,2022-01-18,19,Tuesday,2,10,3
1483527691555020800,2022-01-18 19:52:18,"""Berikan contoh layaknya seorang politisi dan pejabat publik yang baik, yang mengayomi masyarakat, bukan membuat gaduh dengan ucapan-ucapan yang membuat ketersinggungan masyarakat."" https://t.co/R56qxuVu2u",15,9,5,1,2022-01-18,19,Tuesday,2,20,10
1483526715318099969,2022-01-18 19:48:26,"Nadine Kaiser membuka diri untuk pertama kali bercerita tentang banyak hal; Susi Air, Pangandaran, ambisi pribadi, masa remajanya, hingga air mata patah hatinya kepada Indonesia. Simak di sini:  https://t.co/vchMNak4RH",5,0,0,0,2022-01-18,19,Tuesday,2,5,0
1483525710341971975,2022-01-18 19:44:26,Muhammad Sabiq Hibatulbaqi mewarnai dunia NFT Tanah Air. NFT ciptaannya yang berjudul Melancholy of Doubt and Fear berhasil memenangkan kompetisi. Ini kisahnya:  https://t.co/l2tQUpOSPr,5,0,1,0,2022-01-18,19,Tuesday,2,6,0
1483524622607921157,2022-01-18 19:40:07,Indonesia berpeluang besar mengembangkan metaverse versi tersendiri. Perhelatan Presidensi G20 2022 pun jadi unjuk gigi Indonesia di panggung dunia.  https://t.co/zisipPbht8,3,2,0,0,2022-01-18,19,Tuesday,2,3,2
1483522986007314437,2022-01-18 19:33:37,Ini fakta menarik soal iPhone yang mungkin jarang diketahui oleh para penggunanya. Ini daftarnya:  https://t.co/soyaloZfjc,6,1,1,0,2022-01-18,19,Tuesday,2,7,1
1483521920918241289,2022-01-18 19:29:23,"Eureka! segera hadir mewarnai hari-hari dengan tanya jawab bareng pakar. Kali ini temanya soal alien, UFO dan exoplanet. Kira-kira, ada yang pernah lihat UFO? https://t.co/GOqZy0qCGu",2,1,0,1,2022-01-18,19,Tuesday,2,2,2
1483520926469832705,2022-01-18 19:25:26,Rancangan ibu kota baru Indonesia sudah diumumkan oleh pemerintah. Berikut 4 hal yang diketahui. https://t.co/hPsymgtceH,1,1,2,0,2022-01-18,19,Tuesday,2,3,1
1483520185659179008,2022-01-18 19:22:29,"Otoritas kesehatan Beijing, China, mendeteksi adanya varian Omicron pada paket dokumen. Paket ini diketahui berasal dari Kanada. https://t.co/W74oLc8cNr",2,1,3,0,2022-01-18,19,Tuesday,2,5,1
1483519376426995713,2022-01-18 19:19:16,"Muklis Abdul Kholik alias Adul, bocah difabel asal Sukabumi ini tetap semangat menjalani sekolah. Dia bahkan mengajak anak-anak untuk menjalani vaksinasi. https://t.co/PdxT8dm7wX",12,4,1,1,2022-01-18,19,Tuesday,2,13,5
1483518322427801606,2022-01-18 19:15:05,"Dalam rangka mendorong UMKM agar semakin berdaya dan berjaya, Tokopedia dan GoTo Financial terus menggencarkan gerakan #BangkitBersama. https://t.co/in02S9vefO",2,0,0,0,2022-01-18,19,Tuesday,2,2,0
1483517558045171713,2022-01-18 19:12:02,Hingga kini belum diketahui apakah pelaku telah diberikan sanksi dari pihak kepolisian. Polisi menyayangkan sikap pelaku. https://t.co/9HU5VHCWu1,45,47,10,6,2022-01-18,19,Tuesday,2,55,53
1483517063096373254,2022-01-18 19:10:04,Rachel Amanda enggan membahas soal urusan percintaannya. Ia juga nggak mau buru-buru menikah. #RachelAmanda  https://t.co/83R7hUs691,10,0,0,0,2022-01-18,19,Tuesday,2,10,0
1483515315791216644,2022-01-18 19:03:08,Manajer Tottenham Hotspur Antonio Conte menyebut penundaan laga lawan Arsenal sangat aneh. Ia meyoroti pertimbangan Premier League di keputusan itu. https://t.co/iwFoADTca0,2,0,0,0,2022-01-18,19,Tuesday,2,2,0
1483514463697448961,2022-01-18 18:59:45,Angka vaksinasi di dunia masih tidak seimbang. Kini ada masalah baru ketika vaksin yang diberikan ke negara-negara miskin hampir habis masa berlakunya. https://t.co/aJZRMxfCg2,6,1,1,0,2022-01-18,18,Tuesday,2,7,1
1483513713743253511,2022-01-18 18:56:46,Kekalahan dari Spezia menjadi pelajaran berharga untuk AC Milan. Rossoneri harusnya tak kehilangan poin andai tampil lebih mematikan di laga ini. https://t.co/pPq4r1c3t9,1,0,0,0,2022-01-18,18,Tuesday,2,1,0
1483512709127802882,2022-01-18 18:52:46,"Winarno alias Bento (42), warga Klaten, Jawa Tengah ditangkap polisi usai menganiaya biduanita saat manggung. Begini pengakuannya. https://t.co/aQrYAq0Hac",2,0,0,1,2022-01-18,18,Tuesday,2,2,1
1483511718642921472,2022-01-18 18:48:50,Spotlight culture detikcom bakal membahas karya satire video stiker berjalan yang memenangkan kompetisi NFT bernama NFT Art Prized Moments 2021. Simak di sini:  https://t.co/CEbSmqsevp,5,0,1,0,2022-01-18,18,Tuesday,2,6,0
1483510714639728645,2022-01-18 18:44:51,IKN Nusantara ini juga akan menjadi simbol identitas nasional. https://t.co/tkRynh55D9,4,1,2,1,2022-01-18,18,Tuesday,2,6,2
1483510224145293328,2022-01-18 18:42:54,"Membaca doa qunut subuh pendek saat salat adalah sunnah bagi muslim. Doa ini sangat disarankan bagi yang tertimpa masalah dan perlu petunjuk Allah SWT.

via: detikedu https://t.co/Tt5R1SnRKw",39,0,9,0,2022-01-18,18,Tuesday,2,48,0
1483509208809189381,2022-01-18 18:38:52,"Dengan adanya fenonema penjualan NFT foto KTP, bagaimana dampak hingga risiko yang didapatkan? https://t.co/dPFXUS2fuB",5,0,1,2,2022-01-18,18,Tuesday,2,6,2
1483508148065472515,2022-01-18 18:34:39,Britney Spears sempat menikah dengan Jason Alexander pada 2004 lalu. Namun pernikahan mereka hanya bertahan selama 55 jam saja. Ini kisahnya:  https://t.co/7Zj9xGJMe7 https://t.co/qLr542VDov,4,3,2,0,2022-01-18,18,Tuesday,2,6,3
1483507153977630728,2022-01-18 18:30:42,"Pernyataan Arteria Dahlan soal Kajati diganti gegara berbicara bahasa Sunda menuai polemik. Selain itu, artis FTV dikeroyok di klab malam Bogor. https://t.co/KMRp8I6RWt",3,4,0,0,2022-01-18,18,Tuesday,2,3,4
1483505874593320970,2022-01-18 18:25:37,"Orang yang dinyatakan hilang ternyata ditemukan selamat. Atas berbagai pertimbangan, operasi SAR dinyatakan selesai dan diusulkan ditutup. https://t.co/2jsCW6povC",7,2,0,0,2022-01-18,18,Tuesday,2,7,2
1483504879825997828,2022-01-18 18:21:40,Pernyataan Arteria Dahlan soal Kajati dicopot gegara bicara bahasa Sunda dinilai keterlaluan oleh Dosen Satra Unpad Gungun Gunardi dan Budayawan Abah Ruskawan. https://t.co/USqU5mtPv0,14,5,4,1,2022-01-18,18,Tuesday,2,18,6
1483503648533622789,2022-01-18 18:16:46,"Bila kamu merasa percaya diri dalam kemampuan berhitungmu, maka teka-teki ini bisa jadi tantangan yang tepat. Yuk coba selesaikan dalam 10 detik! https://t.co/OchM4JYXEV",23,26,1,1,2022-01-18,18,Tuesday,2,24,27
1483502141180362752,2022-01-18 18:10:47,Presiden Jokowi memilih Nusantara sebagai nama Ibu Kota Negara. Begini asal-usul kata 'Nusantara' menurut sejarawan UGM Sri Margana. https://t.co/cqOsQ3oMgY,20,11,8,1,2022-01-18,18,Tuesday,2,28,12
1483501142382419975,2022-01-18 18:06:49,Shilpa Shetty sempat menjalin kisah cinta dengan Akshay Kumar pada era 90'an. Sang aktor pun disebut sebagai pacar dan pria pertamanya. Ini kisahnya:  https://t.co/ABLSKiLS5Z,2,0,0,0,2022-01-18,18,Tuesday,2,2,0
1483500037091045382,2022-01-18 18:02:25,Polisi akhirnya menangkap pria bernama Winarno alias Bento yang berulah cabul dan menganiaya biduanita yang sedang manggung di Klaten. Begini kronologinya. https://t.co/Rfh4ummRnN,8,0,0,0,2022-01-18,18,Tuesday,2,8,0
1483498755609571333,2022-01-18 17:57:20,"Kasus dugaan suap Bupati Penajam Paser Utara Abdul Gafur Mas'ud menyisakan ironi. Dua tersangka kasus tersebut berusia muda, Gafur dan Nur Afifah Balqis. https://t.co/NU1kZIttju",17,3,3,3,2022-01-18,17,Tuesday,2,20,6
1483497226299191300,2022-01-18 17:51:15,"Viral Wali Kota Bitung Maurits Manriti marah di Discapil. Penyebabnya, Maurits mendapat laporan ada pungutan liar (pungli) pengurusan administrasi kependudukan. https://t.co/mnYkCYQrY4",5,0,2,0,2022-01-18,17,Tuesday,2,7,0
1483496738321281037,2022-01-18 17:49:19,"Kota Semarang, Jawa Tengah, pekan ini kembali berstatus PPKM level 1. Selain itu kondisi kasus COVID-19 di ibu kota Jawa Tengah itu juga menurun. https://t.co/4LF9ZXiiOx",7,1,1,0,2022-01-18,17,Tuesday,2,8,1
1483495986429313029,2022-01-18 17:46:19,"Kasus kekerasan seksual pada anak seakan tak ada habisnya. Rupanya, persoalan psikologis bisa jadi penyebab seseorang menjadi pelaku tindakan keji tersebut. Ini beberapa faktornya: https://t.co/QKppb1q6QL",13,0,0,0,2022-01-18,17,Tuesday,2,13,0
1483495186588221447,2022-01-18 17:43:09,Manajer interim Manchester United Ralf Rangnick menyebut masalah dengan Anthony Martial sudah selesai. Ia juga bicara kans Martial masuk skuad vs Brentford. https://t.co/Hn4Psd9Ucf,2,0,0,0,2022-01-18,17,Tuesday,2,2,0
1483494911055958016,2022-01-18 17:42:03,Raffi Ahmad memperlihatkan bagaimana Rafathar menabung sejak dini. Raffi juga ajarkan Rafathar sedekah.  https://t.co/bEiZ7e0BTi,68,19,8,3,2022-01-18,17,Tuesday,2,76,22
1483493372442652679,2022-01-18 17:35:56,Serangan udara pasukan koalisi pimpinan Arab Saudi menghantam kediaman seorang pejabat militer senior yang tewas bersama istri dan putranya. Serangan pada Senin (17/1) malam menewaskan sedikitnya 14 orang. https://t.co/qCleMoHCq9,4,2,2,3,2022-01-18,17,Tuesday,2,6,5
1483492363720957963,2022-01-18 17:31:56,Seperti apa ucapan Eko yang dinilai melecehkan tersebut? https://t.co/tCOwWPV7OJ,5,3,2,2,2022-01-18,17,Tuesday,2,7,5
1483491134831738884,2022-01-18 17:27:03,Ramai kabar sekolah meminta surat kesediaan orang tua murid untuk melakukan vaksin dan menanggung risiko pascavaksin anak. Menkes Budi Gunadi Sadikin menilai hal tersebut tidak tepat.  https://t.co/2FdHvVgFbp,25,9,7,6,2022-01-18,17,Tuesday,2,32,15
1483490069210189824,2022-01-18 17:22:49,Dewas KPK mengubah peraturan kode etik. Perubahan itu dilakukan imbas pegawai KPK yang telah beralih status menjadi ASN. https://t.co/xHVl9ZZ958,4,0,2,0,2022-01-18,17,Tuesday,2,6,0
1483489073574592519,2022-01-18 17:18:51,"Bareskrim Polri memusnahkan barang sitaan berupa narkoba dari berbagai jenis. 244 kg sabu, 13,8 kg ganja, 200 ribu butir ekstasi, dan happy five dimusnahkan. https://t.co/IOp4XtCjPP",11,1,3,0,2022-01-18,17,Tuesday,2,14,1
1483487823953018880,2022-01-18 17:13:53,Berbagai strategi mitigasi dilakukan untuk membendung penularan COVID-19 varian Omicron. Pelajaran tatap muka siswa dihentikan dan dilakukan micro-lockdown. https://t.co/0qzZPu0cfz,3,0,2,0,2022-01-18,17,Tuesday,2,5,0
1483486799213252609,2022-01-18 17:09:49,Harimau tersebut diduga terganggu oleh aktivitas yang sedang berlangsung. https://t.co/2X5RPfhhS5,18,0,0,1,2022-01-18,17,Tuesday,2,18,1
1483485793515618312,2022-01-18 17:05:49,Teka-teki asah otak ini menguji kemampuan berpikir logika kamu. Apakah kamu bisa menjawabnya? Buktikan di sini. https://t.co/3f72c8motI,33,49,3,1,2022-01-18,17,Tuesday,2,36,50
1483484693861392389,2022-01-18 17:01:27,"Momen itu terjadi saat para calon jemaah hendak bertolak dari Bandara Yogyakarta International Airport (YIA) Kulon Progo, DIY menuju Jakarta. Tak sedikit dari calon jemaah terlihat meneteskan air mata tanda bahagia karena bisa berangkat ke tanah suci. https://t.co/7Ijn6O9k6E",12,0,0,0,2022-01-18,17,Tuesday,2,12,0
1483483807626022917,2022-01-18 16:57:56,"#Terpopuler Yuhu.. warga Yogyakarta dan sekitarnya merapat yuk, ada info lokasi vaksin booster COVID-19 untuk DIY. Lengkap dengan syarat, cara daftar, hingga jadwal suntik. https://t.co/owQLMpqheP",11,0,5,0,2022-01-18,16,Tuesday,2,16,0
1483482774669598722,2022-01-18 16:53:49,"#Terpopuler Lokasi vaksin booster COVID-19 sudah tersedia di Jawa Barat, termasuk Sukabumi, Bandung, dan sekitarnya. Cara daftar, jadwal, jenis vaksin, bisa cek di sini: https://t.co/2irjS8oy1v",1,0,1,0,2022-01-18,16,Tuesday,2,2,0
1483481978364170245,2022-01-18 16:50:40,Tim kuasa hukum Ferdinand Hutahaean memastikan kondisi kesehatan kliennya baik usai menjalani 8 hari masa tahanan. Keterangan ini diungkapkan tim kuasa hukumnya usai menjenguk Ferdinand. https://t.co/Ejo1fyb0DR,7,1,1,2,2022-01-18,16,Tuesday,2,8,3
1483480954706350086,2022-01-18 16:46:36,"KPK akan mengkonfirmasi Bupati nonaktif Penajam Paser Utara (PPU), Abdul Gafur Masud, terkait video viral dirinya menaiki jet pribadi.  https://t.co/XIHzpEMOZf",16,4,2,1,2022-01-18,16,Tuesday,2,18,5
1483479865538007043,2022-01-18 16:42:16,Dewi Irawan mengaku kerap menggunakan barang-barang milik Ria Irawan dan Ade Irawan saat syuting film. https://t.co/9C0rM2PFBL,2,0,0,0,2022-01-18,16,Tuesday,2,2,0
1483478878245068804,2022-01-18 16:38:20,Masker N95 dan KN95 jadi dua jenis masker yang paling disarankan di tengah merebaknya Omicron. Boleh dicuci dan dipakai ulang? Begini kata Kemenkes RI. https://t.co/D2cv27nBZu,26,4,13,4,2022-01-18,16,Tuesday,2,39,8
1483477816763199489,2022-01-18 16:34:07,"Polda Metro Jaya berhasil menangkap 4 pelaku pengeroyokan hingga tewas terhadap anggota TNI AD, Pratu Sahdi (23), di Jakarta Utara. Dari keempat pelaku yang ditangkap, 3 di antaranya menjadi tersangka. Berikut kronologinya: https://t.co/j9WWHfVhEC",5,0,0,0,2022-01-18,16,Tuesday,2,5,0
1483477001855983617,2022-01-18 16:30:53,"Warga Krukut, Jakarta Barat, yang positif COVID-19 bertambah menjadi 101 orang. Jumlah itu melonjak dari dua hari sebelumnya. https://t.co/9nolnnqHFo",11,1,4,0,2022-01-18,16,Tuesday,2,15,1
1483475683724648455,2022-01-18 16:25:39,"Akibat temuan 67 kasus COVID-19, 39 sekolah di DKI ditutup. Corona naik lagi seiring marak Omicron, begini catatan epidemiolog soal pentingnya pembatasan PTM. https://t.co/fZ1o4E7eCh",11,0,0,2,2022-01-18,16,Tuesday,2,11,2
1483474680552075265,2022-01-18 16:21:40,Ada saran agar The Red Devils mendatangkan juru taktik Bighton &amp; Hove Albion Graham Potter. https://t.co/Zni1JIsTR2,6,1,0,0,2022-01-18,16,Tuesday,2,6,1
1483472539280097284,2022-01-18 16:13:09,Salah satu kandidat calon Ketua Demokrat Jatim adalah Bayu Airlangga. Bayu disebut mendapat dukungan terbesar dari semua Musda di Indonesia. https://t.co/RYvZhpNRGt,4,0,2,1,2022-01-18,16,Tuesday,2,6,1
1483470682142953475,2022-01-18 16:05:46,Seorang relawan BPBD Tulungagung meninggal dalam kecelakaan lalu lintas. Korban mengalami kecelakaan usai pulang dari lokasi bencana. https://t.co/D9D9RQhdSV,4,1,0,2,2022-01-18,16,Tuesday,2,4,3
1483470680876359683,2022-01-18 16:05:46,"BMKG memprediksi adanya peningkatan curah hujan di Jakarta, Bogor, Depok, Tangerang, Bekasi. Peningkatan curah hujan bakal terjadi 3 hari ke depan. https://t.co/RzamN7v3Rn",26,1,14,1,2022-01-18,16,Tuesday,2,40,2
1483468229167267856,2022-01-18 15:56:01,Intensitas hujan tinggi di Karawang mengakibatkan Situs Percandian Batujaya terendam banjir. https://t.co/nRFtEPAU58,5,0,3,0,2022-01-18,15,Tuesday,2,8,0
1483466545087098880,2022-01-18 15:49:20,"Sungai Petung yang melintasi wilayah Kota Pasuruan meluber. Luberan air menyebabkan jalur pantura Jalan Ir. Juanda, terendam. https://t.co/OOLUdyOxA8",13,0,1,0,2022-01-18,15,Tuesday,2,14,0
1483465679294631937,2022-01-18 15:45:54,Duel sengit tersaji di Liga 1 2021 antara Bhayangkara FC vs Persebaya Surabaya. Laga ini dimenangkan oleh The Guardian dengan skor 2-1. https://t.co/mzM6Gu1Y5Z,29,1,1,0,2022-01-18,15,Tuesday,2,30,1
1483464932582637580,2022-01-18 15:42:56,Pelapor bernama Dayat membenarkan pencabutan laporan ke polisi. Ada alasan yang disampaikan salah satunya soal kemanusiaan. https://t.co/DjBWSDnUGu,19,14,8,6,2022-01-18,15,Tuesday,2,27,20
1483463628443590660,2022-01-18 15:37:45,"Beredar foto koruptor dan mantan narapidana (napi) kasus korupsi dijual di marketplace NFT, OpenSea. Foto yang muncul mulai dari Setya Novanto hingga Muhammad Nazaruddin. https://t.co/SHfISpM03C",53,12,14,8,2022-01-18,15,Tuesday,2,67,20
1483462870927085572,2022-01-18 15:34:44,"Aurel Hermansyah mengaku bersyukur ibu sambungnya, Ashanty, sudah dinyatakan negatif Covid-19. Selain itu, Aurel pun menegaskan tujuan pergi ke Turki untuk silaturahmi ke keluarga sang suami, Atta Halilintar. https://t.co/KXIcYlWfeY",15,3,0,0,2022-01-18,15,Tuesday,2,15,3
1483460947796705284,2022-01-18 15:27:05,KPK angkat bicara soal ada akun di marketplace NFT yang menjual foto koruptor dan eks napi. KPK menyatakan pihaknya tak pernah membuat akun tersebut. https://t.co/WmZbGwODnW,13,1,1,2,2022-01-18,15,Tuesday,2,14,3
1483460428827172875,2022-01-18 15:25:02,"Tak hanya Islam, aturan halal dan haram juga ada untuk penganut Yahudi. Dikenal dengan istilah kosher dan kashruth, ini yang boleh dan tidak untuk dikonsumsi.  https://t.co/jREvGp3fmx",19,0,1,0,2022-01-18,15,Tuesday,2,20,0
1483458819565010949,2022-01-18 15:18:38,"Newcastle United menjadi tim terkaya di Eropa saat ini, namun terlihat kesulitan membeli pemain-pemain incaran di bulan Januari. Ada apa? https://t.co/ABqwRxfbnE",4,0,1,0,2022-01-18,15,Tuesday,2,5,0
1483458078091755523,2022-01-18 15:15:41,"Tumpahan minyak di Jalan Ciledug Raya, Kebayoran Lama, Jaksel menyebabkan sejumlah pengendara sepeda motor terjatuh. https://t.co/Vkgk1mTyBo",10,2,2,1,2022-01-18,15,Tuesday,2,12,3
1483458050493194250,2022-01-18 15:15:35,Wali Kota Surabaya Eri Cahyadi turun saat banjir menggenangi Jalan Ngagel Jaya Utara dan Timur. Eri berjanji kawasan ini tidak akan banjir lagi setiap tahunnya. https://t.co/nxS7sh8Fst,4,0,1,0,2022-01-18,15,Tuesday,2,5,0
1483456375552417795,2022-01-18 15:08:55,"Newcastle United menjadi tim terkaya di Eropa saat ini, namun terlihat kesulitan membeli pemain-pemain incaran di bulan Januari. Ada apa? https://t.co/38k1bIwRQN",5,0,0,0,2022-01-18,15,Tuesday,2,5,0
1483455253920075796,2022-01-18 15:04:28,"""Aku hanya ingin dikenang oleh orang-orang yang aku cintai. Dikenang sebagai orang yang loyal, memberikan bantuan jika dibutuhkan, dan menyenangkan,"" https://t.co/3oUjNskNZQ",20,0,3,1,2022-01-18,15,Tuesday,2,23,1
1483454703304384523,2022-01-18 15:02:17,Peraturan PPKM terbaru di Jabodetabek kembali dicari tahu usai pemerintah memperpanjang PPKM Jawa Bali selama sepekan terakhir. Berikut informasinya. https://t.co/QHTgne5Bov,5,0,3,1,2022-01-18,15,Tuesday,2,8,1
1483454030286307335,2022-01-18 14:59:36,Si pencetak gol jatuh sampai guling-guling saat mengirim bola ke dalam gawang. Tapi lantas ada bukti bahwa ia curang. https://t.co/Rk9ayHFCjr,7,1,0,0,2022-01-18,14,Tuesday,2,7,1
1483454015987978249,2022-01-18 14:59:33,"Sial betul nasib Samuel Umtiti, cedera dan harus dioperasi usai memperpanjang kontraknya. https://t.co/RDsc0CIPwZ",5,1,1,0,2022-01-18,14,Tuesday,2,6,1
1483453132269043717,2022-01-18 14:56:02,Donna Agnesia akhirnya menyampaikan permintaan maafnya mengenai prank yang sudah dibuatnya. #DonnaAgnesia  https://t.co/k1QF5LtiJg,12,2,3,1,2022-01-18,14,Tuesday,2,15,3
1483452614587076609,2022-01-18 14:53:59,"Ternyata di balik banyak kicauannya yang kerap bikin ramai, Susi Pudjiastuti punya tujuan lain dari kehadirannya di Twitter. Ini fakta tersembunyi menurut sang anak:  https://t.co/T9JNMkt0cj",10,1,1,0,2022-01-18,14,Tuesday,2,11,1
1483451989057015813,2022-01-18 14:51:30,"Sidang lanjutan kasus unlawful killing eks laskar FPI kembali digelar dengan menghadirkan saksi ahli ilmu kepolisian dari Universitas Bhayangkara, Kombes Pol (Purn) Warasman Marbun.  https://t.co/degj7gzhH2",8,6,1,5,2022-01-18,14,Tuesday,2,9,11
1483451941757800463,2022-01-18 14:51:18,"Nadine Kaiser punya banyak cerita sebagai pengusaha Susi Air, hingga anak Susi Pudjiastuti. Keseharian Nadine Kaiser diisi dengan beragam kisah ini:  https://t.co/pMAoLIBppt",16,1,1,1,2022-01-18,14,Tuesday,2,17,2
1483451054326964227,2022-01-18 14:47:47,Presiden Jokowi memilih Nusantara sebagai nama Ibu Kota Baru. Sejarawan menilai nama itu terlalu condong ke kebudayaan Jawa. https://t.co/ACvCwSub2w,100,78,15,14,2022-01-18,14,Tuesday,2,115,92
1483450382189842436,2022-01-18 14:45:06,"BPBD Pandeglang terus mematangkan agenda perbaikan rumah warga yang rusak terdampak gempa magnitudo (M) 6,6 di Banten. https://t.co/1TxdhDhi1s",10,0,0,0,2022-01-18,14,Tuesday,2,10,0
1483450066887233538,2022-01-18 14:43:51,AHY enggan berkomentar saat ditanyai kasus yang menimpa Bupati Penajam Paser Utara Abdul Gafur Mas'ud usai terjaring OTT KPK https://t.co/i48YUjFyDH,6,0,0,0,2022-01-18,14,Tuesday,2,6,0
1483449792529420292,2022-01-18 14:42:46,"Ketika gempa dan tsunami terjadi di dekat Tonga, pesawat ruang angkasa mengumpulkan data penting. Berikut gambar-gambar yang menunjukkan kedahsyatan letusannya. https://t.co/vNZ0HS6qwE",11,1,1,0,2022-01-18,14,Tuesday,2,12,1
1483449766906408969,2022-01-18 14:42:40,"Penggeledahan itu juga dilakukan di Rumah Dinas Jabatan Bupati, Kantor Dinas PUPR dan Kantor Dinas Disdik. Dokumen proyek hingga transaksi uang diamankan. https://t.co/3PYMzULC6N",2,0,0,0,2022-01-18,14,Tuesday,2,2,0
1483449262138695683,2022-01-18 14:40:39,"Lama terdengar namanya, Hari Pantja datang dengan kabar memprihatinkan. Kesehatan presenter program Dunia Lain itu dikabarkan menurun. https://t.co/T6CkuGG0BF",8,0,0,0,2022-01-18,14,Tuesday,2,8,0
1483449245826961416,2022-01-18 14:40:36,Isu miring soal Nagita Slavina yang dituding punya video syur berdurasi 61 detik mulai terang. Ada potongan gambar yang disebut berasal dari video aslinya. https://t.co/TmWs8QVFEs,18,5,0,0,2022-01-18,14,Tuesday,2,18,5
1483448633953509382,2022-01-18 14:38:10,"Fraksi PKS dalam rapat paripurna menyampaikan penolakan atas Rancangan Undang-undang Tindak Pidana Kekerasan Seksual (RUU TPKS) jadi inisiatif DPR. Menurut mereka, RUU TPKS belum komprehensif menjangkau tindak perzinaan dan penyimpangan seksual. https://t.co/QsbYEDWkdd",15,11,2,11,2022-01-18,14,Tuesday,2,17,22
1483448379032154112,2022-01-18 14:37:09,MK memberikan harapan bahwa MK bisa saja mengubah 15 putusan dan berbalik arah. https://t.co/j7Q0BoqMCF,30,7,5,2,2022-01-18,14,Tuesday,2,35,9
1483446978537267202,2022-01-18 14:31:35,"""Nah kalau di pinggir jalan itu lebih tinggi lagi, dulu hanya Rp 50 ribu per-meter, kalau Sekarang Rp 250 ribu per meter"" ujar Risman Abdul, Camat Sepaku  https://t.co/v0AytJx0XY",21,3,6,2,2022-01-18,14,Tuesday,2,27,5
1483446938196447238,2022-01-18 14:31:25,Presiden Jokowi menyebutkan bahwa saat ini Indonesia tengah mengalami tren kenaikan kasus Covid-19 yang diakibatkan oleh varian Omicron. Meski varian Omicron lebih mudah menular namun gejalanya lebih ringan. https://t.co/2LDG8hVewE,17,13,1,1,2022-01-18,14,Tuesday,2,18,14
1483446038149087233,2022-01-18 14:27:51,"Pada 2022 ini, pemerintah hanya merekrut Pegawai Pemerintah dengan Perjanjian Kerja (PPPK). Formasi CPNS tidak tersedia!  https://t.co/1E1Vbq0Z8A",53,6,31,15,2022-01-18,14,Tuesday,2,84,21
1483445424107237393,2022-01-18 14:25:24,Kenang Mirdad dan Tyna Kanna resmi cerai. Kenang pun harus menafkahi anaknya Rp 10 juta perbulan. #KenangMirdad #TynaKanna  https://t.co/WJRuBtOSqj,14,1,3,1,2022-01-18,14,Tuesday,2,17,2
1483445404708622343,2022-01-18 14:25:20,"Menteri PPN/ Kepala Bappenas, Suharso Monoarfa, mengatakan bahwa nama kepala ibu kota baru saat ini sudah dikantongi oleh Presiden Joko Widodo. Diketahui kepala daerah di Ibu Kota Negara (IKN) Nusantara akan dipilih langsung oleh presiden. https://t.co/Z1Kto2FgqG",11,7,2,0,2022-01-18,14,Tuesday,2,13,7
1483445382025814024,2022-01-18 14:25:14,Fadli Zon mengkritik keputusan Pemerintah dan Panja DPR RI yang sepakat ibu kota baru diberi nama Nusantara. Fadli Zon usul nama ibu kota dengan Jokowi. https://t.co/5JLuWDgr9Y,20,17,2,1,2022-01-18,14,Tuesday,2,22,18
1483444793929879555,2022-01-18 14:22:54,"Banjir setinggi sekitar 30 sentimeter merendam Jalan Bungur Besar Raya, tepatnya di depan Pengadilan Negeri Jakarta Pusat, Selasa (18/1). Banjir disebabkan intensitas hujan tinggi sejak pukul 10.00 WIB. https://t.co/Z4967OIBPJ",14,1,2,1,2022-01-18,14,Tuesday,2,16,2
1483443347490549763,2022-01-18 14:17:09,Polda Gorontalo mengeluarkan surat Pemberhentian Tidak dengan Hormat terhadap 3 oknum anggotanya karena desersi. Satu di antaranya bahkan terjerat kasus pidana. https://t.co/bDPG7SHR3W,13,0,0,0,2022-01-18,14,Tuesday,2,13,0
1483442217968717832,2022-01-18 14:12:40,"Pengacara Ferdinand Hutahaean, Rony Hutahean mendatangi Bareskrim mengecek kondisi kesehatan kliennya. Rony menyampaikan permohonan doa untuk kliennya. https://t.co/PVp5g64QlH",6,0,2,0,2022-01-18,14,Tuesday,2,8,0
1483441412192587789,2022-01-18 14:09:28,"Sejumlah siswa yang bersekolah di MTs Mathlaul Anwar di kecamatan Sumur, Pandeglang, Banten, terpaksa belajar di tenda darurat berukuran 6x12 meter. Karena ruang kelas mereka rusak parah usai diguncang gempa pekan lalu. https://t.co/CqGU1a9Msl",11,0,1,1,2022-01-18,14,Tuesday,2,12,1
1483440029149974534,2022-01-18 14:03:58,"Presiden China Xi Jinping menyerukan kerja sama dunia yang lebih besar melawan Covid-19. Ia mengatakan, pemerintahannya akan menyediakan 1 miliar dosis vaksin Covid-19 bagi negara-negara Afrika. https://t.co/5Bd9MJHOZs",9,2,1,1,2022-01-18,14,Tuesday,2,10,3
1483440009227214856,2022-01-18 14:03:53,Walikota Jakarta Barat Yani Wahyu Purwoko meninjau sejumlah permukiman warga yang terdampak banjir usai hujan deras https://t.co/z7FGWVzobR,7,2,1,1,2022-01-18,14,Tuesday,2,8,3
1483439426021871625,2022-01-18 14:01:34,"Kedua anak perempuan penyanyi Ruth Sahanaya kini sudah tumbuh menjadi perempuan dewasa, lho. Intip kedua foto mereka yang semakin cantik di sini. #detikNetwork https://t.co/47JULgHNyv",10,2,1,0,2022-01-18,14,Tuesday,2,11,2
1483438792455376897,2022-01-18 13:59:03,"Video Dorce Gamalama viral di media sosial. Dalam video itu, Dorce meminta bantuan kepada Megawati Soekarno Putri. Begini kata kerabat:  https://t.co/tNptx3Jbzg",8,0,0,1,2022-01-18,13,Tuesday,2,8,1
1483438413894365188,2022-01-18 13:57:33,Majelis yang mengadili gembong narkoba itu diketuai Eddy Army dengan anggota Jupriyadi dan Dwiarso Budi Santiarso. Berikut rekam jejak ketiganya. https://t.co/hnvwzCiPFu,34,16,4,4,2022-01-18,13,Tuesday,2,38,20
1483437892575838208,2022-01-18 13:55:29,"Meski aparat sudah menggerebek besar-besaran, namun pinjol ilegal sepertinya tiada habisnya. Pinjol ilegal masih mengintai dan kerap meneror masyarakat. #detiksAdvocate https://t.co/4BbDPaApLR",24,3,14,4,2022-01-18,13,Tuesday,2,38,7
1483437874599055361,2022-01-18 13:55:24,Kesalahan postingan di akun Twitter Presiden Jokowi terkait sirkuit Portugal yang ditulis Mandalika ramai diperbincangkan. Istana diminta klarifikasi. https://t.co/MmTRPzWanL,8,0,4,0,2022-01-18,13,Tuesday,2,12,0
1483437563650129920,2022-01-18 13:54:10,Kasus kekerasan seksual banyak terjadi di Indonesia. Kekerasan ini bahkan terjadi di ranah pendidikan seperti sekolah dan pesantren. SImak selengkapnya: https://t.co/1RHeNLhjMs,10,2,3,2,2022-01-18,13,Tuesday,2,13,4
1483437551260209155,2022-01-18 13:54:07,Donna Agnesia dan Darius Sinathrya berikan pernyataan soal rumah tangganya. Banyak yang kecewa dengan prank Donna Agnesia dan Darius. https://t.co/P8i6QRGG8H,10,1,2,1,2022-01-18,13,Tuesday,2,12,2
1483437534755622913,2022-01-18 13:54:03,"Legenda sekaligus presiden kehormatan Real Madrid, Francisco Gento, tutup usia. Dia tercatat sebagai sosok yang paling sukses dalam sejarah Liga Champions. https://t.co/hQ6FpBI8wI",8,0,0,0,2022-01-18,13,Tuesday,2,8,0
1483436823775002635,2022-01-18 13:51:14,Twitter Presiden Jokowi ramai diperbincangkan karena unggah gambar sirkuit. PKS mengatakan seharusnya pihak pengelola meminta maaf. https://t.co/htKUALdJDX,21,15,2,2,2022-01-18,13,Tuesday,2,23,17
1483436480064372743,2022-01-18 13:49:52,"Kedatangan Doddy Sudrajat yang ingin mengajak Gala Sky jalan-jalan secara mendadak mengejutkan sahabat Vanessa Angel, Marissya Icha. Marissya heran karena saat Vanessa masih hidup, Doddy diketahui sangat jarang menjenguk cucunya tersebut. https://t.co/vuryhb7qZG",19,2,1,0,2022-01-18,13,Tuesday,2,20,2
1483435956917215237,2022-01-18 13:47:47,"Pada sebuah kesempatan, ibunda Gaga Muhammad, Janariyah, menyebut luka yang dialami Laura Anna di kepala cuma lecet. Keluarga Laura murka dan tunjukan kebenarannya:  https://t.co/gj4X8NDp5N",20,1,4,1,2022-01-18,13,Tuesday,2,24,2
1483435374361853956,2022-01-18 13:45:28,Nenek Ellen Plaissaer Sjair tengah mencari keadilan usai tempat tinggal satu-satunya terancam dieksekusi pengadilan akibat ulah cucu tiri. https://t.co/2QeWM4IhG7,16,3,4,0,2022-01-18,13,Tuesday,2,20,3
1483433959308640261,2022-01-18 13:39:51,"Urusan Luhut vs Haris Azhar-Fatia berlanjut. Sempat ada kehebohan mereka hendak dijemput polisi. Siang hari, kedua aktivis HAM itu datang ke markas polisi. https://t.co/v5YZffYWce",18,2,2,1,2022-01-18,13,Tuesday,2,20,3
1483433957467344899,2022-01-18 13:39:50,Atap sebuah rumah warga di Trenggalek runtuh setelah diguyur hujan deras disertai angin kencang. Kondisi diperparah dengan konstruksi bangunan yang lapuk. https://t.co/Fc004bEDG7,6,0,0,0,2022-01-18,13,Tuesday,2,6,0
1483432910707376130,2022-01-18 13:35:41,Vonis nihil ini bukan berarti Heru Hidayat divonis bebas. Sebab hukuman di perkara sebelumnya merupakan hukuman seumur hidup. https://t.co/tAtMBLf7z4,11,1,3,2,2022-01-18,13,Tuesday,2,14,3
1483432889018634246,2022-01-18 13:35:36,Haris Azhar dan Fatia Maulidiyanti menceritakan momen penjemputannya oleh pihak kepolisian pada Selasa (18/1) pagi. https://t.co/RcfKcxC30l,13,9,3,0,2022-01-18,13,Tuesday,2,16,9
1483432623938711556,2022-01-18 13:34:33,"ONE Championship mengejutkan dunia maya. Sebab menurut studi, ajang tarung bebas itu lebih populer ketimbang UFC dan Liga Champions. Kok bisa? https://t.co/Q7Hn4cgtSn",5,2,0,0,2022-01-18,13,Tuesday,2,5,2
1483432622604886016,2022-01-18 13:34:32,Elang langka yang ditemukan nyaris mati kedinginan itu saat ini dibawa ke Balai Konservasi Sumber Daya Alam (BKSDA) DIY untuk menjalani observasi https://t.co/kD6Ey75vTp,22,1,7,0,2022-01-18,13,Tuesday,2,29,1
1483431711144873992,2022-01-18 13:30:55,Seorang artis FTV bernama Darra Permata Al Faridzi berikan kabar mengejutkan. Ia ngaku jadi korban pengeroyokan. Begini kronologinya:  https://t.co/rYVkXJlhNZ,13,2,3,0,2022-01-18,13,Tuesday,2,16,2
1483431693637894144,2022-01-18 13:30:51,Hujan deras yang mengguyur Kota Malang membuat sejumlah titik banjir. Hujan deras yang terjadi sejak pukul 14.00 WIB itu merendam sejumlah ruas jalan. https://t.co/kUlDGNUoIs,18,2,11,3,2022-01-18,13,Tuesday,2,29,5
1483430885663854595,2022-01-18 13:27:38,"Baru mendapatkan penghargaan spesial dari FIFA, Cristiano Ronaldo akan fokus untuk membantu Manchester United meraih target musim ini. https://t.co/ejoc6x1oc3",14,0,2,0,2022-01-18,13,Tuesday,2,16,0
1483430148737273857,2022-01-18 13:24:42,Sebuah penelitian terbaru menunjukkan ada beberapa makanan yang dapat memicu parosmia atau gangguan penciuman. Hal ini umum dialami penderita 'long Covid-19'.  https://t.co/gVeTH9vEIH,5,1,3,0,2022-01-18,13,Tuesday,2,8,1
1483428727572807680,2022-01-18 13:19:04,"Murid PAUD di Kabupaten Cianjur meninggal dunia pascavaksinasi COVID-19, orang tua menyebut anaknya sempat mengalami demam. https://t.co/oK7FmiQj7X",2001,485,1030,214,2022-01-18,13,Tuesday,2,3031,699
1483428335753613315,2022-01-18 13:17:30,#Foto Asyik! Bekasi rasa Korea nih. Wujud wisata sungai yang digadang-gadang itu pun akan segera terlihat lho. Penasaran? https://t.co/jPVypgC1as,13,2,3,5,2022-01-18,13,Tuesday,2,16,7
1483426554805899267,2022-01-18 13:10:26,Persib Bandung meraih poin sempurna saat bentrok dengan Borneo FC dalam lanjutan BRI Liga 1. Maung Bandung menang tipis 1-0 berkat gol Mohammed Rashid. https://t.co/nGPiu35cCF,11,3,1,0,2022-01-18,13,Tuesday,2,12,3
1483425749898084353,2022-01-18 13:07:14,"Video pria bertato tantang duel polisi di Banyuwangi viral. Rupanya, pria yang nekat mengajak duel itu diduga dalam kondisi mabuk. https://t.co/YmIAh72swD",14,0,3,0,2022-01-18,13,Tuesday,2,17,0
1483425748258021377,2022-01-18 13:07:13,"Banjir melanda belasan desa di tiga kecamatan wilayah timur Kabupaten Pasuruan. Banjir ada yang mencapai 1,5 meter dan menggenangi jalan raya. https://t.co/KU1z1mk1Kf",19,1,3,0,2022-01-18,13,Tuesday,2,22,1
1483425219511521287,2022-01-18 13:05:07,#Terpopuler Gibran menyebut masalah itu hanya salah paham belaka. Begini katanya: https://t.co/tGCKV6CaCO,13,2,3,2,2022-01-18,13,Tuesday,2,16,4
1483424665091641344,2022-01-18 13:02:55,"ITC Fatmawati jadi salah satu tujuan belanja favorit di Jakarta Selatan. Kamu bisa menemukan ragam produk fashion, gawai, hingga jajan enak di sini.  https://t.co/1xgzIqrpf5",17,2,5,2,2022-01-18,13,Tuesday,2,22,4
1483423774892515328,2022-01-18 12:59:23,#Terpopuler Anies turut meninjau perkembangan pembangunan JIS dan memuji aksi panggung Nidji. Menurut Anies lagu yang dibawakan Nidji tak terdengar sumbang. https://t.co/HSG1is2oXS,18,3,3,2,2022-01-18,12,Tuesday,2,21,5
1483423273752924160,2022-01-18 12:57:23,Oknum ulama salah satu pondok pesantren di Kota Balikpapan inisial M resmi jadi tersangka kasus pencabulan 13 santriwati. Tersangka langsung ditahan penyidik. https://t.co/ZV2lr7kxSk,32,19,30,5,2022-01-18,12,Tuesday,2,62,24
1483422997608386561,2022-01-18 12:56:17,"#Terpopuler Seorang petani di Polman, Sulbar, memperkosa putri kandungnya hingga hamil dan melahirkan. Namun, pengakuan anak petani itu membuat geger warga dan polisi. https://t.co/1Lv1o1GKg4",8,7,4,1,2022-01-18,12,Tuesday,2,12,8
1483421794895904768,2022-01-18 12:51:31,"Meninggalnya seorang bocah laki-laki di Kota Tasikmalaya, Senin (17/1/2022) selang 2 hari pascavaksinasi mendapat sorotan dari banyak pihak. https://t.co/JrYgdMw2T7",60,9,24,2,2022-01-18,12,Tuesday,2,84,11
1483421301876346884,2022-01-18 12:49:33,"Oki Setiana Dewi hanya meminta doa saat ditanya perihal adiknya, Ria Ricis, yang dikabarkan tengah hamil. https://t.co/xi7qScqZ2t",8,0,1,1,2022-01-18,12,Tuesday,2,9,1
1483420806587850758,2022-01-18 12:47:35,"Dua orang pria berduel di Ciputat, Tangsel. Penagihan utang oleh korban diduga menjadi pemicu pembacokan itu. https://t.co/qeusEu82xr",15,2,4,2,2022-01-18,12,Tuesday,2,19,4
1483420251522052102,2022-01-18 12:45:23,"Garuda Indonesia sedang menebar tiket murah lho. Tiket PP mulai dari Rp 1,3 juta untuk penerbangan Jakarta-Yogyakarta. Coba cek nih daftarnya: https://t.co/HsWqCqTLmd",26,9,7,5,2022-01-18,12,Tuesday,2,33,14
1483419151880359942,2022-01-18 12:41:01,Badan Kepegawaian Daerah (BKD) Kota Surabaya diminta terbuka menyampaikan hasil asesmen agar DPRD dapat melakukan fungsi kontrol dan memberikan masukkan. https://t.co/w7D3vwmxU6,8,2,1,1,2022-01-18,12,Tuesday,2,9,3
1483418602099417088,2022-01-18 12:38:49,Sebanyak 47 RT dan 8 ruas jalan di Jakarta terendam air. Data wilayah banjir itu tercatat per pukul 18.00 WIB. https://t.co/sgYbwwHQwv,14,3,4,6,2022-01-18,12,Tuesday,2,18,9
1483418600199364612,2022-01-18 12:38:49,"Pembangunan rumah korban banjir dan longsor di Bogor, Jawa Barat, tahun 2020 belum rampung. Apa kendalanya? https://t.co/5nTPL8FlQb",7,0,1,1,2022-01-18,12,Tuesday,2,8,1
1483417849926459397,2022-01-18 12:35:50,YouTuber Adalia Rose meninggal dunia di usia 15 tahun mengidap penyakit Benjamin Button. Seperti apa gejalanya dan siapa yang berisiko terkena penyakit ini? https://t.co/s8THMAMYyR,14,3,8,1,2022-01-18,12,Tuesday,2,22,4
1483417617197060105,2022-01-18 12:34:55,"Seorang pria bernama Kanipah alias Andre (32) di Semarang dibekuk polisi usai tega membunuh istrinya, Indah Safitri (27). Berikut faktanya. https://t.co/THOtGN27j7",8,0,1,1,2022-01-18,12,Tuesday,2,9,1
1483416555023183882,2022-01-18 12:30:41,"Nama Nusantara yang dipilih Jokowi dikritik berbau Jawa-sentrisme. Namun menurut sejarawan ini, nama Nusantara justru merupakan nama asli Kutai Kaltim. https://t.co/NV2v93Ygdx",42,9,14,3,2022-01-18,12,Tuesday,2,56,12
1483415508892409857,2022-01-18 12:26:32,"Direktur Jenderal Ketenagalistrikan Kementerian ESDM Rida Mulyana mengatakan, pajak karbon akan berpengaruh ke biaya pokok penyediaan (BPP) listrik.  https://t.co/iYofBZFMxx",16,1,2,1,2022-01-18,12,Tuesday,2,18,2
1483414969827971078,2022-01-18 12:24:23,"Tinggi muka air di Pos Pantau Sunter Hulu mengalami kenaikan pascahujan deras mengguyur Ibu Kota. Saat ini, Pos Pantau Sunter Hulu berstatus siaga 2. https://t.co/9tyb8DG8OJ",9,1,3,2,2022-01-18,12,Tuesday,2,12,3
1483414447234428928,2022-01-18 12:22:19,Fasilitas Stasiun Pengisian Kendaraan Listrik Umum (SPKLU) semakin diperbanyak.  https://t.co/CCHGr2rCDU,23,0,7,1,2022-01-18,12,Tuesday,2,30,1
1483414426476761091,2022-01-18 12:22:14,"Pelaku kejahatan pertanahan atau mafia tanah bisa dilakukan siapapun, termasuk oknum pegawai dari Kementerian ATR/BPN.  https://t.co/l48AhPSjcr",21,6,13,3,2022-01-18,12,Tuesday,2,34,9
1483414409376641025,2022-01-18 12:22:10,"Banjir yang melanda di Jalan Ahmad Yani, Cempaka Putih, Jakarta Pusat (Jakpus) telah surut. Lalu lintas di lokasi kembali normal. https://t.co/Ac4nfRxs7i",17,0,4,0,2022-01-18,12,Tuesday,2,21,0
1483414407967395841,2022-01-18 12:22:10,"Banjir di Jalan Tanjung Duren Raya, Jakarta Barat kini telah surut. Padahal, siang tadi banjir sempat menggenangi jalan tersebut setinggi 60 cm. https://t.co/ansms6jLIX",17,5,4,0,2022-01-18,12,Tuesday,2,21,5
1483414070804029441,2022-01-18 12:20:49,Tanah di sekitar ibu kota negara (IKN) baru di Kalimantan Timur mulai diburu pengembang besar.  https://t.co/Q7mP6Hzf8P,8,0,5,1,2022-01-18,12,Tuesday,2,13,1
1483414056576901128,2022-01-18 12:20:46,Keluarga almarhum Upin dan Ipin yang makamnya viral di Palu buka suara soal kisah bayi kembar itu. Ada kisah yang membuat keluarga menuliskan Upin dan Ipin. https://t.co/Omxi2iaHEB,95,9,33,6,2022-01-18,12,Tuesday,2,128,15
1483413561372286977,2022-01-18 12:18:48,Sebuah video polisi ditantang seorang pria viral. Pria yang terlihat bertato ini beberapa kali menantang polisi untuk duel. https://t.co/E2abR26oks,5,1,0,0,2022-01-18,12,Tuesday,2,5,1
1483413560013299713,2022-01-18 12:18:47,Undang-undang ibu kota negara sudah resmi disahkan oleh DPR-RI. Rencananya ibu kota negara baru yang terletak di Kalimantan Timur diberi nama Nusantara. https://t.co/bBkEiGGrNi,25,2,3,1,2022-01-18,12,Tuesday,2,28,3
1483413201786220546,2022-01-18 12:17:22,Seorang siswa kelas 11 di SMAN 22 Surabaya positif COVID-19. Dinas Kesehatan Kota Surabaya menyebut sekolah diliburkan selama 5 hari. https://t.co/BYBWLBafwW,6,0,0,1,2022-01-18,12,Tuesday,2,6,1
1483413200452337667,2022-01-18 12:17:22,Komisi VIII DPR-Kemenag sepakat Asrama Haji Pondok Gede jadi tempat karantina jemaah umroh. Kepala BNPB menyebut saat ini tersedia 780 tempat tidur di sana. https://t.co/Kzbd1KGuKS,3,0,0,1,2022-01-18,12,Tuesday,2,3,1
1483413199206719488,2022-01-18 12:17:21,Pengusaha Kiagus Emil Fahmy Cornain divonis 4 tahun penjara. Orang kepercayaan eks Kepala BP Migas Raden Priyono itu terbukti terkait PT Asuransi Jasindo. https://t.co/rwWZ8u1Q3D,6,0,1,0,2022-01-18,12,Tuesday,2,7,0
1483413197830959105,2022-01-18 12:17:21,"Angka rawat inap pasien COVID-19 terus melonjak di rumah sakit di Prancis, di tengah penyebaran varian virus Corona yang sangat menular, Omicron. https://t.co/iCI7Pty3oj",3,0,2,0,2022-01-18,12,Tuesday,2,5,0
1483413196610355203,2022-01-18 12:17:21,"Kepala BNPB Mayjen Suharyanto mengatakan akan mengunjungi Pandeglang, Banten, untuk mengecek kembali lokasi terdampak gempa bersama Wapres Ma'ruf Amin. https://t.co/Q46ji5ZY47",2,0,0,0,2022-01-18,12,Tuesday,2,2,0
1483413195360505856,2022-01-18 12:17:20,Seekor elang hitam di lereng Gunung Merapi nyaris mati kedinginan dan diselamatkan petani bernama Tukiyo Narso Wiyono (50). Seperti apa kisahnya? https://t.co/2bYoljptYC,53,2,16,2,2022-01-18,12,Tuesday,2,69,4
1483413194043494400,2022-01-18 12:17:20,"Ada ribuan hunian sementara (huntara) korban erupsi gunung Semeru, Jawa Timur, yang sedang dibangun. Pembangunan huntara akan rampung dalam waktu dua bulan. https://t.co/9IMzirYW7h",3,1,1,1,2022-01-18,12,Tuesday,2,4,2
1483413192588283908,2022-01-18 12:17:20,"Banjir di kawasan Jalan Danau Sunter Utara dan Jalan Yos Sudarso, Jakarta Utara (Jakut), telah surut. Lalu lintas di sekitar kawasan kembali normal. https://t.co/mjOMgwM6BU",5,1,0,0,2022-01-18,12,Tuesday,2,5,1
1483413190889332737,2022-01-18 12:17:19,"Petugas Pemadam Kebakaran (Damkar) mengevakuasi sarang tawon di Perumahan Puri Indah Blok E, Sidoarjo. Sarang tawon tersebut berukuran sekitar 50 cm. https://t.co/cDLLE4b6hc",5,0,1,1,2022-01-18,12,Tuesday,2,6,1
1483413189618458624,2022-01-18 12:17:19,"Ahli dari Universitas Bhayangkara Warasman Marbun mengatakan, selain orang yang berstatus sebagai tersangka, tak ada keharusan polisi melakukan pemborgolan. https://t.co/ZKzYfCUu15",1,0,3,0,2022-01-18,12,Tuesday,2,4,0
1483412383863394309,2022-01-18 12:14:07,"Haris Azhar dan Fatia Maulidiyanti datangi Polda Metro Jaya, Selasa (18/1). Keduanya datang untuk memenuhi panggilan pemeriksaan atas laporan pencemaran nama baik yang dilaporkan oleh Menko Marinves, Luhut Binsar Panjaitan. https://t.co/jkCfe4j9Jt",10,3,3,0,2022-01-18,12,Tuesday,2,13,3
1483411666272403463,2022-01-18 12:11:16,Jakarta akan menjadi tuan rumah Formula E pada 4 Juni 2022 mendatang. https://t.co/4P4wingKFn,6,2,0,2,2022-01-18,12,Tuesday,2,6,4
1483411135625838593,2022-01-18 12:09:09,Oknum perwira polisi tersebut adalah Kasatreskrim Polres Boyolali AKP Eko Marudin. Begini kronologi kejadiannya: https://t.co/vTWO4vicCO,97,24,27,11,2022-01-18,12,Tuesday,2,124,35
1483410508879384578,2022-01-18 12:06:40,Artis FTV Darra Permata Al Faridzi (DPA) menjadi korban pengeroyokan di salah satu klub malam di Kota Bogor. Polisi tengah mengusut kasus tersebut. https://t.co/esLpV8FZot,7,0,1,0,2022-01-18,12,Tuesday,2,8,0
1483409865020252168,2022-01-18 12:04:06,Kejadian itu berawal saat polisi sedang mengatur lalu lintas. Begini ceritanya: https://t.co/sQF3hmJfF8,10,2,0,1,2022-01-18,12,Tuesday,2,10,3
1483409203607834630,2022-01-18 12:01:29,Rumah produksi membeberkan asal usul Upin Ipin usai viral video yang menunjukkan kuburan Upin Ipin di Indonesia. #CNNIndonesia #detikNetwork  https://t.co/P27Q0SIiGy,20,2,5,0,2022-01-18,12,Tuesday,2,25,2
1483408442173886465,2022-01-18 11:58:27,Aurel Hermansyah mengaku siap untuk melahirkan anak pertamanya nanti. Aurel memiliki harapan dirinya dan calon buah hatinya diberikan kesehatan saat prosesi tersebut. https://t.co/yqrHhz28CZ,12,2,0,1,2022-01-18,11,Tuesday,2,12,3
1483407775254429707,2022-01-18 11:55:48,"#Terpopuler Penanganan gejala pasca-vaksin anak sepenuhnya tanggung jawab negara, termasuk soal biaya. https://t.co/g0EMnoSxSA",27,4,7,2,2022-01-18,11,Tuesday,2,34,6
1483407030681485312,2022-01-18 11:52:51,CEO Dorna Sports  melontarkan pernyataan bahwa MotoGP tidak akan balapan di negara yang mewajibkan karantina 14 hari. Berikut jawaban tegas Sandiaga Uno. https://t.co/hfLCOwiwLy,5,6,0,1,2022-01-18,11,Tuesday,2,5,7
1483406280022794241,2022-01-18 11:49:52,Pemprov Sulsel secara resmi membuka audisi imam masjid dan muazin untuk masjid kubah 99 Asmaul Husna di Makassar. Panitia membuka audisi ini secara online. https://t.co/Jhbtp3zRA2,6,0,0,0,2022-01-18,11,Tuesday,2,6,0
1483405973456838658,2022-01-18 11:48:39,"Mewaspadai tren kenaikan kasus Corona yang disebabkan oleh varian Omicron, Jokowi meminta, jika memungkinkan, agar masyarakat bekerja dari rumah. https://t.co/ltenF7d2z9",66,27,24,19,2022-01-18,11,Tuesday,2,90,46
1483405274849415170,2022-01-18 11:45:52,Matte Green serta Metallic Red merupakan warna terbaru dari Xmax 250 https://t.co/CNZCwPfhd1,3,1,1,1,2022-01-18,11,Tuesday,2,4,2
1483404556432297984,2022-01-18 11:43:01,Mario Balotelli diisukan bakal mencicipi lagi kerasnya kompetisi Premier League.  https://t.co/xw1WD5ljqM,9,1,0,0,2022-01-18,11,Tuesday,2,9,1
1483403885964410880,2022-01-18 11:40:21,Otoritas India menjeratkan dakwaan menghasut kekerasan terhadap seorang pendeta Hindu setelah dia menyerukan 'genosida' terhadap warga Muslim di negara itu. https://t.co/mHnncOJNRj,21,1,14,1,2022-01-18,11,Tuesday,2,35,2
1483403311231508483,2022-01-18 11:38:04,Delapan pelaku yang terlibat aksi itu seluruhnya berstatus warga sipil. https://t.co/bqeYQY7eV8,5,0,1,0,2022-01-18,11,Tuesday,2,6,0
1483402238034948097,2022-01-18 11:33:48,"Anggota DPR RI Fadli Zon usul nama Ibu Kota Negara diambil dari nama presiden saja, Jokowi. Sama seperti Ibu Kota Kazakhstan yang bernama Nursultan, yang diambil dari nama Presiden Nursultan Nazarbayev. https://t.co/yzGuiB5a0Z",12,19,3,4,2022-01-18,11,Tuesday,2,15,23
1483401416668557321,2022-01-18 11:30:32,Cabang olahraga Triathlon menjadi salah satu nomor yang akan dipertandingkan di ajang SEA Games 2022. https://t.co/phsE0q0DrN,4,0,0,0,2022-01-18,11,Tuesday,2,4,0
1483400440373211136,2022-01-18 11:26:39,"Lewat 5 set, Andy Murray berhasil melaju ke babak kedua Australian Open 2022. https://t.co/hTKgVTGoH4",4,0,0,0,2022-01-18,11,Tuesday,2,4,0
1483399475901218822,2022-01-18 11:22:49,"Warga di Dusun 1 Bendoro, Sidrap, Sulawesi Selatan sudah 11 hari mengalami teror pelemparan batu. Pihak TNI-Polri pun dikerahkan untuk memburu pelaku. https://t.co/9Z4pUOKXG8",10,1,3,1,2022-01-18,11,Tuesday,2,13,2
1483399118508773385,2022-01-18 11:21:24,"Indonesia mencatat sebanyak 1.362 kasus baru COVID-19, Selasa (18/1/2022). DKI menyumbang kasus terbanyak dengan jumlah 670. https://t.co/RXtEPv33kL",10,1,4,4,2022-01-18,11,Tuesday,2,14,5
1483398662206201858,2022-01-18 11:19:35,Dinkes Bantul DI Yogyakarta menyebut cakupan vaksin booster COVID-19 masih minim. Salah satu kemungkinannya karena faktor peminat masih minim. Ramaikan yuk! https://t.co/t6yN2NAYds,6,1,0,1,2022-01-18,11,Tuesday,2,6,2
1483397922406518785,2022-01-18 11:16:39,"Mantan Direktur Keuangan dan Investasi PT Asuransi Jasindo, Solihah, divonis 4 tahun penjara. Solihah diyakini telah merugikan negara senilai Rp 7,5 miliar. https://t.co/ih1pVDMlLQ",2,3,1,0,2022-01-18,11,Tuesday,2,3,3
1483397335170355202,2022-01-18 11:14:19,Shin Tae-yong memanggil enam pemain baru untuk laga uji coba melawan Timor Leste.  https://t.co/uUpRZuIVYc,11,0,1,0,2022-01-18,11,Tuesday,2,12,0
1483396073934753792,2022-01-18 11:09:18,Giring PSI mengunggah lagu yang dinyanyikannya dengan lirik 'jangan kau dengarkan suara sumbang'. Gerindra DKI meminta agar Giring tak baperan. https://t.co/q5tHmCy2iN,31,14,5,5,2022-01-18,11,Tuesday,2,36,19
1483395584027410432,2022-01-18 11:07:22,"Seekor harimau Sumatera muncul saat pekerja sebuah perusahaan perkebunan di Kabupaten Pasaman Barat, Sumatera Barat, mengoperasikan alat berat. Satwa liar tampak seperti mengawasi para pekerja yang tengah membuka lahan dan menebang pohon di hutan itu. https://t.co/Xj27aIPuQw",153,82,63,37,2022-01-18,11,Tuesday,2,216,119
1483394950796562436,2022-01-18 11:04:51,Varian lokal di Jatim muncul sejak COVID-19 dua tahun lalu. Varian lokal ini disebut mutasi B.1.619. https://t.co/TuQXzuoYEr,8,3,2,2,2022-01-18,11,Tuesday,2,10,5
1483394274116964354,2022-01-18 11:02:09,"Anggota Fraksi PKS, Hammid Noor Yasin menyampaikan interupsi dalam rapat paripurna pengesahan RUU Ibu Kota Negara (IKN). Fraksi PKS menolak pengesahan RUU IKN, lantaran pemindahan ibu kota negara dinilai akan membebani keuangan negara. https://t.co/8HtuULAEdP",11,3,3,1,2022-01-18,11,Tuesday,2,14,4
1483394224607354885,2022-01-18 11:01:57,Haris Azhar buka suara terkait upaya penjemputan paksa yang dilakukan kepolisian pagi (18/1) tadi. Haris Azhar disebut mangkir dari pemanggilan pemeriksaan dengan alasan tak wajar. https://t.co/OjDy39qVtn,5,3,0,1,2022-01-18,11,Tuesday,2,5,4
1483393146641911808,2022-01-18 10:57:40,Persib Bandung menyadari tekanan dari Bobotoh menjelang duel dengan Borneo FC pada Liga 1 2021/2022. https://t.co/oi9oCiVfHz,3,0,0,0,2022-01-18,10,Tuesday,2,3,0
1483392786913243138,2022-01-18 10:56:15,"Haris Azhar dan Koordinator KontraS, Fatia Maulidiyanti, didatangi polisi pagi ini karena sudah dua kali tidak memenuhi panggilan. Berikut kronologinya. https://t.co/Wd84RtB8Jl",6,0,1,0,2022-01-18,10,Tuesday,2,7,0
1483392081611608065,2022-01-18 10:53:27,Kasus varian Omicron di Indonesia didominasi oleh kasus impor dari pelaku perjalanan luar negeri. Berikut 10 negara penyumbang terbanyak kasus impor Omicron. https://t.co/QtKW1z1YGj,12,2,2,4,2022-01-18,10,Tuesday,2,14,6
1483392043846098944,2022-01-18 10:53:18,"Perseverance NASA melihat lapisan ungu di antara nuansa berkarat kemerahan di Mars. Lapisan ini sungguh misterius, para peneliti sedang mencari tahu apa itu. https://t.co/KusGDX9qaL",3,1,0,1,2022-01-18,10,Tuesday,2,3,2
1483391315660480513,2022-01-18 10:50:24,Viral video yang memperlihatkan aksi seorang perempuan yang mencocol bakso langsung ke mangkuk sambalnya. Dokter beberkan sederet risikonya. https://t.co/Mz0xhTnIda,5,3,1,2,2022-01-18,10,Tuesday,2,6,5
1483390944904945666,2022-01-18 10:48:55,"La Grande Indonesia melakukan aksi mendukung Shin Tae-yong, dengan pamflet  pesan #STYStay dan #HarunaOut terpasang. https://t.co/iLlxzI6f11",7,1,2,0,2022-01-18,10,Tuesday,2,9,1
1483390594936451075,2022-01-18 10:47:32,"Berdasarkan studi terbaru, Manchester United dinobatkan sebagai tim dengan jumlah hadiah penalti terbanyak di lima liga top Eropa. https://t.co/nigH1Zaw3P",5,2,1,2,2022-01-18,10,Tuesday,2,6,4
1483389861520633856,2022-01-18 10:44:37,"Masih sempat masak seharian penuh untuk anggota keluarganya, sebelum menjalankan operasi kanker. Wanita ini dapat pujian dari banyak orang.  https://t.co/JrS65NJgrY",3,0,0,0,2022-01-18,10,Tuesday,2,3,0
1483389502496387072,2022-01-18 10:43:12,"Warga ibukota Jakarta, ada info lokasi sentra vaksin booster lagi nih. Sekarang lokasinya di mal loh. Yuk, kunjungi sekarang biar bisa menangkal Omicron. https://t.co/d1s1YVKrOC",9,0,3,1,2022-01-18,10,Tuesday,2,12,1
1483388756962983938,2022-01-18 10:40:14,Stadion Jatidiri Semarang diketahui telah selesai direnovasi. Berikut wajah baru stadion berkapasitas 25 ribu tempat duduk tersebut! https://t.co/T0bJdo4ysO,0,0,1,0,2022-01-18,10,Tuesday,2,1,0
1483387841723916289,2022-01-18 10:36:36,"Gaya Prilly Latuconsina selama liburan di AS mencuri atensi, terutama penampilannya di New York. Seperti apa ya? https://t.co/kggvdbzv7t",39,6,5,7,2022-01-18,10,Tuesday,2,44,13
1483387751315738627,2022-01-18 10:36:14,"iPhone SE 3 kabarnya akan rilis dalam waktu dekat. Bocoran wujudnya yang mirip iPhone XR beredar, tapi ada yang mencurigakan dari render desain ini:  https://t.co/r9IeL748Bv",5,2,1,0,2022-01-18,10,Tuesday,2,6,2
1483387221856108548,2022-01-18 10:34:08,"Otoritas keamanan Ukraina menyebut ada 70 situs pemerintahan yang terkena serangan siber, dan mereka menduga serangan ini dilancarkan hacker Rusia. https://t.co/pjf5oUJdbY",1,0,0,0,2022-01-18,10,Tuesday,2,1,0
1483386459386265600,2022-01-18 10:31:06,Timor Leste dipilih PSSI sebagai lawan uji coba Timnas Indonesia pada jeda internasional. https://t.co/GNB2oGzcUj,15,3,0,0,2022-01-18,10,Tuesday,2,15,3
1483386251323531264,2022-01-18 10:30:16,"Tanpa kehadiran Djokovic akibat dideportasi, akankah grand slam itu masih menggigit ? https://t.co/Lj7ojB5JX3",2,1,0,0,2022-01-18,10,Tuesday,2,2,1
1483384541276479488,2022-01-18 10:23:29,Pemerintah memastikan harga minyak goreng dibanderol Rp 14.000/liter!  https://t.co/6ncaP2Wucc,189,47,46,24,2022-01-18,10,Tuesday,2,235,71
1483384445898010625,2022-01-18 10:23:06,Waspada Omicron! Peringatan ini diserukan menyusul kasus COVID-19 Indonesia terus mengalami lonjakan sepekan terakhir. Ketahui juga cara penyebaran Omicron ini:  https://t.co/3UTZpUnpzd,6,1,1,0,2022-01-18,10,Tuesday,2,7,1
1483384411995484165,2022-01-18 10:22:58,"Hasil Liga 1: Madura United Ditahan PSS, Barito Putera Imbangi Persikabo https://t.co/zmKjZrglUD",2,0,0,0,2022-01-18,10,Tuesday,2,2,0
1483384042452144128,2022-01-18 10:21:30,Menteri Keuangan Sri Mulyani Indrawati berencana memasukkan pembiayaan ibu kota baru ke dalam program Pemulihan Ekonomi Nasional (PEN) 2022.  https://t.co/7Ocyn0mU9f,32,7,2,2,2022-01-18,10,Tuesday,2,34,9
1483382726531371010,2022-01-18 10:16:16,"Belanja Kini Cuma Tinggal Gerakin Jempol
https://t.co/2ugNmqBP48.",4,0,0,0,2022-01-18,10,Tuesday,2,4,0
1483382550747828224,2022-01-18 10:15:34,"Seorang fotografer mengulang foto 40 tahun yang lalu dengan lokasi, latar belakang bahkan objek orang-orang yang sama yang sama lho. Ini potretnya:  https://t.co/ko6ppVlq0r",17,0,3,0,2022-01-18,10,Tuesday,2,20,0
1483382476923936770,2022-01-18 10:15:17,Hasil Liga 1: PSM Vs Persik Tuntas Tanpa Gol https://t.co/Ct9pXmZacf,6,0,0,0,2022-01-18,10,Tuesday,2,6,0
1483381611613900807,2022-01-18 10:11:50,"Gerai donat di New York, Kora jadi perbincangan hangat di kalangan foodies. Bagaimana tidak? Daftar tunggu untuk mencicipi donat di sini mencapai 10 ribu orang!  https://t.co/aKkOMGzpgI",7,0,0,0,2022-01-18,10,Tuesday,2,7,0
1483381553338200064,2022-01-18 10:11:36,"Menteri Perdagangan, Muhammad Lutfi mengatakan akan memberikan pengumuman mengenai satu harga untuk minyak goreng kemasan sederhana maupun premium.  https://t.co/tYE58qqAJ2",4,0,2,1,2022-01-18,10,Tuesday,2,6,1
1483381242724859905,2022-01-18 10:10:22,"Kafe tak hanya dikunjungi untuk menikmati hidangan lezat, tapi juga bisa sebagai tempat penghilang stres. Salah satunya disediakan oleh kafe di Korea Selatan.  https://t.co/HvnAsq7ZtL",13,0,2,2,2022-01-18,10,Tuesday,2,15,2
1483380725932081158,2022-01-18 10:08:19,AC Milan harus menyerah dari Spezia di kandang sendiri. Mungkin hasilnya akan berbeda jika penalti Theo Hernandez masuk. https://t.co/AXP0gZgqQ7,1,0,0,0,2022-01-18,10,Tuesday,2,1,0
1483380541084819456,2022-01-18 10:07:35,Puncak Omicron di Indonesia diprediksi pemerintah akan terjadi pada bulan Februari-Maret mendatang. Berikut informasi soal prediksinya. https://t.co/El7mE4Leru,6,0,1,1,2022-01-18,10,Tuesday,2,7,1
1483379979769593858,2022-01-18 10:05:21,Hampir seluruh pulau tak lagi terlihat dari atas akibat erupsi Gunung Hunga Tonga-Hunga Ha'apai. Erupsi itu juga menciptakan pulau-pulau kecil baru. https://t.co/B8Dtzj85rU,16,0,6,0,2022-01-18,10,Tuesday,2,22,0
1483379890925809668,2022-01-18 10:05:00,Penjual burger kebelet BAB saat sedang membuat burger pesanan pembeli. Ia pun menyuruh pembeli untuk memasak burger pesanannya sendiri!  https://t.co/sYrMrt9xuN,8,0,2,0,2022-01-18,10,Tuesday,2,10,0
1483379263545950208,2022-01-18 10:02:30,"Free Fire World Series 2022, siap digelar pada Mei mendatang. Turnamen Battle Royale tingkat dunia ini, akan dilaksanakan di Pulau Sentosa, Singapura. https://t.co/gUx1Om1Pef",2,0,0,0,2022-01-18,10,Tuesday,2,2,0
1483378198981541888,2022-01-18 09:58:17,"MrBeast, Youtuber kondang yang meraup pendapatan, hingga Rp 773 miliar selama 2021. Ini sosoknya:  https://t.co/bsJhZE7blW",5,0,1,2,2022-01-18,9,Tuesday,2,6,2
1483377991157702661,2022-01-18 09:57:27,"Genangan air hujan merendam Jalan Medan Merdeka Timur, Gambir, Jakpus, Selasa (18/1). Lokasinya tidak jauh dari kantor gubernur di Jl Medan Merdeka Selatan. https://t.co/AlJzNK3TJu",8,4,1,1,2022-01-18,9,Tuesday,2,9,5
1483377940599611394,2022-01-18 09:57:15,Delegasi Indonesia dilaporkan telah berkunjung ke Israel dalam rangka membahas strategi COVID-19 baru-baru ini. BNPB tegas membantah kabar tersebut. https://t.co/1SdWJnnnoU,6,1,0,0,2022-01-18,9,Tuesday,2,6,1
1483377546007822338,2022-01-18 09:55:41,"Marcelo merupakan pemain asing dengan titel terbanyak di Real Madrid, sudah meraih 23 trofi bersama Real Madrid.  https://t.co/FBf4rNurC8",13,1,0,0,2022-01-18,9,Tuesday,2,13,1
1483377508129161217,2022-01-18 09:55:32,"Saat ini, perusahaan asuransi menyediakan produk asuransi total loss only (TLO) dan all risk. Masih bingung pilih yang mana? Berikut plus-minusnya. https://t.co/OHDV7RFOfr",5,0,0,0,2022-01-18,9,Tuesday,2,5,0
1483377425119686661,2022-01-18 09:55:12,Ia pun turut memberikan apresiasi kepada Presiden Joko Widodo karena peka terhadap sejarah dan mau memberikan nama Ibu Kota Negara dengan sebutan Nusantara. https://t.co/gSnTvfvkN5,19,5,4,0,2022-01-18,9,Tuesday,2,23,5
1483376939712851973,2022-01-18 09:53:16,Survei membandingkan kepuasan pengguna Android dan iOS saat menerima update sistem operasi terbaru. Update OS apa yang bikin pengguna lebih bahagia? https://t.co/5Wyz3tVNCh,3,0,2,0,2022-01-18,9,Tuesday,2,5,0
1483376470831644672,2022-01-18 09:51:25,"Dalam postingan terbaru di media sosialnya, Ariel NOAH memberitahu netizen agar mengembalikan kotak sepatu bikinannya. https://t.co/jx45hkfCBK",4,2,0,0,2022-01-18,9,Tuesday,2,4,2
1483376438837452801,2022-01-18 09:51:17,Israel menjadi negara pertama di dunia yang melangsungkan program vaksinasi keempat COVID-19. Begini hasil studi awal vaksin keempat melawan varian Omicron. https://t.co/4lSca3LgSF,7,4,2,2,2022-01-18,9,Tuesday,2,9,6
1483376181609218048,2022-01-18 09:50:16,Hyundai Creta merupakan mobil rakitan pertama Hyundai di Indonesia. Begini kesan setelah kencan singkat bersama SUV Korea Selatan tersebut. https://t.co/kHpNxs96jB,9,1,0,0,2022-01-18,9,Tuesday,2,9,1
1483376159522017283,2022-01-18 09:50:10,"Tujuh pekerjaan ini dapat dilakukan mahasiswa sambil kuliah nih. Mulai dari penulis lepas sampai content creator. Tertarik coba buat nambah cuan?

via: detikedu https://t.co/ZEb2JBN3Xi",2,1,2,0,2022-01-18,9,Tuesday,2,4,1
1483375533702496256,2022-01-18 09:47:41,"Omicron memicu kenaikan kasus COVID-19 di Indonesia, Presiden Jokowi angkat bicara. Salah satu pesannya adalah tentang vaksinasi, termasuk vaksin booster. https://t.co/vbnbpLKpXw",3,0,4,3,2022-01-18,9,Tuesday,2,7,3
1483374939365421062,2022-01-18 09:45:19,Ardhito Pramono dibawa ke BNNP DKI Jakarta untuk melakukan proses asesmen. Diperkirakan hasil asesmen akan keluar 2 pekan lagi. https://t.co/P8GYg3bttz,21,0,1,1,2022-01-18,9,Tuesday,2,22,1
1483374719231483907,2022-01-18 09:44:27,"#FOTO Rayyanza dan Rafathar mendapatkan tamu kehormatan ke rumahnya. Menteri Ketenagakerjaan RI, Ida Fauziyah. Ini potretnya:  https://t.co/lc9bsjdYfo",5,0,1,1,2022-01-18,9,Tuesday,2,6,1
1483374211297071105,2022-01-18 09:42:26,"Belatung ramai dibicarakan setelah video TikTok belatung dalam vagina viral. Meskipun menjijikkan, ternyata belatung bisa jadi makanan berkhasiat!  https://t.co/u6SGaZrOQe",3,4,1,1,2022-01-18,9,Tuesday,2,4,5
1483373796161736705,2022-01-18 09:40:47,"Datang ke restoran sushi all-you-can-eat, wanita ini ogah rugi. Ia yang sudah bayar makan sushi hingga Rp 715 ribu, justru berujung di rumah sakit!  https://t.co/EJOWMZLHSr",3,1,0,1,2022-01-18,9,Tuesday,2,3,2
1483373576124260358,2022-01-18 09:39:54,"Di balik wajah bule dan caption fotonya yang selalu berbahasa Inggris di media sosial, Nadine Kaiser adalah murni anak pesisir. #HotQuestions  https://t.co/ccgj9TtMxp",7,0,1,0,2022-01-18,9,Tuesday,2,8,0
1483373537767436290,2022-01-18 09:39:45,"Kini hadir tempat nongkrong stylish bergaya Jepang di kawasan Tebet, Jakarta Selatan. Kafe dengan konsep taman zen yang lagi hits ini namanya REN Coffee &amp; Eatery.  https://t.co/dZfNDbLIle",2,1,0,0,2022-01-18,9,Tuesday,2,2,1
1483373511691411456,2022-01-18 09:39:39,Ada-ada saja ulah orang saat hendak ditagih utang. Seperti seorang laki-laki di Banjarnegara nekat pura-pura dibegal agar tak ditagih utang temannya. https://t.co/GK9z82SX6t,6,0,1,1,2022-01-18,9,Tuesday,2,7,1
1483373298436263941,2022-01-18 09:38:48,"Pemerintah menganggarkan program kredit usaha rakyat (KUR) sebesar Rp 373,17 triliun tahun ini.  https://t.co/yZYKX0YnWQ",4,0,2,0,2022-01-18,9,Tuesday,2,6,0
1483373281025605635,2022-01-18 09:38:44,"Kepala Bappenas, Suharso Monoarfa memastikan proses pemindahan ibu kota baru dinilai tak akan membebani Anggaran Pendapatan Belanja Negara (APBN).  https://t.co/L9WEfbwZu3",1,4,0,1,2022-01-18,9,Tuesday,2,1,5
1483372958135500801,2022-01-18 09:37:27,Polisi menyelidiki kasus pencurian motor di Bekasi yang diduga dilakukan oleh suami istri. https://t.co/j6NG9fT2rl,5,0,0,1,2022-01-18,9,Tuesday,2,5,1
1483372175826501634,2022-01-18 09:34:21,Pemerintah melanjutkan program kredit usaha rakyat (KUR) dengan bunga 3% tahun ini. Begini syarat dapatnya.  https://t.co/zq5i5Jy1Rx,7,0,2,0,2022-01-18,9,Tuesday,2,9,0
1483372152321679361,2022-01-18 09:34:15,Logo Bojonegoro dari acrylic pecah tercecer di lantai pintu masuk utama Pasar Rakyat Kedewan. Foto logo Bojonegoro pecah itu viral dan jadi pembicaraan warga. https://t.co/QaLpIJZpG1,0,0,0,0,2022-01-18,9,Tuesday,2,0,0
1483371892824231937,2022-01-18 09:33:13,"Bagi kamu para pencinta film, jangan sekali-sekali coba membuka situs IndoXXI dan LayarKaca21 untuk streaming ya!  https://t.co/5ZhDG5HxnU",134,43,38,21,2022-01-18,9,Tuesday,2,172,64
1483371875426312196,2022-01-18 09:33:09,Siswa pun perlu mengetahui apa saja yang perlu dilakukan apabila terjadi gempa saat masih belajar di sekolah. Ini panduannya. https://t.co/RJnuNECwpj,1,0,1,0,2022-01-18,9,Tuesday,2,2,0
1483371873878614016,2022-01-18 09:33:09,"Jokowi mengakui COVID-19 RI mengalami kenaikan akibat varian Omicron. Meski lebih cepat menular, varian Omicron diketahui memicu gejala yang ringan. https://t.co/nZhtC1GTVz",3,0,0,1,2022-01-18,9,Tuesday,2,3,1
1483371660887613441,2022-01-18 09:32:18,Sejumlah sepeda motor mogok akibat nekat menerobos banjir tersebut. https://t.co/BhYTqM7wKv,10,1,1,2,2022-01-18,9,Tuesday,2,11,3
1483371641690370052,2022-01-18 09:32:13,"Setelah halaman komik yang menampilkan penampakan Spider-Man laku terjual Rp 48 miliar, kini giliran komik DC yang laku Rp 45,5 miliar! https://t.co/stEZuh8MsW",4,0,0,0,2022-01-18,9,Tuesday,2,4,0
1483371605770350595,2022-01-18 09:32:05,"Presiden Jokowi membeberkan tren kasus COVID-19 di Indonesia sedang meningkat imbas varian Omicron. Jokowi meminta semua pihak tetap waspada, namun tidak panik. https://t.co/HnbLWLZHY0",14,7,8,2,2022-01-18,9,Tuesday,2,22,9
1483371332184195074,2022-01-18 09:30:59,Penyesuaian tarif (tarif adjusment) listrik untuk pelanggan golongan non subsidi akan diterapkan pada tahun ini.  https://t.co/Vvlh7fleI1,4,2,1,2,2022-01-18,9,Tuesday,2,5,4
1483371323766235136,2022-01-18 09:30:57,Penyesuaian tarif (tarif adjusment) listrik untuk pelanggan golongan non subsidi akan diterapkan pada tahun ini.  https://t.co/KKlro7Li1n,9,8,2,0,2022-01-18,9,Tuesday,2,11,8
1483370928813842435,2022-01-18 09:29:23,Jokowi meminta warga mengurangi kegiatan di pusat keramaian jika tak ada keperluan mendesak. Jokowi juga mengajak warga untuk mengoptimalkan bekerja dari rumah. https://t.co/aBrR5b3mSd,18,9,4,4,2022-01-18,9,Tuesday,2,22,13
1483370205820731392,2022-01-18 09:26:31,"Hujan deras menyebabkan banjir di Kampung Jawa Malang, Rawa Bengkel, Jakarta Barat. Banjir membuat pengendara memilih memutar balik. https://t.co/A4t4tz6TuR",6,0,0,0,2022-01-18,9,Tuesday,2,6,0
1483369965629681666,2022-01-18 09:25:34,Pemerintah Kota Bandung menggelar sayembara berhadiah total Rp 10 juta untuk mencari pelaku vandalisme di Jalan Siliwangi. https://t.co/cE7h0MEbmp,4,2,1,1,2022-01-18,9,Tuesday,2,5,3
1483369939457163264,2022-01-18 09:25:27,Menko PMK Muhadjir Effendi mengatakan bahwa sebanyak 166 desa terdampak gempa Banten. Pemerintah akan merelokasi rumah warga yang berada di titik patahan. https://t.co/RS0OnnQjKh,4,1,0,0,2022-01-18,9,Tuesday,2,4,1
1483369441492672516,2022-01-18 09:23:29,DPD Partai Demokrat Jatim akan menggelar Musda VI di Surabaya. Sejumlah DPC pemegang mandat siap mengikuti dan melaksanakan Musda secara demokratis dan positif. https://t.co/AynVlqOgw1,0,0,0,0,2022-01-18,9,Tuesday,2,0,0
1483369215340040194,2022-01-18 09:22:35,"Penerima vaksin COVID-19 mengalami gejala ringan, bahkan nihil gejala saat terinfeksi Omicron. Bagaimana dengan yang belum divaksin? Begini perbandingannya: https://t.co/rFZcPreVoa",5,1,1,0,2022-01-18,9,Tuesday,2,6,1
1483368811290148866,2022-01-18 09:20:58,"Gibran Rakabuming Raka, pendiri bisnis es doger dengan merek Goola buka suara soal kehebohan terima suntikan modal Rp 71 miliar!  https://t.co/vVtmg7XmmS",36,28,8,7,2022-01-18,9,Tuesday,2,44,35
1483368412449583105,2022-01-18 09:19:23,Sidang perdana kasus kebakaran maut Lapas Klas IA Kota Tangerang ditunda. Sidang ditunda karena Ketua Majelis Hakim Aji Suryo berhalangan hadir. https://t.co/cYTDEJw3fY,7,0,0,0,2022-01-18,9,Tuesday,2,7,0
1483368190667337729,2022-01-18 09:18:30,Andi membeberkan China sedang menyiapkan perang untuk menguasai samudra Hindia pada 2050. https://t.co/uDvcLqQVja,11,6,3,0,2022-01-18,9,Tuesday,2,14,6
1483368166784999426,2022-01-18 09:18:25,"""Berhati-hati perlu, waspada perlu, tapi jangan menimbulkan ketakutan dan jangan menimbulkan kepanikan,"" kata Jokowi. https://t.co/HqnCR92UWS",18,1,1,1,2022-01-18,9,Tuesday,2,19,2
1483367938275094530,2022-01-18 09:17:30,"""Dengan kurikulum ini, kita ingin menciptakan perubahan pada anak yang memiliki kemampuan berkolaborasi, kemampuan berpikir kritis, belajar berdebat..."" kata Nadiem.

via: detikedu https://t.co/MEgVGGZ68B",4,2,0,1,2022-01-18,9,Tuesday,2,4,3
1483367923855020053,2022-01-18 09:17:27,Presiden Jokowi meminta masyarakat tidak ke luar negeri jika tidak ada keperluan mendesak. Imbauan Jokowi itu untuk mencegah penularan varian omicron. https://t.co/y5UAjFgK83,9,1,2,0,2022-01-18,9,Tuesday,2,11,1
1483367921724411908,2022-01-18 09:17:26,Viral sebuah cerita salah seorang warga Bekasi terkait perusakan mobil di media sosial. Perusakan itu terjadi setelah pihak korban protes terkait balapan liar https://t.co/330uSfFWqt,0,0,0,0,2022-01-18,9,Tuesday,2,0,0
1483367919425933312,2022-01-18 09:17:26,"Presiden Jokowi memberi arahan kepada seluruh masyarakat baik yang belum vaksin, baru vaksin dosis pertama maupun yang sudah lengkap. https://t.co/GUFnf4aoY5",7,0,1,0,2022-01-18,9,Tuesday,2,8,0
1483367662554075138,2022-01-18 09:16:25,"Mewaspadai tren kenaikan kasus Corona yang disebabkan oleh varian Omicron, Jokowi meminta, jika memungkinkan, agar masyarakat bekerja dari rumah. https://t.co/BY46wrVqXc",16,8,10,5,2022-01-18,9,Tuesday,2,26,13
1483367412191932417,2022-01-18 09:15:25,"Hujan deras mengguyur DKI Jakarta dan sekitarnya tadi siang. Jl Letjen R Suprapto, Cempaka Putih, Jakpus tergenang air dengan ketinggian 70 cm. https://t.co/gc0ydCQ3WI",13,0,2,2,2022-01-18,9,Tuesday,2,15,2
1483367381569310721,2022-01-18 09:15:18,"Banjir menggenang di Jalan Jenderal Ahmad Yani, Jakarta, usai diguyur hujan deras. Akibatnya, jalan tersebut tidak bisa dilalui kendaraan untuk sementara. https://t.co/bhE7sfA42d",8,2,1,0,2022-01-18,9,Tuesday,2,9,2
1483366854152368130,2022-01-18 09:13:12,Kasus Omicron di Indonesia terus melonjak. Presiden Joko Widodo (Jokowi) menganjurkan warga untuk bekerja dari rumah untuk mereka yang bisa. https://t.co/hNC2eLBImi,172,64,59,55,2022-01-18,9,Tuesday,2,231,119
1483366343101628422,2022-01-18 09:11:10,"Sejumlah wilayah di Jakarta diguyur hujan. Hujan menyebabkan genangan di Jalan Letjen S. Parman, Jakarta Barat. https://t.co/CJciwPzUVc",4,0,1,0,2022-01-18,9,Tuesday,2,5,0
1483366315339534337,2022-01-18 09:11:03,"Seorang pria berinisial CFS ditangkap polisi di kawasan Patumbak, Deli Serdang, Sumatera Utara. CFS diringkus lantaran mencuri perhiasan pacarnya sendiri. https://t.co/u2TlPtf5Zn",8,0,0,0,2022-01-18,9,Tuesday,2,8,0
1483365811863568387,2022-01-18 09:09:03,"Seorang pria berinisial CFS ditangkap polisi di kawasan Patumbak, Deli Serdang, Sumatera Utara. CFS diringkus lantaran mencuri perhiasan pacarnya sendiri. https://t.co/8rwyCncowJ",7,1,0,0,2022-01-18,9,Tuesday,2,7,1
1483365810668294146,2022-01-18 09:09:03,"Seorang suami di Konawe Selatan, Sultra tega membunuh istrinya karena tidak terima diceraikan. https://t.co/A8gAkmRgul",11,0,0,1,2022-01-18,9,Tuesday,2,11,1
1483364826302894088,2022-01-18 09:05:08,"Hujan yang mengguyur kawasan Jakarta kembali menyebabkan banjir. Banjir salah satunya terjadi di Jalan Bungur Besar, tepatnya di depan Pengadilan Tipikor. https://t.co/jdywExOayw",11,1,1,0,2022-01-18,9,Tuesday,2,12,1
1483364377298354177,2022-01-18 09:03:21,Jumlah titik banjir dan genangan air di Jakarta hari ini kembali bertambah. Kini ada 19 titik. https://t.co/p6ifZaKDE9,42,21,10,2,2022-01-18,9,Tuesday,2,52,23
1483364059286278147,2022-01-18 09:02:05,"Museum Lapawawoi di Kabupaten Bone, Sulawesi Selatan, dibobol maling. Sejumlah benda-benda bersejarah milik Kerajaan Bone dibawa kabur. Parah! https://t.co/RPF2jjXrDY",9,1,1,1,2022-01-18,9,Tuesday,2,10,2
1483364032551735297,2022-01-18 09:01:59,"Bulan Februari mendatang ada game menarik bernama Duckie Land, pemainnya bisa bertani virtual dan menjual dan membeli asetnya menggunakan NFT. https://t.co/ZKx4kUB0JE",19,2,8,1,2022-01-18,9,Tuesday,2,27,3
1483363649179860995,2022-01-18 09:00:28,"Perselingkuhan memang nggak bisa ditoleransi ya, Bun. Dokter cantik ini berusaha kuat meski diselingkuhi saat dirinya hamil. Tapi akhirnya... #detikNetwork  https://t.co/srTlFA7NNe",22,3,10,0,2022-01-18,9,Tuesday,2,32,3
1483363636500385793,2022-01-18 09:00:25,Tyna Kanna dan Kenang Mirdad resmi bercerai. Perceraian mereka diputus di Pengadilan Agama Jakarta Selatan. https://t.co/QgANRepZCf,7,0,0,0,2022-01-18,9,Tuesday,2,7,0
1483363384653402112,2022-01-18 08:59:25,Polisi mengungkapkan motif dari pengeroyokan tersebut ialah kesalahpahaman. Begini ceritanya: https://t.co/0BjLB7lw0r,1,1,1,0,2022-01-18,8,Tuesday,2,2,1
1483362589438623747,2022-01-18 08:56:15,Pria ini merupakan lulusan sarjana Sastra Inggris dan pekerjaannya saat ini jadi retailer di salah satu pusat jual beli handphone ternama. Gimana kisahnya? https://t.co/vvUmSEpVRn,48,15,10,11,2022-01-18,8,Tuesday,2,58,26
1483361472084422660,2022-01-18 08:51:49,"Selesai menjalani karantina selama 12 hari di sebuah hotel di Jakarta, Atta Halilintar dan Aurel Hermansyah mengungkapkan keseruannya. Atta mengaku dirinya jadi bisa quality time bersama Aurel. https://t.co/5XepUsqZIt",4,2,0,1,2022-01-18,8,Tuesday,2,4,3
1483361222317723648,2022-01-18 08:50:49,Almira Andani ngaku pernah mendapat tindakan pelecehan. Hal itu terjadi saat ia diajak manggung di Bandung. Almira tegaskan cuma cari uang halal. https://t.co/wTxGIOQNXH,8,1,3,0,2022-01-18,8,Tuesday,2,11,1
1483360474792144899,2022-01-18 08:47:51,#FOTO Charli D'Amelio adalah bintang TikTok yang meraih pendapatan tertinggi selama tahun 2021. Inilah sosoknya yang menawan:  https://t.co/U7yhU5QCUF,3,0,1,1,2022-01-18,8,Tuesday,2,4,1
1483359955524673536,2022-01-18 08:45:47,"Anthony Martial masih bisa bermanfaat untuk Manchester United. Maka dari itu, Rangnick ingin memperbaiki hubungannya dengan Martial. https://t.co/fmxf5zOxJH",3,0,0,0,2022-01-18,8,Tuesday,2,3,0
1483359390854008832,2022-01-18 08:43:32,"Tepat 11 tahun lalu Ryan Babel, yang ketika itu membela Liverpool, kena denda gegara 'Howard Webb berbaju MU'. Begini kisahnya. https://t.co/dEuZq38g95",2,0,3,0,2022-01-18,8,Tuesday,2,5,0
1483359168861978632,2022-01-18 08:42:39,Mason Mount marah besar saat dicadangkan di laga Manchester City vs Chelsea. Manajer Thomas Tuchel pun memahami dan yakin Mount bakal oke lagi. https://t.co/whSo95QBtE,3,0,0,1,2022-01-18,8,Tuesday,2,3,1
1483359145973714944,2022-01-18 08:42:34,Luna maya telah menjalani prosedur pembekuan sel telur sejak tahun lalu. Prosedur ini digunakan untuk menyelamatkan kemampuan wanita untuk hamil di masa depan. https://t.co/3K61fqoBD7,32,3,6,0,2022-01-18,8,Tuesday,2,38,3
1483358215924559873,2022-01-18 08:38:52,"Jalan Medan Merdeka Timur, tepatnya di depan Stasiun Gambir tergenang. Sejumlah kendaraan tetap melintasi genangan. https://t.co/3HTQrtHuN8",17,6,3,1,2022-01-18,8,Tuesday,2,20,7
1483357224915410946,2022-01-18 08:34:56,Para ahli menyarankan penggunaan masker N95 dan KN95 untuk melindungi diri dari ancaman penularan varian Omicron. Bisakah maskernya dipakai berulang kali? https://t.co/aX87osX0RZ,7,0,4,0,2022-01-18,8,Tuesday,2,11,0
1483356138762641414,2022-01-18 08:30:37,"Ketua Umum PSI, Giring Ganesha, mengunggah video dengan lirik jangan kau dengarkan suara sumbang. Video dan tulisan soal suara sumbang itu diunggah Giring di akun Twitternya pada Senin (17/1/2022). https://t.co/JG3DegpR17",8,6,1,0,2022-01-18,8,Tuesday,2,9,6
1483355643885109249,2022-01-18 08:28:39,Robert Lewandowski jadi Pemain Terbaik FIFA 2021 usai mengungguli Lionel Messi dan Mohamed Salah. Apakah ketiganya juga saling memilih satu sama lain? https://t.co/EgCQefQxFl,7,0,2,0,2022-01-18,8,Tuesday,2,9,0
1483355633130913792,2022-01-18 08:28:37,Spezia mengejutkan usai mengalahkan AC Milan di kandang lawan dan kembali membuktikan statusnya sebagai pemangsa tim-tim besar. https://t.co/hGpaSmxeJk,7,0,0,0,2022-01-18,8,Tuesday,2,7,0
1483355462712152066,2022-01-18 08:27:56,Siapa saja nama-nama yang disebut akan memimpin Ibu Kota Baru? #CNNIndonesia #detiknetwork  https://t.co/3hLG0eUsgz,16,12,2,3,2022-01-18,8,Tuesday,2,18,15
1483355346802335744,2022-01-18 08:27:28,RUU IKN resmi menjadi UU. Ketua Pansus RUU IKN Ahmad Doli Kurnia menyebut nama Ibu Kota Nusantara tetap pemerintah daerah khusus. https://t.co/S0lWj68kaM,5,0,0,0,2022-01-18,8,Tuesday,2,5,0
1483354597292916754,2022-01-18 08:24:30,"Berbeda dengan Doel nama pria Betawi tukang insinyur, Doel di Belgia punya reputasi yang berbeda. Seperti apa ya? https://t.co/Zpzr3W2pSg",3,0,0,0,2022-01-18,8,Tuesday,2,3,0
1483354576275320833,2022-01-18 08:24:25,Siapa sangka ternyata terdapat sederet game online penghasil uang yang bisa beri kamu cuan!  https://t.co/R7zz355Ch8,4,0,2,0,2022-01-18,8,Tuesday,2,6,0
1483354288579620866,2022-01-18 08:23:16,"Banjir akibat luapan Sungai Rejoso dan sungai-sungai kecil di sekitarnya terjadi di Kecamatan Grati, Winongan dan Rejoso, Pasuruan, Jatim. Sedikitnya ada 13 desa yang banjir setinggi 20 cm hingga 1,5 m. https://t.co/ocfzW2yI06",1,0,1,0,2022-01-18,8,Tuesday,2,2,0
1483354279796789248,2022-01-18 08:23:14,Dewi Irawan menceritakan caranya membangun emosi di film Merindu Cahaya de Amstel. Ia mengingat-ingat sosok almarhumah Ria Irawan dan sang ibunda. https://t.co/BZkC649jI2,2,0,0,0,2022-01-18,8,Tuesday,2,2,0
1483354054172499972,2022-01-18 08:22:20,"Polisi menangkap empat orang terduga pelaku pengeroyokan anggota TNI AD, Pratu Sahdi (23), di Jakarta Utara hingga tewas. Begini tampang para terduga pelaku. https://t.co/DibHXR8Itd",7,6,0,0,2022-01-18,8,Tuesday,2,7,6
1483354039907753987,2022-01-18 08:22:17,"Akibat kejadian tersebut, DPA mengalami luka di bagian kepala. https://t.co/1eVTDBPQLN",5,3,2,1,2022-01-18,8,Tuesday,2,7,4
1483352907059707905,2022-01-18 08:17:47,"Jalan Danau Sunter Utara dan Jalan Yos Sudarso, Kecamatan Tanjung Priok, Jakut tergenang banjir. Kondisi ini disebabkan hujan yang mengguyur sejak pagi tadi. https://t.co/lypDmKLNNK",29,11,10,3,2022-01-18,8,Tuesday,2,39,14
1483352895189835778,2022-01-18 08:17:44,Menteri Keuangan Sri Mulyani Indrawati bicara gedung pemerintahan di DKI Jakarta setelah ibu kota resmi pindah ke Kalimantan Timur.  https://t.co/o2bXFj746p,10,2,0,1,2022-01-18,8,Tuesday,2,10,3
1483352636007063552,2022-01-18 08:16:42,Ratusan ribu hektare area pengembangan sudah disiapkan untuk ibu kota baru yang bakal pindah ke Kalimantan Timur.  https://t.co/XpnhiXkC4n,13,1,1,0,2022-01-18,8,Tuesday,2,14,1
1483352635994427393,2022-01-18 08:16:42,Subsidi listrik akan langsung diberikan kepada penerima. Sedangkan listriknya tidak disubsidi.  https://t.co/5JM6CSdbnc,6,0,1,1,2022-01-18,8,Tuesday,2,7,1
1483352634681614338,2022-01-18 08:16:42,"Indeks Harga Saham Gabungan (IHSG) pada jeda sesi I siang tadi tercatat 1,41%.  https://t.co/xc8Gw1u04L",2,0,0,0,2022-01-18,8,Tuesday,2,2,0
1483352325028728832,2022-01-18 08:15:28,"Hujan deras mengguyur sejumlah wilayah di DKI Jakarta, salah satunya di wilayah Tanjung Duren, Jakbar. Akibatnya Jalan Tanjung Duren Raya banjir setinggi 60 cm. https://t.co/yL3NnMsMY7",16,2,2,3,2022-01-18,8,Tuesday,2,18,5
1483351812635774976,2022-01-18 08:13:26,"Sebanyak 18 pelajar Bali berhasil lolos Beasiswa Program Indonesia Maju dari Presiden Jokowi. Mereka diterima di 10 univeritas terkemuka di dunia.

via: detikedu https://t.co/zot48Q9EfL",7,0,1,1,2022-01-18,8,Tuesday,2,8,1
1483350989977657344,2022-01-18 08:10:09,"Sebuah mobil dilaporkan menabrak pom bensin di jalan raya Langen-Bergheim dekat Frankfurt, Jerman pada Senin (17/1). Kejadian itu memicu kebakaran hebat. Dua orang dilaporkan tewas. https://t.co/dnrnTdo1f3",5,0,1,0,2022-01-18,8,Tuesday,2,6,0
1483350274936909827,2022-01-18 08:07:19,DPR RI menggelar rapat paripurna ke-13 masa sidang 2021-2022. Dengan agenda pembahasan pengesahan RUU Tindak Pidana Kekerasan Seksual (TPKS) menjadi RUU inisiatif DPR dan pengesahan RUU Ibu Kota Negara menjadi undang-undang. https://t.co/rnfTcb7m4s,8,1,3,1,2022-01-18,8,Tuesday,2,11,2
1483349754427981824,2022-01-18 08:05:15,"Satu unit mobil pompa air dikerahkan untuk menyedot banjir di Jalan Tanjung Duren Raya, Jakbar. Petugas mulai menggunakan mobil pompa itu untuk menyedot air. https://t.co/oZwggszKcj",7,1,2,0,2022-01-18,8,Tuesday,2,9,1
1483349729434034176,2022-01-18 08:05:09,Donny van de Beek sudah tampil 50 kali bersama MU dan hanya 19 kali ia tampil sebagai starter. https://t.co/bZhafo3IMI,3,0,0,0,2022-01-18,8,Tuesday,2,3,0
1483348948102307842,2022-01-18 08:02:03,Jabodetabek kembali masuk dalam PPKM level 2. Berikut aturan berkendaranya. https://t.co/9FWPbU07pZ,4,0,3,0,2022-01-18,8,Tuesday,2,7,0
1483348916947009537,2022-01-18 08:01:55,Erupsi gunung api bawah laut Hunga Tonga-Gunga Ha'apai terjadi di Tonga menyebabkan gelombang tsunami. Selengkapnya di video berikut. https://t.co/i5o10wx770,31,0,14,0,2022-01-18,8,Tuesday,2,45,0
1483348254037319681,2022-01-18 07:59:17,BMW Group Indonesia akan memboyong tiga kendaraan listrik ke Tanah Air. Berikut bocoran model-modelnya! https://t.co/pJsEu7C09S,11,0,3,0,2022-01-18,7,Tuesday,2,14,0
1483346847007916032,2022-01-18 07:53:42,"Di Braga, Bandung ada racikan seblak unik favorit banyak orang. Namanya Seblak Cobek Teh Ida yang benar-benar diracik di cobek batu! Begini potretnya.  https://t.co/TRTbeef6q7",6,0,2,0,2022-01-18,7,Tuesday,2,8,0
1483346592883171334,2022-01-18 07:52:41,Bola-bola ayam berbalut tepung roti yang renyah ini bisa jadi lauk bekal anak atau camilan sore. Rasanya kenyal gurih dengan lapisan yang renyah garing.  https://t.co/XK14fU8M4l,4,0,1,0,2022-01-18,7,Tuesday,2,5,0
1483346304164057088,2022-01-18 07:51:32,Fazzio Hybrid Connected merupakan motor di kelas 125 cc pertama dengan teknologi hybrid di Indonesia. Apa yang keunggulanya? https://t.co/Qcxu0icj1T,6,0,1,1,2022-01-18,7,Tuesday,2,7,1
1483345797056024579,2022-01-18 07:49:31,Berikut empat langkah menghilangkan bau rokok di kabin mobil. https://t.co/iu3myISN2f,13,2,4,3,2022-01-18,7,Tuesday,2,17,5
1483345776784855042,2022-01-18 07:49:27,"Sebuah rumah bergaya Victoria berusia 122 tahun yang dipasarkan sebagai ""rumah terburuk di blok terbaik"" San Francisco terjual dengan harga hampir Rp 28 miliar!  https://t.co/zGNeGvWQ59",9,0,0,0,2022-01-18,7,Tuesday,2,9,0
1483345015103541249,2022-01-18 07:46:25,Dusan Vlahovic ramai dikaitkan dengan kepindahan ke Arsenal. Namun striker Fiorentina itu lebih suka menunggu hingga akhir musim. https://t.co/ZuzoxWqVja,2,1,0,0,2022-01-18,7,Tuesday,2,2,1
1483344180193554433,2022-01-18 07:43:06,Viral seorang driver ojol di Makassar dihadang polisi akibat kedapatan menerobos jalan tol. Driver mengaku kesasar karena google maps. https://t.co/GINQ6QFcnS,1,1,0,0,2022-01-18,7,Tuesday,2,1,1
1483343650675474433,2022-01-18 07:41:00,Sejumlah nasabah yang tergabung dalam Koordinator Komunitas Korban Asuransi menggeruduk kantor Prudential di Prudential Tower.  https://t.co/DXukBBudhr,57,18,17,11,2022-01-18,7,Tuesday,2,74,29
1483343386593611782,2022-01-18 07:39:57,"Akibat komentar dan mendapatkan sebuah kritik keras, Ronaldo pun disebut bertingkah seperti seorang primadona. https://t.co/BxSqyZAieG",5,1,0,0,2022-01-18,7,Tuesday,2,5,1
1483342907243384835,2022-01-18 07:38:02,"""Dalam skema pembiayaan pemerintah akan mengikuti bisnis model dan financial model yang tidak merugikan APBN, jadi tidak merugikan APBN,"" kata Suharso.  https://t.co/N9PqxsLgL9",6,3,0,2,2022-01-18,7,Tuesday,2,6,5
1483342905926422530,2022-01-18 07:38:02,"CEO Moderna Stephane Bancel menjadi salah satu pembicara di World Economic Forum. Pada kesempatan tersebut, Stephane Bancel mengatakan bahwa perusahaannya akan membuat booster gabungan untuk Covid-19 dan flu. Seperti apa? https://t.co/FbNP7jaOAB",4,1,2,1,2022-01-18,7,Tuesday,2,6,2
1483342636601815041,2022-01-18 07:36:58,"""Mengenai siapa yang akan ditunjuk oleh Presiden bisa ditanyakan Presiden, ada di kantongnya beliau."" ujar Menteri PPN/Kepala Bappenas Suharso Monoarfa  https://t.co/IBERFDiOMV",11,1,2,5,2022-01-18,7,Tuesday,2,13,6
1483342376437530624,2022-01-18 07:35:56,"Kemenkes melaporkan peningkatan kasus Omicron, kini totalnya mencapai 840 kasus. Ada 79 persen di antaranya sudah vaksin lengkap, bergejala ringan. https://t.co/eKutklODyZ",11,0,2,0,2022-01-18,7,Tuesday,2,13,0
1483341635861815298,2022-01-18 07:32:59,Ada pemandangan menarik saat pengumuman pemenang Pemain Terbaik FIFA 2021 tadi malam. Lionel Messi mejeng dengan hanya pakai kaos oblong warna putih.  https://t.co/g3I7NM1UNn,5,0,1,1,2022-01-18,7,Tuesday,2,6,1
1483340789883326464,2022-01-18 07:29:38,Terlalu gabut atau kurang kerjaan. Orang ini bagikan kisah dirinya suka rela cuci piring di rumah teman kekasihnya. Netizen beri komentar kocak!  https://t.co/NLJUs95i4w,4,1,3,1,2022-01-18,7,Tuesday,2,7,2
1483340620995440642,2022-01-18 07:28:57,"Omicron melonjak di banyak negara, meningkat pula kasusnya di Indonesia. Kemenkes RI menyarankan 3 jenis masker yang efektif tangkal Omicron. https://t.co/WKx4x2HUOM",3,0,1,0,2022-01-18,7,Tuesday,2,4,0
1483340601131253762,2022-01-18 07:28:53,Pelaku sudah dimintai keterangan sebagai tersangka. https://t.co/PvQ4eL1SZ8,7,0,1,0,2022-01-18,7,Tuesday,2,8,0
1483339899038220288,2022-01-18 07:26:05,"Viral di media sosial ASN Dinas Kesehatan Kabupaten Humbahas yang berjoget sambil menenggak miras. Para ASN itu sedang merayakan ulang tahun Kepala Dinas Kesehatan Humbahas, Hasudungan Silaban. Namun narasi itu dibantah langsung oleh Hasudungan. https://t.co/egyMH9eSb3",4,0,2,1,2022-01-18,7,Tuesday,2,6,1
1483339879748616193,2022-01-18 07:26:01,Bukan hanya bubur ayam dan bakso enak yang bisa dinikmati di Sukabumi. Di kota ini juga ada mie goreng legendaris porsi jumbo yang mantap enak. Wajib coba!  https://t.co/AL4vUXKXxb,14,3,2,0,2022-01-18,7,Tuesday,2,16,3
1483339129240932357,2022-01-18 07:23:02,"Jessica Jane dan keluarganya kulineran di kawasan Suryakencana, Bogor, tepatnya di Gang Aut. Ada 5 kuliner paling enak menurutnya, apa saja?  https://t.co/rKtdtwGqUo",8,0,4,0,2022-01-18,7,Tuesday,2,12,0
1483339116179771395,2022-01-18 07:22:59,"Miliarder dan pendiri Microsoft, Bill Gates memang menjadi sorotan selama pandemi ini. Ini penyebabnya.   https://t.co/WCpSZEoAvk",16,5,7,2,2022-01-18,7,Tuesday,2,23,7
1483338810305957888,2022-01-18 07:21:46,Berlian hitam 'the enigma' dipamerkan di Dubai. Berlian yang diyakini dari luar angkasa tersebut bakal dilelang. Diperkirakan terjual pada angka Rp 97 miliar!  https://t.co/qTj2DOxUYA,6,0,1,1,2022-01-18,7,Tuesday,2,7,1
1483338789833658368,2022-01-18 07:21:41,"Jokowi memilih Nusantara sebagai nama Ibu Kota baru. Kritik datang dari sejarawan, nama Nusantara dinilai Jawa-sentris. Pihak pemerintah menanggapi. https://t.co/t4NaLlm4Qw",13,14,2,1,2022-01-18,7,Tuesday,2,15,15
1483338270599790595,2022-01-18 07:19:37,Polisi mengamankan ratusan knalpot racing dalam dua pekan terakhir. Selanjutnya knalpot tersebut akan dimusnahkan. https://t.co/fFV8WLQwyn,6,4,1,0,2022-01-18,7,Tuesday,2,7,4
1483338249099698177,2022-01-18 07:19:32,"#Foto Lesti Kejora dan Rizky Billar menggelar aqiqah untuk putra mereka, Baby L. Lesti tampil anggun dengan busana serba putih. Ini 7 gayanya.... https://t.co/Wv196xislR",6,1,0,0,2022-01-18,7,Tuesday,2,6,1
1483338014206173189,2022-01-18 07:18:36,"Penampakan satelit sebelum dan sesudah letusan utama gunung api Hunga Tonga Hunga Ha-apai dirilis. Potret satelit terbaru ini dirilis oleh Maxar Technologies pada hari ini, Selasa (18/1). https://t.co/kFpZ1jVB4m",1,0,0,0,2022-01-18,7,Tuesday,2,1,0
1483337755677671426,2022-01-18 07:17:34,"Ruas Jl HR Rasuna Said di Jakarta Selatan berlubang dan mengganggu pengendara. Kini, kerusakan permukaan jalan itu ditambal (lagi). #detikcomdoyourmagic https://t.co/PJo36G9Yxs",2,1,0,0,2022-01-18,7,Tuesday,2,2,1
1483337217758085122,2022-01-18 07:15:26,Gubernur Bank Indonesia (BI) Perry Warjiyo hari ini melantik 39 pimpinan baru Kantor Pusat dan kantor Perwakilan BI secara virtual.  https://t.co/x3C6xa9RCx,3,1,0,0,2022-01-18,7,Tuesday,2,3,1
1483337210938200067,2022-01-18 07:15:24,"Status PPKM level 2 DKI Jakarta diperpanjang hingga 24 Januari 2022. Lalu, bagaimana dengan PTM?

via: detikedu https://t.co/GmcRdEURTa",3,0,0,0,2022-01-18,7,Tuesday,2,3,0
1483336162953633798,2022-01-18 07:11:14,Pemindahan ibu kota negara (IKN) dari Jakarta ke Kalimantan Timur akan dilakukan secara bertahap. Proses pembangunan ibu kota baru akan berlangsung sampai 2045.  https://t.co/8msE56z2eu,97,16,19,12,2022-01-18,7,Tuesday,2,116,28
1483336143060058114,2022-01-18 07:11:10,"IHSG anjlok. Sempat dibuka menguat menguat tipis 5 poin (0,08%) ke level 6.650 pada pagi tadi, IHSG kemudian turun 1,41% di jeda siang hari ini.  https://t.co/ZPhbMwOuZw",3,1,2,0,2022-01-18,7,Tuesday,2,5,1
1483335909835743238,2022-01-18 07:10:14,Manajer Chelsea Thomas Tuchel berkelakar saat menjawab pertanyaan jurnalis. Ia membawa-bawa ibu mertua. https://t.co/AvWoInMHWt,2,0,1,0,2022-01-18,7,Tuesday,2,3,0
1483335908585873411,2022-01-18 07:10:14,"""Kami tinggal menunggu saja karena kami sudah masukkan ke PTUN, tinggal menunggu jadwal sidang,"" ujar Wakil Ketua DPP Apindo DKI Jakarta Nurjaman  https://t.co/7GeRp6RcwZ",2,1,0,0,2022-01-18,7,Tuesday,2,2,1
1483335325959311360,2022-01-18 07:07:55,"Harga pangan menjadi sorotan sejak akhir 2021 hingga awal 2022 ini, mulai dari minyak goreng hingga cabai rawit.  https://t.co/fE4zZQ7kLt",6,2,2,2,2022-01-18,7,Tuesday,2,8,4
1483335317885231104,2022-01-18 07:07:53,"Indeks Harga Saham Gabungan (IHSG) hari ini terkapar di zona merah. Sepanjang sesi I saja IHSG sudah turun hingga 1,41%.  https://t.co/gxMezd1Dg8",2,0,1,0,2022-01-18,7,Tuesday,2,3,0
1483335078457626628,2022-01-18 07:06:56,"Meski diprioritaskan untuk lansia, vaksin COVID-19 booster juga boleh kok untuk non lansia. Tapi begini syaratnya: https://t.co/q8st1MtlB6",2,0,0,1,2022-01-18,7,Tuesday,2,2,1
1483334840976089089,2022-01-18 07:05:59,Jokowi menyetujui penambahan jumlah penonton menjadi 100.000 atau 50% dari kapasitas pada gelaran MotoGP 2022.  https://t.co/SeluOJeVCl,8,0,0,2,2022-01-18,7,Tuesday,2,8,2
1483334824723165191,2022-01-18 07:05:55,"Hujan deras sekitar 40 menit membuat Jalan Cikini Raya, Jakarta tergenang, (18/1). Curah hujan tinggi tidak sebanding dengan lobang drainase di kawasan itu. https://t.co/CN9ScpOIl2",6,0,2,0,2022-01-18,7,Tuesday,2,8,0
1483334465866944514,2022-01-18 07:04:30,DPR RI resmi menyetujui Rancangan Undang-Undang tentang Ibu Kota Negara (RUU IKN) menjadi UU.  https://t.co/s5SO9q92yR,6,0,1,1,2022-01-18,7,Tuesday,2,7,1
1483334103718154241,2022-01-18 07:03:03,Oki Setiana Dewi angkat bicara soal kabar Ria Ricis yang disebut sedang hamil. Ini kata Oki Setiana Dewi:  https://t.co/An9YQ0obuQ,4,1,1,3,2022-01-18,7,Tuesday,2,5,4
1483333757952221186,2022-01-18 07:01:41,Proses pemindahan Ibu Kota Negara (IKN) dari Jakarta ke Kalimantan Timur (Kaltim) terus berlangsung.  https://t.co/FN0WEg7tdM,9,7,6,2,2022-01-18,7,Tuesday,2,15,9
1483333750750597121,2022-01-18 07:01:39,Gaji personel TNI sudah diatur dalam Peraturan Pemerintah Nomor 28 Tahun 2019 tentang Perubahan Kedua Belas atas Peraturan Pemerintah Nomor 28 Tahun 2001  https://t.co/3pGW6dOwIb,3,1,1,0,2022-01-18,7,Tuesday,2,4,1
1483333401700614147,2022-01-18 07:00:16,BPBD DKI Jakarta mencatat terdapat 10 RT dan 1 ruas jalan di Jakarta Barat yang terendam air. https://t.co/gZoSUrPwi7,6,0,2,0,2022-01-18,7,Tuesday,2,8,0
1483333380313919492,2022-01-18 07:00:11,Cristiano Ronaldo dapat penghargaan spesial di ajang the Best FIFA Awards 2021. Simak foto-foto senyum merekah CR7 dengan trofi anyarnya. https://t.co/AQFSTGchiJ,6,1,1,0,2022-01-18,7,Tuesday,2,7,1
1483333111261896704,2022-01-18 06:59:07,"DPR mengebut pembahasan Rancangan Undang-Undang Ibu Kota Negara (IKN), bahkan rela rapat hingga dini hari.   https://t.co/Qdw0W4jj8G",7,2,4,0,2022-01-18,6,Tuesday,2,11,2
1483332852506845184,2022-01-18 06:58:05,"Jika kalah di PTUN, pengusaha siap mematuhi Gubernur DKI Jakarta Anies Baswedan dengan menaikkan UMP DKI Jakarta sebesar 5,1% pada tahun ini!  https://t.co/CkUxB6ZjDd",3,0,3,1,2022-01-18,6,Tuesday,2,6,1
1483332851424706560,2022-01-18 06:58:05,Para penonton dari luar negeri akan mengikuti karantina sistem bubble saat menonton MotoGP 2022 di Mandalika. Begini penjelasan Sandiaga: https://t.co/vJod1D7RI7,3,0,2,0,2022-01-18,6,Tuesday,2,5,0
1483332545479647242,2022-01-18 06:56:52,IKN Nusantara dipimpin oleh Kepala Otorita yang ditunjuk oleh Presiden. Simak selengkapnya: https://t.co/GSTUMwP34Q,10,9,5,0,2022-01-18,6,Tuesday,2,15,9
1483332242768384000,2022-01-18 06:55:40,"Banjir setinggi 60 cm terjadi di depan Jalan Raya Tanjung Duren, Jakbar. Banjir terjadi usai hujan deras sedari pagi di wilayah Jakarta Barat. https://t.co/YbCf9x4YkK",123,43,37,11,2022-01-18,6,Tuesday,2,160,54
1483332225932443652,2022-01-18 06:55:36,Desakan agar Haruna Soemitro mundur dari posisi anggota Exco PSSI masih ramai diperbincangkan. Penghasilan anggota Exco PSSI sendiri berapa ya?   https://t.co/Ws9hMH63GA,2,0,1,0,2022-01-18,6,Tuesday,2,3,0
1483331755411136512,2022-01-18 06:53:44,Ribut-ribut soal anggota Exco PSSI Haruna Soemitro melebar ke politik. Partai Hanura jadi korban tagar #HarunaOut. Waduh... https://t.co/JXNTUU3OEI,3,2,0,1,2022-01-18,6,Tuesday,2,3,3
1483331732610994183,2022-01-18 06:53:38,Shin Tae-yong dan Evan Dimas Darmono ikut menyumbang suara dalam FIFA Awards 2021. Siapa yang menjadi pilihan keduanya? https://t.co/oXXtOU4vzE,9,0,0,0,2022-01-18,6,Tuesday,2,9,0
1483331273368219649,2022-01-18 06:51:49,"Selagi menunggu keputusan pengadilan, Apindo menyatakan akan mengacu pada Kepgub Nomor 1395 Tahun 2021.  https://t.co/obl9VzLPGU",3,0,0,0,2022-01-18,6,Tuesday,2,3,0
1483331176786010113,2022-01-18 06:51:26,RUU IKN resmi disahkan menjadi UU. Pengesahan RUU IKN menjadi UU dilakukan dalam rapat paripurna ke-13 DPR masa sidang 2021-2022. https://t.co/JATHhxsEqy,12,6,5,7,2022-01-18,6,Tuesday,2,17,13
1483330620025679877,2022-01-18 06:49:13,Operator seluler Telkomsel berkolaborasi dengan Samsung Indonesia menghadirkan bundling Galaxy S21 FE. Bonus kuota berlimpah pun ditawarkan.  https://t.co/R7cQAZBGnk,17,1,5,0,2022-01-18,6,Tuesday,2,22,1
1483329874362355712,2022-01-18 06:46:15,"Pernyataan Anggota Exco PSSI Haruna Soemitro bikin geram netizen. Alhasil, tagar #HarunaOut menggema dari kemarin, bahkan hingga saat ini. https://t.co/EYndBoMJ0Y",4,1,1,0,2022-01-18,6,Tuesday,2,5,1
1483329855928348672,2022-01-18 06:46:11,"Dunia seni budaya Pacitan berduka. Sutiman, pencipta Tari Kethek Ogleng wafat pada usia 76 tahun. https://t.co/bcXivEMjPw",7,0,1,1,2022-01-18,6,Tuesday,2,8,1
1483329518798475264,2022-01-18 06:44:50,"Mobil sedan Toyota Vios berpelat merah kedapatan melawan arah di Kota Bekasi. Meski disebut tak sengaja melawan arah, polisi tetap mencari pemilik kendaraan untuk dikenakan tilang. https://t.co/82bzYmKVaG",4,0,0,0,2022-01-18,6,Tuesday,2,4,0
1483329039913955328,2022-01-18 06:42:56,"Kediaman Raffi Ahmad dan Nagita Slavina kali ini kembali kedatangan tamu spesial. Tamu itu adalah Menteri Ketenagakerjaan RI, Ida Fauziyah. https://t.co/rkm3jA2RJ9",14,7,0,2,2022-01-18,6,Tuesday,2,14,9
1483328418590646272,2022-01-18 06:40:28,"Desakkan agar Haruna Soemitro mundur dari posisi anggota Exco PSSI belum surut. Bahkan, ada spanduk #HarunaOut dan poster yang ditempel. https://t.co/MU3bdWNWY8",16,0,4,2,2022-01-18,6,Tuesday,2,20,2
1483328394955616258,2022-01-18 06:40:22,Haris Azhar angkat bicara soal keterangan polisi yang menilainya mangkir pemeriksaan dua kali dengan alasan yang tidak wajar. Begini katanya. https://t.co/1GOTempebz,6,9,1,0,2022-01-18,6,Tuesday,2,7,9
1483328061340848128,2022-01-18 06:39:03,Bintang mandarin Cecilia Yip dihujat warganet karena kenakan rok mini dan mewarnai rambutnya jadi pirang. Ini kisahnya:  https://t.co/ZVf1dYopvs,6,0,0,0,2022-01-18,6,Tuesday,2,6,0
1483327577813139459,2022-01-18 06:37:08,"Penampilan Venna Melinda banyak menuai kritikan pedas dari netizen. Dia yang dinilai kurang cocok mengenakan gaun pengantin itu. Hmm, gimana menurutmu? https://t.co/JhN43kwKBE",7,1,1,0,2022-01-18,6,Tuesday,2,8,1
1483326830379679745,2022-01-18 06:34:09,Ini yang buat si Crazy Rich Malang keluarkan uang demi bantu orang. Istrinya tak komplen. https://t.co/XUa1W9AFcL,22,1,4,1,2022-01-18,6,Tuesday,2,26,2
1483326812302323712,2022-01-18 06:34:05,"Apa ya tujuan manusia melakukan kegiatan ekonomi? Yuk, cari tahu jawabannya:

via: detikedu https://t.co/HZQPNLY99v",6,1,2,0,2022-01-18,6,Tuesday,2,8,1
1483326256351531018,2022-01-18 06:31:53,Mendagri Tito Karnavian mengeluarkan Instruksi Mendagri (Inmendagri) terkait daerah Jawa dan Bali yang menerapkan PPKM. Jabodetabek menerapkan PPKM level 2. https://t.co/PQ2iczi3af,11,0,6,0,2022-01-18,6,Tuesday,2,17,0
1483325193145749506,2022-01-18 06:27:39,Pasangan Venna Melinda dan Ferry Irawan memutuskan untuk melangkah ke jenjang pernikahan. Venna dan Ferry Irawan bocorkan konsep pernikahan mereka:  https://t.co/2eHXe5cmxw,6,0,1,0,2022-01-18,6,Tuesday,2,7,0
1483324935917477890,2022-01-18 06:26:38,"Para bintang TikTok semakin kaya raya, bahkan pendapatan sebagian dari mereka disebut telah menyamai bahkan melebihi penghasilan CEO di perusahaan top. https://t.co/Om5VwGCYeA",14,1,2,2,2022-01-18,6,Tuesday,2,16,3
1483324651598196742,2022-01-18 06:25:30,"Usai Nidji, giliran Afgan yang tampil di JIS. Anies Baswedan kembali menyaksikan check sound tersebut. https://t.co/SmqpeUSx06",73,25,4,2,2022-01-18,6,Tuesday,2,77,27
1483324637031419909,2022-01-18 06:25:26,"""Saya atas nama Kapolres Boyolali menyampaikan kepada seluruh masyarakat Boyolali pada khususnya permohonan maaf atas perilaku yang sempat dilontarkan oleh salah satu anggota saya."" https://t.co/CQUeYwNktm",9,3,2,0,2022-01-18,6,Tuesday,2,11,3
1483323403184615426,2022-01-18 06:20:32,"Hujan deras sejak Senin (17/1) sore hingga malam menyebabkan banjir bandang menerjang Dusun Pancoran, Probolinggo.1 Orang dilaporkan meninggal. https://t.co/TKp0E5lUyE",3,2,1,0,2022-01-18,6,Tuesday,2,4,2
1483322887989829635,2022-01-18 06:18:29,Rolade daging ini merupakan menu gaya Belanda yang populer. Bisa digoreng sebagai lauk atau diberi kuah kaldu sebagai sup. Gampang dibuat dan enak rasanya.  https://t.co/0dPm0GvbDQ,4,1,4,0,2022-01-18,6,Tuesday,2,8,1
1483322076903907331,2022-01-18 06:15:16,"Lihatlah rumah Mak Unah ini. Rumah reyot ini pun bukan miliknya, tapi pinjaman tetangga. Mak Unah butuh bantuan #sahabatbaik untuk hidup lebih layak. 

Ayo bantu Mak Unah dengan donasi melalui platform @berbuatbaik_id atau klik https://t.co/kjwGpSkS0P. Donasimu 100% tersalurkan! https://t.co/4rj4snwMFJ",33,0,10,0,2022-01-18,6,Tuesday,2,43,0
1483321651832004609,2022-01-18 06:13:35,Ahli mengungkap dua gejala COVID-19 utama yang menjadi pertanda terpapar Omicron. Waspadai pilek dan sakit kepala seperti ini. https://t.co/KiHMxiSNtz,11,1,1,0,2022-01-18,6,Tuesday,2,12,1
1483320900980297729,2022-01-18 06:10:36,Berkas perkara Olivia Nathania terkait kasus rekruitment CPNS fiktif dilimpahkan ke Pengadilan Negeri Jakarta Selatan dan siap disidangkan. https://t.co/K07v47yHML,7,0,1,0,2022-01-18,6,Tuesday,2,8,0
1483320899818467329,2022-01-18 06:10:35,Presiden Jokowi mengungkapkan banyak negara yang kaget melihat kasus di RI bisa menurun secara drastis. Menurun dari 56 ribu menjadi ratusan kasus. https://t.co/u70TLxuNW0,17,4,2,4,2022-01-18,6,Tuesday,2,19,8
1483320404836077568,2022-01-18 06:08:37,"Filipina melarang warga yang tak mau divaksin menaiki angkutan umum di manila. Diketahui, aturan ini diberlakukan mulai pekan ini. https://t.co/OB8yPzWK5q",16,0,7,2,2022-01-18,6,Tuesday,2,23,2
1483319670463676416,2022-01-18 06:05:42,Dewi Irawan menceritakan momen menyentuh saat syuting film Merindu Cahaya de Amstel. Ia teringat Ria sampai Ade Irawan...  https://t.co/2XltRV6nlX,6,0,1,0,2022-01-18,6,Tuesday,2,7,0
1483319171224113154,2022-01-18 06:03:43,Batik Air membuka kembali rute penerbangan dari Jakarta menuju ke Banyuwangi. Traveler bisa merasakan sensasi Africa van Java lagi di Banyuwangi. Hore! https://t.co/lyrrL2CXsW,9,0,3,0,2022-01-18,6,Tuesday,2,12,0
1483318673192460288,2022-01-18 06:01:45,"Di mana saja lokasi vaksin booster COVID-19 Jakarta Selatan? Buat yang memenuhi syarat, ini lokasi, jenis vaksin, hingga kuota per harinya. https://t.co/1vK4nDF3WB",4,0,1,0,2022-01-18,6,Tuesday,2,5,0
1483318142592077825,2022-01-18 05:59:38,"Gol Kemenangan AC Milan melawan Spezia di injury time dianulir wasit. Kemenangan Rossoneri seperti ""dirampok"". https://t.co/RnvlsNoeAQ",8,0,2,0,2022-01-18,5,Tuesday,2,10,0
1483317390192562180,2022-01-18 05:56:39,"Apa jadinya ya jika pemimpin umat Katolik sedunia, Paus Fransiskus ketahuan jalan-jalan tanpa pengawalan di sebuah toko kaset di Roma? https://t.co/vj4un3NAfj",24,7,3,1,2022-01-18,5,Tuesday,2,27,8
1483316654532710404,2022-01-18 05:53:43,"BMW mengalami kenaikan penjualan sepanjang tahun 2021, penjualan mobil mewah di Indonesia masih bertumbuh.  https://t.co/R30idWhKkd",13,4,1,0,2022-01-18,5,Tuesday,2,14,4
1483316179464769539,2022-01-18 05:51:50,"Ungguli Lionel Messi dan Mohamed Salah, Robert Lewandowski sukses menjadi Pemain Terbaik FIFA 2021.  https://t.co/9B1ZLa7wAR",10,1,0,0,2022-01-18,5,Tuesday,2,10,1
1483315663594823681,2022-01-18 05:49:47,"Garuda Indonesia menggelar program ""Wisata Nusantara"". Tiket murah ditawarkan oleh maskapai hingga tanggal 23 Januari mendatang. Wuih! https://t.co/WrOXwJ6QIN",21,2,2,0,2022-01-18,5,Tuesday,2,23,2
1483315082243325960,2022-01-18 05:47:28,"Tak lekang waktu, soto ayam Jarkomi masih eksis jadi kuliner pilihan saat berwisata ke Pangandaran. Selain rasanya yang gurih mantap, harganya pun terjangkau.  https://t.co/K0MUM4HhBp",5,0,1,0,2022-01-18,5,Tuesday,2,6,0
1483314551596752896,2022-01-18 05:45:22,Berikut ini cara kerja sistem hybrid dari Yamaha Fazzio. https://t.co/vC0jdj39ZR,15,2,2,1,2022-01-18,5,Tuesday,2,17,3
1483314300097867787,2022-01-18 05:44:22,Bintang mandarin Eddie Peng sempat diisukan penyuka sesama jenis. Pihak manajemennya tak tinggal diam dan membawa kasus ini ke jalur hukum. https://t.co/iCU9DxuD8p,6,0,0,0,2022-01-18,5,Tuesday,2,6,0
1483313306060349450,2022-01-18 05:40:25,Gibran dan Kaesang diadukan oleh Ubedillah Badrun ke KPK dengan dugaan KKN relasi bisnis. KPK sendiri masih menelaah laporan itu. https://t.co/PSo3AaeaiK,17,11,2,1,2022-01-18,5,Tuesday,2,19,12
1483312556668297217,2022-01-18 05:37:26,"Berlian hitam dengan usia miliaran tahun ini diklaim jatuh dari luar angkasa. Kini, berlian yang dijuluki 'The Enigma' itu akan dilelang. https://t.co/VxW0AvrCOQ",7,0,0,0,2022-01-18,5,Tuesday,2,7,0
1483311183952326658,2022-01-18 05:31:59,"Susunan tim terbaik FIFA FIFPro 2021 telah diumumkan. Bagian penyerang ada 4 pemain yaitu Cristiano Ronaldo, Lionel Messi, Robert Lewandowski dan Erling Haaland. https://t.co/NnTNo8LixJ",6,0,0,0,2022-01-18,5,Tuesday,2,6,0
1483310086210605061,2022-01-18 05:27:37,"Gol Kemenangan AC Milan melawan Spezia di injury time dianulir wasit. Kemenangan Rossoneri seperti ""dirampok"". https://t.co/oDYM6GBzUa",7,4,1,1,2022-01-18,5,Tuesday,2,8,5
1483309590007758849,2022-01-18 05:25:39,"Polres Metro Jakarta Barat membawa musisi Ardhito Pramono hari ini, Selasa (18/1), ke BNNP DKI Jakarta untuk menjalani asesmen terkait rehabilitasi karena narkoba. Saat ditanya kondisi kesehatan, Ardhito mengaku sehat. https://t.co/Laaz1Np0eG",7,1,0,0,2022-01-18,5,Tuesday,2,7,1
1483309068471218176,2022-01-18 05:23:35,Sayur gurih yang sederhana bisa jadi ide lauk enak yang murah. Beragam sayuran sederhana diberi bumbu cabe dan rempah dengan kuah santan. Pedas gurih rasanya.  https://t.co/7OOIh9bVKE,5,0,0,0,2022-01-18,5,Tuesday,2,5,0
1483308817735630850,2022-01-18 05:22:35,Presiden Joko Widodo menyetujui diskon PPnBM untuk mobil baru diperpanjang. Program Pajak Penjualan atas Barang Mewah Ditanggung Pemerintah (PPnBM DTP) dilanjutkan di tahun 2022 ini. https://t.co/Ly0cciguoT,6,0,1,0,2022-01-18,5,Tuesday,2,7,0
1483308291308597248,2022-01-18 05:20:29,"Belum selesai kasus COVID-19 varian Omicron, kini muncul Flurona dari Israel. Apa lagi itu? https://t.co/uoBCF4T08C",8,1,7,6,2022-01-18,5,Tuesday,2,15,7
1483307527257350144,2022-01-18 05:17:27,Sempat heboh seorang dokter berhasil mencangkokkan jantung babi ke manusia di Amerika Serikat. Ini kata Ustaz:  https://t.co/rTK3fCkUGb,22,1,11,4,2022-01-18,5,Tuesday,2,33,5
1483307502888538114,2022-01-18 05:17:21,"Video seorang ibu hamil di Musi Rawas Utara (Muratara), Sumatera Selatan, yang mau melahirkan terpaksa ditandu menuju puskesmas karena kondisi jalan rusak. Awalnya ibu itu hendak dijemput menggunakan ambulans, namun sayang kondisi jalan tak bisa dilewati. https://t.co/KkSJhh0Bs5",9,0,2,0,2022-01-18,5,Tuesday,2,11,0
1483306659200049153,2022-01-18 05:14:00,"Bali memang indah, tak hanya alam namun sosial dan budayanya. Nah, biar lebih akrab sama orang Bali, ketahui dulu nih bahasa sederhana Bali yang bisa dihafal. https://t.co/3l0H59lf6v",10,1,3,0,2022-01-18,5,Tuesday,2,13,1
1483306637263781888,2022-01-18 05:13:55,Bisnis cafe Temu Kamu ternyata menjadi bisnis baru Denis karena bisnis sebelumnya yang terdampak pandemi.  https://t.co/TKFCQ5DTdA,5,0,0,0,2022-01-18,5,Tuesday,2,5,0
1483306154772115459,2022-01-18 05:12:00,Cristiano Ronaldo dan Lionel Messi sama-sama tidak saling memilih dalam pemungutan suara Pemain Terbaik FIFA 2021.  https://t.co/J48oCGBRCP,30,0,1,0,2022-01-18,5,Tuesday,2,31,0
1483305853969215490,2022-01-18 05:10:48,RUU TPKS resmi disahkan jadi RUU inisiatif DPR dalam rapat paripurna DPR RI hari ini. https://t.co/OEJPnjbdPl,14,6,6,2,2022-01-18,5,Tuesday,2,20,8
1483305576562102273,2022-01-18 05:09:42,Langkah itu diambil usai Haris Azhar dan Fatia Maulidiyanti mangkir dari jadwal pemeriksaan sebanyak dua kali. https://t.co/2Ly0jdlHhE,4,0,3,0,2022-01-18,5,Tuesday,2,7,0
1483304949463269379,2022-01-18 05:07:13,Ryan's Kitchen dapat menjual lebih dari 1.000 porsi setiap bulannya. Omzet yang dihasilkan pun juga mencapai Rp 20 juta sebulan!  https://t.co/A5UaGDdHbU,12,0,2,0,2022-01-18,5,Tuesday,2,14,0
1483304666494648326,2022-01-18 05:06:05,Kata-kata bijak cinta bisa jadi cara mengungkapkan perasaan pada seseorang yang disayang. Berikut kumpulan kata-kata bijak cinta yang bisa dijadikan inspirasi. https://t.co/6BYGwqN9Hc,9,1,2,2,2022-01-18,5,Tuesday,2,11,3
1483304646907240450,2022-01-18 05:06:00,"Terima menu makan siang unik, seorang warganet mengunggah foto makanan yang ia dapat ke Twitter. Hasilnya unggahan ini memicu perdebatan netizen.  https://t.co/mQgYFjVnfw",7,0,1,3,2022-01-18,5,Tuesday,2,8,3
1483303908575481856,2022-01-18 05:03:04,"Nadine Kaiser adalah anak dari mantan Menteri KKP, Susi Pudjiastuti. Namanya memang tak terlalu ramai dibicarakan. Penasarankan pelajaran apa yang dia dapat dari sang ibu? Saksikan video berikut ini: https://t.co/uaAN74g1dE",2,0,0,1,2022-01-18,5,Tuesday,2,2,1
1483303094712782848,2022-01-18 04:59:50,Perselisihan antara Doddy Sudrajat dan H Faisal sempat dikira berakhir dengan damai. Namun ternyata kata damai urung ditemukan pada pertemuan keduanya...  https://t.co/xCLb3WRYVs,7,3,0,0,2022-01-18,4,Tuesday,2,7,3
1483302583867527178,2022-01-18 04:57:49,#Ngegas Anies Baswedan memuji penampilan Nidji saat cek sound di JIS. Sindiran itu dibalas oleh Giring yang juga mantan vokalis Nidji. detikers tim Anies atau tim Giring nih? https://t.co/YLvUghOURy,632,313,62,45,2022-01-18,4,Tuesday,2,694,358
1483301975521472516,2022-01-18 04:55:24,Nmax model lawas sudah tak lagi diproduksi Yamaha Indonesia. https://t.co/r8I8b5Kud4,2,0,1,1,2022-01-18,4,Tuesday,2,3,1
1483301460741865476,2022-01-18 04:53:21,Gubernur DKI Jakarta Anies Baswedan berjanji bakal membiayai seluruh pengobatan sastrawan Remy Sylado selama sakit. #RemySylado  https://t.co/MHVvawfrWC,18,0,1,0,2022-01-18,4,Tuesday,2,19,0
1483301212179120130,2022-01-18 04:52:22,Univeler akan melakukan mega merger senilai 50 miliar Euro atau setara dengan Rp 820 triliun!  https://t.co/HR2kwZJ2oF,24,10,5,3,2022-01-18,4,Tuesday,2,29,13
1483300904044568580,2022-01-18 04:51:08,Polandia harus mengalami gelombang kelima infeksi Corona akibat lonjakan kasus yang sangat tinggi. Hal ini dipicu kemunculan varian Omicron di negara tersebut. https://t.co/MEhPS5Qgns,3,0,0,0,2022-01-18,4,Tuesday,2,3,0
1483300881672060932,2022-01-18 04:51:03,Menteri PAN-RB Tjahjo Kumolo mengatakan rekrutmen PPPK untuk 2022 demi memenuhi kebutuhan guru dan tenaga kesehatan di Indonesia.  https://t.co/WFXZxVzZrC,1,1,0,0,2022-01-18,4,Tuesday,2,1,1
1483300656320499713,2022-01-18 04:50:09,"Hingga 2022 ini pemerintah masih akan mencairkan sejumlah bantuan sosial, termasuk bantuan langsung tunai (BLT) Program Keluarga Harapan (PKH).`  https://t.co/66jtn6BX8L",3,0,0,0,2022-01-18,4,Tuesday,2,3,0
1483300638859608066,2022-01-18 04:50:05,"#Foto Ini potret Adalia Rose, dikenal sebagai Youtuber dan latar belakang penyakit langkanya. Remaja yang memiliki sindrom 'Benjamin Button' itu meninggal dunia. https://t.co/yvcDR1Os2d",12,2,1,0,2022-01-18,4,Tuesday,2,13,2
1483300611974127618,2022-01-18 04:49:58,"Viral di media sosial Amerika Serikat (AS), masyarakat mengeluhkan rak-rak di supermarket besar, kosong!  https://t.co/HSmGIAmuWE",3,1,1,0,2022-01-18,4,Tuesday,2,4,1
1483299860908584965,2022-01-18 04:46:59,"Patah hati terhadap Indonesia? ""Iya, it broke my heart,"" kata Nadine Kaiser, sang pengawal Susi Air, putri Susi Pudjiastuti. Simak kisah Nadine di #HotQuestions  https://t.co/6n59G8jAE1",8,0,2,1,2022-01-18,4,Tuesday,2,10,1
1483299491251998721,2022-01-18 04:45:31,Nagita Slavina diserang isu miring sejak beberapa hari terakhir. Ia disebut punya video syur berdurasi 61 detik. Ini secercah kebenaran soal isu tersebut. https://t.co/qurtPbNpE8,12,4,1,1,2022-01-18,4,Tuesday,2,13,5
1483299023297597441,2022-01-18 04:43:40,Polisi mengatakan semua pengguna jalan harus menaati aturan lalu lintas. https://t.co/XsjB6ZHehv,8,3,0,3,2022-01-18,4,Tuesday,2,8,6
1483298213318828036,2022-01-18 04:40:27,"Diet keto tengah populer belakangan ini. Namun kalau mau ikuti diet keto, enam tips berikut perlu diperhatikan bagi pemula.  https://t.co/SG4ZXRiUlB",5,2,0,1,2022-01-18,4,Tuesday,2,5,3
1483297720571998210,2022-01-18 04:38:29,Menkes memaparkan ada ratusan ribu vaksin COVID-19 yang kedaluwarsa. Vaksin yang mendekati kedaluwarsa tersebut kebanyakan donasi dari beberapa negara untuk RI. https://t.co/e6Xrq3aQR9,8,0,2,4,2022-01-18,4,Tuesday,2,10,4
1483297224260034563,2022-01-18 04:36:31,Yamaha merilis Fazzio Hybrid Connected untuk pasar Indonesia. Berikut wujudnya! https://t.co/S0rBBVpqjl,10,1,2,1,2022-01-18,4,Tuesday,2,12,2
1483296664240726019,2022-01-18 04:34:17,"Gelandang MU Fred kembali menegaskan, para pemain berteman baik. https://t.co/DPxu9ruPtz",6,0,0,1,2022-01-18,4,Tuesday,2,6,1
1483296156088217603,2022-01-18 04:32:16,"Kamu yang sering menggunakan kereta api pernah penasaran dengan arti angka dan simbol '+' di papan nama stasiun? Ternyata itu bukan untuk penunjuk jarak lho.

via: detikedu https://t.co/UgvhGmzQ1g",11,6,1,2,2022-01-18,4,Tuesday,2,12,8
1483295282544664579,2022-01-18 04:28:48,Berikut mobil yang cocok untuk warga +62! https://t.co/qDVpsuoHm9,5,0,0,0,2022-01-18,4,Tuesday,2,5,0
1483294771066060806,2022-01-18 04:26:46,"Bukan Donnarumma ataupun Neuer, Edouard Mendy meraih penghargaan Kiper Terbaik FIFA 2021.  https://t.co/Wi3xUXeyO8",9,1,0,0,2022-01-18,4,Tuesday,2,9,1
1483293800776749060,2022-01-18 04:22:55,Menurutnya nama Nusantara kurang cocok dan dia mengusulkan nama Jokowi. https://t.co/JHnuhOn6Pf,138,140,23,34,2022-01-18,4,Tuesday,2,161,174
1483293783424966656,2022-01-18 04:22:50,"Infinix resmi mengumumkan kehadiran laptop barunya InBook X2. Laptop ini menawarkan spesifikasi oke namun dibanderol murah, mulai dari harga Rp 5,7 juta. https://t.co/OrsEdBiKYS",2,0,0,0,2022-01-18,4,Tuesday,2,2,0
1483293230762496003,2022-01-18 04:20:39,Meningkatnya kolesterol jahat dalam tubuh bisa dipengaruhi karena kebiasaan minum yang buruk. Seperti minuman yang tinggi gula dan lemak jenuh.  https://t.co/LStwzZlBz7,9,1,3,0,2022-01-18,4,Tuesday,2,12,1
1483292732705677313,2022-01-18 04:18:40,"Seorang pengendara motor wanita ditegur polisi untuk memakai helm di Pasar Rebo, Jakarta Timur. Namun pemotor ini justru mengacungkan jari tengah ke arah polisi hingga videonya viral di media sosial. https://t.co/NK70SsOyDj",9,14,2,0,2022-01-18,4,Tuesday,2,11,14
1483292290974199810,2022-01-18 04:16:55,Sedikitnya ada dua gempa bumi yang mengguncang wilayah Afghanistan bagian barat dalam selang waktu dua jam pada Senin (17/1) sore waktu setempat. https://t.co/Nh8yejVxeG,10,0,0,2,2022-01-18,4,Tuesday,2,10,2
1483291623253590019,2022-01-18 04:14:15,"Novak Djokovic baru saja terusir dari Australia. Selanjutnya, Prancis juga memberinya ancaman. https://t.co/fslUVtrADe",5,1,0,1,2022-01-18,4,Tuesday,2,5,2
1483291110382448642,2022-01-18 04:12:13,"Heboh ahli menemukan varian lokal Jawa Timur. Eks petinggi WHO buka suara, minta kejelasan analisis genomik dan informasi di balik temuan tersebut. https://t.co/QrqktqEKAJ",6,11,3,1,2022-01-18,4,Tuesday,2,9,12
1483290836842524676,2022-01-18 04:11:08,"Ardhito Pramono dibawa ke BNNP DKI Jakarta, Cideng, Jakarta Pusat, untuk melakukan proses asesmen. Istri Ardhito turut mendampingi. https://t.co/V0qur0nASZ",6,0,0,0,2022-01-18,4,Tuesday,2,6,0
1483290539961331715,2022-01-18 04:09:57,"Hai Pisces, jalani dengan hati lapang dan jangan pernah berhenti untuk selalu berusaha ya. Bagaimana dengan #RamalanZodiak kamu hari ini? https://t.co/CYviCijdI4",3,1,1,0,2022-01-18,4,Tuesday,2,4,1
1483290067338682368,2022-01-18 04:08:04,Massimiliano Allegri menegaskan Coppa Italia adalah gelar yang penting dan mengindikasikan para pemainnya harus penuh obsesi di ajang itu. https://t.co/6XlV90TFm0,5,0,1,0,2022-01-18,4,Tuesday,2,6,0
1483289756536655873,2022-01-18 04:06:50,Presiden Joko Widodo (Jokowi) menyetujui perpanjangan diskon PPnBM untuk mobil baru. Berikut perbedaannya! https://t.co/qHO4gWu75z,4,2,2,0,2022-01-18,4,Tuesday,2,6,2
1483289264016211971,2022-01-18 04:04:53,Robert Lewandowski menjadi Pemain Terbaik FIFA 2021. Berikut daftar lengkap pemenang The Best FIFA Awards 2021. https://t.co/hA4DELX8lR,7,1,1,1,2022-01-18,4,Tuesday,2,8,2
1483288644295311361,2022-01-18 04:02:25,"Syarat penerbangan terbaru yang berlaku bulan Januari tahun 2022, 3 model berpakaian yang bisa bikin kamu diusir dari pesawat. Ini #BeritaTerpopuler kali ini: https://t.co/ngxT7J2FfB",7,0,0,0,2022-01-18,4,Tuesday,2,7,0
1483288077690880002,2022-01-18 04:00:10,Cristiano Ronaldo menegaskan bahwa dirinya masih penuh gairah dan bernafsu cetak banyak gol. https://t.co/5JN8qolgkG,14,2,2,0,2022-01-18,4,Tuesday,2,16,2
1483287573019693063,2022-01-18 03:58:10,Dua kali beruntun! Robert Lewandowski berhasil mengalahkan Lionel Messi dalam penghargaan pemain terbaik FIFA 2021. https://t.co/ccJqWW7yM7,24,4,5,0,2022-01-18,3,Tuesday,2,29,4
1483287331561951232,2022-01-18 03:57:12,"DKI Jakarta dan Bodetabek berada di level 2. Kapasitas WFO dan masuk mal jadi 50 persen, begini aturan terbaru yang berlaku hingga 24 Januari 2022: https://t.co/KOERZEHAH1",19,2,12,6,2022-01-18,3,Tuesday,2,31,8
1483286792753319938,2022-01-18 03:55:04,"Nadine Kaiser membuka diri untuk pertama kalinya, bercerita tentang Susi Air, Pangandaran, ambisi pribadi, masa remajanya, hingga air mata. #HotQuestions  https://t.co/GXlQw7xK7P",9,1,1,0,2022-01-18,3,Tuesday,2,10,1
1483286001657294854,2022-01-18 03:51:55,Media sosial ramai dengan video Upin Ipin meninggal dan dimakamkan. Pihak pembuat Upin Ipin di Malaysia membuat klarifikasi ini:  https://t.co/ww4GcCn7qF,16,0,3,1,2022-01-18,3,Tuesday,2,19,1
1483285713290473478,2022-01-18 03:50:46,Tim terbaik FIFA FIFPro tahun 2021 telah diumumkan. Siapa saja pemain yang masuk? https://t.co/errmEFJtwq,6,0,1,1,2022-01-18,3,Tuesday,2,7,1
1483285402320576515,2022-01-18 03:49:32,"LTMPT memperpanjang masa sanggah kuota SNMPTN 2022 sebab masih ada sejumlah sekolah yang memperbarui data. Catat ya, ini jadwal terbarunya:

via: detikedu https://t.co/Up7di1Juuq",7,1,0,0,2022-01-18,3,Tuesday,2,7,1
1483284631604678660,2022-01-18 03:46:28,"Ardhito Pramono mengajukan rehabilitasi. Hari ini, ia dibawa polisi untuk jalani asesmen. #ArdhitoPramono  https://t.co/hUaE13F3FB",5,1,0,1,2022-01-18,3,Tuesday,2,5,2
1483284622310088706,2022-01-18 03:46:26,Remy Sylado jalani operasi hernia di RSUD Tarakan tadi pagi. Ini riwayat sakit yang membuat kondisi kesehatannya terus menurun:  https://t.co/CQkARDONex,1,0,0,0,2022-01-18,3,Tuesday,2,1,0
1483284105915686912,2022-01-18 03:44:23,Bagaimana posisi Yamaha Fino usah Fazzio Hybrid Connected meluncur di Indonesia? https://t.co/ekCnqcUIhc,7,0,2,1,2022-01-18,3,Tuesday,2,9,1
1483283197639200771,2022-01-18 03:40:47,"#Foto Gaya Prilly Latuconsina selama liburan di Amerika Serikat mencuri atensi, terutama penampilannya di New York. Seperti apa ya? https://t.co/H2QKvZu4mX",13,4,1,1,2022-01-18,3,Tuesday,2,14,5
1483282708004585472,2022-01-18 03:38:50,Ramai video yang memperlihatkan makam Upin Ipin di media sosial. Begini klarifikasi dari rumah produksi Upin Ipin:  https://t.co/GWrxFmyYhR,9,0,1,1,2022-01-18,3,Tuesday,2,10,1
1483282221054279683,2022-01-18 03:36:54,"Setelah video mesra yang heboh di awal pergantian tahun, hubungan Ayu Aulia dan Zikry Daulay tampaknya makin dekat. #ZikriDaulay  https://t.co/bfkM9vHnKc",3,0,0,1,2022-01-18,3,Tuesday,2,3,1
1483281970121658369,2022-01-18 03:35:54,Seorang pemotor perempuan mengacungkan jari tengah ke petugas polisi yang menegurnya karena tak pakai helm. https://t.co/T1ycXcoQ4U,66,47,11,12,2022-01-18,3,Tuesday,2,77,59
1483281486296064000,2022-01-18 03:33:59,Radio militer Israel melaporkan kedatangan delegasi pejabat kesehatan dari Indonesia. Namun otoritas Indonesia mengaku tidak tahu menahu soal itu. https://t.co/aGwVvgQrH1,5,3,3,2,2022-01-18,3,Tuesday,2,8,5
1483280581358202890,2022-01-18 03:30:23,"Ardhito Pramono mengajukan rehabilitasi usai ditangkap polisi terkait kasus narkoba. Pagi ini, Ardhito dibawa ke BNNP DKI Jakarta. https://t.co/rZspAxHHmm",2,2,1,1,2022-01-18,3,Tuesday,2,3,3
1483280580179632134,2022-01-18 03:30:22,"Unair punya 2 juruan yang tidak disediakan kampus lain di Indonesia. Keduanya mempelajari teknologi maju dengan disiplin ilmu berbeda. Kamu tertarik?

via: detikedu https://t.co/GJap6CWUTf",8,0,1,2,2022-01-18,3,Tuesday,2,9,2
1483280025101254657,2022-01-18 03:28:10,"Jadwal puasa Ramadhan 2022 banyak dinantikan oleh umat muslim dari seluruh dunia. Kapan ya kita mulai berpuasa?

via: detikedu https://t.co/Ixw2uFZkGy",25,3,6,2,2022-01-18,3,Tuesday,2,31,5
1483279280763199494,2022-01-18 03:25:13,"Kolektivitas jadi kunci tak terbendungnya The Citizens di Liga Inggris, menurut John Stones. https://t.co/UMf75xaKWx",1,0,0,0,2022-01-18,3,Tuesday,2,1,0
1483278039349960709,2022-01-18 03:20:17,"Manajer Chelsea Thomas Tuchel ingin menuntaskan kontraknya sampai 2024. Namun, Tuchel juga sadar Chelsea punya 'tradisi' memecat pelatih apabila dianggap gagal. https://t.co/4wPsJkdkjv",7,0,0,0,2022-01-18,3,Tuesday,2,7,0
1483277310438653955,2022-01-18 03:17:23,Diet berprotein tinggi merupakan salah satu cara untuk bantu penurunan berat badan lebih maksimal. Ini rekomendasi makanannya. https://t.co/y16EWR0Clb,8,0,2,0,2022-01-18,3,Tuesday,2,10,0
1483276934444429316,2022-01-18 03:15:53,Bank sentral China memangkas suku bunga acuan. Pemangkasan ini dilakukan karena pada kuartal terakhir ekonomi hanya tumbuh 4%.  https://t.co/TCwCUCBUgt,4,0,0,0,2022-01-18,3,Tuesday,2,4,0
1483276415701237760,2022-01-18 03:13:50,PT Bursa Efek Indonesia (BEI) mengumumkan akan menghapus atau menjatuhkan delisting saham PT Hanson International Tbk (MYRX) dari papan perdagangan saham.  https://t.co/iG0GCtjROM,6,0,2,0,2022-01-18,3,Tuesday,2,8,0
1483275908286926849,2022-01-18 03:11:49,"Nilai tukar dolar Amerika Serikat (AS) pagi ini melemah terhadap rupiah. Mata uang Paman Sam turun 48 poin (0,33%) ke level Rp 14.289.  https://t.co/4mM056BpZ8",7,0,0,0,2022-01-18,3,Tuesday,2,7,0
1483275194546503684,2022-01-18 03:08:58,Mayoritas pembaca detikcom tidak setuju tarif KRL dinaikkan menjadi Rp 5.000. Ini alasannya.  https://t.co/mDCdu7XXD9,10,4,2,4,2022-01-18,3,Tuesday,2,12,8
1483275128628776962,2022-01-18 03:08:43,Cristiano Ronaldo diganjar sebuah penghargaan spesial. Penghargaan apa itu? https://t.co/wZJxGtMjwb,12,1,1,1,2022-01-18,3,Tuesday,2,13,2
1483274878132359169,2022-01-18 03:07:43,"Pengusaha batu bara sekaligus orang terkaya ke-18 di Indonesia versi Forbes, Dato Low Tuck Kwong kehilangan cuan US$ 260 juta, setara Rp 3,7 triliun!  https://t.co/Vh7n5mfqsF",2,0,2,1,2022-01-18,3,Tuesday,2,4,1
1483274641632342020,2022-01-18 03:06:47,"Penumpang dari 153 negara dilarang transit di Hong Kong, termasuk Indonesia. Hal ini dilakukan untuk mencegah penularan COVID-19 di negara tersebut. https://t.co/pAhFzRIA37",5,0,1,1,2022-01-18,3,Tuesday,2,6,1
1483273845494661122,2022-01-18 03:03:37,"Setelah dideportasi dari Australia, Novak Djokovic telah tiba di Serbia. https://t.co/B3i01tKXGV",6,0,0,0,2022-01-18,3,Tuesday,2,6,0
1483273278416470019,2022-01-18 03:01:22,"Haris Azhar dan Koordinator KontraS, Fatia Maulidiyanti, dikabarkan didatangi polisi di kediamannya pagi ini. Mereka hendak dibawa ke Polda Metro Jaya. https://t.co/GKYfSXNkTs",26,28,4,2,2022-01-18,3,Tuesday,2,30,30
1483272925218283522,2022-01-18 02:59:57,"#Foto Kiky Sapturi merenovasi rumah lamanya. Kini, rumah itu hadir dalam desain minimalis yang lebih modern. Wah, seperti apa transformasinya? https://t.co/GAbTxd4mkq",4,0,0,0,2022-01-18,2,Tuesday,2,4,0
1483271928811077635,2022-01-18 02:56:00,Jaksa penuntut umum memutarkan video yang menjadi bukti Munarman menyampaikan ceramah yang disebut menggerakkan orang lain untuk melakukan teror.  https://t.co/qIBLLBhLZO,8,1,1,1,2022-01-18,2,Tuesday,2,9,2
1483270915446218753,2022-01-18 02:51:58,"Ramainya pembahasan soal Haruna Soemitro memunculkan tagar #HarunaOut, yang dipicu komentar soal Shin Tae-yong. https://t.co/H5WFZHlrx8",5,2,1,0,2022-01-18,2,Tuesday,2,6,2
1483270625724715016,2022-01-18 02:50:49,Harga emas hari ini akhirnya naik. Harga emas Antam 24 karat hari ini naik Rp 2.000 per gram menjadi Rp 939.000 per gram.  https://t.co/qRgIQLspF2,8,0,2,2,2022-01-18,2,Tuesday,2,10,2
1483270615079563269,2022-01-18 02:50:47,"Indeks Harga Saham Gabungan (IHSG) hari ini dibuka menguat tipis 5 poin (0,08%) ke level 6.650.  https://t.co/45SLXpKZY3",0,0,0,0,2022-01-18,2,Tuesday,2,0,0
1483270033677733891,2022-01-18 02:48:28,"Melansir dari huffpost, Selasa (18/1/2022), rumah lelang Sotheby's menyebut berlian hitam 555,55 karat ini diyakini berasal dari luar angkasa!  https://t.co/i6OdcJrOK2",5,0,1,0,2022-01-18,2,Tuesday,2,6,0
1483270032473964546,2022-01-18 02:48:28,"Inilah momen penggerebekan arena judi sabung ayam di Dusun Cariu, Desa Ciberes, Kecamatan Patokbeusi, Subang, oleh unit Pidum Satreskrim Polres Subang. Puluhan pejudi langsung lari terbirit-birit ke sawah. https://t.co/3lvhQ7ZNDT",2,2,0,0,2022-01-18,2,Tuesday,2,2,2
1483267828052594690,2022-01-18 02:39:42,"Undip siap menampung dua ribu mahasiswa lebih di SNMPTN 2022. Wakil Rektor Undip membocorkan rahasia agar lolos menjadi salah satunya. Mau tahu?

via: detikedu https://t.co/XveLG31UC3",14,1,0,0,2022-01-18,2,Tuesday,2,14,1
1483266752280674304,2022-01-18 02:35:26,Sebuah perusahaan asing menjual rumah yang berlokasi di pinggir pantai Karimunjawa. Kejadian ini bikin heboh karena ditujukan untuk WNA. https://t.co/vPGyyhOdBu,15,3,5,0,2022-01-18,2,Tuesday,2,20,3
1483266048795230216,2022-01-18 02:32:38,#Foto Seorang wanita menikah dengan pria yang usianya jauh dengan dirinya. Pasutri ini dikira anak dan bapak. Seperti apa ya potretnya? https://t.co/yLfRWfch44,11,0,2,0,2022-01-18,2,Tuesday,2,13,0
1483265142964072455,2022-01-18 02:29:02,"Sesi foto kehamilan biasanya dilakukan di studio atau tempat yang Instagramble. Namun bumil ini memilih foto maternity di samping kandang ayam. Unik ya, bund... https://t.co/4xKVwOaYa0",5,0,0,0,2022-01-18,2,Tuesday,2,5,0
1483262869282205702,2022-01-18 02:20:00,#Terpopuler Jembatan KW 6 atau dikenal dengan Jembatan Kepuh di Karawang ambles. Padahal jembatan tersebut baru saja diresmikan pada 29 Desember 2021 lalu. https://t.co/QoeewJFclf,17,6,1,3,2022-01-18,2,Tuesday,2,18,9
1483262095898685441,2022-01-18 02:16:55,Alexia Putellas berhasil menjadi Pemain Wanita Terbaik FIFA 2021. Setelah mengalahkan Jennifer Hermoso. https://t.co/IinGTgbi0w,10,0,2,0,2022-01-18,2,Tuesday,2,12,0
1483260980528390150,2022-01-18 02:12:30,Jumlah pasien COVID-19 yang dirawat di RS Prancis mencetak rekor tertinggi sejak November 2020. Laporan pasien di ICU juga terus bertambah. https://t.co/1H4nHsNU0n,8,2,0,0,2022-01-18,2,Tuesday,2,8,2
1483259751177887744,2022-01-18 02:07:36,"Infeksi Covid-19 Omicron punya gejala demam, batuk, pilek, hingga kelelahan. Untuk meringankan, ada makanan terbaik dikonsumsi saat terinfeksi Covid-19 Omicron.  https://t.co/tD5LcANyov",10,0,2,0,2022-01-18,2,Tuesday,2,12,0
1483259224268455938,2022-01-18 02:05:31,"Banjir melanda belasan desa di tiga kecamatan wilayah timur Kabupaten Pasuruan. Banjir ada yang mencapai 1,5 meter dan menggenangi jalan raya. https://t.co/XAdVp2aZWs",7,1,3,0,2022-01-18,2,Tuesday,2,10,1
1483259211760951305,2022-01-18 02:05:28,"Gempa bumi berkekuatan Magnitudo 5,6 mengguncang wilayah Afghanistan. Lebih dari 20 orang dilaporkan tewas dan ratusan rumah hancur. https://t.co/OoP4ete5TQ",6,0,3,0,2022-01-18,2,Tuesday,2,9,0
1483258199952269313,2022-01-18 02:01:27,"""'Sebelum Anda itu [Indonesia] sudah lima kali jadi runner-up'. Ya ada atau tidak adanya Shin Tae Yong itu prestasi tertinggi kita itu runner up,"" ucap Haruna Soemitro. #CNNIndonesia #detiknetwork  https://t.co/lCf1UzYDcJ",121,93,11,15,2022-01-18,2,Tuesday,2,132,108
1483257043788214272,2022-01-18 01:56:51,Pembalap mobil Yoga S Prabowo fokus menggarap bisnis kopinya yang bernama Payu. Omzet yang berhasil dikantongi mencapai Rp 200 jutaan per bulan!  https://t.co/9Y303Llvm6,14,2,1,0,2022-01-18,1,Tuesday,2,15,2
1483255951117455360,2022-01-18 01:52:30,"#Terpopuler ""Jangan kau dengarkan suara sumbang. Oktober bakal ada yg tumbang,"" tulis Giring. https://t.co/yowzQj7IXB",89,86,11,16,2022-01-18,1,Tuesday,2,100,102
1483255207043772417,2022-01-18 01:49:33,"Bicara warung makan Padang tak bisa meninggalkan Jalan Kramat Raya di Senen, Jakarta Pusat. Di sini berjejer penjual nasi kapau enak yang begitu kesohor!  https://t.co/OWbKbX3Iwr",14,1,7,1,2022-01-18,1,Tuesday,2,21,2
1483254211567628289,2022-01-18 01:45:36,"Doyan makan, bocah ini begitu ekspresif saat melihat makanan. Melotot saat melihat donat hingga kegirangan saat diberi es krim!  https://t.co/uSVSPIZ9xL",8,0,1,1,2022-01-18,1,Tuesday,2,9,1
1483253960324620291,2022-01-18 01:44:36,"Minum kopi memang bisa menambah energi dan fokus, namun tak sedikit orang yang merasakan efek mual usai minum kopi. Berikut tiga alasan dan cara mengatasinya.  https://t.co/W7iZGS6Tev",13,0,8,2,2022-01-18,1,Tuesday,2,21,2
1483252723642507268,2022-01-18 01:39:41,Yusuf Ubay menjadi vokalis Nidji menggantikan Giring. Pria yang juga kontestan Indonesian Idol tahun 2014 ini punya banyak momen kuliner asyik.  https://t.co/d0SDiFraNq,18,0,1,0,2022-01-18,1,Tuesday,2,19,0
1483251681164992518,2022-01-18 01:35:32,"#Terpopuler Seorang rentenir, NS, terlibat duel maut dengan pedagang gorengan berinisial CS di Ciputat, Tangerang Selatan. Rentenir itu tewas setelah dibacok oleh CS. https://t.co/r9HHID7oME",14,0,3,2,2022-01-18,1,Tuesday,2,17,2
1483251667814469637,2022-01-18 01:35:29,Video resep memasak bisa menjadi konten menarik di TikTok. Simak trik membuat video agar disukai penonton!  https://t.co/N4pdMmSdjq,6,0,1,0,2022-01-18,1,Tuesday,2,7,0
1483250565287133188,2022-01-18 01:31:06,"Baru saja lulus dari sekolah hukum, anak Hotman Paris, Felicia Hutapea resmi menjadi pengacara di Inggris. Begini momen serunya saat kulineran di Inggris. #hotmanparis  https://t.co/jSdwBipRVa",11,0,1,1,2022-01-18,1,Tuesday,2,12,1
1483250554012852227,2022-01-18 01:31:04,"Setelah liburan panjang, Jin dan J-Hope BTS kini akhirnya bertemu. Itu berawal dari unggahan Jin yang memamerkan hasil panen strawberry di kebun pamannya.  https://t.co/WvwIzIvMw7",9,0,2,0,2022-01-18,1,Tuesday,2,11,0
1483249251324989442,2022-01-18 01:25:53,Seorang kakek penjual cilok yang berjualan sampai tubuhnya gemetar kini bisa tersenyum bahagia. Ia mendapatkan donasi puluhan juta rupiah sebagai modal usaha. https://t.co/OfTMfBD2pK,105,2,11,0,2022-01-18,1,Tuesday,2,116,2
1483248259044986880,2022-01-18 01:21:57,"Jangan menilai buku dari sampulnya, tapi masalahnya sampul bisa menjadi penilaian awal di mata orang. Makanya coba dandan kayak gini biar keliatan kayak sultan!  https://t.co/rF6Qa86XI6",8,1,1,1,2022-01-18,1,Tuesday,2,9,2
1483248015305490432,2022-01-18 01:20:58,Kementerian Energi dan Sumber Daya Mineral (ESDM) menargetkan Indonesia bisa menyediakan listrik dari pembangkit listrik tenaga nuklir (PLTN) pada 2049.  https://t.co/aN7aR7sJmT,9,0,7,1,2022-01-18,1,Tuesday,2,16,1
1483247996129234946,2022-01-18 01:20:54,Direktur Utama Perum Bulog Budi Waseso memproyeksi harga beras naik sampai bulan Februari 2022.   https://t.co/l9uLk8OEut,5,1,1,1,2022-01-18,1,Tuesday,2,6,2
1483247003714871297,2022-01-18 01:16:57,"Pembahasan Rancangan Undang-Undang Ibu Kota Negara (IKN) dikebut DPR. Bahkan, malam kemarin rapat panjang dilakukan Pansus RUU IKN bersama pemerintah.  https://t.co/f8LS9bKhHl",13,6,0,0,2022-01-18,1,Tuesday,2,13,6
1483246759669338117,2022-01-18 01:15:59,#Terpopuler Viral rencana Tabligh Akbar Ustaz Khalid Basalamah di Palu ditolak sejumlah ormas. Relawan Sahabat Khalid Basalamah memberikan penjelasan. https://t.co/6KHPuxVcAK,14,9,1,3,2022-01-18,1,Tuesday,2,15,12
1483245495346774017,2022-01-18 01:10:58,Jokowi memberikan pernyataan jika Kereta Cepat operasi Juni 2023. Ini fakta-faktanya  https://t.co/QpOiASujVs,9,3,5,2,2022-01-18,1,Tuesday,2,14,5
1483244996513996810,2022-01-18 01:08:59,Direktur Utama Perum Bulog Budi Waseso memproyeksi harga beras naik sampai bulan Februari 2022.  https://t.co/O5a2e9HMMx,12,3,2,4,2022-01-18,1,Tuesday,2,14,7
1483243686658031616,2022-01-18 01:03:46,"Tak seperti Jakarta, ibu kota baru ini sendiri akan dipimpin oleh sebuah badan otorita yang dikepalai oleh seorang kepala otorita yang posisinya setara menteri.  https://t.co/r8bJMo6oEk",52,20,6,7,2022-01-18,1,Tuesday,2,58,27
1483242896144936965,2022-01-18 01:00:38,"Ketua Umum PSI, Giring Ganesha, bicara soal 'tumbang' dan mengunggah video singkat lagu dengan lirik 'Jangan kau dengarkan suara sumbang' di media sosial. https://t.co/gPbvfn77Bl",12,9,1,0,2022-01-18,1,Tuesday,2,13,9
1483242651675672582,2022-01-18 00:59:40,"Alexia Putellas berhasil menjadi Pemain Wanita Terbaik FIFA 2021. Dia mengalahkan rekan satu timnya di Barcelona, Jennifer Hermoso. https://t.co/STHqydPSap",7,0,1,0,2022-01-18,0,Tuesday,2,8,0
1483242313484836865,2022-01-18 00:58:19,Roy Kiyoshi punya ratusan spirit doll. Harga spirit doll milik Roy Kiyoshi capai harga puluhan juta rupiah. https://t.co/m7GwKxuM6k,5,1,0,2,2022-01-18,0,Tuesday,2,5,3
1483241817126715392,2022-01-18 00:56:21,Kapolrestabes Medan Kombes Riko Sunarko diduga terima suap dari istri bandar narkoba. Sejumlah fakta terungkap saat kasus tengah diusut. https://t.co/xWUxpRPR5e,12,1,4,2,2022-01-18,0,Tuesday,2,16,3
1483241569587245056,2022-01-18 00:55:22,"Ramainya pembahasan soal Haruna Soemitro memunculkan tagar #HarunaOut, yang dipicu komentar soal Shin Tae-yong ak bawa timnas Indonesia Juara AFF 2020. https://t.co/qvnNQGHfjA",31,2,7,3,2022-01-18,0,Tuesday,2,38,5
1483241031869083655,2022-01-18 00:53:13,"Pelatih Chelsea Thomas Tuchel diganjar penghargaan Pelatih Terbaik FIFA 2021. Tuchel mengalahkan dua kandidat lainnya, Pep Guardiola dan Roberto Mancini. https://t.co/zB4OLhJP0N",13,2,2,0,2022-01-18,0,Tuesday,2,15,2
1483241010989780994,2022-01-18 00:53:08,"Polisi masih menyelidiki pengeroyokan yang menewaskan anggota TNI Pratu Sahdi di Jakut. Terkini, sudah ada 3 orang ditangkap polisi. https://t.co/XlFNv4t7Yp",4,2,0,0,2022-01-18,0,Tuesday,2,4,2
1483240786254864396,2022-01-18 00:52:15,Kapal selam nukli AS tiba-tiba muncul di pelabuhan Guam pada akhir pekan kemarin. Kemunculan kapal selam itu menjadi momen langka. https://t.co/flKpZSC3HR,11,0,2,0,2022-01-18,0,Tuesday,2,13,0
1483240539088723972,2022-01-18 00:51:16,"Hujan deras disertai angin kencang terjadi di Kota Malang dan sekitarnya, siang tadi. Atap parkir angkot di Terminal. Arjosari, Kota Malang, roboh. https://t.co/SnsCdo6HJr",9,1,4,1,2022-01-18,0,Tuesday,2,13,2
1483240041283522560,2022-01-18 00:49:17,Ketua Komisi 3 DPRD Karawang Endang Sodikin meminta pembangunan Jembatan Kepuh yang ambles dievaluasi. Perbaikan jembatan harus memerhatikan kualitas. https://t.co/GOrwZTc73Q,4,0,0,1,2022-01-18,0,Tuesday,2,4,1
1483239815621623809,2022-01-18 00:48:23,Robbie Williams berbagi kisah yang dialaminya kala menjadi target pembunuh bayaran. Begini kisahnya:  https://t.co/fXrhU1dWei,5,0,0,0,2022-01-18,0,Tuesday,2,5,0
1483239801763553282,2022-01-18 00:48:20,Atta Halilintar ngaku nyaman ketika karantina. Sebab pihak hotel benar-benar menerapkan aturan dari pemerintah. https://t.co/CfTwhelmLJ,28,35,3,7,2022-01-18,0,Tuesday,2,31,42
1483238505203617794,2022-01-18 00:43:11,Pansus IKN bersama pemerintah telah menyepakati RUU IKN pada tingkat satu. DPR RI akan menggelar rapat paripurna pengesahan RUU IKN hari ini. https://t.co/F8S0HQ2mAh,12,3,3,3,2022-01-18,0,Tuesday,2,15,6
1483238287552700429,2022-01-18 00:42:19,Ferdinand Hutahaean menulis surat permintaan maaf atas cuitannya 'Allahmu ternyata lemah'. Apa isinya? https://t.co/YhtBEey86y,6,1,1,1,2022-01-18,0,Tuesday,2,7,2
1483237288293416964,2022-01-18 00:38:21,Mendagri Tito Karnavian mengeluarkan Inmendagri terbaru terkait daerah Jawa dan Bali yang menerapkan PPKM. Jabodetabek menerapkan PPKM level 2. https://t.co/V52OEgal2Q,6,0,1,1,2022-01-18,0,Tuesday,2,7,1
1483236967873662977,2022-01-18 00:37:05,"Heru Hidayat akan menjalani sidang vonis kasus korupsi ASABRI, Selasa (18/1). Heru diketahui dituntut hukuman mati oleh jaksa penuntut umum (JPU). https://t.co/UBf5u2pTl4",6,2,2,0,2022-01-18,0,Tuesday,2,8,2
1483236474657157122,2022-01-18 00:35:07,Polri akan memperkenalkan seragam baru satpam berwarna krem pada hari ulang tahun (HUT) satpam yang jatuh pada 31 Januari 2022. Apa kata para satpam? https://t.co/tklWxsGwy1,13,1,2,4,2022-01-18,0,Tuesday,2,15,5
1483236220041891843,2022-01-18 00:34:06,Ibu kota baru Indonesia telah diputuskan bernama Nusantara. Namun penamaan Nusantara ini mendapatkan kritik dari anggota DPR. https://t.co/Spwgyot4on,27,13,3,1,2022-01-18,0,Tuesday,2,30,14
1483235435996397576,2022-01-18 00:30:59,Pangeran Harry ngaku ingin memboyong keluarganya kembali ke Inggris. Namun ia mengajukan syarat ini agar hal itu bisa tercapai:  https://t.co/aaPdQtI4kY,12,0,0,1,2022-01-18,0,Tuesday,2,12,1
1483235418199973890,2022-01-18 00:30:55,"COVID-19 kehilangan kemampuan menginfeksi atau menular ketika sudah bertahan di udara selama 20 menit, berdasarkan hasil riset baru. Begini gambarannya. https://t.co/MULIC3G76n",11,2,6,0,2022-01-18,0,Tuesday,2,17,2
1483235172132732929,2022-01-18 00:29:56,"Wanita berusia 55 tahun terus-menerus sakit perut. Rupanya, sakit tersebut disebabkan gunting 'ketinggalan' di perutnya sejak operasi 20 tahun silam. Kok bisa? https://t.co/KjVNjmsOc7",9,1,0,1,2022-01-18,0,Tuesday,2,9,2
1483234672175943685,2022-01-18 00:27:57,Pemerintah mengeluarkan kebijakan untuk memberikan vaksinasi booster COVID-19 kepada masyarakat. Bagaimana cara mendapatkan tiket vaksin booster? https://t.co/xwrutY1SIh,13,1,4,1,2022-01-18,0,Tuesday,2,17,2
1483233814969208833,2022-01-18 00:24:33,Menteri Agama Yaqut Cholil Qoumas membeberkan sejumlah aturan terkait keberangkatan haji dan umrah di tahun 2022. Meski keberangkatan haji belum diketahui. https://t.co/Fkc4xTIsQC,4,1,1,0,2022-01-18,0,Tuesday,2,5,1
1483233318229393409,2022-01-18 00:22:34,"MotoGP 2022 tinggal menghitung hari. Rider Gresini, Enea Bastianini, memberi prediksi balapan tahun ini akan berjalan lebih seru. https://t.co/s3EQsMsBOy",2,0,0,0,2022-01-18,0,Tuesday,2,2,0
1483232031848939520,2022-01-18 00:17:28,"Tak ada DKI Jakarta, daftar wilayah PPKM level 1 diisi Jabar dan wilayah lain. Cek daftar terbaru wilayah PPKM level 1 di Jawa Bali. https://t.co/C3CMfE9fiM",12,0,0,0,2022-01-18,0,Tuesday,2,12,0
1483231737601736710,2022-01-18 00:16:18,Tiga pria ditangkap polisi gegara diduga memperkosa pelajar SMP yang masih berusia 15 tahun. Polisi mengungkap kronologi kasus tersebut. https://t.co/UeXlQfFQtI,23,0,4,1,2022-01-18,0,Tuesday,2,27,1
1483231240287309824,2022-01-18 00:14:19,Tawuran antar-pelajar bukan peristiwa awam di Bekasi. Plt Walkot Bekasi ingin ada siraman materi khusus kepada siswa selama 15 menit sebelum pulang sekolah. https://t.co/8kYWSHd459,5,0,1,1,2022-01-18,0,Tuesday,2,6,1
1483230748501065728,2022-01-18 00:12:22,Jembatan KW 6 atau dikenal dengan Jembatan Kepuh di Kabupaten Karawang ambles. Padahal jembatan tersebut baru saja diresmikan pada 29 Desember 2021 lalu. https://t.co/RtpmA2yyCR,22,40,9,5,2022-01-18,0,Tuesday,2,31,45
1483230246673522690,2022-01-18 00:10:22,"Saksi menceritakan keanehan saat acara diduga pembaiatan ISIS digelar di Gedung Syahida Inn UIN Syarif Hidayatullah, Ciputat, yang diduga diikuti Munarman. https://t.co/OCyvviuqoa",13,1,1,3,2022-01-18,0,Tuesday,2,14,4
1483228733330935808,2022-01-18 00:04:21,Ruang persidangan terdakwa kasus terorisme Munarman memanas. Emosi Munarman meledak-ledak saat jaksa hendak menginterupsi. https://t.co/XT6jFJtc0t,9,4,0,0,2022-01-18,0,Tuesday,2,9,4
1483227849951748097,2022-01-18 00:00:51,"Supaya otak bisa cepat memecahkan masalah, maka pikiran perlu dilatih. Coba, bisa jawab nggak soal yang satu ini? https://t.co/dfwejKunuC",188,240,15,10,2022-01-18,0,Tuesday,2,203,250
1483226359610621952,2022-01-17 23:54:55,"Seohyun SNSD dan Lee Jun Young membintangi Love and Leashes. Yuk, intip trailernya! #LoveandLeashes  https://t.co/4wZ89IAihv",21,0,4,4,2022-01-17,23,Monday,1,25,4
1483225840058052609,2022-01-17 23:52:51,Aksi Anies mengundang Nidji dinilai sebagai upaya 'memukul' balik Giring dan PSI. Anies juga dinilai menyampaikan pesan sederhana lewat pujiannya ke Nidji. https://t.co/JDxjkpmLP1,48,29,5,4,2022-01-17,23,Monday,1,53,33
1483225341888020484,2022-01-17 23:50:53,"Ada yang berbeda di antara huruf, kata, dan warna pada teka-teki ini. Bisakah kamu mencarinya? Artinya mata kamu masih berfungsi dengan baik. https://t.co/t72GZUNNU5",2,0,0,1,2022-01-17,23,Monday,1,2,1
1483224848012828672,2022-01-17 23:48:55,"Indonesia mencatat sebanyak 772 kasus baru COVID-19, Senin (17/1/2022). DKI menyumbang kasus terbanyak dengan jumlah 493. https://t.co/HCvpuyCX7G",6,0,1,1,2022-01-17,23,Monday,1,7,1
1483224324270174208,2022-01-17 23:46:50,Tim Nasional (Timnas) Hoki Outdoor Putri Indonesia yang berkekuatan 20 pemain akan tampil pada Kejuaraan Outdoor Putri Piala Asia 2022. https://t.co/FLTj7bUBMY,6,0,0,1,2022-01-17,23,Monday,1,6,1
1483223329884545031,2022-01-17 23:42:53,Sekjen PDIP Hasto Kristiyanto menduga laporan Dosen UNJ Ubedillah Badrun ada kaitannya dengan partai politik. Ubedillah menilai tudingan Hasto keliru. https://t.co/41VdmTJadL,9,1,1,1,2022-01-17,23,Monday,1,10,2
1483222835552305153,2022-01-17 23:40:55,"Aksi panggung Nidji dipuji Gubernur DKI Jakarta, Anies Baswedan. Mereka disebut spektakuler dan tanpa suara sumbang. https://t.co/efgDNjYN4x",73,6,10,0,2022-01-17,23,Monday,1,83,6
1483222606379732995,2022-01-17 23:40:00,"Kedatangan Xavi di kursi pelatih Barcelona, belum terlihat dampak besar. Salah satu penyebabnya, beberapa para pemain Barca bak jadi pesakitan! https://t.co/4kAnl6dKbc",7,0,1,0,2022-01-17,23,Monday,1,8,0
1483222591787737090,2022-01-17 23:39:57,Tim terbaik FIFA FIFPro tahun 2019 telah diumumkan. Untuk kali pertama cuma diisi oleh tiga bek dan ada empat striker. https://t.co/Z9Gz3GcuYg,4,0,1,0,2022-01-17,23,Monday,1,5,0
1483222100194299906,2022-01-17 23:38:00,Cara mengecek NIK terdaftar di Dukcapil mudah dan bisa dilakukan dari rumah. Cek di sini prosedurnya:  https://t.co/9wfxwyILSW,41,1,15,0,2022-01-17,23,Monday,1,56,1
1483221323317153796,2022-01-17 23:34:55,"Novak Djokovic baru saja terusir dari Australia lantaran status vaksinasinya. Selanjutnya, Prancis juga memberinya ancaman. https://t.co/CccFGVXmoA",2,0,1,1,2022-01-17,23,Monday,1,3,1
1483219465865252867,2022-01-17 23:27:32,"Malang bagi seorang bayi sakit di Kota Makassar, Sulsel yang meninggal di ambulans saat dilarikan ke RS. Berikut 5 fakta miris peristiwa tersebut. https://t.co/s9dTTTjgjl",9,3,3,0,2022-01-17,23,Monday,1,12,3
1483218743958331397,2022-01-17 23:24:40,"Seorang pelajar SMA, Satria Adi, tewas karena terseret arus ketika berenang di Sungai Oya Pedukuhan Jetis, Selopamioro, Imogiri, Bantul, Senin (17/1). https://t.co/vCIzXCTBh6",7,0,0,0,2022-01-17,23,Monday,1,7,0
1483217997909135363,2022-01-17 23:21:42,Pelaku perjalanan luar negeri (PPLN) masih mendominasi kasus varian Omicron di DKI Jakarta. Hingga kini tercatat sudah ada 825 kasus Omicron di ibukota. https://t.co/O6C2lOjeBh,6,5,9,7,2022-01-17,23,Monday,1,15,12
1483216662803488772,2022-01-17 23:16:23,"Ribuan orang turun ke jalan-jalan di seluruh Sudan menentang kudeta militer. Aksi berujung ricuh, hingga menewaskan 3 pedemo. https://t.co/hVdvb6MOnZ",8,0,1,1,2022-01-17,23,Monday,1,9,1
1483216178931810304,2022-01-17 23:14:28,"Seorang pria berinisial AF (34) di Jalan Olah Raga, Bojong Gede, Kabupaten Bogor, tewas dibacok orang tidak dikenal. Polisi saat ini menyelidiki kasus tersebut. https://t.co/OARthCCOjq",2,0,0,0,2022-01-17,23,Monday,1,2,0
1483215440444854273,2022-01-17 23:11:32,"Saksi menceritakan keanehan saat acara diduga pembaiatan ISIS digelar di Gedung Syahida Inn UIN Syarif Hidayatullah, Ciputat, yang diduga diikuti Munarman. https://t.co/A7W2zaePHE",10,0,2,0,2022-01-17,23,Monday,1,12,0
1483213901500239873,2022-01-17 23:05:25,"BPOM RI telah menyetujui sejumlah kombinasi vaksin booster COVID-19, baik homolog maupun heterolog. Makin banyak pilihan yang bisa digunakan. https://t.co/rthHHUy1Sj",3,1,5,1,2022-01-17,23,Monday,1,8,2
1483213128909443078,2022-01-17 23:02:21,"Jadwal puasa Ramadhan 2022 banyak dinantikan oleh umat muslim dari seluruh dunia. Pasalnya, hal ini menjadi acuan agar umat muslim bisa mempersiapkan dirinya. https://t.co/NDxo05TtXb",6,0,6,0,2022-01-17,23,Monday,1,12,0
1483212503786086410,2022-01-17 22:59:52,Ferdinand Hutahaean menulis surat permintaan maaf ke masyarakat dari balik tahanan. Apa isinya? https://t.co/auHRoeXrdh,4,3,0,3,2022-01-17,22,Monday,1,4,6
1483211406099025920,2022-01-17 22:55:30,"Pesepakbola wanita Nadia Nadim melewati perjalanan panjang sebelum jadi pemain bintang di Eropa. Tak cuma oke di lapangan, Nadim juga brilian di luar lapangan. https://t.co/pSVkEYfhmy",8,0,1,1,2022-01-17,22,Monday,1,9,1
1483209858409279488,2022-01-17 22:49:21,Twitter Presiden Jokowi ramai diperbincangkan karena sempat mengunggah foto sirkuit Portugal ditulis Mandalika. PPP mengusulkan tim medsos presiden diganti. https://t.co/9SofTq1Lp0,15,4,3,1,2022-01-17,22,Monday,1,18,5
1483209126993973248,2022-01-17 22:46:27,Cristiano Ronaldo bukannya bertangan hampa di Penghargaan FIFA 2021. Megabintang sepakbola Portugal ini diganjar sebuah penghargaan spesial. Apa itu? https://t.co/MzGhVNZecX,14,0,3,0,2022-01-17,22,Monday,1,17,0
1483207818282999809,2022-01-17 22:41:15,Kiper Real Madrid Thibaut Courtois membuat penyelamatan fantastis saat membantu timnya juara Piala Super Spanyol. Penalti lawan ditepisnya dengan ujung kaki! https://t.co/BtQO6c5g6q,5,2,0,0,2022-01-17,22,Monday,1,5,2
1483205927914328074,2022-01-17 22:33:44,"Menghadapi lonjakan Omicron, Luhut mengimbau pembatasan WFO. Jangan cuma kantor, pakar edpidemiologi menilai sekolah tatap muka juga perlu dibatasi. https://t.co/Qtlr0aIL6q",50,21,14,6,2022-01-17,22,Monday,1,64,27
1483205192275435520,2022-01-17 22:30:49,Munarman menuding saksi IM berbohong saat memberikan keterangan di persidangan. Munarman mengaku akan menuntut saksi di yaumul hisab nanti. https://t.co/0k5ZK5go8G,40,33,2,2,2022-01-17,22,Monday,1,42,35
1483204203245981704,2022-01-17 22:26:53,"Usai Jason Momoa memutuskan pisah dari Lisa Bonet, ramai tudingan Amber Heard sebagai pelakor. Hmm… https://t.co/IBWVHx5Fv8",8,0,1,2,2022-01-17,22,Monday,1,9,2
1483203000080424960,2022-01-17 22:22:06,"Ramai #HarunaOut imbas dari pernyataan Anggota Exco PSSI, Haruna Soemitro mengkritik Shin Tae-yong tak bawa timnas Indonesia Juara AFF 2020. https://t.co/REOLO65Jxj",32,31,6,5,2022-01-17,22,Monday,1,38,36
1483202150238990340,2022-01-17 22:18:43,Dirut Garuda Indonesia Irfan Setiaputra memutuskan menarik seluruh snack dengan ilustrasi Kaesang Pangarep setelah menjadi perbincangan. https://t.co/DeotAAPB1D,13,2,4,1,2022-01-17,22,Monday,1,17,3
1483200598673666050,2022-01-17 22:12:33,"Pria MJ (58) diduga membunuh wanita Aceh Timur, Aceh, Asrawati (35) dengan cara menggorok leher korban. Pembunuhan itu diduga dipicu masalah asmara. https://t.co/6vyO7wfUXC",3,1,0,0,2022-01-17,22,Monday,1,3,1
1483199275165179912,2022-01-17 22:07:18,"Meski infeksi COVID-19 varian Omicron cenderung ringan, virus ini tidak bisa dianggap remeh. Pakar IDI menyinggung kondisi di AS sebagai gambaran. https://t.co/xfUNqIY39k",8,0,2,0,2022-01-17,22,Monday,1,10,0
1483198318964621312,2022-01-17 22:03:30,"Mahasiswi Jambi, Mualimatus Shaliha berhasil ditemukan setelah dilaporkan hilang. Mualimatus hilang lantaran kabur karena mengetahui kekasihnya akan dijodohkan. https://t.co/cGdkTtFK1G",22,5,1,4,2022-01-17,22,Monday,1,23,9
1483196805152231426,2022-01-17 21:57:29,"PM Malaysia Ismail Sabri Yaakob memberikan komitmennya untuk membantu Rohana Abdullah, gadis keturunan Indonesia, mendapatkan kewarganegaraan Malaysia. https://t.co/93QsEs8c3d",33,2,2,0,2022-01-17,21,Monday,1,35,2
1483194819363098629,2022-01-17 21:49:36,BMKG mengeluarkan prakiraan cuaca untuk wilayah DKI Jakarta. BMKG memprediksi sejumlah wilayah Jakarta diguyur hujan disertai angin kencang. https://t.co/zACAmXeDvj,15,1,3,0,2022-01-17,21,Monday,1,18,1
1483190588145082371,2022-01-17 21:32:47,"Para peneliti merilis gambar mikroskop Virus Corona, patogen mematikan yang telah merenggut ratusan nyawa dan menyebar ke berbagai benua. Ini penampakannya: https://t.co/xeyYCv44To",8,1,2,0,2022-01-17,21,Monday,1,10,1
1483189091818684419,2022-01-17 21:26:50,Sempat memanas antara Fadly dengan Doddy Sudrajat yang ingin mengambil Gala Sky secara tiba-tiba. Mereka bahkan hampir adu jotos.  https://t.co/EpWcNui4Wk,23,7,0,0,2022-01-17,21,Monday,1,23,7
1483188048028442628,2022-01-17 21:22:41,Kanye West seolah menabuh genderang perang dengan Pete Davidson. Sementara Pete malah berikan respon dingin dan santai. https://t.co/mh56cEGD3S,4,1,1,0,2022-01-17,21,Monday,1,5,1
1483186812088729601,2022-01-17 21:17:46,Nama ibu kota baru kini telah disepakati oleh pemerintah dengan nama Nusantara. Bagaimana fakta terbarunya? https://t.co/kxoKKoNzOy,9,3,7,2,2022-01-17,21,Monday,1,16,5
1483185790381346818,2022-01-17 21:13:43,"Mengenal acetylcysteine, obat yang berguna untuk mengencerkan atau memecah lendir yang ada di mulut, tenggorokan, dan paru-paru. https://t.co/LVBtl8mVOk",13,0,5,0,2022-01-17,21,Monday,1,18,0
1483184803927232513,2022-01-17 21:09:48,Angka kelahiran di China anjlok ke rekor terendah. Angka ini menjadi yang terendah yang tercatat di data Buku Tahunan Statistik tahunan negara itu sejak 1978. https://t.co/Q3dDCe9WNa,9,2,1,1,2022-01-17,21,Monday,1,10,3
1483183647175888905,2022-01-17 21:05:12,"Olla Ramlan dan Aufar Hutapea terlihat mesra saat merayakan ulang tahun anaknya, Aleena Hutapea. Ini potretnya: https://t.co/81gz8fREUQ",9,0,2,0,2022-01-17,21,Monday,1,11,0
1483181702306537473,2022-01-17 20:57:28,Seorang dokter di San Francisco menemukan gejala baru saat terinfeksi virus Corona varian Omicron. Gejala Omicron satu ini muncul saat bangun tidur. https://t.co/qkVV2fRxTe,33,24,13,7,2022-01-17,20,Monday,1,46,31
1483180684587974661,2022-01-17 20:53:26,"Kabid Propam Polda Sumut, Kombes JF Panjaitan, menjelaskan pemeriksaan Kapolrestabes Medan Kombes Riko Sunarko yang diduga terima suap dari bandar narkoba. https://t.co/d88ze1w0ke",10,4,3,0,2022-01-17,20,Monday,1,13,4
1483179572304695299,2022-01-17 20:49:00,Robert Lewandowski berhasil mengalahkan Lionel Messi dalam penghargaan pemain terbaik FIFA 2021. Ini jadi gelar keduanya secara beruntun. https://t.co/ula1xilGfU,7,1,4,0,2022-01-17,20,Monday,1,11,1
1483178811789348872,2022-01-17 20:45:59,Marissya Icha menceritakan kronologi hingga dirinya dituduh melakukan penganiayaan terhadap Medina Zein. Marissya mengaku tidak melakukan kontak fisik terhadap Medina. https://t.co/fuFGwdS9Eo,8,0,1,0,2022-01-17,20,Monday,1,9,0
1483177965076680705,2022-01-17 20:42:37,Azis Syamsuddin saat diperiksa sebagai terdakwa mengaku pernah ditakut-takuti AKP Robin. Bagaimana ceritanya? https://t.co/FLIS0pEsFn,4,0,1,0,2022-01-17,20,Monday,1,5,0
1483176446029930500,2022-01-17 20:36:35,"Gubernur Anies Baswedan memuji penampilan Nidji saat sound check di JIS. Hal itu diduga sebagai satire yang ditujukan untuk Giring, benarkah? https://t.co/Vt6WOIdCIL",67,6,14,3,2022-01-17,20,Monday,1,81,9
1483175310510149636,2022-01-17 20:32:04,Tuntutan hukuman mati kepada Herry Wirawan pemerkosa 13 santriwati di Bandung menuai pro-kontra. Bagaimana respons Herry? https://t.co/nHBXeeDExQ,1,3,0,0,2022-01-17,20,Monday,1,1,3
1483171963329732611,2022-01-17 20:18:46,"""Jangan kau dengarkan suara sumbang. Oktober bakal ada yg tumbang,"" tulis Giring. https://t.co/2H5Go2lWqb",55,62,4,10,2022-01-17,20,Monday,1,59,72
1483171015882686469,2022-01-17 20:15:00,"Mantan Wakil Ketua DPR RI Azis Syamsuddin saat ini tengah terjerat kasus suap berkaitan dengan DAK Lampung Tengah 2017. Dalam sidang, Azis mengaku khilaf telah mengirimkan sejumlah uang kepada eks penyidik KPK Stephanus Robin Pattuju. https://t.co/nw0bsF1Ygy",2,2,1,0,2022-01-17,20,Monday,1,3,2
1483170107983642635,2022-01-17 20:11:24,"Seorang pengendara motor wanita ditegur polisi untuk memakai helm di Pasar Rebo, Jakarta Timur. https://t.co/59ptZXfHDt",10,1,1,0,2022-01-17,20,Monday,1,11,1
1483168630888181764,2022-01-17 20:05:32,"Saat kejadian, cuaca berkabut tebal. Bachtiar tiba-tiba tertembak dari belakang oleh KKB. https://t.co/9UFgDHEBbg",8,2,4,2,2022-01-17,20,Monday,1,12,4
1483167451235950598,2022-01-17 20:00:50,Jokowi tampak berbincang bersama Kepala BAIS Letjen Joni Supriyanto sebelum bertolak ke Bandung. Ini yang dibicarakan. https://t.co/GausPOCXDU,1,0,1,0,2022-01-17,20,Monday,1,2,0
1483166428006133763,2022-01-17 19:56:46,"Jaksa memutarkan video Munarman saat menghadiri acara tablig akbar pada 25 Januari 2015. Dalam video tersebut, Munarman berbicara syariat Islam. https://t.co/kRXHLyKuvC",6,3,1,0,2022-01-17,19,Monday,1,7,3
1483165046083665928,2022-01-17 19:51:17,"Duel berdarah rentenir dan pedagang gorengan di Ciputat, Tangsel, mengakibatkan 1 tewas. Terduga pelaku, pedagang gorengan juga mengalami luka-luka. https://t.co/DaIeH22AKR",13,1,3,1,2022-01-17,19,Monday,1,16,2
1483163934504927242,2022-01-17 19:46:52,Sebuah video yang menunjukkan seorang warga membawa peti mati menggunakan sepeda motor melewati jalan rusak viral. Peristiwa itu disebut terjadi di Sumut. https://t.co/AJW9A6xxql,1,0,2,0,2022-01-17,19,Monday,1,3,0
1483162592243859466,2022-01-17 19:41:32,RS (26) menjadi korban aksi cabul dan pemukulan W alias Bento (42) saat manggung di Klaten. Begini kisah pilunya. https://t.co/UZDml4ViqM,6,1,3,0,2022-01-17,19,Monday,1,9,1
1483161040586166274,2022-01-17 19:35:22,Hakim menilai keduanya tidak terbukti melakukan pencemaran nama baik. https://t.co/BkpuQmwRbH,3,0,0,0,2022-01-17,19,Monday,1,3,0
1483159726020087815,2022-01-17 19:30:09,Nisan kuno bertulisan aksara jawi ditemukan pekerja kontraktor pembangunan jaringan drainase di Jembatan Ampera langsung dikuburkan kembali. Kenapa? https://t.co/u3oaPJlvAT,10,1,6,0,2022-01-17,19,Monday,1,16,1
1483158690400243719,2022-01-17 19:26:02,"Seorang rentenir, NS terlibat duel maut dengan pedagang gorengan berinisial CS di Pondok Aren, Tangerang Selatan. Rentenir itu tewas setelah dibacok oleh CS. https://t.co/9BzwHpFUJa",12,0,3,0,2022-01-17,19,Monday,1,15,0
1483157566628712452,2022-01-17 19:21:34,"Menkes menyebut DKI adalah medan perang pertama RI melawan varian Omicron. Lantas, apa kabar wilayah-wilayah lain? Seberapa besar risiko ikut diterpa Omicron? https://t.co/wvroLX2ZLE",8,3,1,1,2022-01-17,19,Monday,1,9,4
1483156452986470403,2022-01-17 19:17:08,"""Sebagai negara dengan penduduk muslim terbesar di dunia, saya yakin potensi zakat kita yang belum tergali masih sangat besar,"" kata Jokowi. https://t.co/UPWnBJQDL1",58,68,8,10,2022-01-17,19,Monday,1,66,78
1483155412815855618,2022-01-17 19:13:00,Memiliki jerawat saja sudah menyebalkan ditambah dengan noda hitam bekas jerawat yang susah hilang. Gimana ya cara menghilangkannya? Intip 8 caranya: https://t.co/aVBAysVNjv,7,0,0,0,2022-01-17,19,Monday,1,7,0
1483153850420846601,2022-01-17 19:06:48,"Ibu hamil Rusmina (40) di Sumsel yang mau melahirkan, videonya viral terpaksa ditandu karena kondisi jalan rusak. Pilunya, bayi Rusmina meninggal dunia. https://t.co/G6ATg7Gufv",61,7,25,10,2022-01-17,19,Monday,1,86,17
1483152774716084228,2022-01-17 19:02:31,Gol Erik Lamela ke gawang Arsenal berhasil meraih Puskas Award 2021. Ini menjadi dua tahun beruntun gol terbaik datang dalam laga Tottenham Hotspur. https://t.co/YTHDzwOpkA,7,0,0,0,2022-01-17,19,Monday,1,7,0
1483151679059070977,2022-01-17 18:58:10,"Mantan wakil ketua DPR yang kini jadi terdakwa kasus suap eks penyidik KPK, Azis Syamsuddin memaparkan pengalamannya menangkap pegawai KPK gadungan. Seperti apa? https://t.co/QtyewSdpGb",4,2,2,1,2022-01-17,18,Monday,1,6,3
1483150603605970944,2022-01-17 18:53:54,"Menurut LaNyalla nasib Jakarta harus diputuskan secara terbuka dan matang, baik dari sisi aset maupun new positioning. https://t.co/5KISVqpWGg",17,5,9,2,2022-01-17,18,Monday,1,26,7
1483149226578268162,2022-01-17 18:48:25,Azis mengaku saat mengirim uang itu pikirannya sedang kalut. https://t.co/oWL8fxOUqh,35,45,8,13,2022-01-17,18,Monday,1,43,58
1483148086650314755,2022-01-17 18:43:54,Ibu bayi tujuh bulan yang meninggal di ambulans gegara tak diberi jalan oleh pengendara lain di Makassar mengaku tak punya biaya sehingga melewati RS terdekat. https://t.co/OrdudIg9yJ,13,4,1,0,2022-01-17,18,Monday,1,14,4
1483145929385549844,2022-01-17 18:35:19,Seorang anak berusia 10 tahun di Kota Tasikmalaya meninggal dunia beberapa hari setelah mendapatkan vaksinasi. Dinkes Kota Tasikmalaya memberikan penjelasan. https://t.co/Ltab41Fx5y,369,80,183,35,2022-01-17,18,Monday,1,552,115
1483144833128701954,2022-01-17 18:30:58,"Seorang rentenir tewas setelah duel dengan pedagang gorengan di Ciputat, Tangsel. Kejadian ini dipicu penagihan utang oleh korban. https://t.co/HGxaKTA5mP",15,0,2,1,2022-01-17,18,Monday,1,17,1
1483144233745797125,2022-01-17 18:28:35,Pansus IKN bersama pemerintah menggelar rapat kerja membahas RUU IKN. Ada sejumlah agenda yang akan dibahas dalam rapat kerja hingga dini hari ini. https://t.co/OqyuY5vwHG,4,1,2,1,2022-01-17,18,Monday,1,6,2
1483142006490734599,2022-01-17 18:19:44,Striker Inter Milan Edin Dzeko sedang mejan. Dzeko mesti segera bikin gol lagi karena Inter mulai memasuki fase penting kompetisi. https://t.co/4LNd64i6et,7,0,0,2,2022-01-17,18,Monday,1,7,2
1483140570289692686,2022-01-17 18:14:02,Ibu kota tersebut akan berbentuk pemerintah daerah bersifat khusus setingkat provinsi. https://t.co/2Bt33pXsN6,9,4,2,2,2022-01-17,18,Monday,1,11,6
1483139515711692800,2022-01-17 18:09:50,Eks Wakil Ketua DPR Azis Syamsuddin mengaku mentransfer sejumlah uang ke eks penyidik KPK Stepanus Robin Pattuju. Azis mengirimkan uang tersebut secara bertahap. https://t.co/VYjSaS5Etg,9,0,2,0,2022-01-17,18,Monday,1,11,0
1483137734193684485,2022-01-17 18:02:45,Ketua Umum PSI Giring Ganesha berbicara soal suara sumbang. Giring turut mengunggah video dengan lirik 'jangan kau dengarkan suara sumbang'. Membalas Anies? https://t.co/ibQxekzVBW,35,43,2,4,2022-01-17,18,Monday,1,37,47
1483136600175529984,2022-01-17 17:58:15,"Terdakwa kasus dugaan terorisme, Munarman, emosi ke saksi pelapor berinisial IM yang dihadirkan jaksa penuntut umum (JPU) di persidangan. https://t.co/uwgDNrltmb",9,3,0,0,2022-01-17,17,Monday,1,9,3
1483135299760885767,2022-01-17 17:53:05,"Covid-19 telah membuat orang kaya makin kaya sementara kemiskinan terus meningkat, kata lembaga nirlaba Oxfam. https://t.co/sX3qbmUAux",13,3,8,1,2022-01-17,17,Monday,1,21,4
1483134106544320516,2022-01-17 17:48:20,"Menkes Budi menyampaikan Indonesia sudah memesan obat oral Covid-19 buatan Pfizer, 'Paxlovid'. Obat 'Paxlovid' ini nantinya tersedia di RS hingga apotek. https://t.co/DY4Bvw02sh",9,1,8,2,2022-01-17,17,Monday,1,17,3
1483133058249285634,2022-01-17 17:44:11,Jembatan KW 6 atau dikenal dengan Jembatan Kepuh di Karawang ambles. Padahal jembatan tersebut baru saja diresmikan pada 29 Desember 2021 lalu. https://t.co/d7h4ZLgIng,35,13,6,5,2022-01-17,17,Monday,1,41,18
1483132087687434240,2022-01-17 17:40:19,"Nidji memiliki vokalis baru. Yusuf Ubay, vokalis Nidji jadi sorotan dan langsung dipuji Anies Baswedan. https://t.co/YS5em5kfqK",18,2,1,1,2022-01-17,17,Monday,1,19,3
1483130989870206981,2022-01-17 17:35:57,"Anies memuji penampilan Band Nidji saat tampil di JIS. PDIP menilai pujian itu sindiran Anies ke Ketum DPP PSI, Giring Ganesha. https://t.co/DQbe6qE3Ty",12,7,2,2,2022-01-17,17,Monday,1,14,9
1483129472203251715,2022-01-17 17:29:56,Jaksa menyebut video itu diserahkan saksi inisial IM sebagai bukti untuk melaporkan Munarman ke polisi terkait dugaan pembaiatan ke pimpinan ISIS. https://t.co/fTcI7FaKLp,3,0,1,0,2022-01-17,17,Monday,1,4,0
1483128690275934223,2022-01-17 17:26:49,"""One gate policy tetap diberlakukan. Jangan kemudian di masing-masing daerah bisa terbang sendiri-sendiri,"" kata Menag. https://t.co/RQ4NyD8Qr9",9,0,1,2,2022-01-17,17,Monday,1,10,2
1483127586469339139,2022-01-17 17:22:26,Jokowi menghampiri sejumlah pedagang yang berada di pasar tersebut. Jokowi memberikan bantuan kepada para pedagang. https://t.co/6iMg0eD4Oy,18,1,1,1,2022-01-17,17,Monday,1,19,2
1483126516653432841,2022-01-17 17:18:11,Aksi pelecehan seksual kembali terjadi di Kabupaten Pasuruan. Seorang perempuan menjadi korban begal payudara saat mengendarai sepeda. https://t.co/9KZGZzm4eF,26,8,2,3,2022-01-17,17,Monday,1,28,11
1483125474029154304,2022-01-17 17:14:02,"Seorang saksi, Abdullah mengatakan jasad AS ditemukan pukul 09.30 WIB. Saat itu, warga Kampung Gedong, Beji, Depok ini hendak memancing. https://t.co/n972Fj3K2D",2,0,1,0,2022-01-17,17,Monday,1,3,0
1483124431799164928,2022-01-17 17:09:54,Azis Syamsuddin berdalih mengenai pemberian uang darinya untuk AKP Robin adalah pinjaman. Namun jaksa KPK tidak percaya. https://t.co/pj5UbDLVtc,10,0,4,1,2022-01-17,17,Monday,1,14,1
1483123562546405380,2022-01-17 17:06:27,"Kemenag masih menunggu keputusan pemerintah Arab Saudi terkait penyelenggaraan haji 2022. Jika nantinya ibadah haji jadi diselenggarakan, Kemenag akan memprioritaskan pemberangkatan kepada jemaah yang tertunda pada 2020. https://t.co/3LHqaiKFGq",2,0,1,0,2022-01-17,17,Monday,1,3,0
1483122063770628101,2022-01-17 17:00:29,"Nisan kuno bertulisan yang ditemukan di kawasan Jembatan Ampera, Palembang, langsung dikuburkan kembali. Nisan kuno itu kini dibongkar lagi untuk diteliti. https://t.co/wAE9RUCxgJ",13,2,4,0,2022-01-17,17,Monday,1,17,2
1483120928909406208,2022-01-17 16:55:59,Riza menganggap gugatan itu hal biasa terutama di negara demokrasi. https://t.co/rkUzFpHyom,10,0,2,2,2022-01-17,16,Monday,1,12,2
1483119630747156483,2022-01-17 16:50:49,Ada beberapa opsi sebelum pemerintah memilih Nusantara. https://t.co/qWR5wnyi57,12,10,1,3,2022-01-17,16,Monday,1,13,13
1483118426507862020,2022-01-17 16:46:02,Polisi memastikan kejadian tersebut merupakan pelanggaran lalu lintas. https://t.co/j942LGrT3u,9,0,0,0,2022-01-17,16,Monday,1,9,0
1483117316187598850,2022-01-17 16:41:37,Setidaknya ada dua posting-an ilustrasi yang diunggah Jokowi di media sosial dan menuai kontroversi. Apa saja? https://t.co/kXvwqKXMht,6,1,1,0,2022-01-17,16,Monday,1,7,1
1483116714481094664,2022-01-17 16:39:14,"#Terpopuler Vaksinasi booster vaksin COVID-19 dimulai hari ini. Khusus Jakarta Timur, ini daftar lokasi vaksin booster untuk 18 tahun ke atas sampai lansia. https://t.co/3cGrWHKKYG",5,0,0,0,2022-01-17,16,Monday,1,5,0
1483115417916878852,2022-01-17 16:34:05,"Sejumlah rumah di Desa Baro, Kecamatan Pidie, Kabupaten Pidie, Aceh terendam banjir. Banjir terjadi akibat jebolnya tanggul sungai. https://t.co/rwmxUMPoNa",5,1,1,0,2022-01-17,16,Monday,1,6,1
1483115066291634177,2022-01-17 16:32:41,Sopir ambulans itu memberi alasan mengapa menyebut-nyebut polisi dalam video viral. Simak di sini. https://t.co/pRNrOdrEw8,8,0,2,1,2022-01-17,16,Monday,1,10,1
1483114096560070657,2022-01-17 16:28:50,"Dua orang anggota polisi Polres Badung, Bali bernama Aiptu I Gusti Ngurah Menara dan Briptu Gde Made Ardana dipecat. Keduanya terlibat tindak pidana narkotika. https://t.co/tPT68liCuA",3,1,1,1,2022-01-17,16,Monday,1,4,2
1483113007953715205,2022-01-17 16:24:30,"Seniman Klaten berharap kasus itu diusut dengan tuntas. Harapannya agar para seniman, terutama wanita nyaman dalam berkarya. https://t.co/KhZx36ZiZK",10,0,2,1,2022-01-17,16,Monday,1,12,1
1483111903513780224,2022-01-17 16:20:07,"Salah seorang warga di kawasan Pondok Bambu, Duren Sawit, Jakarta Timur membuat tanggul yang halangi akses jalan. Kini, tanggul tersebut telah dibongkar. #detikcomdoyourmagic https://t.co/CHcqGA9a4p",3,0,2,0,2022-01-17,16,Monday,1,5,0
1483111209062838272,2022-01-17 16:17:21,Sopir bernama Mawardi itu berdalih hanya berusaha mengikuti perintah keluarga korban. https://t.co/IaamNPpixN,9,0,1,0,2022-01-17,16,Monday,1,10,0
1483109925874278404,2022-01-17 16:12:15,"Seorang murid SD di Agam, Sumatera Barat diterkam buaya, Senin (17/1/2022) pagi. Korban diterkam usai mandi di sungai. https://t.co/EirxzHNhjG",12,0,1,0,2022-01-17,16,Monday,1,13,0
1483108985284800517,2022-01-17 16:08:31,Begini cerita saksi mata yang sempat mencuci nisan kuno tersebut! https://t.co/brvZjHas6b,10,0,2,0,2022-01-17,16,Monday,1,12,0
1483108236496621570,2022-01-17 16:05:33,Majelis Hakim Pengadilan Tipikor meminta mantan Wakil Ketua DPR RI Azis Syamsuddin agar memberikan keterangan jujur di persidangan. Hal itu diungkapkan saat sidang dengan agenda pemeriksaan Azis Syamsuddin sebagai terdakwa. https://t.co/unuUa5iFAE,4,0,2,0,2022-01-17,16,Monday,1,6,0
1483107640205062157,2022-01-17 16:03:10,"Munarman disebut salah seorang saksi berkaitan dengan peristiwa pengeboman di Jolo, Filipina pada 2019. https://t.co/11kZyVkp0A",7,3,4,0,2022-01-17,16,Monday,1,11,3
1483107287761887235,2022-01-17 16:01:46,Sempat dihebohkan dengan adanya akun yang menjual beragam foto KTP di platform NFT OpenSea melalui akun Indonesian identity card (KTP) Collection. Guru Besar STEI Suhono Harso Supangkat ingatkan pemerintah untuk menindak tegas dugaan pelanggaran ITE. https://t.co/cLFBUv8usI,13,2,4,0,2022-01-17,16,Monday,1,17,2
1483106581004828672,2022-01-17 15:58:58,Ratusan warga Lumajang yang mengatasnamakan diri sebagai Laskar Barisan Indonesia Menegakkan Keberagaman atau Bhineka melakukan unjuk rasa di depan kantor DPRD Lumajang. Mereka menuntut pelaku pembuang sesajen di lokasi erupsi diproses hukum di Lumajang. https://t.co/UaegA3Emax,18,10,3,0,2022-01-17,15,Monday,1,21,10
1483106287663689736,2022-01-17 15:57:48,Musda DPD Partai Demokrat Jatim akan digelar pada Kamis (20/1). Begini teknis Musda yang akan digelar di Hotel Shangri-La Surabaya tersebut. https://t.co/6788fbP96T,3,0,1,0,2022-01-17,15,Monday,1,4,0
1483105981290668042,2022-01-17 15:56:35,Tidak sedikit wanita yang akhirnya memalsukan orgasme saat berhubungan seks. Hal ini justru dapat memicu stres bahkan perselingkuhan. https://t.co/xRLGb1B7sM,7,2,1,1,2022-01-17,15,Monday,1,8,3
1483104628636102662,2022-01-17 15:51:12,Sejumlah PNS dalam video viral PNS di Humbahas berjoget melapor ke polisi. Mereka melapor lantaran keberatan dituding menenggak miras dan diviralkan. https://t.co/pdDL5QRvjq,14,5,11,12,2022-01-17,15,Monday,1,25,17
1483104400444956680,2022-01-17 15:50:18,"Menkes menyebut akan menggencarkan program pencegahan bagi penyakit-penyakit berat yang menimbulkan beban pembiayaan besar, mulai dari stroke hingga kanker. https://t.co/OJK596e1sw",9,0,1,0,2022-01-17,15,Monday,1,10,0
1483104152221851654,2022-01-17 15:49:19,"Presiden Joko Widodo (Jokowi) mengungkapkan kereta cepat Jakarta-Bandung baru dapat dioperasikan pada Juni 2023. Jokowi mengatakan saat ini progres pembangunan sudah mencapai 79,9 persen. https://t.co/guQTBXMvx4",17,0,3,0,2022-01-17,15,Monday,1,20,0
1483102465377673220,2022-01-17 15:42:37,Polisi berhasil menemukan Mualimatus Sholiha mahasiswi Jambi yang dilaporkan hilang oleh keluarganya. Dia ditemukan di Pekanbaru yang menemui kekasihnya. https://t.co/NvoGfh86gZ,49,46,4,7,2022-01-17,15,Monday,1,53,53
1483101855446147076,2022-01-17 15:40:11,"Masih di Jakarta Utara, giliran Anies Baswedan memuji Nidji, band yang dulu menaungi Giring. https://t.co/Gt0wvdC0Eb",8,1,2,0,2022-01-17,15,Monday,1,10,1
1483100879301578753,2022-01-17 15:36:18,"Ada wisata alam cantik yang belum banyak dikunjungi wisatawan. Lokasinya di Muara Cibentang, Desa Jatisari, Kecamatan Cisompet, Garut. Suara aliran air di muara Cibentang ini memberi kesejukan https://t.co/O7T70jVO6u",10,0,2,0,2022-01-17,15,Monday,1,12,0
1483100008186527745,2022-01-17 15:32:51,"#Terpopuler Yuk merapat! Ini informasi vaksin booster COVID-19 di Jakarta Pusat yang tersedia mulai hari ini. Lengkap dengan lokasi, syarat, dan cara daftarnya: https://t.co/RzsQ8bhWj6",6,0,1,0,2022-01-17,15,Monday,1,7,0
1483099277211705345,2022-01-17 15:29:56,"Seorang pria di Kampung Baru Pasir Penambang, Malaysia, diduga membunuh ibundanya sendiri dengan memenggalnya. https://t.co/egVgIxZXcf",11,0,0,0,2022-01-17,15,Monday,1,11,0
1483098549143408644,2022-01-17 15:27:03,Jepang melontarkan kecaman keras atas penembakan dua rudal balistik yang diduga dilakukan Korea Utara pada Senin (17/1). Tindakan itu menurut Jepang dapat mengancam perdamaian dan keamanan negara. https://t.co/8Uj2APOJFh,9,0,0,0,2022-01-17,15,Monday,1,9,0
1483098319371055105,2022-01-17 15:26:08,Penyebar video syur mirip Nagita Slavina dilaporkan ke polisi. Sang pelapor menyebut jika tindakan itu jahat dan berharap pelaku ditangkap.  https://t.co/jqXEyJ2qOz,13,0,3,0,2022-01-17,15,Monday,1,16,0
1483097245084012552,2022-01-17 15:21:52,"Luapan Sungai Kali Jompo membuat rumah Bupati Jember Hendy Siswanto kebanjiran hingga ketinggian 1,5 meter. Banjir sudah surut namun menyisakan lumpur. https://t.co/IOd5hWR1sQ",1,0,1,0,2022-01-17,15,Monday,1,2,0
1483096743013146626,2022-01-17 15:19:52,Pasukan Taliban menggunakan semprotan merica terhadap para pengunjuk rasa wanita yang menuntut hak atas pekerjaan dan pendidikan. https://t.co/gMClWi5rQH,18,2,2,0,2022-01-17,15,Monday,1,20,2
1483095602380611588,2022-01-17 15:15:20,Snack dengan ilustrasi Kaesang dalam paket makanan di pesawat Garuda Indonesia ramai diperbincangkan. Komisi VI DPR buka suara. https://t.co/qMc7urMAiS,11,4,1,1,2022-01-17,15,Monday,1,12,5
1483093372692742151,2022-01-17 15:06:29,"Setelah mengalami stroke yang ketiga kalinya, sastrawan Remy Sylado terbaring lemah. Esok pagi, dia bakal jalani operasi. Lekas pulih Remy Sylado… https://t.co/pzNVhZpEUG",18,0,1,0,2022-01-17,15,Monday,1,19,0
1483093358939619329,2022-01-17 15:06:25,Bertemu calon mertua memang mendebarkan. Apalagi jika disindir hanya karena perkara tidak bisa mengkupas buah mangga!  https://t.co/XUwraWMS0w,5,2,0,1,2022-01-17,15,Monday,1,5,3
1483092539867602944,2022-01-17 15:03:10,Pelaku mengaku pusing dan nekat menusuk wanita yang sudah dinikahi 8 tahun itu. https://t.co/mNmGcuIVmr,139,68,41,27,2022-01-17,15,Monday,1,180,95
1483090865665019904,2022-01-17 14:56:31,"Teganya Taliban, melawan pendemo wanita menggunakan semprotan merica. Aksi itu dilakukan Taliban saat para wanita menuntut hak atas pekerjaan dan pendidikan. https://t.co/2KfJl5ySSm",9,4,3,0,2022-01-17,14,Monday,1,12,4
1483090864318685191,2022-01-17 14:56:31,"Teganya Taliban, melawan pendemo wanita menggunakan semprotan merica. Aksi itu dilakukan Taliban saat para wanita menuntut hak atas pekerjaan dan pendidikan. https://t.co/JgaSVxW9TR",9,1,1,2,2022-01-17,14,Monday,1,10,3
1483090372653899781,2022-01-17 14:54:33,"Nadiem mengatakan, keberadaan Pusat pembelajaran ini bisa menjadi tempat berkolaborasi, antara mahasiswa dari berbagai disiplin ilmu. https://t.co/2JUPNrkxcn",10,0,1,2,2022-01-17,14,Monday,1,11,2
1483089520765640709,2022-01-17 14:51:10,"Anies menilai suara Nidji tak ada sumbang sama sekali. Memangnya siapa yang suaranya sumbang, Pak Anies? https://t.co/tqoDkAD7H1",50,23,3,6,2022-01-17,14,Monday,1,53,29
1483088698996580352,2022-01-17 14:47:54,"Saat ini, KAI masih berkoordinasi dengan Pemerintah Provinsi DKI Jakarta. https://t.co/mxBKu90VHz",8,1,4,0,2022-01-17,14,Monday,1,12,1
1483086555115831301,2022-01-17 14:39:23,"Banjir di Kabupaten Pasuruan semakin parah. Di Desa Kedawung Kulon, Kecamatan Grati, ketinggian air setinggi leher orang dewasa. https://t.co/2CB7W7htMO",17,0,11,0,2022-01-17,14,Monday,1,28,0
1483086088549904394,2022-01-17 14:37:32,Negara Tonga terletak di mana banyak dicari tahu usai kabar erupsi gunung berapi bawah laut terjadi. Ini rangkuman informasinya. #Tonga https://t.co/kyNBSv9nGa,11,0,5,1,2022-01-17,14,Monday,1,16,1
1483085788007043072,2022-01-17 14:36:20,"K-Talk kali ini membahas drama Korea yang menggaet Song Hye Kyo dan Jang Ki Yong, Now We Are Breaking Up, yang baru saja tamat. Drama ber-genre romantis ini mengangkat kisah cinta yang terhalang restu orang tua. Seperti apa review-nya?  https://t.co/R1ZIM44zsg",7,3,2,1,2022-01-17,14,Monday,1,9,4
1483085245620662279,2022-01-17 14:34:11,"""Jadi saya kira itu bisa disikapi dengan sesuai ketentuan yang berlaku aja,"" kata Tri Adhianto. https://t.co/jcQ36d1yWa",8,0,1,0,2022-01-17,14,Monday,1,9,0
1483084443518648330,2022-01-17 14:31:00,Pemerintah menahan Peraturan Menteri Energi dan Sumber Daya Mineral (Permen ESDM) Nomor 26 Tahun 2021 tentang Pembangkit Listrik Tenaga Surya Atap.  https://t.co/Df1ZAmlAYb,9,0,0,1,2022-01-17,14,Monday,1,9,1
1483083668788850690,2022-01-17 14:27:55,"Anggota TNI AD, bernama Sahdi, tewas dikeroyok di Penjaringan, Jakarta Utara. Begini detik-detik pengeroyokan maut itu. https://t.co/0tDSIpSqRv",7,0,2,1,2022-01-17,14,Monday,1,9,1
1483083411149537294,2022-01-17 14:26:54,"#Terpopuler ""Saya sebenarnya dari kecil sudah tahu bahasa Kek, karena memang ibu saya orang Tionghoa dan bapak saya Jawa,"" kata Bripka Mernawati. https://t.co/x0nt9MKW3s",17,1,3,0,2022-01-17,14,Monday,1,20,1
1483083020823416836,2022-01-17 14:25:21,"Sesosok bayi ditemukan warga di dalam tas plastik (kresek) di Jalan Sencaki, Semampir. Bayi tersebut kondisinya masih hidup. https://t.co/fZhl8FVI3p",32,6,2,1,2022-01-17,14,Monday,1,34,7
1483082645944819718,2022-01-17 14:23:51,Kaleb Ramot Gemilang secara dramatis membawa Dewa United Surabaya merebut kemenangan dari Bima Perkasa Jogja pada seri pertama IBL 2022. https://t.co/Z63xD9a1Vi,14,0,0,0,2022-01-17,14,Monday,1,14,0
1483082196483293184,2022-01-17 14:22:04,Varian Omicron mendongkrak penambahan kasus harian positif COVID-19 di Indonesia. Varian yang tiga kali lipat lebih menular daripada Delta ini berpotensi memicu gelombang ketiga pandemi. https://t.co/o585Nmslv0,27,4,13,3,2022-01-17,14,Monday,1,40,7
1483081622379540491,2022-01-17 14:19:47,"Ghozali, mahasiswa asal Semarang viral dan dapat cuan sekitar Rp 1,5 miliar dari menjual foto selfie NFT. Mau buat apa uangnya? Ini kata Ghozali:  https://t.co/urJrYh6NDW",27,6,3,1,2022-01-17,14,Monday,1,30,7
1483080747988705281,2022-01-17 14:16:19,Hati-hati dengan gadget anda. Bisa-bisa malah menjerumuskan pemiliknya ke dalam persoalan rumit. Begini ceritanya! #detiksAdvocate https://t.co/JL9THqcWR6,14,1,2,0,2022-01-17,14,Monday,1,16,1
1483080211784769542,2022-01-17 14:14:11,Okky Lukman tak mau pusing soal jodoh. Dia justru ingin menghabiskan waktu lebih banyak bersama orang tua. https://t.co/xyHoIeBw9l,39,1,6,3,2022-01-17,14,Monday,1,45,4
1483078499669889026,2022-01-17 14:07:23,"Terdakwa kasus dugaan terorisme, Munarman, emosi ke saksi pelapor berinisial IM yang dihadirkan jaksa penuntut umum (JPU) di persidangan. Munarman marah karena dia menilai saksi IM telah membuatnya masuk penjara. https://t.co/YCnMCM2uZV",14,7,0,1,2022-01-17,14,Monday,1,14,8
1483078230949117955,2022-01-17 14:06:19,Son Dam Bi dikabarkan segera menikah dengan Lee Kyu Hyuk. Manajemen pun buka suara: #SonDamBi  https://t.co/nRdUyKS055,13,0,0,0,2022-01-17,14,Monday,1,13,0
1483077989877301250,2022-01-17 14:05:21,Pemain sinetron Roby Tremonti akhirnya kesampaian mewujudkan mimpi yang tertunda karena kesibukannya. Ia wujudkan usaha baru. https://t.co/4sCrK0j3sO,7,0,0,0,2022-01-17,14,Monday,1,7,0
1483077714248704000,2022-01-17 14:04:15,Pencarian terhadap makhluk hidup atau alien di luar Bumi makin diintensifkan. Lembaga antariksa NASA dan SETI Institute berharap akan ada titik terang. https://t.co/YKGc6jKzP9,16,2,1,3,2022-01-17,14,Monday,1,17,5
1483076859793485827,2022-01-17 14:00:52,"Suami kasar dan suka memukul, dan kalau memukul itu di depan anak. Sebegitu kerasnya dia kepada saya, membuat saya enggak tahan dan siap pergi dari hubungan ini. #detikNetwork  https://t.co/6pLFyRjPEr",11,3,0,0,2022-01-17,14,Monday,1,11,3
1483076304148832268,2022-01-17 13:58:39,Rumah Bupati Jember Hendy Siswanto terendam banjir. Ketinggian air di rumah itu mencapai 2 meter. https://t.co/X0q5GIOOx0,13,0,0,2,2022-01-17,13,Monday,1,13,2
1483076063592919050,2022-01-17 13:57:42,Korut kembali menembakkan proyektil yang diduga sebagai rudal balistik. Ini menjadi uji coba rudal keempat bulan ini yang dilakukan negara itu. https://t.co/cn42SYsgxg,6,1,0,0,2022-01-17,13,Monday,1,6,1
1483075542609977344,2022-01-17 13:55:38,"Pelatih Xavi Hernandez kabarnya kesal, dan merasa ditipu, karena kontrak Ousmane Dembele yang belum selesai. https://t.co/ev9Dti7XEk",6,1,0,1,2022-01-17,13,Monday,1,6,2
1483075282680623107,2022-01-17 13:54:36,#Terpopuler Kelompok ini mendukung Prabowo-Jokowi maju sebagai pasangan Capres dan Cawapres di Pemilu 2024. Simak alasan mereka: https://t.co/c7jJbkVn0p,5,6,2,2,2022-01-17,13,Monday,1,7,8
1483075026135965696,2022-01-17 13:53:35,Ghozali Everday kaya mendadak setelah foto selfie NFT yang ia jual. Ini pertanyaan paling sering soal jual NFT di OpenSea:  https://t.co/fZf6pXnRr9,22,0,0,1,2022-01-17,13,Monday,1,22,1
1483074659369291787,2022-01-17 13:52:07,"#Terpopuler ""...Jadi Ahok, kemudian Anies Baswedan yang Arab, Ahok yang China itu WNI asli, bangsa Indonesia asli. Keturunannya boleh saja beberapa generasi,"" kata Jimly. https://t.co/BKaXsFW2xk",25,6,3,0,2022-01-17,13,Monday,1,28,6
1483074081981411328,2022-01-17 13:49:49,"Pergantian posisi puncak dantsu ini tidak terlepas dari langkah CEO dentsu Indonesia terdahulu, Maya Watono, yang akan mengabdi di salah satu holding BUMN.  https://t.co/7spoMc9H7k",13,0,2,0,2022-01-17,13,Monday,1,15,0
1483073248900358146,2022-01-17 13:46:31,"Nisa (9), bocah SD yang hilang diterkam buaya di sungai Batang Masang, Agam, Sumbar ditemukan dalam keadaan meninggal dunia. https://t.co/BKwnB9DVvD",24,2,3,0,2022-01-17,13,Monday,1,27,2
1483072757835472910,2022-01-17 13:44:34,Pandemi yang masih terjadi hingga saat ini sudah mulai mereda. Banyak perusahaan yang harus beradaptasi dan menjalankan transformasi digital dengan cepat.  https://t.co/J0YhHgGkHO,13,0,4,0,2022-01-17,13,Monday,1,17,0
1483072484727480326,2022-01-17 13:43:29,Sebuah pesan suara berisi peringatan adanya gempa susulan memicu tsunami di Kabupaten Sukabumi beredar melalui aplikasi perpesanan. BMKG pastikan info itu hoax. https://t.co/szuZ5yAUKi,10,2,1,1,2022-01-17,13,Monday,1,11,3
1483072276920684548,2022-01-17 13:42:39,"Pencurian paket di kereta barang di Amerika Serikat, melonjak beberapa waktu terakhir. Puncaknya adalah saat orang ramai-ramai belanja online jelang Natal.  https://t.co/CNloL3OGgr",10,1,2,0,2022-01-17,13,Monday,1,12,1
1483072260688818181,2022-01-17 13:42:35,Penggunaan telepon genggam untuk anak-anak meningkat intensitasnya. Ini kata Kak Seto soal penggunaan telepon genggam untuk anak:  https://t.co/jFHRVYk81u,16,2,4,1,2022-01-17,13,Monday,1,20,3
1483071701923639304,2022-01-17 13:40:22,"Clauds Food menawarkan hotteok dengan varian rasa nikmat, yakni cokelat dan keju.  https://t.co/peWYKowT6q",8,2,2,0,2022-01-17,13,Monday,1,10,2
1483070794473295880,2022-01-17 13:36:46,"Pembangunan Tol Trans Sumatera ruas Kapalbetung seksi 2 dan 3 dari Kramasan hingga Betung sepanjang 69,19 km ditargetkan rampung 2023 mendatang.  https://t.co/JZQAoMn4c9",17,1,1,1,2022-01-17,13,Monday,1,18,2
1483070770209304584,2022-01-17 13:36:40,Anies mendengar penampilan Nidji tidak ada suara sumbang saat check sound di JIS. Apakah Anies membalas serangan Giring? https://t.co/fgrGUEtwcx,63,14,10,8,2022-01-17,13,Monday,1,73,22
1483070214413721600,2022-01-17 13:34:27,Kehadiran Artificial Intelligence jadi salah satu teknologi yang dampaknya dirasakan secara signifikan dalam kehidupan masyarakat. https://t.co/6squ9jU76V,6,0,1,0,2022-01-17,13,Monday,1,7,0
1483070198550876160,2022-01-17 13:34:24,Microsoft membuat fitur Walkie Talkie untuk Microsoft Teams yang kini sudah tersedia secara umum untuk semua pengguna layanan komunikasinya tersebut. https://t.co/z6u2DU21Wx,3,0,2,0,2022-01-17,13,Monday,1,5,0
1483069725827641347,2022-01-17 13:32:31,"Gelaran MotoGP seri Indonesia di Mandalika bisa mengerek industri pariwisata, khususnya Mandalika. Untuk mendukung itu, pemerintah membangun sarana pendukung  https://t.co/IsezEJDuj3",23,0,3,1,2022-01-17,13,Monday,1,26,1
1483067958524063751,2022-01-17 13:25:30,Ular berjenis sanca batik dengan panjang dua meter dan berat lima kilogram berhasil dievakuasi oleh Damkar Kota Sukabumi. Ular tersebut ditemukan penuh luka. https://t.co/JM51l0fsZo,16,3,1,2,2022-01-17,13,Monday,1,17,5
1483067670090108930,2022-01-17 13:24:21,Martabak telur lumpia jadi jajanan favorit banyak orang Indonesia. Ternyata jajanan bercita rasa gurih ini sangat mirip dengan pizza khas Vietnam. Seperti apa?  https://t.co/giKhbx5wfD,15,0,1,0,2022-01-17,13,Monday,1,16,0
1483066184035667970,2022-01-17 13:18:26,Puluhan mahasiswa demo di kantor Pemkab dan DPRD Lamongan. Mahasiswa memberi kartu merah soal penanganan banjir di kawasan Bengawan Njero. https://t.co/TYiCn07sTo,12,1,1,0,2022-01-17,13,Monday,1,13,1
1483065888140152835,2022-01-17 13:17:16,"Akun Presiden Joko Widodo (Jokowi) di Twitter bikin heboh. Pasalnya, dalam unggahan di akun tersebut ilustrasi yang disebut Sirkuit Mandalika ternyata adalah sirkuit di Portugal. https://t.co/LsBBF4KkST",46,27,16,3,2022-01-17,13,Monday,1,62,30
1483065589790875653,2022-01-17 13:16:05,"Buah strawberry yang segar harus dicuci terlebih dahulu sebelum dimakan. Agar bakteri dan sisa pestisida hilang, bisa dibersihkan dengan garam dan air cuka.  https://t.co/ItFH5zQGns",20,0,2,1,2022-01-17,13,Monday,1,22,1
1483065077762822149,2022-01-17 13:14:03,Konservasionis memperingatkan bahwa sampah plastik di tempat pembuangan sampah terbuka di Sri Lanka timur membunuh gajah di wilayah tersebut. https://t.co/XpPdvGkNQd,23,2,12,4,2022-01-17,13,Monday,1,35,6
1483063939202228227,2022-01-17 13:09:31,Suzuki New U-Enjoy 125 versi 2022 diklaim bisa mencatat konsumsi bensin 100 km/liter. Yuk simak penampakannya. https://t.co/nhC4kezaG1,19,4,5,2,2022-01-17,13,Monday,1,24,6
1483063667801403394,2022-01-17 13:08:27,"Banjir menerjang sejumlah desa di Grati, Kabupaten Pasuruan setelah hujan lebat yang terjadi sejak siang hari. Ketinggian banjir mencapai 60 cm - 1 meter. https://t.co/v2UJM7ziIJ",19,0,1,1,2022-01-17,13,Monday,1,20,1
1483063148290715654,2022-01-17 13:06:23,Jokowi meninjau proyek Kereta Cepat Jakarta-Bandung di Kabupaten Purwakarta untuk melihat langsung terowongan yang dikabarkan terkendala.  https://t.co/fEjUs4RwVf,27,5,6,3,2022-01-17,13,Monday,1,33,8
1483062674321719298,2022-01-17 13:04:30,Tahun 2022 disebut bakal menjadi momen terbaik di industri manga. Ini deretan manga yang paling dinantikan kelanjutan ceritanya pada 2022:  https://t.co/xxnNgJD50x,24,1,5,1,2022-01-17,13,Monday,1,29,2
1483062360281604103,2022-01-17 13:03:15,Pendiri KedaiKOPI Hendri Satrio menilai level kematangan politik Giring di bawah Anies. Hensat melihat manuver Anies menyindir Giring mengikuti gaya Jokowi. https://t.co/0m7fC9sMAj,17,9,3,2,2022-01-17,13,Monday,1,20,11
1483061825168097283,2022-01-17 13:01:07,Penyelenggara pemerintahan di ibu kota baru akan dipimpin Kepala Otorita. Kepala Otorita setara menteri yang ditunjuk presiden.  https://t.co/7VjCVma0nO,55,19,6,4,2022-01-17,13,Monday,1,61,23
1483060413591871494,2022-01-17 12:55:31,"Polisi menangkap empat pria pelaku perampokan di SMPN 3 Tenjo, Kabupaten Bogor. Saat melancarakan aksinya, para pelaku menyekap seorang penjaga sekolah. https://t.co/bkqVtYEd82",7,0,2,2,2022-01-17,12,Monday,1,9,2
1483059257633300484,2022-01-17 12:50:55,Tiga film Indonesia ini mulai tayang di KlikFilm pada 14 Januari 2022. Ini daftarnya:  https://t.co/Z2scDmBfGy,8,0,1,0,2022-01-17,12,Monday,1,9,0
1483058993325125637,2022-01-17 12:49:52,"Giliran legenda komik AS sekaligus pencipta Deadpool, Rob Liefeld menciptakan semesta superhero baru sebagai NFT.  https://t.co/N112qwIhuy",7,0,1,0,2022-01-17,12,Monday,1,8,0
1483058961255481352,2022-01-17 12:49:44,"Hujan lebat sekitar satu jam membuat jalan alternatif ke arah Stasiun Kereta Api Delanggu, Kecamatan Delanggu, Klaten, Jawa Tengah terendam. https://t.co/vnMrpUkmNf",18,0,3,0,2022-01-17,12,Monday,1,21,0
1483058452507377667,2022-01-17 12:47:43,"Sebuah video berisi seorang wanita menaiki kap mesin mobil di Asahan, ramai beredar di medsos. Wanita itu disebut sedang melabrak pelakor yang berada di mobil. https://t.co/Sb1IEU0Fno",26,4,4,1,2022-01-17,12,Monday,1,30,5
1483057612518305793,2022-01-17 12:44:23,"15 sekolah di DKI Jakarta ditutup sementara usai ditemukan kasus positif COVID-19. Dari 15 sekolah ditutup itu, 3 di antaranya sudah diizinkan lagi gelar PTM. https://t.co/Rp7dLLgk6L",15,0,2,1,2022-01-17,12,Monday,1,17,1
1483056202506461185,2022-01-17 12:38:47,"""Pasien saya meninggal di atas mobil, pengantaran dari (Jalan) Talasalapang menuju RS Daya. Meninggal di (Jalan) Urip karena tidak ada yang membukakan jalan,"" kata pria dalam video viral tersebut. https://t.co/eZ8ZmFwMES",200,41,57,13,2022-01-17,12,Monday,1,257,54
1483055684686131201,2022-01-17 12:36:43,"#Terpopuler Tutupnya pabrik Foxconn perakit iPhone di India ternyata menyimpan banyak masalah besar, yaitu buruknya kondisi kehidupan para buruh. https://t.co/7NBM7I8iRJ",54,3,13,1,2022-01-17,12,Monday,1,67,4
1483054633736151043,2022-01-17 12:32:33,"Netflix kembali merilis drama Korea bertemakan zombie. Berjudul All of Us Are Dead, serangan zombie kini terjadi di sebuah sekolah di Korea Selatan. Ini potretnya:  https://t.co/iZZYC5aMHy",10,0,4,1,2022-01-17,12,Monday,1,14,1
1483054464848523270,2022-01-17 12:31:52,"Setiap tahunnya, IndiHome meningkatkan kualitas layanan dengan melakukan penurunan harga paket internet rumah yang signifikan https://t.co/yM6KWlTgxD",16,12,8,5,2022-01-17,12,Monday,1,24,17
1483054281024765953,2022-01-17 12:31:09,IndiHome mendukung penuh pengembangan bakat atlet esport di Tanah Air melalui LEAD by IndiHome https://t.co/ECq21m8crm,5,0,2,0,2022-01-17,12,Monday,1,7,0
1483053297766481929,2022-01-17 12:27:14,Video ibu hamil yang hendak melahirkan viral di medsos. Video itu viral lantaran sang ibu terpaksa ditandu ke puskesmas lantaran kondisi jalan yang rusak. https://t.co/Adx9mDBQJN,30,1,3,0,2022-01-17,12,Monday,1,33,1
1483052249794420739,2022-01-17 12:23:04,Polisi mengaku belum menerima pengajuan izin soal viral penolakan rencana tabligh akbar Khalid Basalamah di Kota Palu. https://t.co/MZo6WotUGl,7,5,1,1,2022-01-17,12,Monday,1,8,6
1483051668300304385,2022-01-17 12:20:46,Polisi telah menelusuri mobil sedan lawan arah di Bekasi. Bagaimana hasilnya? https://t.co/pLnC69wbB2,12,1,0,0,2022-01-17,12,Monday,1,12,1
1483051379790913542,2022-01-17 12:19:37,"Heboh video 61 detik mirip Nagita Slavina yang kemudian dikonfirmasi sebagai sebuat editan. Di Korea Selatan, sejumlah artis jadi sasaran deepfake. https://t.co/9TkIIxzPvp",7,1,1,0,2022-01-17,12,Monday,1,8,1
1483050582436941824,2022-01-17 12:16:27,"Iklan jual beli rumah di Karimunjawa, Jepara, Jawa Tengah jadi sorotan di media sosial. Seperti ini faktanya. https://t.co/AxFkRjUqbL",12,2,1,0,2022-01-17,12,Monday,1,13,2
1483050083306422272,2022-01-17 12:14:28,"Restoran China di Inggris dipaksa harus mengganti pelayan mereka, dengan pelayan robot yang harganya ratusan juta rupiah. Efek pandemi tak kunjung berakhir.  https://t.co/MgYlH7XAQH",10,0,1,0,2022-01-17,12,Monday,1,11,0
1483049540521541632,2022-01-17 12:12:18,Wanita di China ini 'terjebak' di rumah teman kencan karena di area rumah si pria tiba-tiba berlaku kebijakan lockdown. Begini kisahnya!  https://t.co/SWYqXh3dlk,9,4,0,1,2022-01-17,12,Monday,1,9,5
1483048629472538629,2022-01-17 12:08:41,"Bosan saat tengah malam, pria ini usil mencari makanan di kulkas kakaknya. Namun karena keliru, ia berakhir meminum stok ASI sang kakak!  https://t.co/GSiIKjW1as",20,1,1,0,2022-01-17,12,Monday,1,21,1
1483048444768002051,2022-01-17 12:07:57,"Meski berdiri di tengah pandemi, usaha makanan yang mengandalkan penjualan online ini bisa raup omzet Rp 20-30 juta per bulan, dengan penjualan 80 pesanan.  https://t.co/aWpFvldw6D",11,0,2,0,2022-01-17,12,Monday,1,13,0
1483048108561145865,2022-01-17 12:06:37,Sinovac akan meluncurkan vaksin khusus untuk tangkal Omicron. Wakil Presiden Sinovac Biotech pun meyakini jika vaksin baru tersebut akan berperan signifikan untuk mengakhiri puncak Covid-19 varian Omicron dunia. https://t.co/MUtSXNioQ9,4,0,1,0,2022-01-17,12,Monday,1,5,0
1483048089682423810,2022-01-17 12:06:32,#Terpopuler Tim arkeolog menemukan yang diklaim sebagai sumber kekayaan Nabi Sulaiman sekitar 3.000 tahun yang lalu berupa situs pemisahan bijih tembaga. https://t.co/SLPLMWVw1r,14,0,5,0,2022-01-17,12,Monday,1,19,0
1483047547614765059,2022-01-17 12:04:23,Wanita ini dipenjara setelah membuat 30 akun Instagram palsu yang seolah mengindikasikan kalau pemilik akun itu adalah mantan kekasihnya. https://t.co/WsmVMQ8ZyL,4,0,1,0,2022-01-17,12,Monday,1,5,0
1483047246748958721,2022-01-17 12:03:11,Nama Marina Budiman sempat menjadi perhatian setelah dirinya masuk sebagai salah satu pendatang baru pada daftar orang terkaya Indonesia versi Forbes 2021.  https://t.co/CGZUpSyToN,10,0,0,1,2022-01-17,12,Monday,1,10,1
1483047016846573570,2022-01-17 12:02:17,"#Terpopuler Viral pasangan yang beda usia 14 tahun. Saat istri masih TK, sedangkan suami sudah menjadi anggota polisi. Penasaran dengan kisahnya? https://t.co/t9vrkHiKoe",17,4,0,3,2022-01-17,12,Monday,1,17,7
1483046992796434433,2022-01-17 12:02:11,"Seekor buaya di Kabupaten Agam, Sumatera Barat, diburu oleh Tim gabungan kepolisian dan BKSDA setelah menerkam Nisa (9) Senin (17/1) pagi. Pencarian buaya bertujuan untuk menemukan tubuh Nisa. https://t.co/bsyEU3wYIW",5,0,0,0,2022-01-17,12,Monday,1,5,0
1483046813687070726,2022-01-17 12:01:28,"Pemerintah Turki meluncurkan kampanye wisata 'Halo Turkiye' meski angka positif Omicron melonjak. Apa saja yang menarik sehingga orang mau liburan ke Turki?

Baca selengkapnya disini:
https://t.co/hqf6Yghbe3 https://t.co/wVFIgesvG4",48,4,6,5,2022-01-17,12,Monday,1,54,9
1483046762059288578,2022-01-17 12:01:16,Produsen makanan ringan PT Jaya Swarasa Agung Tbk (Tays Baker) angkat suara setelah produknya yang bergambar karikatur Kaesang Pangarep ditarik oleh PT Garuda Indonesia (Persero) Tbk. #CNNIndonesia #detikNetwork  https://t.co/2YEr1EWz5x,15,3,2,2,2022-01-17,12,Monday,1,17,5
1483046362082164740,2022-01-17 11:59:41,Heboh rumah Gala Sky dijaga polisi setelah Doddy Sudrajat tiba-tiba datang. Faisal membantah karena Doddy dan beri penjelasan ini:  https://t.co/NaH8w3HCjs,0,0,0,0,2022-01-17,11,Monday,1,0,0
1483045551524483072,2022-01-17 11:56:27,Polisi gerak cepat menyelidiki informasi viral soal anak berkebutuhan khusus di Bekasi yang disodomi tetangganya. Pelaku kini ditangkap polisi. https://t.co/0WCuRiXmz3,1,1,0,0,2022-01-17,11,Monday,1,1,1
1483045057724833792,2022-01-17 11:54:30,Harga Samsung Galaxy S22 series dikabarkan akan sedikit lebih mahal dibandingkan pendahulunya. Ternyata ini penyebabnya:  https://t.co/yRZh7j3aIv,5,0,0,2,2022-01-17,11,Monday,1,5,2
1483044758503239682,2022-01-17 11:53:18,"Ricky Kambuaya bicara soal sosok sang pelatih di Timnas Indonesia, Shin Tae-yong. Menurutnya, Shin Tae-yong adalah orang yang disiplin dan tegas. https://t.co/Jo9gExJkdl",16,0,2,0,2022-01-17,11,Monday,1,18,0
1483043407736025089,2022-01-17 11:47:56,"Satu korban erupsi Semeru kembali ditemukan. Jenazah ditemukan di aliran Sungai Besuk Kobokan, Desa Supit Urang, Pronojiwo, Lumajang. https://t.co/xWtecX32E1",8,0,1,0,2022-01-17,11,Monday,1,9,0
1483043406242852868,2022-01-17 11:47:56,"KPK menyita Rp 36 miliar dari kasus korupsi proyek jalan di Bengkalis, Riau. Uang sitaan tersebut disita dari tersangka Petrus Edy Susanto (PES). https://t.co/ZulpWSpNxz",16,2,5,2,2022-01-17,11,Monday,1,21,4
1483042373722677248,2022-01-17 11:43:50,DPD Partai Demokrat Jawa Barat akan menyelenggarakan musyawarah daerah (Musda) guna menghadapi pemilu 2024. https://t.co/yAsKCAMAC4,7,0,1,1,2022-01-17,11,Monday,1,8,1
1483042185624920065,2022-01-17 11:43:05,"Tonga diterjang gelombang tsunami, dipicu letusan dahsyat gunung berapi bawah laut di lepas pantai. Belum banyak yang tahu, di mana letak negara ini. https://t.co/pP7QvwTtHD",13,0,3,0,2022-01-17,11,Monday,1,16,0
1483042158647070721,2022-01-17 11:42:58,"Haruna Soemitro heboh di medsos lantaran komentar miringnya ke pelatih Timnas Indonesia, Shin Tae-yong. https://t.co/XeLKxtoGe0",4,1,2,1,2022-01-17,11,Monday,1,6,2
1483040949164982273,2022-01-17 11:38:10,Nindy Ayunda mulai terbuka soal pria yang sudah membuat hatinya kembali berbunga-bunga. Ini sosok Dito yang diketahui tengah dekat dengan Nindy:  https://t.co/cW32Gpl75l,8,0,1,1,2022-01-17,11,Monday,1,9,1
1483040694658908160,2022-01-17 11:37:09,"Vaksinasi booster di Solo tak semulus vaksinasi COVID-19 sebelumnya, karena minimnya ketersediaan vaksin booster dan kurangnya tenaga kesehatan yang menyuntik. https://t.co/WLm2DZcljw",4,0,2,2,2022-01-17,11,Monday,1,6,2
1483040453092065280,2022-01-17 11:36:12,Gol Karim Benzema di Piala Super Spanyol menyalip koleksi Cristiano Ronaldo. Tapi masih di bawah Lionel Messi sang top skor. Berikut daftar 10 besarnya! https://t.co/Vbd483RWyV,7,0,1,0,2022-01-17,11,Monday,1,8,0
1483040149873344514,2022-01-17 11:34:59,"All New Hybrid hadir membawa berbagai penyegaran, mulai dari desain berubah total, hingga fitur Honda sensing yang ditawarkan menjadi daya tarik sendiri. https://t.co/bJ6K2OG2v0",5,0,1,0,2022-01-17,11,Monday,1,6,0
1483039569612312580,2022-01-17 11:32:41,"Dari hasil Drawing Piala AFC 2022, lawan-lawan Bali United di Piala AFC 2022 sudah diketahui. Juga ada PSM yang berjumpa dengan mantan pelatihnya, Bojan Hodak. Berikut hasil lengkap drawing Piala AFC 2022! https://t.co/gjlMQh7NzF",11,0,1,0,2022-01-17,11,Monday,1,12,0
1483039007651123204,2022-01-17 11:30:27,"Ada beberapa negara yang memiliki jam sekolah pendek. Walaupun begitu para siswanya tetap unggul dari berbagai aspek. Mana saja ya?

via: detikedu https://t.co/6nhFFjL8mU",14,0,2,0,2022-01-17,11,Monday,1,16,0
1483039002362101762,2022-01-17 11:30:26,"Penyebab otak lemot bisa jadi bukan karena aktivitas yang dilakukan melainkan kebiasaan buruk yang sering diabaikan. Apa saja kebiasaan buruk itu?

via: detikedu https://t.co/1iJzQ2fNrW",8,1,2,0,2022-01-17,11,Monday,1,10,1
1483038750833885187,2022-01-17 11:29:26,"Taeyeon SNSD akan merilis lagu terbaru, Can't Control Myself. Ia menulis sendiri lirik untuk lagu tersebut. #Taeyeon  https://t.co/1onQtdDsLw",18,0,2,0,2022-01-17,11,Monday,1,20,0
1483038733863694341,2022-01-17 11:29:22,"Anggota Exco PSSI, Haruna Soemitro, sedang jadi topik hangat. Selain pernyataannya soal Shin Tae-yong, juga lantaran topik match fixing alias pengaturan skor. https://t.co/DBreoIANjh",4,5,0,0,2022-01-17,11,Monday,1,4,5
1483038201661042696,2022-01-17 11:27:15,Dikenal sebagai presenter dan YouTuber mebuat Aurel Valen banjir tawaran endorsement. Ia ngaku jarang terima endorsement dan lebih suka bantu teman. https://t.co/iAY9y8EMNQ,27,5,4,2,2022-01-17,11,Monday,1,31,7
1483038179687084035,2022-01-17 11:27:10,Ramai #HarunaOut akibat Haruna Soemitro mengkritik Shin Tae-yong tak bawa timnas Indonesia Juara AFF 2020. https://t.co/yUMFl6TxkD,14,17,2,1,2022-01-17,11,Monday,1,16,18
1483037624977825794,2022-01-17 11:24:57,Erika Carlina tak tertarik dengan bule meski didekati Charlie Puth. Erika Carlina lebih suka dengan cowok Indonesia. https://t.co/MCQ1cvxDqx,121,32,11,24,2022-01-17,11,Monday,1,132,56
1483036558710214662,2022-01-17 11:20:43,"Berawal dari penyerempetan motor, oknum ojek online berinisial DS tega menganiaya korban HA hingga luka parah. Perempuan berusia 30 tahun ini mengaku baru pulang dari sebuah klub malam sesaat sebelum kejadian. https://t.co/EWfN0TlmH9",7,1,0,1,2022-01-17,11,Monday,1,7,2
1483036542046199810,2022-01-17 11:20:39,"Seorang pria merasa ada yang aneh dengan telinganya. Ternyata setelah diperiksa, ada kecoa yang hidup di telinga pria ini selama 3 hari. https://t.co/F0izGgzDg6",4,3,2,0,2022-01-17,11,Monday,1,6,3
1483036519355097094,2022-01-17 11:20:34,"Ratusan warga Matanair, Rubaru, Sumenep, Madura melakukan aksi unjuk rasa. Aksi ini menuntut Bupati segera melantik Kepala Desa Matanair, Ahmad Rasidi. https://t.co/QTELs6HtxY",5,0,2,0,2022-01-17,11,Monday,1,7,0
1483036517232742401,2022-01-17 11:20:33,Hujan deras disertai angin menerjang Kabupaten dan Kota di Probolinggo. Akibatnya sejumlah pohon tumbang dan sejumlah titik jalan terendam banjir. https://t.co/4sp61lDpJr,8,0,1,0,2022-01-17,11,Monday,1,9,0
1483035642464456709,2022-01-17 11:17:05,"Indonesia melaporkan 772 kasus COVID-19 pada Senin (17/1/2022). Total kasus positif menjadi 4.272.421, sembuh 4.119.472, dan meninggal 144.174. https://t.co/tWPFEUiLp3",7,0,2,0,2022-01-17,11,Monday,1,9,0
1483035389682200580,2022-01-17 11:16:05,"Kepala Bappenas, Suharso Monoarfa, mengumumkan Nusantara sebagai nama Ibu Kota Negara baru. Suharso mengatakan nama Nusantara telah mendapat persetujuan dari Presiden Joko Widodo. https://t.co/CEZHvGKsP3",22,14,3,3,2022-01-17,11,Monday,1,25,17
1483035141081600006,2022-01-17 11:15:05,"Senin (17/1) pagi, Aska Ongi menyambangi Polda Metro Jaya. Ditemani kuasa hukumnya, Aska memenuhi undangan polisi untuk melengkapi bukti atas laporannya pada tahun 2020 terhadap Aliff Alli terkait dugaan pemalsuan dokumen. https://t.co/oXnnar7d2j",5,2,1,0,2022-01-17,11,Monday,1,6,2
1483035122546974724,2022-01-17 11:15:01,"Pemprov DKI Jakarta mengirimkan bantuan logistik serta personel gabungan untuk membantu penanganan bencana gempa bumi di Kabupaten Pandeglang, Banten. https://t.co/2yuaDCv7Ub",9,2,2,0,2022-01-17,11,Monday,1,11,2
1483034474736762886,2022-01-17 11:12:26,Karim Benzema membantu Real Madrid menjuarai Piala Super Spanyol dan berhasul melewati catatan Cristiano Ronaldo. https://t.co/SvPlu80Ipc,7,0,0,0,2022-01-17,11,Monday,1,7,0
1483034181030621184,2022-01-17 11:11:16,Doddy Sudrajat datang ke rumah Faisal untuk membawa Gala Sky. Faisal berharap kedatangan besannya itu membawa solusi...  https://t.co/K97Uuklqmh,1,0,0,1,2022-01-17,11,Monday,1,1,1
1483033160082362370,2022-01-17 11:07:13,"Gambaran mengenai syarat masuk SD Negeri 2022 dapat disimak pada aturan PPDB tahun sebelumnya. Apa benar usia minimal siswa harus 7 tahun?

via: detikedu https://t.co/qegaqJL16z",9,0,3,0,2022-01-17,11,Monday,1,12,0
1483032658766888968,2022-01-17 11:05:13,Operasi Kereta Cepat Jakarta-Bandung diproyeksi mundur ke Juni 2023 dari rencana sebelumnya Desember 2022. Ini biang keroknya.  https://t.co/Fhea1lEoLt,9,7,1,6,2022-01-17,11,Monday,1,10,13
1483032616416813058,2022-01-17 11:05:03,Seorang siswa sekolah menengah di Hong Kong dijatuhi hukuman nyaris delapan tahun penjara karena menikam seorang polisi di leher. https://t.co/GtLvjn4KQd,3,0,1,0,2022-01-17,11,Monday,1,4,0
1483032614965501956,2022-01-17 11:05:03,Seisme merupakan gerakan yang terjadi pada kulit bumi. Namun apa dampak dari gerakan tersebut? https://t.co/TI68IgJlbl,2,0,1,0,2022-01-17,11,Monday,1,3,0
1483032111787433987,2022-01-17 11:03:03,"Beberapa negara justru dikenal sebagai tempat kuliah yang murah untuk para pelajar atau mahasiswa. Negara mana yang termurah nih?

via: detikedu https://t.co/g1WV5uxfLf",12,0,4,0,2022-01-17,11,Monday,1,16,0
1483032093458317312,2022-01-17 11:02:59,"Pelaku mengincar tas ransel seorang pengendara motor yang melintas di Terminal Pulogadung, Jaktim. Waspadai modusnya. https://t.co/5rAn7c5DXP",3,0,2,1,2022-01-17,11,Monday,1,5,1
1483031203804557317,2022-01-17 10:59:27,"Berakhir sudah usaha terakhir petenis Novak Djokovic untuk tetap di Australia. Bandingnya ditolak, membuat visanya dicabut, sehingga kena deportasi. https://t.co/LXn5wviKRh",2,1,0,0,2022-01-17,10,Monday,1,2,1
1483030638731141121,2022-01-17 10:57:12,Suzuki New U-Enjoy 125 versi 2022 resmi meluncur di China. Dengan menawarkan keunggulan yang cukup mencengangkan dalam hal efisiensi bahan bakar. https://t.co/3FADNkMNQM,10,2,1,2,2022-01-17,10,Monday,1,11,4
1483030637229580291,2022-01-17 10:57:11,"Kampus ITB di Cirebon resmi beroperasi untuk kegiatan belajar mengajar pada Senin, 17 Januari 2022 https://t.co/l8VyLzsfBA",3,2,3,1,2022-01-17,10,Monday,1,6,3
1483029792555511809,2022-01-17 10:53:50,Wuling Hongguang Mini EV berhasil meraih rekor penjualan selama 2021. https://t.co/joxLwBondV,7,1,1,0,2022-01-17,10,Monday,1,8,1
1483029770623410178,2022-01-17 10:53:45,"Takoyaki, bola-bola berisi gurita merupakan jajanan kaki lima khas Osaka, Jepang. Rasanya empuk lembut dengan topping saus mayo dan takoyaki yang gurih.  https://t.co/QTWVri7zFg",15,1,0,0,2022-01-17,10,Monday,1,15,1
1483029466658000897,2022-01-17 10:52:32,"Bila dibandingkan dengan angkutan massal berbasis rel serupa di negara-negara lain, tarif KRL commuter line di Indonesia jadi yang paling murah.  https://t.co/RXPvXsoJY5",4,6,2,3,2022-01-17,10,Monday,1,6,9
1483029112814186499,2022-01-17 10:51:08,"Secara legalitas, perubahan ini telah mengantongi surat Keputusan Menteri Hukum dan Hak Asasi Manusia Republik Indonesia pada 27 Desember 2021.  https://t.co/Y2yOpaGCga",3,0,0,0,2022-01-17,10,Monday,1,3,0
1483029109685071877,2022-01-17 10:51:07,Pemerintah kian serius memindahkan ibu kota negara (IKN) baru ke Kalimantan Timur. Ini lokasi ibu kota negara yang dinamakan Nusantara.  https://t.co/21XhmD7Y7p,35,5,1,2,2022-01-17,10,Monday,1,36,7
1483028493676027912,2022-01-17 10:48:40,Munarman tidak terima ketika jaksa hendak menginterupsi keterangan saksi. Sebab Munarman merasa sebelumnya tidak menyela kesempatan jaksa saat bertanya ke saksi https://t.co/gMzPdIK1Pd,13,7,0,0,2022-01-17,10,Monday,1,13,7
1483027978158280705,2022-01-17 10:46:37,Viral rencana Tabligh Akbar Ustaz Khalid Basalamah di Palu ditolak sejumlah ormas. Relawan Sahabat Khalid Basalamah lalu memberikan penjelasan terkait hal ini. https://t.co/PwDe8I7hqB,46,19,8,5,2022-01-17,10,Monday,1,54,24
1483027747735805954,2022-01-17 10:45:43,Tarif KRL diwacanakan bakal naik. Kenaikan terjadi pada tarif dasar sejauh 25 km pertama yang menjadi Rp 5.000 per penumpang. Masyarakat sanggup nggak ya?  https://t.co/fnaUvTZD16,5,1,4,1,2022-01-17,10,Monday,1,9,2
1483027516939980800,2022-01-17 10:44:48,"Presiden Joko Widodo mendatangi Pasar Sederhana Bandung. Di Pasar tersebut, Jokowi menemukan masih ada minyak goreng yang harganya Rp 20 ribu per liter. https://t.co/RdufLwdemQ",12,16,2,1,2022-01-17,10,Monday,1,14,17
1483026628955492354,2022-01-17 10:41:16,Nama Kaesang Pangarep ramai diperbincangkan karena wajahnya muncul dalam gambar di sebuah cemilan yang disediakan maskapai Garuda Indonesia.  https://t.co/pIZHZQzNuF,5,5,1,3,2022-01-17,10,Monday,1,6,8
1483026608214745088,2022-01-17 10:41:11,Polisi kembali menangkap dua pelaku lain yang terlibat pengeroyokan anggota TNI di Jakut. Total kini sudah 3 pelaku yang ditangkap. https://t.co/ZviC0f86Xs,1,0,0,0,2022-01-17,10,Monday,1,1,0
1483026351120699392,2022-01-17 10:40:10,Sebanyak 11 petugas biro penyedia layanan umrah terinfeksi COVID-19 varian Omicron sepulang dari Arab Saudi. Hal ini dikonfirmasi oleh Menteri Agama. https://t.co/nIWr1z2sVa,3,1,1,0,2022-01-17,10,Monday,1,4,1
1483026328139886594,2022-01-17 10:40:04,"Nama Nusantara sudah dikenal sejak dulu dan ikonik di internasional. Selain itu, nama itu mudah menggambarkan Republik Indonesia. Gimana menurutmu? https://t.co/1QM2SAjWKL",271,110,39,31,2022-01-17,10,Monday,1,310,141
1483026052050042882,2022-01-17 10:38:58,"Laura Anna ternyata pernah mengutarakan kekecewaannya pada Gaga Muhammad yang tega selingkuh. Tapi, Gaga Muhammad cuek. https://t.co/eJL763DRK6",40,6,5,2,2022-01-17,10,Monday,1,45,8
1483024713337217025,2022-01-17 10:33:39,KPK kini mengusut dugaan adanya TPPU yang dilakukan Wali Kota Bekasi nonaktif Rahmat Effendi dalam kasus dugaan suap lelang jabatan dan pengadaan barang-jasa. https://t.co/6ugXas2c7u,6,0,0,1,2022-01-17,10,Monday,1,6,1
1483024171940687872,2022-01-17 10:31:30,Kelompok masyarakat yang menamakan diri Gerakan Inisiatif Bersihkan Udara Koalisi Semesta (Ibu Kota) mengajukan banding atas vonis hakim terkait polusi udara. https://t.co/ESxCoMk1S7,3,0,0,0,2022-01-17,10,Monday,1,3,0
1483023862875009025,2022-01-17 10:30:16,"Mantan Wakil Ketua DPR Aziz Syamsuddin menjalani sidang di Pengadilan Tipikor, Jakarta Pusat, Senin (17/1/2021). Sidang ini mengagendakan pemeriksaan terdakwa. https://t.co/38ijjpi1Ck",3,1,1,0,2022-01-17,10,Monday,1,4,1
1483023842511667200,2022-01-17 10:30:11,Proses terjadinya tsunami seperti apa? Ini informasinya. https://t.co/0s5dBBM7rD,7,0,1,0,2022-01-17,10,Monday,1,8,0
1483023614739898368,2022-01-17 10:29:17,Sejumlah anggota DPR yang tergabung dalam Pansus RUU IKN mengkritik soal Nusantara jadi nama ibu kota baru. Begini kritik mereka. https://t.co/QeecAaIgPl,27,10,4,0,2022-01-17,10,Monday,1,31,10
1483023348871348224,2022-01-17 10:28:14,"Penyelenggaraan Ibadah Haji tahun 2022 belum dapat dipastikan. Meski begitu, Kementerian Agama (Kemenag) telah menyiapkan 3 opsi pemberangkatan jemaah haji tahun 1443 H/2022 masehi. https://t.co/ghFyJlPNHi",2,0,0,0,2022-01-17,10,Monday,1,2,0
1483023331280531458,2022-01-17 10:28:10,"Inilah lima rekor sepanjang masa di Juventus. Dipegang tiga nama, salah satunya Cristiano Ronaldo! https://t.co/OxCN9NuHNc",6,0,1,0,2022-01-17,10,Monday,1,7,0
1483022758065942533,2022-01-17 10:25:53,Keluarga Anang Hermansyah dan Atta Halilintar sengaja menyewa satu lantai hotel untuk jalani karantina usai pulang dari Turki. https://t.co/9CONQPDx0L,9,5,0,1,2022-01-17,10,Monday,1,9,6
1483022371250442242,2022-01-17 10:24:21,"Menag Yaqut Cholil Qoumas dan Komisi VIII DPR menggelar rapat kerja di kompleks Parlemen, Senayan, Jakarta. Raker membahas ibadah haji tahun 1443 H/2022. https://t.co/unUHgLTbgm",5,1,0,0,2022-01-17,10,Monday,1,5,1
1483022087983882240,2022-01-17 10:23:13,Anggota Komisi III DPR Fraksi Demokrat Benny Harman membela dosen Universitas Negeri Jakarta (UNJ) Ubedillah Badrun yang dipolisikan relawan Jokowi Mania. https://t.co/8rWHvGWVju,13,0,3,0,2022-01-17,10,Monday,1,16,0
1483022061371023366,2022-01-17 10:23:07,Ashanty akhirnya diperbolehkan pulang setelah dinyatakan sembuh dari COVID-19. Ashanty 11 hari karantina di rumah sakit sepulang dari Turki.  https://t.co/QfiXW6O617,5,4,0,1,2022-01-17,10,Monday,1,5,5
1483022040634384389,2022-01-17 10:23:02,China mencatat tambahan 223 kasus harian pada Senin (17/1/2022). Angka tersebut adalah jumlah infeksi harian tertinggi yang tercatat sejak Maret 2020. https://t.co/unMLpCxCub,3,0,1,0,2022-01-17,10,Monday,1,4,0
1483021700782604294,2022-01-17 10:21:41,"Doddy Sudrajat kaget Faisal mendatangi rumahnya. Awalnya, pertemuan mereka sempat membuat suasana memanas.  https://t.co/JNh8P25G9B",57,48,11,9,2022-01-17,10,Monday,1,68,57
1483021435845160962,2022-01-17 10:20:38,"Indonesia merupakan negara yang sangat luas. Coba ingat lagi, seperti apa batas wilayah Indonesia secara astronomis ya? https://t.co/ESSiO6n15M",11,0,3,0,2022-01-17,10,Monday,1,14,0
1483021413678211075,2022-01-17 10:20:32,"Sebanyak 404 kasus Omicron dirawat di RSDC Wisma Atlet, Kemayoran, Jakarta Pusat. Sebanyak 357 orang di antaranya telah diizinkan pulang. https://t.co/Z1XxNcAcvd",6,0,6,3,2022-01-17,10,Monday,1,12,3
1483021128876625924,2022-01-17 10:19:24,Tya Ariestya tengah belajar pakai hijab. Begini reaksi sang anak dan suami:  https://t.co/kvKDenzbyu,4,0,0,0,2022-01-17,10,Monday,1,4,0
1483021127568052225,2022-01-17 10:19:24,Novak Djokovic batal bermain di Australian Open 2022 dan dideportasi oleh pemerintah Australia. Berikut kata Presiden Serbia Aleksandar Vucic! https://t.co/JhmvMujUXe,4,1,1,2,2022-01-17,10,Monday,1,5,3
1483020783450476549,2022-01-17 10:18:02,PT Asuransi Tugu Mandiri berganti nama menjadi PT Perta Life Insurance.  https://t.co/lyeX7pl5wu,1,0,1,2,2022-01-17,10,Monday,1,2,2
1483020473663377409,2022-01-17 10:16:48,Presiden Joko Widodo meminta agar mahasiswa tidak dibatasi terlalu banyak dengan program studi fakultas di kampus. Jokowi menyarankan agar para mahasiswa belajar kepada siapa saja dan di mana saja agar ke depan bisa mencetak SDM yang unggul. https://t.co/qu4xcPeJz3,9,0,2,0,2022-01-17,10,Monday,1,11,0
1483019868337319939,2022-01-17 10:14:24,"Merespons situasi pandemi, pelukis Haryanto Gunawan melalui seri karya Odourless Scent [e]motions membuat 9 lukisan dari wewangian. https://t.co/8WshOeyDjL",5,1,0,0,2022-01-17,10,Monday,1,5,1
1483019842349412356,2022-01-17 10:14:18,"Jaksa penuntut umum menghadirkan saksi pelapor berinisial IM di sidang lanjutan kasus dugaan terorisme Eks Sekretaris Front Pembela Islam ( FPI) Munarman. IM menduga kuat Munarman ada kaitan dengan aksi bom bunuh diri di Gereja Katedral, Jolo, Filipina. https://t.co/CSh33WSaTK",4,4,0,0,2022-01-17,10,Monday,1,4,4
1483018552995106816,2022-01-17 10:09:10,Ratusan warga Lumajang berunjuk rasa di kantor DPRD Lumajang. Warga menuntut tersangka pembuang dan penendang sesajen di Semeru diproses hukum di Lumajang https://t.co/REQ8fOQV1f,26,4,6,2,2022-01-17,10,Monday,1,32,6
1483018057693995008,2022-01-17 10:07:12,Gol Karim Benzema di Piala Super Spanyol menyalip koleksi Cristiano Ronaldo. Tapi Benzema masih di bawah Lionel Messi sang top skor. Ini daftar 10 besarnya. https://t.co/NiWKkGoWBo,3,0,0,0,2022-01-17,10,Monday,1,3,0
1483018056024604677,2022-01-17 10:07:12,Snack di Garuda viral lantaran sempat menjadi bagian dari paket makanan penumpang pesawat Garuda Indonesia. Berikut tanggapan dari berbagai pihak. https://t.co/CsuPWJEho8,5,9,0,0,2022-01-17,10,Monday,1,5,9
1483017261199863811,2022-01-17 10:04:02,"Terkait pelaporan terhadap Gibran dan Kaesang, KPK berbicara soal 'keharusan' penyelenggara negara dalam suatu tindak pidana korupsi. https://t.co/DkSTU7PC9S",7,0,2,0,2022-01-17,10,Monday,1,9,0
1483016728082894851,2022-01-17 10:01:55,"BMKG mengingatkan potensi gempa megathrust dengan magnitudo 8,7. Apa yang dimaksud dengan gempa megathrust? https://t.co/7OnJhc66kY",13,1,5,2,2022-01-17,10,Monday,1,18,3
1483016390332370953,2022-01-17 10:00:35,"Memilih PTN tidak boleh asal, detikers dapat melihat universitas terbaik melalui 3 lembaga ranking. Yuk cari tahu di sini!

via: detikedu https://t.co/cIcazvimVM",3,2,0,0,2022-01-17,10,Monday,1,3,2
1483015871677276162,2022-01-17 09:58:31,Lee Da Hae dan Se7en sudah 7 tahun menjalin asmara. Keduanya disebut akan menikah dalam waktu dekat. #LeeDaHae #Se7en  https://t.co/hRSHdaKb6s,5,0,0,0,2022-01-17,9,Monday,1,5,0
1483015853704679425,2022-01-17 09:58:27,Mobil Rp 200-250 juta akan mendapatkan diskon PPnBM 50% di tiga bulan pertama 2022. Berikut mobil yang berpotensi dapat diskon PPnBM 50%. https://t.co/fXaXH1MHcn,4,1,0,0,2022-01-17,9,Monday,1,4,1
1483015600003858432,2022-01-17 09:57:26,"Satu halaman karya seni asli dari tahun 1984 yang menampilkan Spider-Man mencetak rekor, laku senilai Rp 48 miliar. Wow!  https://t.co/HLgzlbBzxe",3,2,1,0,2022-01-17,9,Monday,1,4,2
1483015575987228674,2022-01-17 09:57:21,"Untuk mencegah infeksi nosokomial, RSUD Pandan Arang Boyolali kini punya gedung bersalin terpadu untuk persalinan dan perawatan intensif bayi dan anak-anak. https://t.co/QgNGKPcyUK",3,1,0,0,2022-01-17,9,Monday,1,3,1
1483015010154684420,2022-01-17 09:55:06,Media sosial dihebohkan dengan rekaman video viral menunjukkan dua kuburan yang tertuliskan di batu nisan dengan nama Upin dan Ipin. #UpinIpin  https://t.co/L2woksNObA,9,2,0,1,2022-01-17,9,Monday,1,9,3
1483014771226165249,2022-01-17 09:54:09,Presiden Joko Widodo (Jokowi) menyetujui diskon PPnBM untuk mobil baru diperpanjang. https://t.co/aGc6xk9tRn,6,0,0,0,2022-01-17,9,Monday,1,6,0
1483014232186753031,2022-01-17 09:52:00,"Kecelakaan lalu lintas terjadi di Jalan Raya Bogor dekat Mal Cijantung, Jaktim, melibatkan pemotor ibu-ibu, dan 2 truk, pada pagi tadi. https://t.co/vDQF1O0OzS",12,1,2,1,2022-01-17,9,Monday,1,14,2
1483013340012204032,2022-01-17 09:48:27,Komisi II DPR RI memastikan akan memutuskan jadwal dan tahapan pemilihan umum (Pemilu) 2024 pada pekan depan. https://t.co/vJ3jB7bIUA,7,0,0,0,2022-01-17,9,Monday,1,7,0
1483013099418439684,2022-01-17 09:47:30,Temuan yang satu ini menurut para ilmuwan adalah hewan hybrid pertama yang dikembangkan oleh manusia. https://t.co/TWktrNUw78,4,0,4,0,2022-01-17,9,Monday,1,8,0
1483012828458110979,2022-01-17 09:46:26,KPK telah memeriksa Kepala BPBD hingga Sekda Kota Bekasi. KPK mengkonfirmasi soal dugaan Rahmat Effendi menerima uang dari potongan dana pegawai. https://t.co/Tlo4ZXthiJ,5,1,2,0,2022-01-17,9,Monday,1,7,1
1483012344070524929,2022-01-17 09:44:30,WhatsApp memperkenalkan fitur-fitur anyar bahkan disukai oleh penggunanya dan yang terbaru WhatsApp akan segera rilis fitur Reaction. #WhatsApp  https://t.co/But6LOP33a,5,1,2,0,2022-01-17,9,Monday,1,7,1
1483011840334614534,2022-01-17 09:42:30,Presiden Jokowi mendapatkan bisikan dari Gubernur Jawa Barat Ridwan Kamil. Tentang apa? https://t.co/ZriDDyUTcO,14,17,7,3,2022-01-17,9,Monday,1,21,20
1483011813440733185,2022-01-17 09:42:24,Tertinggal jauh dari Manchester City di klasemen Liga Inggris. The Reds dilarang menyerah. https://t.co/DAta0DrQcz,1,0,3,0,2022-01-17,9,Monday,1,4,0
1483011271159132161,2022-01-17 09:40:14,"Menang tiga set langsung atas Marcos Giron, Rafael Nadal melewati babak pertama Australian Open 2022 dengan kemenangan straight sets. https://t.co/5FbJPaPYmf",4,0,0,0,2022-01-17,9,Monday,1,4,0
1483011246437842946,2022-01-17 09:40:08,Gempita mengutarakan keinginannya di hadapan Gisel dan Gading Marten. Ternyata keinginan Gempita tak muluk-muluk. https://t.co/bnyBHs799L,2,2,0,0,2022-01-17,9,Monday,1,2,2
1483010772863176709,2022-01-17 09:38:15,Kementerian perhubungan (Kemenhub) menggelar touring kendaraan listrik Jakarta-Jambi. Total ada 15 mobil listrik dari berbagai merek yang ikut serta. https://t.co/FOPEB0EKkh,1,0,0,0,2022-01-17,9,Monday,1,1,0
1483010530743058435,2022-01-17 09:37:18,PSS Sleman bentrok dengan Madura United pada lanjutan BRI Liga 1 2021/2022. Super Elang Jawa mewaspadai serangan sayap Sape Kerrab. https://t.co/MTKFupOOxw,3,0,0,0,2022-01-17,9,Monday,1,3,0
1483010507795841027,2022-01-17 09:37:12,"Corndog sebenarnya jajanan asal Amerika Serikat, namun kini justru jadi jajanan populer di Korsel. Corndog Korea dengan keju mulur kini mudah ditemui di Jakarta  https://t.co/K1lOlOm14c",7,0,0,0,2022-01-17,9,Monday,1,7,0
1483010195894714368,2022-01-17 09:35:58,Diskon pajak mobil baru atau diskon PPNBM dilanjutkan pemerintah di 2022 ini. Kebijakan itu telah disetujui oleh Jokowi  https://t.co/lcAtryZlkp,5,0,1,1,2022-01-17,9,Monday,1,6,1
1483009829367074816,2022-01-17 09:34:30,"Menghadapi kenaikan kasus COVID-19 terkait varian Omicron, Luhut merekomendasikan pembatasan WFO setidaknya 2 pekan ke depan. Perlukah? Begini kata epidemiolog: https://t.co/twAnqhXO44",9,1,2,2,2022-01-17,9,Monday,1,11,3
1483009553415483393,2022-01-17 09:33:25,Beberapa kata yang sering kita pakai sehari-hari rupanya adalah serapan bahasa portugis. Apa saja ya? https://t.co/sDPOUXYMPn,1,0,2,0,2022-01-17,9,Monday,1,3,0
1483009524873191424,2022-01-17 09:33:18,"#FOTO detikInet menantang kamu untuk menemukan kucing yang bersembunyi di foto ini. Kalau kamu merasa punya mata jeli, yuk temukan posisi kucing ini:  https://t.co/ni5KQ4M5Ms",4,1,0,0,2022-01-17,9,Monday,1,4,1
1483008978091220997,2022-01-17 09:31:08,Komedian Abdel mengaku masih menggunakan sabu saat mengisi acara dakwah bersama Mamah Dedeh. Lalu bagaimana reaksi Mamah Dedeh? Simak kisahnya berikut. #detikNetwork https://t.co/059CP38IIg,36,16,1,3,2022-01-17,9,Monday,1,37,19
1483008195228581888,2022-01-17 09:28:01,KPK menggeledah beberapa lokasi di Penajam Paser Utara terkait kasus suap yang menjerat Abdul Gafur Mas'ud selaku Bupati. Salah satunya yakni Kantor Bupati. https://t.co/r3XchmUsTa,4,1,1,1,2022-01-17,9,Monday,1,5,2
1483007949182324737,2022-01-17 09:27:02,De Bruyne tercatat sebagai eks pemain Chelsea paling banyak yang jebolin gawang The Blues di Liga Inggris! https://t.co/uN6DNnowCj,10,1,0,0,2022-01-17,9,Monday,1,10,1
1483007947760406531,2022-01-17 09:27:02,Tesla akan kembali menunda produksi Cybertruck. Ada masalah apa? https://t.co/uHqFXKWmhx,4,0,0,0,2022-01-17,9,Monday,1,4,0
1483007399359307776,2022-01-17 09:24:51,Uap air telah terdeteksi di atmosfer sebuah exoplanet seukuran Neptunus sekitar 150 tahun cahaya dari Bumi.  https://t.co/U9UkCeIzyb,13,2,2,2,2022-01-17,9,Monday,1,15,4
1483006766724096002,2022-01-17 09:22:20,"Melawan Spezia nanti malam, Milan berpeluang menggeser Inter Milan dari puncak klasemen Liga Italia. https://t.co/3dCe75cxXA",9,0,1,0,2022-01-17,9,Monday,1,10,0
1483006471604420613,2022-01-17 09:21:10,"Gubernur DKI Jakarta, Anies Baswedan, ikut menyaksikan aksi panggung band Nidji di Jakarta International Stadium (JIS). Anies pun mengapresiasi penampilan band yang dulu dipelopori oleh Giring Ganesha tersebut. https://t.co/9NPfx3bgLP",13,3,0,1,2022-01-17,9,Monday,1,13,4
1483006462469287939,2022-01-17 09:21:08,"Menkes Budi Gunadi Sadikin menyampaikan arahan dari Presiden terkait DKI Jakarta yang menjadi medan perang pertama melawan Omicron. Jokowi berpesan untuk tidak usah panik, tetapi harus hati-hati dan waspada. Lalu, apa saja langkah yang akan ditempuh? https://t.co/07Cu2Sw71r",3,2,0,0,2022-01-17,9,Monday,1,3,2
1483005918900072448,2022-01-17 09:18:58,"detikers tentu sudah tidak asing membaca artikel dan berita sains menarik di detikINET. Nah, ada konten baru buat kalian yang suka dengan sains! #Eureka  https://t.co/YbjEJd6DAK",4,0,1,0,2022-01-17,9,Monday,1,5,0
1483005677291413507,2022-01-17 09:18:01,"Ingin memberi motivasi dan semangat siswa dalam belajar, guru di Sekolah Menengah Pertama (SMP) ini memborong seblak untuk dibagikan ke anak-anak muridnya.  https://t.co/UbVO1R5WOr",2,0,2,0,2022-01-17,9,Monday,1,4,0
1483005433719803906,2022-01-17 09:17:02,"Ricky Kambuaya bicara soal Shin Tae-yong. Menurutnya, Shin Tae-yong adalah orang yang disiplin dan tegas. https://t.co/B4hcKymFLj",17,2,1,0,2022-01-17,9,Monday,1,18,2
1483004937571344386,2022-01-17 09:15:04,"Kecanduan makanan membuat beberapa orang tak bisa berhenti mengonsumsi makanan yang sama. Jenisnya ada yang ekstrem, seperti mengonsumsi pasir dan air kencing!  https://t.co/KzXfAEb5Zh",3,0,0,0,2022-01-17,9,Monday,1,3,0
1483004918424387584,2022-01-17 09:15:00,Pep Guardiola baru menambah koleksi Manager of the Month Premier League. Seperti ini reaksi Pep saat tahu jumlah koleksi Sir Alex. https://t.co/O3bOM2zDeU,4,0,0,0,2022-01-17,9,Monday,1,4,0
1483004404613660675,2022-01-17 09:12:57,Pelapor video 61 detik yang dinarasikan 'mirip Nagita Slavina' diperiksa polisi. Pelapor melampirkan bukti dalam pemeriksaan tersebut. https://t.co/NKgIoZM1HC,6,0,0,0,2022-01-17,9,Monday,1,6,0
1483004117815595008,2022-01-17 09:11:49,"Tidak hanya iPhone 14 series, Apple dikabarkan akan merilis tablet baru tahun ini. Perangkat yang dimaksud adalah iPad Pro 2022. Ini sederet bocorannya:  https://t.co/g75ShUsQwv",7,0,2,3,2022-01-17,9,Monday,1,9,3
1483003769818333186,2022-01-17 09:10:26,Perum Bulog mengungkap harga beras diproyeksi naik sejak Desember 2021 sampai Februari 2022.  https://t.co/04rivEQd3J,6,1,2,0,2022-01-17,9,Monday,1,8,1
1483003749358616578,2022-01-17 09:10:21,Munarman emosi ke saksi IM di persidangan. Munarman marah karena dia menilai saksi IM telah membuatnya masuk penjara. https://t.co/BHUNyVQ89X,7,2,1,1,2022-01-17,9,Monday,1,8,3
1483003480537280514,2022-01-17 09:09:17,Para astronom melaporkan kemungkinan telah ditemukan Bulan yang ukurannya lebih besar dari Bumi. https://t.co/JxFZzwC3ll,26,2,1,0,2022-01-17,9,Monday,1,27,2
1483002909675732997,2022-01-17 09:07:01,Wacana kenaikan tarif KRL commuter line muncul. Ditjen Perkeretaapian Kementerian Perhubungan sedang mengkaji kenaikan tarif ini.  https://t.co/K0l7bcmLcQ,4,1,1,2,2022-01-17,9,Monday,1,5,3
1483002908505518080,2022-01-17 09:07:00,Ratusan ribu unit sepeda motor buatan Indonesia diekspor ke berbagai negara di dunia. https://t.co/WapoYYf7Jw,18,4,4,1,2022-01-17,9,Monday,1,22,5
1483002632398594052,2022-01-17 09:05:55,Jokowi menyebut Kereta Cepat Jakarta-Bandung akan beroperasi pada Juni 2023.  https://t.co/TemcDiCWXg,17,20,2,2,2022-01-17,9,Monday,1,19,22
1483001305199222786,2022-01-17 09:00:38,"Belum lama ini ramai diperbincangkan terkait cemilan atau makanan ringan di pesawat Garuda Indonesia yang bergambar anak Jokowi, Kaesang Pangarep!  https://t.co/KdX3IToEn9",8,0,0,0,2022-01-17,9,Monday,1,8,0
1483000991465279492,2022-01-17 08:59:23,"Aturan baru, Kemenkes RI kini tidak memperbolehkan vaksin Sinovac untuk vaksin primer dosis 1 di luar usia anak. Apa saja yang menjadi pertimbangan? https://t.co/2jhWM0Oe7S",9,0,1,2,2022-01-17,8,Monday,1,10,2
1483000483958734848,2022-01-17 08:57:22,"Setelah sejumlah tim advance Umroh didapati positif COVID-19 usai pulang dari tanah suci, Menag Yaqut memberi evaluasinya. https://t.co/PCf7kQdGS4",5,1,1,0,2022-01-17,8,Monday,1,6,1
1483000464031502338,2022-01-17 08:57:18,#Foto Gadis sederhana yang jatuh cinta pada pria kaya sering diperankan Thalia di telenovela. Ini perbedaan gayanya dari karya debut sampai terakhir. https://t.co/qJXuPNmpFC,6,2,0,1,2022-01-17,8,Monday,1,6,3
1482999981145530374,2022-01-17 08:55:22,"Real Madrid sukses merebut Piala Super Spanyol 2021/2022. Madrid mengalahkan Athletic Bilbao 2-0 di final, meski bermain dengan 10 orang di menit-menit akhir. https://t.co/ZUCUDAbeAF",9,0,0,0,2022-01-17,8,Monday,1,9,0
1482999474939211777,2022-01-17 08:53:22,Arteria Dahlan sempat menyinggung ada seorang Kepala Kejaksaan Tinggi yang berbicara memakai bahasa Sunda saat rapat. Seperti apa? https://t.co/N64SInSiMH,23,33,3,16,2022-01-17,8,Monday,1,26,49
1482998355194224645,2022-01-17 08:48:55,Sebagian orang mungkin masih belum mengerti bagaimana cara mendapatkan vaksin booster. Begini petunjuk dari Kemenkes RI: https://t.co/XfrhKPCUt0,7,0,3,1,2022-01-17,8,Monday,1,10,1
1482998245978951681,2022-01-17 08:48:29,"Hayo ngaku, siapa yang suka begini?",5,1,1,0,2022-01-17,8,Monday,1,6,1
1482998115712081922,2022-01-17 08:47:58,Publik dihebohkan dengan video berdurasi 61 detik yang disebut terdapat wanita mirip Nagita Slavina sedang beradegan syur. https://t.co/qO7XRbGnYC,6,2,1,1,2022-01-17,8,Monday,1,7,3
1482998098133725190,2022-01-17 08:47:54,MK membuka kemungkinan mengubah presidential threshold atau ambang batas presiden dari 20 persen menjadi 0 persen. Kenapa? https://t.co/3UFefsKToY,24,5,4,3,2022-01-17,8,Monday,1,28,8
1482997552211537921,2022-01-17 08:45:43,"Gunung bawah laut, Hunga Tonga-Hunga Ha'apai meletus, Sabtu (15/1/2022) sore. Selain gunung tersebut, ada 7 gunung bawah laut lainnya yang masih aktif.

via: detikedu https://t.co/svWrOOCDRy",11,0,2,0,2022-01-17,8,Monday,1,13,0
1482997310040723461,2022-01-17 08:44:46,Salah satu mobil yang mendapat relaksasi PPnBM DTP ini adalah mobil di segmen LCGC. Seberapa laris segmen LCGC? Ini data penjualannya. https://t.co/g0H6FCeCqO,5,1,0,1,2022-01-17,8,Monday,1,5,2
1482997034995044352,2022-01-17 08:43:40,"Foto selfie Ghozali Everyday selama setiap hari dalam lima tahun, rupanya bukan yang terlama. Sebelumnya, Hugo Cornellier selfie hampir selama 10 tahun! https://t.co/m6eqsUqLVK",4,0,0,0,2022-01-17,8,Monday,1,4,0
1482997011934818304,2022-01-17 08:43:35,Perseteruan antara Aska Ongi dengan Aliff Alli ternyata belum usai. Keduanya masih bersitegang usai cerai hingga berebut hak asuh anak. https://t.co/gi66ga9KHl,2,0,0,1,2022-01-17,8,Monday,1,2,1
1482996476527759360,2022-01-17 08:41:27,"Ada sejumlah tren di dunia pendidikan yang muncul dan terus berlanjut pada 2022. Harus mulai diadaptasi oleh para guru. Apa saja ya?

via: detikedu https://t.co/7euNM010aT",9,1,1,2,2022-01-17,8,Monday,1,10,3
1482996208591425537,2022-01-17 08:40:23,"Tanda-tanda kelahiran Samsung Galaxy Tab S8 semakin terlihat. Setelah ramai bocoran beredar, tablet gahar buatan Samsung ini dinyatakan lolos TKDN Kemenperin.  https://t.co/As8Kwgnr7T",6,0,2,0,2022-01-17,8,Monday,1,8,0
1482995710727536647,2022-01-17 08:38:24,Veronica Tan menawarkan layanan tes PCR yang disebut bisa mendeteksi varian Omicron. Tesnya pun disebut telah mendapatkan registrasi dari Kemenkes. https://t.co/MVuL3Ou7Bj,12,0,2,2,2022-01-17,8,Monday,1,14,2
1482995225635217412,2022-01-17 08:36:29,"Kondisi ruang kelas 1 SDN 2 Klaling Kecamatan Jekulo, Kabupaten Kudus, Jawa Tengah memprihatinkan. Meski demikian, siswa tetap belajar dengan kondisi atap kelas yang sebagian ambrol. https://t.co/169idhnS4e",8,1,0,1,2022-01-17,8,Monday,1,8,2
1482995207671009281,2022-01-17 08:36:24,"Bagi kamu yang masih bingung tentang tata cara dan bacaan sholat jenazah perempuan, berikut penjelasannya. https://t.co/RbO66o6Apr",9,0,1,0,2022-01-17,8,Monday,1,10,0
1482994959645040641,2022-01-17 08:35:25,Gading Marten dan Gisel merayakan ulang tahun ke-7 Gempita dengan sederhana. Gisel ingin mengajak Gempita belajar sederhana. https://t.co/tW1lRbDG11,18,1,0,0,2022-01-17,8,Monday,1,18,1
1482994736390672385,2022-01-17 08:34:32,Menag Yaqut mengimbau kepada masyarakat agar tetap waspada di tengah maraknya penularan Omicron saat ini. https://t.co/7y839NB5SA,9,5,2,0,2022-01-17,8,Monday,1,11,5
1482994720552988678,2022-01-17 08:34:28,Indonesia bakal menghadapi puncak Omicron pertengahan Februari sampai awal Maret. Jabodetabek diprediksi menjadi yang pertama mencatat lonjakan Omicron. https://t.co/5bBGJWMqOw,7,10,3,1,2022-01-17,8,Monday,1,10,11
1482993943734325248,2022-01-17 08:31:23,"Lokasi vaksin booster COVID-19 sudah tersedia di Jawa Barat, termasuk Sukabumi, Bandung, dan sekitarnya. Cara daftar, jadwal, jenis vaksin, bisa cek di sini: https://t.co/Buj7f1mBI1",6,0,0,0,2022-01-17,8,Monday,1,6,0
1482993183114022912,2022-01-17 08:28:22,"Gempi menginjak usia 7 tahun. Momen pergantian usia itu dirayakan oleh orang tuanya, Gading Marten dan Gisel. Ini potretnya:  https://t.co/R9XywuVpRZ",15,0,0,0,2022-01-17,8,Monday,1,15,0
1482992667453796353,2022-01-17 08:26:19,Carlo Ancelotti mengirim peringatan kepada para rival usai Real Madrid menjuarai Piala Super Spanyol. Madrid punya ambisi besar untuk meraih lebih banyak trofi. https://t.co/zA1y6BRCtt,8,0,0,0,2022-01-17,8,Monday,1,8,0
1482992167157223424,2022-01-17 08:24:19,"Setiap negara memiliki sejumlah prosedur dan aturan yang ketat di tengah pandemi COVID-19, salah satunya Indonesia yang menetapkan wajib karantina. Lalu, apakah hal ini juga berlaku bagi pembalap dan tim kru MotoGP yang akan tampil di Sirkuit Mandalika? https://t.co/8R6vwBtY85",5,0,0,0,2022-01-17,8,Monday,1,5,0
1482991424287223814,2022-01-17 08:21:22,"Masuk sebagai pemain pengganti, Takumi Minamino menandai hari ulang tahunnya dengan mencetak gol. Jürgen Klopp pun memuji! https://t.co/BPmoHtx211",6,0,0,0,2022-01-17,8,Monday,1,6,0
1482991403626078208,2022-01-17 08:21:17,Keluarga membocorkan bukti-bukti Laura Anna selalu memenuhi kebutuhan Gaga Muhammad. Semua bukti masih ada di ponsel Laura Anna. https://t.co/dLkVTiHlGs,58,11,13,5,2022-01-17,8,Monday,1,71,16
1482990896530530304,2022-01-17 08:19:17,"Gambar-gambar berikut ini memang terlihat biasa saja, namun ada keanehan atau kejanggalan yang perlu kamu temukan. Yuk cari dengan teliti! https://t.co/XgODG3SId7",8,0,0,1,2022-01-17,8,Monday,1,8,1
1482990397295058948,2022-01-17 08:17:18,"Indorent sedang menyiapkan armada double decker dengan pilihan kelas First Class, Super Executive Class, dan Executive Class, rute Jakarta-Yogyakarta. https://t.co/5nFQg86KNd",10,0,2,2,2022-01-17,8,Monday,1,12,2
1482989796528209924,2022-01-17 08:14:54,Forbes merilis daftar YouTuber dengan penghasilan tertinggi sepanjang tahun 2021. Di posisi nomor satu ada Mr. Beast yang meraup Rp 773 miliar. Ini sosoknya:  https://t.co/CLZaiz1WQU,8,2,2,0,2022-01-17,8,Monday,1,10,2
1482989277281538048,2022-01-17 08:12:50,Comeback Luis Nani di Serie A ditandai dengan mencatatkan assist di laga debutnya Venezia. https://t.co/Cm8MgCD4tc,7,0,1,0,2022-01-17,8,Monday,1,8,0
1482988380292108289,2022-01-17 08:09:17,Tukul Arwana sedang sakit. Ia disebut seniman penyayang hingga penuh pengertian...  https://t.co/8KLsunNOGx,76,6,7,0,2022-01-17,8,Monday,1,83,6
1482987886723178499,2022-01-17 08:07:19,"Ada 5 tren dunia kerja tahun 2022 yang harus diketahui fresh graduate. Apa saja itu? Simak ya, fresh graduate....

via: detikedu https://t.co/mDpAUtyhvU",7,0,1,0,2022-01-17,8,Monday,1,8,0
1482987624914726918,2022-01-17 08:06:17,#Foto Pemerintah Turki meluncurlan kampanye wisata 'Halo Turkiye' meski Omicron melonjak. Apa saja yang menarik sehingga orang mau liburan ke Turki ya? #Turki https://t.co/dQUpxK4aew,6,2,1,2,2022-01-17,8,Monday,1,7,4
1482986877229666306,2022-01-17 08:03:18,"""...tidak ada salahnya kita mulai membatasi dan menahan mobilitas keluar rumah serta aktivitas berkumpul yang tidak perlu..."" ujar Luhut. https://t.co/7uchuUX1Fz",38,61,10,8,2022-01-17,8,Monday,1,48,69
1482986464493416448,2022-01-17 08:01:40,"NFT makin banyak diserbu seiring potensi cuan di dalamnya, seperti Ghozali Everyday. Kominfo mengawasi kegiatan transaksi NFT di RI. #NFT  https://t.co/MOmmv2BBZ5",4,0,2,0,2022-01-17,8,Monday,1,6,0
1482986335745060865,2022-01-17 08:01:09,PT Brantas Abipraya (Persero) membuka lowongan kerja untuk lulusan Sarjana Komunikasi dan sejenisnya.  https://t.co/u1OjaRxzSF,11,0,2,1,2022-01-17,8,Monday,1,13,1
1482986018483671046,2022-01-17 07:59:54,Google memberikan kesempatan kepada para pencari kerja untuk bekerja di Google Indonesia. Ada 24 posisi yang dibuka untuk penempatan di Indonesia.  https://t.co/sU7hF4a7XC,18,0,8,0,2022-01-17,7,Monday,1,26,0
1482986017183473665,2022-01-17 07:59:53,Perkenalkan motor pertama di kelasnya yang mengusung nama hybrid. Berikut spesifikasi dari Yamaha Fazzio Hybrid Connected di Indonesia.  https://t.co/TNqP8er1dE,14,0,3,1,2022-01-17,7,Monday,1,17,1
1482985756796850178,2022-01-17 07:58:51,"Berkas kasus dugaan cabul Dekan FISIP Universitas Riau, Syafri Harto telah dilimpahkan ke Kejaksaan. Syafri Harto langsung ditahan. https://t.co/MqqyoVs4HA",21,0,5,1,2022-01-17,7,Monday,1,26,1
1482985243170996224,2022-01-17 07:56:49,Bosan makan nasi? Coba racik spaghetti aglio olio dengan paduan sosis dan cabe yang praktis ini. Diberi taburan keju parmesan rasanya selezat bikinan restoran.  https://t.co/OUMK0uJ2hD,3,0,1,0,2022-01-17,7,Monday,1,4,0
1482984998449909761,2022-01-17 07:55:50,Real Madrid sukses merebut Piala Super Spanyol 2021/2022. Madrid mengalahkan Athletic Bilbao 2-0. Ini reaksi netizen di linimasa:  https://t.co/1Nq9mAPahw,5,0,1,0,2022-01-17,7,Monday,1,6,0
1482984474254225408,2022-01-17 07:53:45,"""Buat apa saya ikut pemilu, yang berhak memilih kan saya. Ada 10 parpol yang baru, biarin (mencalonkan nama capres-red). Jangan dibatesin,"" kata Lieus Sungkharisma. https://t.co/Fvj0Sugj35",41,30,9,0,2022-01-17,7,Monday,1,50,30
1482984458248761344,2022-01-17 07:53:42,Kentang goreng menjadi camilan favorit banyak orang. Kentang goreng yang gurih lezat dan mengenyangkan ini ternyata memiliki efek buruk bagi kesehatan.  https://t.co/9way1lGsol,6,0,1,1,2022-01-17,7,Monday,1,7,1
1482983988826451968,2022-01-17 07:51:50,"Lakukan aksi mulia, TikToker ini dituduh hanya cari followers. Dirinya yang beri makanan untuk gelandangan justru menuai hujatan!  https://t.co/k0h6GxYvHK",6,0,0,1,2022-01-17,7,Monday,1,6,1
1482983968660238338,2022-01-17 07:51:45,Disebut jadi medan perang pertama lawan COVID-19 Omicron. lebih dari 90 persen kasus lokal dilaporkan di DKI Jakarta. Bagaimana situasinya? https://t.co/gmkRlJTFXJ,13,2,1,1,2022-01-17,7,Monday,1,14,3
1482983180202397696,2022-01-17 07:48:37,"Jadwal Liga 1 awal pekan ini menyuguhkan 7 pertandingan. Ada duel tim papan atas Bhayangkara FC vs Persebaya Surabaya, juga Borneo FC vs Persib Bandung. https://t.co/QF9Up44Wq9",7,3,1,0,2022-01-17,7,Monday,1,8,3
1482982955261825027,2022-01-17 07:47:43,Seorang barista asal Jepang bernama Kohei Matsuno terkenal sebagai master 3D latte art. Ia membuat kopi dengan latte art keren dan menggemaskan!  https://t.co/53dc8ZWzbj,33,1,2,1,2022-01-17,7,Monday,1,35,2
1482982930972651524,2022-01-17 07:47:37,AS Roma cuma menang 1-0 atas Cagliari meski punya sejumlah peluang untuk mencetak gol. Jose Mourinho menyadari masalah Roma yang kesulitan menghabisi lawan. https://t.co/06RcRHSc9Y,6,0,1,0,2022-01-17,7,Monday,1,7,0
1482982420794249217,2022-01-17 07:45:36,Penampilan Song Jia memakai seragam sekolah menuai pro kontra. Netizen khawatir sang influencer membuat imej negatif karena terlihat seksi. https://t.co/dBczACQi1o,9,0,0,0,2022-01-17,7,Monday,1,9,0
1482981919537221633,2022-01-17 07:43:36,"Drama di kubu Manchester United! Ralf Rangnick bilang Anthony Martial enggan masuk skuad di laga kontra Aston Villa, tapi sang pemain membantah! https://t.co/Qg1hCKAwxf",4,0,0,0,2022-01-17,7,Monday,1,4,0
1482981670483644417,2022-01-17 07:42:37,"Pada awal tahun 2022, aplikasi Gmail mencapai rekor baru yaitu 10 miliar unduhan di Google Play Store sejak pertama kali diluncurkan pada 1 April 2004. https://t.co/quW9Vm9nNl",9,0,1,0,2022-01-17,7,Monday,1,10,0
1482980927890505729,2022-01-17 07:39:40,"Badan Pusat Statistik (BPS) mencatat nilai ekspor Indonesia Desember 2021 mencapai US$ 22,38 miliar. Angka ini turun 2,04% dibandingkan periode November 2021.  https://t.co/iWFH67rv3v",9,0,1,0,2022-01-17,7,Monday,1,10,0
1482980688030846977,2022-01-17 07:38:43,Pemerintah menargetkan energi baru terbarukan (EBT) menjadi satu-satunya sumber energi di 2060. Sekarang kondisinya bagaimana?  https://t.co/Fa0ZiDtiha,12,0,3,0,2022-01-17,7,Monday,1,15,0
1482979939095830531,2022-01-17 07:35:44,Ada cara baru makan mie instan yakni digoreng garing. Ada miras non alkohol yang tak bisa dapat sertifikat halal serta wanita yang selalu memberi makan semut.  https://t.co/6pGi4DUzbc,11,2,2,0,2022-01-17,7,Monday,1,13,2
1482979669964206081,2022-01-17 07:34:40,Gibran menyebut masalah itu hanya salah paham belaka. Begini katanya: https://t.co/Ms0tB6ZDS7,5,1,0,3,2022-01-17,7,Monday,1,5,4
1482979419635519492,2022-01-17 07:33:40,"Agar masakan Jepang yang kita buat mirip seperti aslinya, kamu bisa menggunakan bumbu masakan Jepang. Ada beberapa bumbu yang sudah bersertifikat halal MUI.  https://t.co/hMEKD9VE2L",17,3,0,0,2022-01-17,7,Monday,1,17,3
1482979178261712896,2022-01-17 07:32:43,"Martin Shkreli, seorang mantan eksekutif perusahaan obat telah dilarang untuk bekerja di industri farmasi seumur hidup. Ini penyebabnya.  https://t.co/jskV956WCz",6,0,6,1,2022-01-17,7,Monday,1,12,1
1482978255774924800,2022-01-17 07:29:03,"""Mengapa kita bisa menurunkan, itu karena kita punya gotong royong, Pancasila ada disitu,"" kata Jokowi. https://t.co/P3DnJmElen",16,1,2,0,2022-01-17,7,Monday,1,18,1
1482977695160057856,2022-01-17 07:26:49,Pihak keluarga akhirnya berencana memindahkan korban ke sekolah lain. https://t.co/NwgmPyISRZ,9,2,4,0,2022-01-17,7,Monday,1,13,2
1482977489941143552,2022-01-17 07:26:00,Tren TikTok tak selamanya layak diikuti. Salah satu yang membahayakan adalah tren masak ayam dengan obat flu. Bahayanya bisa kematian!  https://t.co/UQHdDwJNra,4,4,1,1,2022-01-17,7,Monday,1,5,5
1482977177146728450,2022-01-17 07:24:46,Ada-ada saja kelakuan warga +62. Sifatnya yang suka FOMO membuat masyarakat Indonesia selalu terdepan dalam mengikuti tren terbaru!  https://t.co/6cBsqOybrk,7,1,2,2,2022-01-17,7,Monday,1,9,3
1482976962230505476,2022-01-17 07:23:54,STI E-RA adalah mobil listrik konsep yang punya tenaga 1.073 HP dan dibantu oleh motor listrik garapan Yamaha. https://t.co/QFKPlMTF1R,5,0,0,0,2022-01-17,7,Monday,1,5,0
1482976935110193152,2022-01-17 07:23:48,PT Bank Central Asia Tbk (BCA) membuka banyak lowongan kerja untuk fresh graduate maupun pekerja berpengalaman.  https://t.co/ud0tow6CDM,24,0,8,0,2022-01-17,7,Monday,1,32,0
1482976684928348161,2022-01-17 07:22:48,Jokowi menegaskan bahwa pemerintah akan terus melakukan hilirisasi industri dari sumber daya alam (SDA) Indonesia.  https://t.co/BdbPNavqeM,10,4,0,1,2022-01-17,7,Monday,1,10,5
1482976669401063428,2022-01-17 07:22:45,Nama Nusantara sebagai ibu kota baru mendapat masukan dari anggota Pansus DPR RI. Nama itu juga disebut bisa multitafsir jika digabungkan dengan IKN baru.  https://t.co/sud5xsxQYW,27,5,10,5,2022-01-17,7,Monday,1,37,10
1482976413003259906,2022-01-17 07:21:43,"""Karena kalau saudara jujur dalam memberikan keterangan maka itu akan menjadi variabel yang dapat menjadi pertimbangan meringankan saudara,"" ujar hakim. https://t.co/yZP3mY5HZC",7,0,3,3,2022-01-17,7,Monday,1,10,3
1482976393524822018,2022-01-17 07:21:39,Proyek Kereta Cepat Jakarta-Bandung menemui tantangan berupa tanah lempung di lokasi proyek. Begini kondisinya.  https://t.co/GlaGKvpN4E,5,0,1,0,2022-01-17,7,Monday,1,6,0
1482976130118397952,2022-01-17 07:20:36,Menteri PPN/Kepala Bappenas Suharso Monoarfa mengatakan ibu kota negara (IKN) di Kalimantan Timur dinamakan Nusantara.   https://t.co/5dhFClF3WT,12,4,0,1,2022-01-17,7,Monday,1,12,5
1482976118042939393,2022-01-17 07:20:33,"Sebelum akhirnya Nusantara dipilih Jokowi untuk nama IKN baru, ada 80-an nama lain yang telah diusulkan Suharso setelah konsultasi dengan para ahli bahasa.  https://t.co/TvpG7qMKI0",7,2,1,1,2022-01-17,7,Monday,1,8,3
1482975891198287872,2022-01-17 07:19:39,"Badan Pusat Statistik (BPS) mencatat jumlah penduduk miskin di Indonesia mencapai 26,5 juta per September 2021  https://t.co/vDvh6u4w61",5,2,2,1,2022-01-17,7,Monday,1,7,3
1482975365748473863,2022-01-17 07:17:34,"Marvel Comics dan Webtoon memutuskan untuk berkolaborasi dalam beberapa serial komiknya sejak tahun lalu. Menyambut 2022, serial baru Eternals diumumkan. https://t.co/hTG4I4cCiN",7,0,1,0,2022-01-17,7,Monday,1,8,0
1482975344688836611,2022-01-17 07:17:29,Banyak yang kaget dengan video 61 detik yang mirip dengan Nagita Slavina. Sebagian yakin bahwa video itu adalah bukti deepfake yang semakin merajalela. https://t.co/CmQN8sQpmI,4,0,0,0,2022-01-17,7,Monday,1,4,0
1482975081676644352,2022-01-17 07:16:26,Jokowi mengungkapkan kriteria ibu kota negara (IKN) baru yang dia idam-idamkan.  https://t.co/Gvvblr2UXI,5,2,1,0,2022-01-17,7,Monday,1,6,2
1482974826860281863,2022-01-17 07:15:25,"Bendungan Bintang Bano di Sumbawa Barat, NTB, telah diresmikan pada Jumat (14/1) lalu. Bendungan ini adalah yang terbesar dari sisi kapasitas tampungnya di NTB.  https://t.co/3bye6UjKKm",15,2,4,2,2022-01-17,7,Monday,1,19,4
1482974825463308289,2022-01-17 07:15:25,Dude Harlino was-was anak sekolah lagi di tengah pandemi. Ia harap prokes tetap dijaga. https://t.co/D6FLWLtuE6,3,0,0,0,2022-01-17,7,Monday,1,3,0
1482974309949878273,2022-01-17 07:13:22,Nama Nusantara sebagai IKN baru merupakan perintah Jokowi. https://t.co/kabDfnzC8G,55,12,13,4,2022-01-17,7,Monday,1,68,16
1482974308725145601,2022-01-17 07:13:22,Sule meminta pertanggungjawaban Reza Rahadian atas perubahan sikap Nathalie Holscher. Lho kok...  https://t.co/BnoJ96W4kk,9,2,0,0,2022-01-17,7,Monday,1,9,2
1482973676173672448,2022-01-17 07:10:51,"Penerima vaksin Sinovac bisa dapat booster apa? Bisa pilih merek? BPOM baru saja menambah daftar kombinasi, simak aturan terbarunya di sini: https://t.co/RKrkabNbgY",11,0,2,0,2022-01-17,7,Monday,1,13,0
1482973657467076608,2022-01-17 07:10:46,"Menteri Agama (Menag), Yaqut Cholil Qoumas mengatakan penyelenggaraan ibadah haji tahun 1443 H/2022 belum dapat dipastikan. Lantaran masih belum adanya izin dari Pemerintah Arab Saudi. https://t.co/Kmi4GuzSct",7,1,0,0,2022-01-17,7,Monday,1,7,1
1482972897681588224,2022-01-17 07:07:45,Serundeng daging ini dibuat dari daging sapi dan kelapa yang disangrai hingga kering. Rasanya empuk dengan rasa gurih manis dan aromanya harum.  https://t.co/mSTSP5xIm4,12,1,0,0,2022-01-17,7,Monday,1,12,1
1482972152471203843,2022-01-17 07:04:48,"Yoo Ah In sebelumnya sukses membintangi drama Korea berjudul Hellbound. Kini, sang aktor siap kembali lewat drama Goodbye Earth. https://t.co/wOgZtoc1Zq",3,0,0,0,2022-01-17,7,Monday,1,3,0
1482972134305632256,2022-01-17 07:04:43,Bangka Belitung dan Kalimantan digadang-gadang sebagai lokasi pembangunan pembangkit listrik tenaga nuklir (PLTN). Seperti apa progresnya?  https://t.co/HTxs0aosed,10,1,3,3,2022-01-17,7,Monday,1,13,4
1482971639499444225,2022-01-17 07:02:45,Anies Baswedan melakukan pemantauan kesiapan Jakarta International Stadium. Ia memuji saat grup band Nidji melakukan check sound. https://t.co/E9ENa6S6l4,34,8,4,3,2022-01-17,7,Monday,1,38,11
1482971067245334529,2022-01-17 07:00:29,"""Hasil koordinasi dengan Siber Polda Metro Jaya video itu fake alias palsu, hasil editing,"" kata Kasat Reskrim Polres Metro Jakarta Pusat AKBP Wisnu Wardhana. #CNNIndonesia #detiknetwork  https://t.co/KJKKy9M6Le",2,2,2,0,2022-01-17,7,Monday,1,4,2
1482970504499769346,2022-01-17 06:58:15,"Agnez Mo tampil menghiasi majalah Amerika Serikat, Composure. Penyanyi yang go international itu bahkan didaulat jadi model sampulnya. Keren! https://t.co/kKYuqRrPrN",162,6,54,2,2022-01-17,6,Monday,1,216,8
1482969981713362944,2022-01-17 06:56:10,"Pada akhir pekan lalu, Marc Marquez mengikuti ajang trackday di Sirkuit Portimao, Portugal, dengan membesut RC213V-S. https://t.co/Gm26sDzVm3",6,0,3,0,2022-01-17,6,Monday,1,9,0
1482969512366456833,2022-01-17 06:54:18,Presiden Jokowi menghadiri Dies Natalis ke-67 Universitas Katolik Parahyangan. Saat memberikan sambutan Ketua Pelaksana Kegiatan sekaligus Ketua IKA Unpar Ivan Petrus Sadik mengusulkan Jokowi bikin kuis berhadiah sepeda di acara tersebut. https://t.co/bBz3zY9BYt,11,0,1,0,2022-01-17,6,Monday,1,12,0
1482969489650110464,2022-01-17 06:54:13,"Beberapa waktu lalu, Darius Sinathrya jadi sorotan di media sosial. Hal itu dikarenakan dirinya yang mencari-cari sang istri, Donna Agnesia. https://t.co/2KZRzVH8CR",6,0,1,1,2022-01-17,6,Monday,1,7,1
1482968945787351042,2022-01-17 06:52:03,Ade Fitrie Kirana pantau kasus pemerkosa 13 santriwati. Ia dukung tuntutan hukuman mati. https://t.co/mv5NXop169,14,1,4,0,2022-01-17,6,Monday,1,18,1
1482968923830169601,2022-01-17 06:51:58,Baru-baru ini para ilmuwan menemukan jutaan sarang ikan aneh di laut Weddel di Antartika. Sarang itu milik ikan bertengkorak transparan yang masuk dalam spesies icefish atau Neopagetopsis ionah. https://t.co/L7zPtP94oH,6,0,3,0,2022-01-17,6,Monday,1,9,0
1482968035245936640,2022-01-17 06:48:26,Johnston yang merupakan pengusaha kripto ini pindah karena Puerto Rico sangat ramah dengan bitcoin cs.  https://t.co/PL4Tbdy6oq,7,0,0,0,2022-01-17,6,Monday,1,7,0
1482967511658336256,2022-01-17 06:46:21,Viral seorang pasien anak di Makassar tewas dalam perjalanan karena ambulans yang mengantarnya tak diberi jalan. Polisi turun tangan untuk mendalami kasus ini. https://t.co/nfZoMxhvhd,19,10,2,0,2022-01-17,6,Monday,1,21,10
1482967005712068608,2022-01-17 06:44:21,"""Itu kan harusnya ke rumah sakit terdekat dengan melihat kondisi korban,"" kata Dirlantas Polda Sulsel Kombes Faisal. https://t.co/F5cLzaSqUm",11,4,0,0,2022-01-17,6,Monday,1,11,4
1482966991107506176,2022-01-17 06:44:17,"Berikut profil Ka Bais, Letjen Joni Supriyanto, yang diajak ngobrol serius dengan Jokowi pagi tadi! https://t.co/DjKPbyx9os",5,0,0,0,2022-01-17,6,Monday,1,5,0
1482966515125264384,2022-01-17 06:42:24,"Pemerintah terus memperbaharui syarat penerbangan domestik di bulan Januari 2022. Traveler yang mau terbang, harap cek syarat-syarat terbaru berikut ya! https://t.co/7hpro8bPeT",10,2,5,0,2022-01-17,6,Monday,1,15,2
1482965688012742658,2022-01-17 06:39:06,Di Garut ada wahana bermain river tubing baru yang belum banyak dikunjungi wisatawan. Pemerintah bersiap menyulap jadi objek wisata alam yang komplit. Wih! https://t.co/OtePdAcJPg,7,2,0,0,2022-01-17,6,Monday,1,7,2
1482964161508356097,2022-01-17 06:33:02,Tagar #HarunaOut menggema di Twitter. Nama anggota Komisi Eksekutif PSSI itu ramai dibicarakan lantaran komentarnya dalam sebuah podcast. PSSI pun angkat bicara. https://t.co/HGU62mjfcM,11,3,5,0,2022-01-17,6,Monday,1,16,3
1482963941445840896,2022-01-17 06:32:10,"Banyak orang memuji ketulusan dan kasih sayang wanita ini pada anak TKW yang dirawatnya sejak usia dua bulan karena ditinggal ibunya. Menyentuh, ini kisahnya. https://t.co/PgF9FU7Kb9",93,9,9,3,2022-01-17,6,Monday,1,102,12
1482963369816727553,2022-01-17 06:29:54,"Manchester City mencatatkan 12 kemenangan beruntun di Liga Inggris. Manajer Manchester City, Pep Guardiola pun merendah dengan mengatakan timnya tidak mungkin memenangkan semua laga. https://t.co/NNU052aabT",5,0,0,1,2022-01-17,6,Monday,1,5,1
1482962895533219841,2022-01-17 06:28:01,"Pelaku pembakaran rumah wartawan harian Serambi Indonesia di Aceh Tenggara, Asnawi Luwi, diduga oknum TNI. Kodam Iskandar Muda bakal mengusut tuntas kasus itu. https://t.co/gILMzUZMmt",3,1,2,0,2022-01-17,6,Monday,1,5,1
1482962345349558273,2022-01-17 06:25:49,"Jokowi mengakui bahwa saat ini merupakan saat-saat yang sulit, bukan hanya di Indonesia tapi juga di seluruh dunia.  https://t.co/CsFxwmwSD0",11,5,0,3,2022-01-17,6,Monday,1,11,8
1482962339536252929,2022-01-17 06:25:48,"Warga pesisir Selandia Baru terkena dampak erupsi gunung api bawah laut di Tonga, Hunga Tonga-Hunga Haapai. Mereka berlarian karena tiba-tiba ada tsunami, seraya melihat kapal mereka dihantam air. https://t.co/DqNeWNE9X3",4,0,3,0,2022-01-17,6,Monday,1,7,0
1482961627498561538,2022-01-17 06:22:58,"PSSI mengomentari kegaduhan tagar #HarunaOut. Federasi sepakbola tanah air menyebut bahwa komentar anggota Exco PSSI, Haruna Soemitro, pandangan pribadi. https://t.co/s2eZmkIn6S",10,4,1,0,2022-01-17,6,Monday,1,11,4
1482961604119515136,2022-01-17 06:22:53,Menteri PPN/Kepala Bappenas Suharso Monoarfa mengatakan ibu kota negara (IKN) di Kalimantan Timur dinamakan Nusantara.  https://t.co/VR4RqZNSEZ,51,16,13,8,2022-01-17,6,Monday,1,64,24
1482961251932200963,2022-01-17 06:21:29,Snack gambar Kaesang itu ditarik dan diganti dengan kemasan standar. Simak penjelasannya: https://t.co/9ZyIzZxjRo,5,1,1,2,2022-01-17,6,Monday,1,6,3
1482961001033121795,2022-01-17 06:20:29,Ketidakpahaman penduduk terhadap pentingnya melindungi data diri dan pribadi menjadi isu penting yang harus disikapi bersama-sama oleh semua pihak.  https://t.co/KABp4Nymux,6,0,2,1,2022-01-17,6,Monday,1,8,1
1482960999808442372,2022-01-17 06:20:29,"BPOM memperbarui kombinasi vaksin COVID-19 booster bagi masyarakat umum 18 tahun ke atas. Divaksin Sinovac dan AstraZeneca, kini bisa dapat apa saja? https://t.co/kBRwEalQjT",8,1,2,0,2022-01-17,6,Monday,1,10,1
1482960186709057536,2022-01-17 06:17:15,"Gaikindo telah mengeluarkan data terbaru penjualan mobil tahun 2021. Dari barisan mobil listrik, siapa yang jadi juara di Indonesia? https://t.co/XRsVf7rvH8",8,0,2,0,2022-01-17,6,Monday,1,10,0
1482959628199735297,2022-01-17 06:15:02,"""Jemaah haji yang diberangkatkan pada 1443H/2022M adalah jemaah haji yang berhak berangkat pada tahun 1441H/2020M,"" kata Yaqut. https://t.co/EhoY2bUKGQ",5,2,1,0,2022-01-17,6,Monday,1,6,2
1482959126732881921,2022-01-17 06:13:02,"Terakhir hari ini! Sanggah kuota SNMPTN 2022 hanya berlangsung sampai Senin, 17 Januari 2022. LTMPT sampaikan caranya yang benar seperti ini.

via: detikedu https://t.co/OMTusRu8T8",2,0,0,0,2022-01-17,6,Monday,1,2,0
1482958116895567879,2022-01-17 06:09:01,Anies Baswedan menonton Nidji tanpa suara sumbang di Jakarta International Stadium. Begini respons PSI yang kini dipimpin Giring Ganesha. https://t.co/IuLZEyBxuh,42,32,5,7,2022-01-17,6,Monday,1,47,39
1482957594390106114,2022-01-17 06:06:57,Peneliti Administrasi Kelautan dan Atmosfer Nasional AS (NOAA) dan NASA menyebut tahun 2021 menduduki peringkat keenam sebagai tahun terpanas sepanjang sejarah. Ini penjelasannya: https://t.co/RisIe3zbZC,3,1,1,1,2022-01-17,6,Monday,1,4,2
1482957103098736643,2022-01-17 06:05:00,"Panti pijat plus-plus di Sawangan, Depok tidak memiliki ijin. Wakil Wali Kota Depok Imam Budi Hartono memerintahkan panti pijat itu ditutup. https://t.co/NIIkbCCOr9",7,2,0,0,2022-01-17,6,Monday,1,7,2
1482956853206257667,2022-01-17 06:04:00,Menkes Budi Gunadi Sadikin menyampaikan terkait prediksi puncak kasus Omicron di Indonesia berdasarkan kejadian di negara lain. https://t.co/DfBneqn1YZ,1,0,1,1,2022-01-17,6,Monday,1,2,1
1482956371414953987,2022-01-17 06:02:05,"Irwansyah tiba-tiba mengungkapkan permintaan maafnya kepada sang istri, Zaskia Sungkar. https://t.co/fH0uzpEODw",5,0,0,0,2022-01-17,6,Monday,1,5,0
1482956042615013376,2022-01-17 06:00:47,Posting-an Presiden Jokowi di Twitter soal sirkuit Mandalika ramai dibahas. Unggahan itu kemudian dihapus setelah netizen mengoreksi. https://t.co/ACpzGmLA4i,102,54,22,17,2022-01-17,6,Monday,1,124,71
1482956031491813378,2022-01-17 06:00:44,Alex Song bercerita tentang transfernya dari Arsenal ke Barcelona pada 2012 silam. Semua karena uang! https://t.co/KRqTorjn90,4,0,0,0,2022-01-17,6,Monday,1,4,0
1482955263577665536,2022-01-17 05:57:41,"Zaskia Sungkar dan Irwansyah bicara soal kasus penggelapan aset yang dilakukan adiknya, Hafiz Fatur. Keduanya ngaku berbesar hati menerima kenyataan itu.  https://t.co/iIr4Aylnri",13,0,1,0,2022-01-17,5,Monday,1,14,0
1482954513648660485,2022-01-17 05:54:42,"Kedatangan Doddy Sudrajat untuk mengajak Gala Sky jalan-jalan, Minggu (16/1) pagi, membuat H. Faisal kaget. Alasan H. Faisal tak memberikan izin ke Doddy lantaran ia takut sesuatu yang tak diharapkan terjadi. https://t.co/MVgjYhHY6l",10,4,0,0,2022-01-17,5,Monday,1,10,4
1482953439349035008,2022-01-17 05:50:26,Debut manis Sergio Oliveira yang langsung mencetak gol saat AS Roma menang 1-0 atas Cagliari di lanjutan Liga Italia. https://t.co/2pI8GuKBJO,6,0,0,1,2022-01-17,5,Monday,1,6,1
1482952710160855041,2022-01-17 05:47:32,"Kawanan kerbau membuat kendaraan di Jalur Trans Sulawesi, Desa Tandung, Kecamatan Tinambung, terhambat pada Minggu (16/01) sore. Kondisi ini terjadi pada pagi hari dan sore saat kawanan kerbau ini berangkat mencari makan dan pulang. https://t.co/tFS6ALn8mY",9,1,0,0,2022-01-17,5,Monday,1,9,1
1482952201135968257,2022-01-17 05:45:31,"Pernyataan Anggota Exco PSSI Haruna Soemitro bikin geram netizen. Tagar #HarunaOut menggema, di saat bersamaan #SaveSTY juga trending topic di lini masa. https://t.co/PtLQlsORTH",33,6,6,2,2022-01-17,5,Monday,1,39,8
1482951946281570304,2022-01-17 05:44:30,"Pertemuan antara Doddy Sudrajat dengan orang tua Bibi, H. Faisal kembali terjadi, Minggu (16/1) pagi. Keduanya pun lagi-lagi mengisyaratkan perdamaian. https://t.co/FjEhjTX9cH",6,3,0,1,2022-01-17,5,Monday,1,6,4
1482951423482634240,2022-01-17 05:42:25,"Lewandowski, Messi, dan Mohamed Salah akan berebut titel Pemain Terbaik FIFA 2021 malam ini waktu Zurich, Swiss. Siapa yang terbaik? https://t.co/rfMjfUMrRH",5,1,0,0,2022-01-17,5,Monday,1,5,1
1482949427203817472,2022-01-17 05:34:29,"Tak mudah jalani sulitnya hidup seperti Mak Unah. Tinggal di rumah papan ukuran 3x3 meter milik tetangga, yang menyatu dengan kandang ayam.

Ayo bantu Mak Unah lewat platform @berbuatbaik_id agar memiliki hidup layak atau klik https://t.co/kjwGpSkS0P. Donasimu 100% tersalurkan! https://t.co/4dL2ogxnQ3",10,1,3,0,2022-01-17,5,Monday,1,13,1
1482949261683838980,2022-01-17 05:33:50,"Gong Yoo beberapa waktu lalu diincar membintangi drama Korea Devil. Namun, sang aktor harus menolak tawaran tersebut. #GongYoo  https://t.co/DLNEScXx4h",9,0,0,0,2022-01-17,5,Monday,1,9,0
1482947688123584515,2022-01-17 05:27:35,Sebanyak 500 ribu Pegawai Negeri Sipil (PNS) kementerian dan lembaga (K/L) akan dipindah terlebih dulu ke ibu kota negara (IKN) baru di Kalimantan Timur.  https://t.co/ql827sA2Mx,319,125,137,241,2022-01-17,5,Monday,1,456,366
1482947250049458176,2022-01-17 05:25:50,"Sangat berdampak fatal terhadap mesin, jika kendaraan yang tetap digunakan dalam kondisi oli yang buruk. https://t.co/YPQtiCRafT",6,0,0,0,2022-01-17,5,Monday,1,6,0
1482946697445662721,2022-01-17 05:23:39,Ardhito Pramono berharap rehabilitasi di kasus narkoba. Apa jawaban polisi? https://t.co/oS0XOlYVJz,15,6,1,2,2022-01-17,5,Monday,1,16,8
1482945938289266723,2022-01-17 05:20:38,Juventus ingin mengubah proposal kontrak baru untuk Paulo Dybala. Apakah Dybala akan pergi secara gratis akhir musim nanti? https://t.co/EJqdPwPL5g,5,1,2,2,2022-01-17,5,Monday,1,7,3
1482944632963190787,2022-01-17 05:15:26,Dominasi bitcoin sebagai alat pembayaran mulai menurun. Ini sebabnya.  https://t.co/zxGKnMGiNs,8,0,1,0,2022-01-17,5,Monday,1,9,0
1482943898997731329,2022-01-17 05:12:31,Sebuah hal mengejutkan disampaikan Erika Carlina. Ia mengaku didekati oleh Charlie Puth.  https://t.co/GrwjCOPByy,13,0,0,1,2022-01-17,5,Monday,1,13,1
1482943628309938179,2022-01-17 05:11:27,"Nagita Slavina diterpa isu video 61 detik yang diduga mirip dirinya. Mengenai hal itu, Nagita Slavina tak mau banyak memikirkannya. https://t.co/ozKc7UNsKo",4,0,0,1,2022-01-17,5,Monday,1,4,1
1482943341516005378,2022-01-17 05:10:19,"Kedatangan Jeanneta Sanfadelia jenguk Ardhito Pramono, awalnya dikira adalah kekasih sang musisi. Kabarnya, Jeanneta dan Ardhito sudah menikah. Ini momen kebersamaan mereka:  https://t.co/tgNCO3Oq96",5,0,1,1,2022-01-17,5,Monday,1,6,1
1482942701880422400,2022-01-17 05:07:46,Medina Zein menyiapkan langkah hukum atas status tersangka di kasus pencemaran nama baik. Medina Zein akan mengajukan praperadilan. https://t.co/HrMtc8LjC4,1,0,0,0,2022-01-17,5,Monday,1,1,0
1482941705309544450,2022-01-17 05:03:48,"Keren! Lagi dan lagi, Agnez Mo bikin bangga Indonesia. Kali ini Agnez Mo mejeng di sampul majalah ternama AS. Ini potretnya:  https://t.co/diK28pWRM3",168,8,60,0,2022-01-17,5,Monday,1,228,8
1482941169717891077,2022-01-17 05:01:41,Real Madrid menang 2-0 atas Athletic Bilbao untuk menjuarai Piala Super Spanyol 2022. Ini adalah trofi Piala Super ke-12 El Real. https://t.co/WRQTJf4Hsj,6,0,0,0,2022-01-17,5,Monday,1,6,0
1482940890884808705,2022-01-17 05:00:34,"Chinese food jadi favorit orang Indonesia. Kalau mau cicip yang enak, lima tempat makan Chinese food yang punya rating tinggi di ojol ini layak dicoba.  https://t.co/Mj06N4XTBF",8,0,2,0,2022-01-17,5,Monday,1,10,0
1482940872647974912,2022-01-17 05:00:30,Akhirnya! Rentetan gol Inter Milan yang berjalan selama setahun akhirnya terhenti juga. Usai imbang tanpa gol saat melawan Atalanta. https://t.co/Pc7aBFX7Xj,2,0,0,0,2022-01-17,5,Monday,1,2,0
1482940623611125761,2022-01-17 04:59:31,"Manis! Dihari ulang tahunnya, Minamino turut menyumbang satu gol dan memberikan kemenangan untuk Liverpool. https://t.co/k0ZtZ5jg5K",10,0,2,0,2022-01-17,4,Monday,1,12,0
1482940000442499076,2022-01-17 04:57:02,"BPS mencatatkan kinerja ekspor pada Desember melemah secara bulanan. Meski begitu, ekspor masih tumbuh secara tahunan.  https://t.co/gyZ20T6mcn",5,0,0,0,2022-01-17,4,Monday,1,5,0
1482939695550058496,2022-01-17 04:55:49,"Gempa 17 Januari 2022 pagi tadi mengguncang Banten, Jawa Barat. Gempa tersebut dikonfirmasi oleh BMKG bermagnitudo 5.4. https://t.co/nDaOjzKtqK",12,1,4,1,2022-01-17,4,Monday,1,16,2
1482939667263672327,2022-01-17 04:55:43,"Sering dianggap sebagai menu yang sehat, telur ternyata dikatakan peneliti dapat menyebabkan kanker. Begini penjelasannya.  https://t.co/DaZ5mYFXoa",8,0,0,0,2022-01-17,4,Monday,1,8,0
1482938932472037378,2022-01-17 04:52:47,Hyundai Staria juga dipasarkan dalam versi kendaraan niaga. Apakah model ini bakal dipasarkan di Indonesia? https://t.co/pPwlLLH2wL,3,0,0,0,2022-01-17,4,Monday,1,3,0
1482938670772625408,2022-01-17 04:51:45,"Bank Indonesia mencatat Utang Luar Negeri (ULN) Indonesia pada November 2021 tercatat sebesar US$ 416,4 miliar atau sekitar Rp 5.954 triliun.  https://t.co/fTCr8H71Lq",10,0,2,3,2022-01-17,4,Monday,1,12,3
1482938134329450503,2022-01-17 04:49:37,Hendra Setiawan/Mohammad Ahsan harus puas dengan hasil runner up di India Open 2022. Mereka mengaku sulit mengantisipasi serangan lawan. https://t.co/hI5BdJ1210,8,0,0,0,2022-01-17,4,Monday,1,8,0
1482937345305452547,2022-01-17 04:46:29,"Chelsea didesak kembali konsisten, dimulai dengan Brighton. Cesar Azpilicueta mengakui kalau Manchester City sulit dikejar. https://t.co/3eUGLTo5K2",3,0,0,0,2022-01-17,4,Monday,1,3,0
1482937058830213123,2022-01-17 04:45:21,Pemerintah bakal membangun pembangkit listrik tenaga nuklir (PLTN). Ini penjelasannya.   https://t.co/1lfW0CAgZc,10,9,3,1,2022-01-17,4,Monday,1,13,10
1482937037527334912,2022-01-17 04:45:16,"Perusahaan manager investasi terbesar dunia, BlackRock mencatat mengelola US$ 10 triliun atau setara Rp 143.210 triliun (kurs Rp 14.321) sepanjang 2021.  https://t.co/yVSJHLnBTV",6,0,1,1,2022-01-17,4,Monday,1,7,1
1482936567295586304,2022-01-17 04:43:23,Jokowi telah menyetujui perpanjangan diskon PPnBM untuk pembelian mobil baru. Ini harga terbarunya!   https://t.co/KDN2NGlK4K,3,2,0,2,2022-01-17,4,Monday,1,3,4
1482936551306842112,2022-01-17 04:43:20,"Kemenkes mengeluarkan keputusan baru terkait penggunaan vaksin jenis Sinovac. Kini, vaksin tersebut hanya diberikan pada kelompok usia anak 6-11 tahun. https://t.co/oMrQyXC9lS",14,0,2,0,2022-01-17,4,Monday,1,16,0
1482935986120187904,2022-01-17 04:41:05,Jokowi dijadwalkan meninjau proyek Kereta Cepat Jakarta-Bandung di Kabupaten Purwakarta hari ini.  https://t.co/6byGoRvhDm,11,1,1,0,2022-01-17,4,Monday,1,12,1
1482935702606295040,2022-01-17 04:39:57,"UNDIP mengumumkan kuota yang akan diterima tahun ini, termasuk di jalur SNMPTN 2022. Cek juga prodi apa yang paling diminati. Buruan cek nih!

via: detikedu https://t.co/2MQmwCPVxk",7,1,2,0,2022-01-17,4,Monday,1,9,1
1482935685959008258,2022-01-17 04:39:53,"Harga minyak goreng yang tinggi membuat kalangan ibu-ibu kewalahan. Mereka bahkan rela menunggu berjam-jam operasi pasar murah di Pasar Pelita, Sukabumi.  https://t.co/Rn3cgahvkT",8,2,2,2,2022-01-17,4,Monday,1,10,4
1482934890190495753,2022-01-17 04:36:44,"Kini, Honda Thailand mulai memasarkan New PCX160 Endless Sport Edition. https://t.co/xTuR4ZKvrF",4,0,2,0,2022-01-17,4,Monday,1,6,0
1482934612846419973,2022-01-17 04:35:37,Harga emas hari ini turun lagi. Harga emas Antam 24 karat hari ini turun Rp 1.000 per gram menjadi Rp 937.000 per gram.  https://t.co/3p6FJ2BbBD,6,0,0,0,2022-01-17,4,Monday,1,6,0
1482934339923058689,2022-01-17 04:34:32,"Anggota Komite Eksekutif PSSI, Haruna Soemitro, memberi pandangan mengenai pelatih Timnas Indonesia, Shin Tae-yong. Komentar itu berujung tagar #HarunaOut. https://t.co/qFbjvhRzVy",22,24,4,4,2022-01-17,4,Monday,1,26,28
1482934324550897665,2022-01-17 04:34:29,"Nilai tukar dolar Amerika Serikat (AS) pagi ini menguat terhadap rupiah. Mata uang Paman Sam aik 34 poin (0,24%) ke level Rp 14.321.  https://t.co/LRhWo6S0FD",5,1,1,0,2022-01-17,4,Monday,1,6,1
1482933786677501959,2022-01-17 04:32:20,"Praveen Jordan/Melati Daeva Oktavianti digosipkan akan dicoret dari pelatnas PBSI. Lewat media sosialnya, ia memberikan sebuah 'kode'. https://t.co/dTL2pjlkc3",16,0,0,1,2022-01-17,4,Monday,1,16,1
1482931984326406144,2022-01-17 04:25:11,"#Foto Terlihat kuno nan usang dari luar, namun kamar hotelnya terbilang nyaman dengan pemandangan wahid. Ini potret dari Grand Inna Samudra Beach Sukabumi.  https://t.co/sIAQYCiqqt",14,1,3,2,2022-01-17,4,Monday,1,17,3
1482930971620126721,2022-01-17 04:21:09,"Indeks Harga Saham Gabungan (IHSG) hari ini dibuka menguat 18 poin (0,27%) ke level 6.711. Indeks LQ45 juga naik 2 poin (0,31%) ke level 955.  https://t.co/xfBSCL9jyK",4,0,0,0,2022-01-17,4,Monday,1,4,0
1482930965899096068,2022-01-17 04:21:08,"Vespa matic hadir dalam berbagai tipe di Indonesia. Namun di pasar Vespa matic bekas, tipe ini yang paling banyak diincar! https://t.co/jhcgIsHUBI",6,1,1,2,2022-01-17,4,Monday,1,7,3
1482930476172066818,2022-01-17 04:19:11,"Sempat terpapar Omicron, dr Faheem membeberkan jenis masker yang sebaiknya dipakai untuk menghindari paparan virus varian baru kategori mengkhawatirkan. https://t.co/uM8WdVGCa3",6,0,1,0,2022-01-17,4,Monday,1,7,0
1482929686569230338,2022-01-17 04:16:03,IHSG ditutup menguat didorong aksi bargain hunting investor yang mengabaikan kekhawatiran akan suku bunga the fed yang direncakan naik pada Maret 2022.  https://t.co/z87lYThPRE,1,0,1,0,2022-01-17,4,Monday,1,2,0
1482929685210308614,2022-01-17 04:16:03,"Penanganan gejala pasca-vaksin anak sepenuhnya tanggung jawab negara, termasuk soal biaya. https://t.co/t9QC6ZMcfe",34,7,14,2,2022-01-17,4,Monday,1,48,9
1482929185735823362,2022-01-17 04:14:04,Presiden Joko Widodo disebut telah menyetuji penambahan jumlah penonton MotoGP Mandalika yang akan diselenggarakan pada pertengahan Maret 2022.  https://t.co/bM1WLroAhE,10,0,3,1,2022-01-17,4,Monday,1,13,1
1482928614656073731,2022-01-17 04:11:47,Anies Baswedan memperlihatkan grup band Nidji melakukan check sound di Jakarta International Stadium. Ia pun memuji penampilan mereka. https://t.co/NzC15MOxV0,50,15,8,6,2022-01-17,4,Monday,1,58,21
1482928354789670916,2022-01-17 04:10:45,"Tim d'House Hunter detikcom langsung meluncur ke Dramaga, Bogor khusus untuk berburu rumah. Bisa buat tempat tinggal, hingga bisnis kosan. Simak nih!  https://t.co/G661hlsCQ6",10,0,2,0,2022-01-17,4,Monday,1,12,0
1482927861422043138,2022-01-17 04:08:48,Presiden Joko Widodo (Jokowi) menyetujui diskon PPnBM untuk mobil baru diperpanjang. https://t.co/2f57gBPvcL,7,0,1,0,2022-01-17,4,Monday,1,8,0
1482927321908748291,2022-01-17 04:06:39,Raksasa retail Walmart tampaknya secara diam-diam tengah mempersiapkan diri untuk berjualan di metaverse.  https://t.co/1z9QmXpXcG,2,0,2,1,2022-01-17,4,Monday,1,4,1
1482927041171410944,2022-01-17 04:05:32,Jimmy Donaldson (23) atau yang lebih akrab dikenal dengan MrBeast merupakan Youtuber dengan penghasilan paling tinggi di dunia pada 2021 versi Forbes!  https://t.co/8X0fDEDAfH,16,3,4,1,2022-01-17,4,Monday,1,20,4
1482926789882228748,2022-01-17 04:04:32,"Angka penjualan sepeda motor di pasar domestik naik sebesar 38%, menurut data dari AISI https://t.co/DEAthfykAV",5,0,2,0,2022-01-17,4,Monday,1,7,0
1482926297064038407,2022-01-17 04:02:35,"Setelah 1 jam lebih, petugas gabungan akhirnya bisa mengevakuasi korban turun dari tower SUTET setinggi 40 meter itu. Korban turun dalam kondisi tak sadarkan diri. https://t.co/JvH3nlPC3Z",4,1,1,0,2022-01-17,4,Monday,1,5,1
1482925956612431876,2022-01-17 04:01:14,"Setelah menikah selama 34 tahun, Chow Yun Fat dan istri memutuskan untuk tidak memiliki anak. Kira-kira apa alasannya, ya? Simak selengkapnya di sini, yuk! #detiknetwork  https://t.co/MZIp7069lS",6,1,1,0,2022-01-17,4,Monday,1,7,1
1482924929842569223,2022-01-17 03:57:09,Sejumlah siswa MTs Mathla'ul Anwar Kecamatan Sumur Pandeglang terpaksa belajar di tenda darurat. Ruang kelas mereka rusak parah. https://t.co/o8rxkW7576,3,0,1,0,2022-01-17,3,Monday,1,4,0
1482923925948534784,2022-01-17 03:53:09,"Kasus video syur 61 detik yang dinarasikan mirip artis Nagita Slavina berlanjut. Usai video itu dinyatakan palsu, pelapor kasus tersebut kini diperiksa. https://t.co/2BCvzyVas7",18,3,5,1,2022-01-17,3,Monday,1,23,4
1482923662898573314,2022-01-17 03:52:07,Canti Tachril kembali melahirkan karya terbarunya berjudul Sanubariku yang sudah dapat dinikmati di platform digital. https://t.co/jlpI2JoBDb,10,1,2,0,2022-01-17,3,Monday,1,12,1
1482922369052258306,2022-01-17 03:46:58,"Berita terpopuler sepekan dari dunia entertainment, ada fakta menarik di balik penangkapan Ardhito Pramon dan kabar pernikahan Vidi Aldiano. https://t.co/zFODYlMuwr",2,1,1,0,2022-01-17,3,Monday,1,3,1
1482921369696354307,2022-01-17 03:43:00,Marissya Icha bicara soal kedatangan Doddy Sudrajat ke kediaman Faisal. Ini kata Marissya Icha:  https://t.co/mkUyFTdhbr,4,0,1,0,2022-01-17,3,Monday,1,5,0
1482919616238268417,2022-01-17 03:36:02,"Mengakui Manchester City sulit disaingi, Andy Robertson hanya minta Liverpool meraih kemenangan sebanyak mungkin. https://t.co/FaOpkmPPSr",2,0,0,0,2022-01-17,3,Monday,1,2,0
1482919033196498948,2022-01-17 03:33:43,"Kasus positif Corona Indonesia tembus seribu kasus, jumlah pasien COVID-19 yang dirawat inap di Wisma Atlet nyaris menembus 3 ribu, ini laporannya: https://t.co/q3mkSEVO4j",10,2,10,0,2022-01-17,3,Monday,1,20,2
1482918783614439424,2022-01-17 03:32:43,Pemerintah tengah berupaya agar penyebaran kasus Covid-19 di Indonesia bisa lebih terkendali. Salah satu yang disorot pemerintah adalah kapasitas perkantoran.  https://t.co/Foq8jHv7b3,3,0,6,1,2022-01-17,3,Monday,1,9,1
1482917623390253059,2022-01-17 03:28:07,"Monyet digambarkan dengan kesukaannya yang selalu makan pisang, ini tak sepenuhnya benar. Ternyata monyet juga nggak boleh makan sembarangan. https://t.co/cGC9RvPScR",6,1,3,0,2022-01-17,3,Monday,1,9,1
1482917103548219392,2022-01-17 03:26:03,"Presiden Jokowi terlihat mengobrol bersama Letjen Joni Supriyanto sebelum bertolak ke Bandung, Jawa Barat. Apa yang dibahas keduanya? https://t.co/nCKUrfPCTi",4,0,0,3,2022-01-17,3,Monday,1,4,3
1482916355007463427,2022-01-17 03:23:04,"SNMPN 2022 telah dibuka. Berikut informasi untuk alur pendaftaran, persyaratan umum, beserta jadwalnya. Simak ya! #SNMPN2022

via: detikedu https://t.co/14hZH9WcV7",5,0,2,0,2022-01-17,3,Monday,1,7,0
1482915843231330305,2022-01-17 03:21:02,"Bila awalnya tarif KRL untuk 25 km pertama hanya Rp 3.000, rencananya akan dinaikkan menjadi Rp 5.000.

Apabila ternyata diputuskan untuk naik, detikers setuju nggak nih? Jangan lupa sertakan alasannya ya.",7,8,3,3,2022-01-17,3,Monday,1,10,11
1482915774801100803,2022-01-17 03:20:46,Rafael Benitez resmi dipecat Everton. Berikut kandidat pengganti pelatih asal Spanyol tersebut! https://t.co/d0o0lCtSsV,6,0,0,0,2022-01-17,3,Monday,1,6,0
1482915275758579714,2022-01-17 03:18:47,"Tahukah detikers jika ada beberapa artis Korea yang mengambil jurusan teknik loh semasa kuliah. Kira-kira siapa saja ya?

via: detikedu https://t.co/qY3BGRDlFX",2,0,3,1,2022-01-17,3,Monday,1,5,1
1482914291389018126,2022-01-17 03:14:52,Jumlah guru dan siswa di Jakarta yang dilaporkan positif COVID-19 terus bertambah. https://t.co/MKTyyhfdYF,31,14,20,8,2022-01-17,3,Monday,1,51,22
1482913201956306947,2022-01-17 03:10:33,"Komnas Perlindungan Anak siap menjadi saksi untuk sidang perwalian Gala Sky. Mendapat dukungan tersebut, H. Faisal kian optimis akan memenangkan perwalian dan hak asuh cucunya tersebut. https://t.co/At7GpFdcKr",14,4,3,0,2022-01-17,3,Monday,1,17,4
1482912468984905754,2022-01-17 03:07:38,Hartono (38 tahun) merupakan penyandang tunarungu yang berjuang menafkahi keluarganya di Kota Bandung dengan menjadi pengemudi ojek online (ojol). Ini sosoknya: https://t.co/VfpoeC6Hna,25,4,10,0,2022-01-17,3,Monday,1,35,4
1482911477602430982,2022-01-17 03:03:42,Kisah cinta beda usia ini viral pasalnya ketika jalan berdua di mall pasutri ini  sering dikira ayah dan anak. Seperti apa ya kisahnya? https://t.co/fpPBz3RFQ7,7,4,3,1,2022-01-17,3,Monday,1,10,5
1482910728797499398,2022-01-17 03:00:43,Anies turut meninjau perkembangan pembangunan JIS dan memuji aksi panggung Nidji. Menurut Anies lagu yang dibawakan Nidji tak terdengar sumbang. https://t.co/3Lprz6bKq7,473,140,79,79,2022-01-17,3,Monday,1,552,219
1482910478661787649,2022-01-17 02:59:43,"Bermain bersama monyet-monyet liar, Monkey Forest punya peraturan terkait keamanan wisatawan. Ini beberapa hal yang dilarang saat liburan ke sana: https://t.co/oOd5WQ5m9B",4,0,1,0,2022-01-17,2,Monday,1,5,0
1482909740242018304,2022-01-17 02:56:47,"Kehadiran Doddy Sudrajat di kediaman Faisal hanya untuk mengajak cucunya, Gala Sky jalan-jalan. Namun sayangnya Gala masih tidur. https://t.co/nTW11ws1HR",4,0,1,0,2022-01-17,2,Monday,1,5,0
1482909261768364033,2022-01-17 02:54:53,Jasad seorang guru ngaji ditemukan masih utuh setelah dikuburkan lebih dari 17 tahun lamanya. Jasad tersebut diketahui utuh ketika makamnya hendak dipindahkan agar tidak berdekatan dengan kandang domba. https://t.co/qz8g05VpPq,153,13,26,1,2022-01-17,2,Monday,1,179,14
1482908446970331136,2022-01-17 02:51:39,Mendapatkan poin penuh saat melawan Brentford. Menjadi tanda The Reds belum menyerah mengejar Manchester City di puncak Premier League. https://t.co/GpW4HSq8Of,7,1,0,0,2022-01-17,2,Monday,1,7,1
1482907679278481409,2022-01-17 02:48:36,Real Madrid juarai Supercopa de Espana 2021/22 usai mengalahkan Athletic Bilbao dengan skor 2-0 dalam duel final.  https://t.co/Vb8wpDZHcE,9,1,0,0,2022-01-17,2,Monday,1,9,1
1482907185197850625,2022-01-17 02:46:38,"#Terpopuler Mahasiswa Fispol Unsrat, Manado, Sulut, Mineshia Lesawengen mengungkap pengalaman bisa lulus kuliah tanpa skripsi. Seperti apa ceritanya? https://t.co/nkS5x4kZap",10,4,3,2,2022-01-17,2,Monday,1,13,6
1482906435130474498,2022-01-17 02:43:39,"Siapa yang zodiaknya Cancer? Meskipun ada rintangan sebaiknya tak perlu berkecil hati dan tak perlu risau ya. Yuk, intip kata zodiak kalian hari ini: #RamalanZodiak https://t.co/DxXNa4J7Td",3,0,1,0,2022-01-17,2,Monday,1,4,0
1482905440652603407,2022-01-17 02:39:42,"Liverpool kembali rasakan kemenangan pada pertandingan pekan ke-21 yang dihelat di Anfield. Tampil doniman walau tanpa Mohamed Salah dan Sadio Mane, The Reds menang tiga gol tanpa balas https://t.co/cQPkViSP9a",7,0,1,0,2022-01-17,2,Monday,1,8,0
1482904704522850304,2022-01-17 02:36:47,Penarikan itu dilakukan untuk menghindari terjadinya konflik kepentingan. https://t.co/fM8JjeHgc0,42,22,5,1,2022-01-17,2,Monday,1,47,23
1482903713408815107,2022-01-17 02:32:50,"Balap liar di Jakarta yang sangat meresahkan warga hingga bertaruh nyawa. Hal ini membuat Kapolda Metro Jaya, Irjen Pol Fadil Imran menginisiasi dibuatkanya lomba balap motor legal bagi para joki balap liar. https://t.co/2gT8QuFFwR",8,1,2,0,2022-01-17,2,Monday,1,10,1
1482902479545192448,2022-01-17 02:27:56,"Jokowi menyetujui anggaran sebesar Rp 451 triliun pada 2022 untuk pemulihan ekonomi nasional. Anggaran tersebut untuk tiga sektor yakni kesehatan, perlindungan sosial, dan terkait fasilitas fiskal beberapa sektor.  https://t.co/Vm3hPasEin",5,2,2,0,2022-01-17,2,Monday,1,7,2
1482901502771568644,2022-01-17 02:24:03,Liverpool akhirnya menyudahi puasa kemenangannya di Liga Inggris. Setelah memenangi pertandingan melawan Brentford dengan skor telak 3-0.  https://t.co/tTpWNtqv6f,8,0,0,0,2022-01-17,2,Monday,1,8,0
1482900768877338627,2022-01-17 02:21:08,"#Foto Usai akad nikah, Vidi Aldiano dan Sheila Dara menggelar resepsi bertema budaya Minang. Lihat yuk potret suasana dan dekorasinya. https://t.co/E3n8JU7bHe",13,1,2,0,2022-01-17,2,Monday,1,15,1
1482900749008973827,2022-01-17 02:21:04,"""Palabuhanratu hanya ngejeut hungkul (guncangan sekali saja), terasa sekitar 2 detik "" kata Siswo Wasito, warga Sukabumi. https://t.co/OHl9M1leIa",9,0,3,0,2022-01-17,2,Monday,1,12,0
1482899736894050304,2022-01-17 02:17:02,"Usai mengalahkan Athletic Bilbao 2-0 di final, Real Madrid sukses merebut Piala Super Spanyol 2021/2022. https://t.co/WtmDyOXV1n",7,0,1,0,2022-01-17,2,Monday,1,8,0
1482899025942794242,2022-01-17 02:14:13,"Liverpool berhasil mengalahkan Brentford 3-0. Tapi, Juergen Klopp mengakui Brentford membuat The Reds tidak bermain dengan nyaman. Apa alasannya? https://t.co/nI0z2wRbdw",0,0,1,0,2022-01-17,2,Monday,1,1,0
1482898030873522177,2022-01-17 02:10:16,Pantai Gading gagal melanjutkan laju positifnya saat diimbangi Sierra Leone 2-2. Kejutan terjadi saat juara bertahan Aljazair dikalahkan Ekuatorial Guinea 0-1. https://t.co/Nm2kcb0xV9,2,0,1,0,2022-01-17,2,Monday,1,3,0
1482897532711809024,2022-01-17 02:08:17,"#Foto Pria asal Purwakarta, Jawa Barat ini tak pernah menduga jika jodohnya adalah bule asal Jerman. Intip yuk kisah dan potret pasutri beda negara itu.  https://t.co/yApfqGTUN3",10,8,4,3,2022-01-17,2,Monday,1,14,11
1482897046981988353,2022-01-17 02:06:21,"Setelah serangkaian hasil buruk The Toffees, Benitez yang hanya melatih Everton selama tujuh bulan, akhirnya dipecat. https://t.co/5vHcGyZgwK",5,0,0,0,2022-01-17,2,Monday,1,5,0
1482896541669117956,2022-01-17 02:04:21,Legenda Persib Bandung meminta fans bersabar dengan Robert Rene Alberts. Dia meyakini Rene Alberts bisa seperti Juergen Klopp di Liverpool. https://t.co/hr78QOxcbo,4,1,0,2,2022-01-17,2,Monday,1,4,3
1482895810744537088,2022-01-17 02:01:26,"Yusuf Mansur menghadapi gugatan sejumlah pihak karena salah satu bisnisnya, Paytren. Terbaru, ia digugat Rp98,7 triliun ke PN Jaksel atas tuduhan ingkar janji atau wanprestasi terhadap Zaini Mustofa. #CNNIndonesia #detiknetwork  https://t.co/ghnl8qK7sN",12,6,4,1,2022-01-17,2,Monday,1,16,7
1482895252138643457,2022-01-17 01:59:13,"Tornado memporak-porandakan wilayah Fort Myers di Florida, AS pada Minggu (16/1). Puluhan rumah rusak dan hancur akibat terjangan tornado ini. https://t.co/IFcZJ6az99",2,0,2,0,2022-01-17,1,Monday,1,4,0
1482894502822125572,2022-01-17 01:56:14,Sinovac Biotech mengkonfirmasi tengah mengerjakan vaksin COVID-19 yang mampu melawan varian Omicron. Vaksin ini direncanakan akan rilis Februari mendatang. https://t.co/bRCLDLbGMc,11,8,6,4,2022-01-17,1,Monday,1,17,12
1482893148439425035,2022-01-17 01:50:52,"Kota Petah Tikva yang berdekatan dengan ibu kota Israel, Tel Aviv, dilanda banjir pada Minggu (16/1). Ketinggian air tampak setinggi lutut orang dewasa. https://t.co/cXeoGbdFeR",3,1,1,0,2022-01-17,1,Monday,1,4,1
1482892609655918596,2022-01-17 01:48:43,"Jubir Somalia Mohamed Ibrahim Moalimuu menjadi target serangan bom bunuh diri kelompok ekstremis al-Shabab pada Sabtu (16/1) di ibu kota Somalia, Mogadishu. Kondisi Moalimuu saat ini mengalami luka-luka. https://t.co/jcwsIdZfuq",2,0,1,0,2022-01-17,1,Monday,1,3,0
1482891859571757056,2022-01-17 01:45:44,Mantan Presiden Mali Ibrahim Boubacar Keita yang dikudeta oleh militer pada Agustus 2020 lalu meninggal dunia pada Minggu (16/1). Ia meninggal di usia 76 tahun. https://t.co/P7XTrJHkV2,4,0,1,0,2022-01-17,1,Monday,1,5,0
1482888633346674692,2022-01-17 01:32:55,"Susu sapi termasuk minuman yang tidak bisa bertahan lama, terutama untuk jenis susu segar. Susu mudah basi dan rusak sehingga berbahaya jika tetap dikonsumsi.  https://t.co/cgo2lXVSZi",8,1,2,1,2022-01-17,1,Monday,1,10,2
1482887135044771841,2022-01-17 01:26:58,Penemuan hewan menjijikkan di dalam makanan kerap membuat heboh netizen. Seperti seorang netizen yang menemukan tikus hidup di dalam wadah berisi mie.  https://t.co/NbivJexWmt,16,3,4,1,2022-01-17,1,Monday,1,20,4
1482886165229445120,2022-01-17 01:23:07,"Awalnya dianggap sebagai makanan tak sehat, kini daging babi justru digandrungi orang Korea terutama pada bagian perut babi. Ternyata ini alasannya.  https://t.co/NrLVtbDVEF",10,3,3,2,2022-01-17,1,Monday,1,13,5
1482885419440164883,2022-01-17 01:20:09,"Memilih menu sarapan sebaiknya tak sekadar yang mengenyangkan, tapi juga yang bernutrisi. Ahli gizi ungkap 7 makanan ini sebaiknya tak dikonsumsi saat sarapan.  https://t.co/XIdwIwRNMF",6,1,2,0,2022-01-17,1,Monday,1,8,1
1482884929893588999,2022-01-17 01:18:12,Ada video iseng dari sekelompok pengunjung yang diam-diam membawa mie ke restoran hotpot. Hal ini menuai kritikan dan hujatan dari netizen.  https://t.co/qMSPnqjiYr,2,1,2,1,2022-01-17,1,Monday,1,4,2
1482884365461999616,2022-01-17 01:15:58,Food vlogger ini bikin camilan unik dari Indomie goreng. Bukan direbus dan diaduk dengan bumbu. Tetapi mienya digoreng garing bersama telur.  https://t.co/SZks8c2Ym9,10,3,3,2,2022-01-17,1,Monday,1,13,5
1482883595060629513,2022-01-17 01:12:54,"Kalau tarif KRL diputuskan untuk naik, detikers setuju nggak nih? Kasih tahu jawabannya dengan memilih 'setuju' atau 'tidak setuju' pada kolom komentar.  https://t.co/Q7DDXcsb8Q",5,9,2,1,2022-01-17,1,Monday,1,7,10
1482883129778085897,2022-01-17 01:11:03,Jerome Kurnia curi atensi lewat perannya sebagai Tariq di film Penyalin Cahaya. Aktor tampan ini menunjukkan kemampuan akting terbaiknya.  https://t.co/rKkF3nQnmA,12,0,1,0,2022-01-17,1,Monday,1,13,0
1482882647093350401,2022-01-17 01:09:08,Barley merupakan sejenis biji-bijian yang sangat digemari oleh Nabi Muhammad SAW. Barley kaya akan nutrisi yang dapat mencegah berbagai penyakit.  https://t.co/EtPApVLNyX,14,0,5,2,2022-01-17,1,Monday,1,19,2
1482882631096315912,2022-01-17 01:09:04,Ayu Wisya punya banyak momen makan seru. Ia selalu membuat konten YouTube sambil memperlihatkan dirinya seru makan nasi Padang hingga balado pete super pedas!  https://t.co/hU2tGyncan,245,434,40,221,2022-01-17,1,Monday,1,285,655
1482881880626237440,2022-01-17 01:06:05,"Jokowi menyetujui anggaran sebesar Rp 451 triliun pada 2022 untuk pemulihan ekonomi nasional. Anggaran tersebut untuk tiga sektor yakni kesehatan, perlindungan sosial, dan terkait fasilitas fiskal beberapa sektor. #jokowi   https://t.co/Sch2Yqcteh",12,2,2,0,2022-01-17,1,Monday,1,14,2
1482881109834833925,2022-01-17 01:03:01,Bek kiri Liverpool Andy Robertson mengakui Manchester City sulit disaingi untuk sekarang. Fokus Liverpool kini cuma meraih kemenangan sebanyak mungkin. https://t.co/VDRJUShIiw,6,0,0,0,2022-01-17,1,Monday,1,6,0
1482880507809570822,2022-01-17 01:00:38,Menaker Ida Fauziyah berpesan agar para lulusan baru segera mendaftar ke layanan aplikasi SIAPkerja atau Sistem Informasi dan Aplikasi Pelayanan Ketenagakerjaan  https://t.co/03Musw3C4s,10,0,5,1,2022-01-17,1,Monday,1,15,1
1482880496568836107,2022-01-17 01:00:35,Satu lagi negara yang mencatat kasus kematian COVID-19 varian Omicron. Kali ini berasal dari negara ASEAN. https://t.co/g97dekEzdD,4,0,1,0,2022-01-17,1,Monday,1,5,0
1482880018804056067,2022-01-17 00:58:41,Pemerintah kembali memperpanjang PPKM Jawa-Bali. PPKM diperpanjang selama satu pekan. https://t.co/omKGoMpRUN,6,0,0,1,2022-01-17,0,Monday,1,6,1
1482879743536115712,2022-01-17 00:57:36,"Gempa bumi magnitudo (M) 5,4 mengguncang Banten. Gempa dirasakan hingga Sukabumi dan Bogor. https://t.co/PzcSKRsDtT",57,5,18,2,2022-01-17,0,Monday,1,75,7
1482879507593895936,2022-01-17 00:56:39,Rumah mewah makin murah harganya di Jakarta. Rumah para 'sultan' ini harganya terkoreksi dibandingkan sebelum masa pandemi.  https://t.co/4hm1098s9B,7,1,1,0,2022-01-17,0,Monday,1,8,1
1482879506184556551,2022-01-17 00:56:39,"""Nah, saya juga heran kok orang ini, dia kan doktor, dia kan akademisi, dia dosen, pijakan berpikirnya kok jadi ngawur, ngelantur?"" kata Immanuel Ebenezer. https://t.co/sGCeI63b9o",58,105,4,8,2022-01-17,0,Monday,1,62,113
1482879406871830529,2022-01-17 00:56:15,Sederet lowongan kerja lagi dibuka nih! Ada juga lowongan kerja yang dibuka untuk minimal lulusan SMA sederajat.  https://t.co/eNugIjWprm,6,0,3,0,2022-01-17,0,Monday,1,9,0
1482879267507777539,2022-01-17 00:55:42,Menurut Luhut Pandjaitan imbauan itu diberikan dalam rangka meningkatkan kewaspadaan terhadap varian Omicron.  https://t.co/togcFX9lJ1,19,20,7,5,2022-01-17,0,Monday,1,26,25
1482879266450780166,2022-01-17 00:55:42,GISAID melaporkan kasus Omicron di Indonesia melesat menjadi 660 orang. Kemenkes RI mengingatkan jangan meremehkan batuk dan pilek. https://t.co/uXzgqNF5qS,7,2,2,1,2022-01-17,0,Monday,1,9,3
1482878269204619269,2022-01-17 00:51:44,"Tiba-tiba platform penjualan atau marketplace NFT dibanjiri hal-hal aneh yang dijual dalam bentuk digital, salah satunya KTP!  https://t.co/jnRFX0Pq4w",9,1,5,3,2022-01-17,0,Monday,1,14,4
1482878254809817094,2022-01-17 00:51:41,"Tanggul di Pondok Bambu, Jaktim yang bikin warga resah akhirnya dibongkar. Disebut, tanggul itu bertujuan untuk mencegah banjir. https://t.co/mw1bwDt7ev",6,0,0,2,2022-01-17,0,Monday,1,6,2
1482877740013531139,2022-01-17 00:49:38,Pihak Tan Paulin pun buka suara terkait ramainya pemberitaan soal 'Ratu Batu Bara'. Pihaknya membantah keras semua tuduhan miring itu!  https://t.co/tkVwl4hDJk,15,5,4,1,2022-01-17,0,Monday,1,19,6
1482876740741513219,2022-01-17 00:45:40,"Gempa bumi magnitudo (M) 5,4 mengguncang Banten. Gempa tidak berpotensi menimbulkan gelombang tsunami. https://t.co/Kksbc5xq6U",38,0,23,6,2022-01-17,0,Monday,1,61,6
1482875729251651585,2022-01-17 00:41:39,SIM Keliling yang dioperasikan Satuan Lalu Lintas Polrestabes Bandung ini akan melayani masyarakat yang hendak memperpanjang masa berlaku SIM. https://t.co/moP7ji2OM3,15,0,0,0,2022-01-17,0,Monday,1,15,0
1482874713605124097,2022-01-17 00:37:36,"Sebanyak 3 unit kapal milik nelayan terbakar di Dermaga T Pelabuhan Muara Angke, Jakarta Utara pagi ini. Tidak ada korban jiwa atau korban luka. https://t.co/dRZ5G39Mfe",4,0,2,1,2022-01-17,0,Monday,1,6,1
1482873728031768580,2022-01-17 00:33:41,Carlo Ancelotti memenangi trofi kelimanya bersama Real Madrid usai merebut Piala Super Spanyol. Hanya gelar LaLiga saja yang masih kurang dari Ancelotti. https://t.co/bhSQAt1BUP,6,0,1,0,2022-01-17,0,Monday,1,7,0
1482870993802702849,2022-01-17 00:22:49,Salat magrib secara astronomis biasanya dimulai pada waktu matahari terbenam ditambah dua menit. Mengapa demikian dan kapan batas akhirnya? https://t.co/CASbP3X4RA,10,1,4,0,2022-01-17,0,Monday,1,14,1
1482870497947881482,2022-01-17 00:20:51,"Seorang petani di Polman, Sulbar, memperkosa putri kandungnya hingga hamil dan melahirkan. Namun, pengakuan anak petani itu membuat geger warga dan polisi. https://t.co/93GE3jo1ex",59,24,12,2,2022-01-17,0,Monday,1,71,26
1482869736232869894,2022-01-17 00:17:50,"Agar tak sampai dibekukan, berikut ini cara membuka akun LTMPT yang terkunci. Tips ini bisa dilakukan untuk siswa maupun sekolah. https://t.co/kCOkTauK7H",5,0,1,1,2022-01-17,0,Monday,1,6,1
1482868993639727111,2022-01-17 00:14:53,"Morning sex banyak dikaitkan dengan berbagai manfaat kesehatan, tentunya bagi yang punya pasangan. Sebagian di antaranya didukung bukti ilmiah yang meyakinkan. https://t.co/AmVmUrIhG7",6,0,1,3,2022-01-17,0,Monday,1,7,3
1482867994535641090,2022-01-17 00:10:54,Apa benar Gus Yahya tengah melakukan politik akomodasi dengan tampilnya sejumlah politisi dalam susunan PBNU-nya ? https://t.co/7XfKa3q18Z,5,0,1,0,2022-01-17,0,Monday,1,6,0
1482867250516398087,2022-01-17 00:07:57,"Ketua Umum JoMan Noel dan UNJ Ubedillah Badrun berdebat soal laporan dugaan KKN Gibran dan Kaesang Pangarep. Padahal, laporan itu masih ditelaah KPK. https://t.co/Gzplox6f96",9,3,2,0,2022-01-17,0,Monday,1,11,3
1482866504920145920,2022-01-17 00:04:59,Rafael Benitez resmi dipecat Everton. Sejumlah nama telah dipertimbangkan The Toffees untuk menggantikan manajer asal Spanyol itu. https://t.co/JJceUoZFvG,4,0,0,0,2022-01-17,0,Monday,1,4,0
1482866001461059586,2022-01-17 00:02:59,Kecelakaan sepeda motor terjadi Jakarta Timur (Jaktim). Kecelakaan ini menyebabkan ada korban tewas. https://t.co/1LhTWaz5ri,8,0,2,2,2022-01-17,0,Monday,1,10,2
1482864965652516866,2022-01-16 23:58:52,Kemenangan atas Brentford berarti penting untuk Liverpool. Sebab ini jadi tanda The Reds belum menyerah mengejar Manchester City di puncak Premier League. https://t.co/BqKM7O1ACF,15,0,1,0,2022-01-16,23,Sunday,7,16,0
1482864469063655436,2022-01-16 23:56:54,"Pengeroyokan dialami anggota TNI Angkatan Darat (AD) bernama Sahdi (23) hingga tewas. Setelah diusut, polisi menangkap salah seorang pelaku pengeroyokan. https://t.co/PUt3Ifv52m",10,0,3,2,2022-01-16,23,Sunday,7,13,2
1482862645866901512,2022-01-16 23:49:39,"Muncul deklarasi dukungan kepada Prabowo-Jokowi pada Pilpres 2024. Deklarasi yang mendukung Jokowi maju lagi di Pilpres, lantas menuai pro kontra. https://t.co/IMV9QefKSU",34,25,2,6,2022-01-16,23,Sunday,7,36,31
1482855816524963840,2022-01-16 23:22:31,Pengemudi Mercy berinisial KZYK (20) terlibat kecelakaan 'adu banteng' dengan motor di Jalan Raya Pondok Indah. Pengemudi Mercy itu dites urine oleh polisi. https://t.co/913MmGeCsb,24,4,4,2,2022-01-16,23,Sunday,7,28,6
1482854364897320961,2022-01-16 23:16:45,"""DKI Jakarta memiliki pengalaman yang baik dalam menangani COVID-19. DKI Jakarta merupakan provinsi terbaik dalam menangani COVID-19,"" kata Wagub Riza Patria. https://t.co/LBAd2lq6TO",10,12,3,2,2022-01-16,23,Sunday,7,13,14
1482853559779663872,2022-01-16 23:13:33,Efektivitas pembentukan antibodi pada 2 jenis vaksin booster diungkap oleh ilmuwan Litbangkes RI. Ada dua vaksin yang dibandingkan yakni Sinovac dan Moderna. https://t.co/z5WA21OLoH,8,0,3,1,2022-01-16,23,Sunday,7,11,1
1482852809821368321,2022-01-16 23:10:34,Pelarian dalang utama di balik pembunuhan Presiden Haiti Jovenel Moise terhenti di Jamaika. Berikut kronologinya. https://t.co/gkcmZ65JO8,8,0,1,0,2022-01-16,23,Sunday,7,9,0
1482851548938051584,2022-01-16 23:05:33,"DKI Jakarta jadi 'medan perang' pertama melawan varian Omicron. Di tengah peningkatan jumlah kasus, DKI menjadi penyumbang terbesar transmisi lokal. https://t.co/M4vQ9rrxvL",34,13,12,5,2022-01-16,23,Sunday,7,46,18
1482850445940998144,2022-01-16 23:01:10,Pantai Gading gagal melanjutkan laju positifnya saat diimbangi Sierra Leone 2-2. Kejutan terjadi saat juara bertahan Aljazair dikalahkan Ekuatorial Guinea 0-1. https://t.co/wvYkbhHrTm,5,0,0,0,2022-01-16,23,Sunday,7,5,0
1482849189981835264,2022-01-16 22:56:11,"SIAPkerja merupakan alat utama ekosistem digital untuk empat pelayanan ketenagakerjaan yakni Skillhub, Sertihub, Karirhub, dan Bizhub https://t.co/fRilc7k7ZW",13,0,4,2,2022-01-16,22,Sunday,7,17,2
1482848194342105093,2022-01-16 22:52:14,"Keributan melibatkan antar kelompok warga terjadi di Kabupaten Polewali Mandar, Sulawesi Barat (Sulbar). 5 orang diamankan polisi https://t.co/u62J96iv0g",3,0,0,1,2022-01-16,22,Sunday,7,3,1
1482847119094517766,2022-01-16 22:47:57,UNS membuka 13 jalur mandiri. Jalur mandiri tersebut terdiri dari 7 jalur S1 dan 6 jalur vokasi. https://t.co/Zk1iMszKGY,7,0,2,0,2022-01-16,22,Sunday,7,9,0
1482846355831808004,2022-01-16 22:44:55,2 wanita tenggelam di sebuah pantai di Peru. Keduanya tenggelam usai diterjang gelombang pantai. https://t.co/n4MyhNMitL,2,1,0,1,2022-01-16,22,Sunday,7,2,2
1482845345323360257,2022-01-16 22:40:54,Pemerintah akan melakukan isolasi terpusat di pelabuhan untuk mengantisipasi masuknya Omicron ke Indonesia https://t.co/a3OW1OTZiO,7,1,2,3,2022-01-16,22,Sunday,7,9,4
1482844364103692291,2022-01-16 22:37:00,Menteri Ketenagakerjaan Ida Fauziyah menemui beberapa pekerja/buruh penerima bantuan subsidi gaji/upah (BSU) tahun 2021 di DI Yogyakarta https://t.co/RgL22e0Kgs,8,0,2,1,2022-01-16,22,Sunday,7,10,1
1482842597404155904,2022-01-16 22:29:59,"Banyuwangi dipilih jadi tuan rumah oleh Komunitas Xpander Mitsubishi Owner Club (X-MOC), untuk menggelar Jambore Nasional (Jamnas) kedua. Juga Rakernas kelima. https://t.co/7UdNUTF7Sq",11,0,2,0,2022-01-16,22,Sunday,7,13,0
1482840868197474318,2022-01-16 22:23:07,Kasus harian Covid-19 di Tanah Air kembali sentuh angka 1.000. Pemerintah siapkan sejumlah langkah dan strategi. https://t.co/2LQAg1T0A1,23,28,12,7,2022-01-16,22,Sunday,7,35,35
1482838867795496964,2022-01-16 22:15:10,Presiden Jokowi menyetujui penambahan jumlah penonton untuk ajang balap MotoGP di Mandalika. Jumlah penonton MotoGP nantinya akan ditambah menjadi 100 ribu. https://t.co/idM8iO2uf9,30,12,7,7,2022-01-16,22,Sunday,7,37,19
1482837282646282242,2022-01-16 22:08:52,Prakiraan cuaca besok 17 Januari 2022 patut jadi acuan bila akan beraktivitas di luar rumah. Simak di sini ya. https://t.co/ew39NrWRzB,12,0,4,0,2022-01-16,22,Sunday,7,16,0
1482836534378348548,2022-01-16 22:05:54,"Pemkot Denpasar, Bali, bakal membangun Monumen Sita Kepandung. Pembiayaan monumen tersebut digalang dari CSR melalui mekanisme non-fungible token (NFT). https://t.co/KYqnnLiVTt",10,0,3,0,2022-01-16,22,Sunday,7,13,0
1482835515170766849,2022-01-16 22:01:51,"Dua remaja di Makassar, Sulsel dinyatakan hilang usai tersapu ombak saat mandi di Pantai Angin Mammiri. Tim SAR gabungan hingga kini masih melakukan pencarian. https://t.co/05Boz5l4aX",8,0,3,0,2022-01-16,22,Sunday,7,11,0
1482834512925151232,2022-01-16 21:57:52,"Wali Kota Eri menyampaikan, target vaksinasi booster untuk lansia di Surabaya sebanyak 80.747. Vaksinasi dilakukan secara bertahap sesuai dengan stok vaksin. https://t.co/T6MC8LG9R6",14,1,5,0,2022-01-16,21,Sunday,7,19,1
1482832512921518082,2022-01-16 21:49:55,Rentetan kemenangan Inter Milan di Serie A terhenti sudah. Ini setelah Nerazzurri berimbang 0-0 di markas Atalanta. https://t.co/pb4ahHbCOh,9,0,1,0,2022-01-16,21,Sunday,7,10,0
1482831988637720580,2022-01-16 21:47:50,Otoritas Denmark tengah mempertimbangkan memberikan vaksinasi Corona dosis keempat. Vaksinasi tersebut diberikan kepada warga yang rentan terpapar Corona. https://t.co/kWx2oo4UzX,14,0,6,1,2022-01-16,21,Sunday,7,20,1
1482830236131774465,2022-01-16 21:40:52,BMKG mengeluarkan prakiraan cuaca untuk wilayah DKI Jakarta. BMKG memprediksi 5 kota di Jakarta diguyur hujan disertai petir https://t.co/hbq4Q3LSb6,16,0,6,0,2022-01-16,21,Sunday,7,22,0
1482829502740938758,2022-01-16 21:37:57,"Kifosis adalah kelainan tulang belakang yang disebabkan karena tulang terlalu membungkuk ke depan. Kondisi ini bisa terjadi pada siapa saja, termasuk lansia. https://t.co/MxNOPZ36I3",12,0,6,0,2022-01-16,21,Sunday,7,18,0
1482828501820526592,2022-01-16 21:33:59,"Seorang imigran Afghanistan, Sayid Nader Balkhi (41), ditemukan tewas dalam Pengungsian Imigran Wisma Indah Sari Pekanbaru, Riau. Korban tewas akibat bunuh diri https://t.co/XtcvbDqGKE",2,0,2,0,2022-01-16,21,Sunday,7,4,0
1482826979430834178,2022-01-16 21:27:56,Hujan deras disertai angin kencang menumbangkan pohon di jalan nasional Trenggalek-Tulungagung. Pohon tumbang juga ada yang menimpa gerobak warung makan. https://t.co/ZvTSxiIbkg,8,0,2,0,2022-01-16,21,Sunday,7,10,0
1482825695680253952,2022-01-16 21:22:50,Satgas menemukan 25 CPMI tidak memiliki dokumen penempatan dan diindikasikan ditampung oleh PT PBAS. Mereka akan ke Arab Saudi sebagai pekerja rumah tangga. https://t.co/47yo3S10tH,8,0,3,0,2022-01-16,21,Sunday,7,11,0
1482824706675941379,2022-01-16 21:18:54,Pemerintah memperbarui data terkait kasus Corona di Indonesia. Hari ini dilaporkan ada tambahan 855 kasus positif COVID-19 di Indonesia. https://t.co/24EWuEgEWN,7,0,3,0,2022-01-16,21,Sunday,7,10,0
1482823467405918208,2022-01-16 21:13:58,Pemerintah kembali memperpanjang PPKM di luar Jawa-Bali. PPKM diperpanjang hingga 31 Januari 2022. https://t.co/BmjtsVmreJ,12,1,4,1,2022-01-16,21,Sunday,7,16,2
1482822440057290754,2022-01-16 21:09:53,"Untuk meminimalisir penyebaran COVID-19 varian Omicron, polisi di Sidoarjo menggelar razia warga yang belum divaksin. Seperti yang digelar di Pos Waru. https://t.co/EZQiO0vWbj",4,0,3,1,2022-01-16,21,Sunday,7,7,1
1482821677964795904,2022-01-16 21:06:52,"Menkes menyebut tingkat hospitalisasi pada varian Omicron lebih rendah dibanding Delta. Dari yang sempat dirawat di RS, lebih dari setengah sudah sembuh. https://t.co/cAOCWM36Lp",7,0,3,0,2022-01-16,21,Sunday,7,10,0
1482820380943388676,2022-01-16 21:01:42,"Manajer Liverpool Juergen Klopp mengakui wajar kalau timnya merindukan Mohamed Salah dan Sadio Mane. Tapi, The Reds lagi berusaha ""hidup"" tanpanya. https://t.co/JpOvWnwKaY",6,0,0,0,2022-01-16,21,Sunday,7,6,0
1482819587301425158,2022-01-16 20:58:33,Penyerahan tersebut merupakan upaya untuk melindungi kekayaan intelektual (KI) di Bali. https://t.co/iHOHcPnkh5,2,0,1,0,2022-01-16,20,Sunday,7,3,0
1482818841465995266,2022-01-16 20:55:35,"Real Madrid sukses merebut Piala Super Spanyol 2021/2022. Madrid mengalahkan Athletic Bilbao 2-0 di final, meski bermain dengan 10 orang di menit-menit akhir. https://t.co/8mxWqJr9k0",13,0,4,0,2022-01-16,20,Sunday,7,17,0
1482818345242177538,2022-01-16 20:53:37,Menurut Bamsoet langkah tersebut bertujuan agar para pembalap liar mampu bergabung dengan tim balap resmi dan mengukir sejumlah prestasi. https://t.co/ekiuNbwtlY,2,0,2,0,2022-01-16,20,Sunday,7,4,0
1482816027004223493,2022-01-16 20:44:24,"""Namun di belahan negara Asia seperti India, Thailand, Filipina, masih terjadi peningkatan kasus yang cukup tinggi,"" kata Luhut Binsar Pandjaitan. https://t.co/JPxj8UfSA7",7,1,3,2,2022-01-16,20,Sunday,7,10,3
1482814791903232013,2022-01-16 20:39:30,"Kepala Staf TNI Angkatan Laut (Kasal) Laksamana TNI Yudo Margono mengunjungi SDN 2 Desa Garon, Kecamatan Balerejo, Madiun. Ia meninjau vaksinasi anak. https://t.co/DUaR6Nw7yB",5,0,0,0,2022-01-16,20,Sunday,7,5,0
1482813505506009091,2022-01-16 20:34:23,Seorang wanita warga negara asing (WNA) asal Somalia berinisial MIA yang sedang hamil tua ditolak masuk Indonesia gegara masalah visa https://t.co/u9ZtCyHgaU,2,1,0,0,2022-01-16,20,Sunday,7,2,1
1482811979643461635,2022-01-16 20:28:19,"Bamsoet menerangkan, selain level Kejurnas, akan ada juga kejuaraan Balap Motor tingkat nasional/club event yang berada dibawah pengawasan IMI Pusat. https://t.co/j4nvxJuAG6",8,0,0,0,2022-01-16,20,Sunday,7,8,0
1482810748178944006,2022-01-16 20:23:26,"Kasus Omicron di Malang menjadi perhatian Gubernur Khofifah. Ia menegaskan, PPKM Mikro tingkat RT diterapkan untuk mencegah sebaran virus, bukan lockdown. https://t.co/qWZKnj9BFP",6,0,0,0,2022-01-16,20,Sunday,7,6,0
1482809223868297221,2022-01-16 20:17:22,"Untuk perkembangan kasus Omicron, Airlangga menerangkan, per 15 Januari 2021 terjadi tren kenaikan kasus dan mulai naiknya kasus karena transmisi lokal. https://t.co/UHEcJVFTQw",6,5,1,0,2022-01-16,20,Sunday,7,7,5
1482808189301231623,2022-01-16 20:13:16,Sebanyak 17 kontak erat pasien Omicron di Kabupaten Malang telah menjalani tes PCR. Satu di antaranya positif COVID-19. https://t.co/psQCGB7rXW,7,1,1,0,2022-01-16,20,Sunday,7,8,1
1482806676747173890,2022-01-16 20:07:15,AS Roma berhasil mengalahkan Cagliari 1-0 di giornata ke-22 Liga Italia musim ini. Tiga poin tersebut menjadi yang pertama bagi Giallorossi di 2022. https://t.co/sfQKP6Pll6,2,0,1,0,2022-01-16,20,Sunday,7,3,0
1482805325564715012,2022-01-16 20:01:53,Camat Cibeureum dan Dinas Pendidikan Kota Sukabumi menggelar mediasi terkait bangunan PAUD yang diduga dirusak dan ditutup pengurus RW. https://t.co/NmZUc6ESMc,7,0,0,1,2022-01-16,20,Sunday,7,7,1
1482803439419772935,2022-01-16 19:54:23,Seorang bayi berusia 3 minggu di Qatar meninggal dunia terpapar COVID-19 https://t.co/xphB04jRwN,4,0,2,0,2022-01-16,19,Sunday,7,6,0
1482803221466865664,2022-01-16 19:53:31,Ratusan calon penumpang berebut naik kapal di Pelabuhan Kalianget Sumenep. Itu terjadi setelah ada penundaan pelayaran akibat cuaca buruk. https://t.co/Dp32DRExNK,3,0,2,0,2022-01-16,19,Sunday,7,5,0
1482801735332732928,2022-01-16 19:47:37,"Berikut ini sejumlah cara mengecilkan ukuran foto tanpa harus mengurangi kualitasnya. Bisa pakai HP, komputer, aplikasi, atau situs. https://t.co/hdGURJ4YyR",14,0,2,0,2022-01-16,19,Sunday,7,16,0
1482798708836212739,2022-01-16 19:35:35,Wakil Ketua Komisi IV DPR RI Dedi Mulyadi mengaku keberatan terkait dibukanya kembali tambang batu andesit di Gunung Sirnalanggeng oleh salah satu perusahan. https://t.co/iOQsNfFCtV,3,1,2,0,2022-01-16,19,Sunday,7,5,1
1482797368491880459,2022-01-16 19:30:16,Menkes Budi mengatakan 400 tablet Paxlovid sudah masuk ke Indonesia. Ini menjadi persiapan untuk menghadapi lonjakan kasus COVID-19. https://t.co/9DmnViur1D,3,0,3,0,2022-01-16,19,Sunday,7,6,0
1482795591088357386,2022-01-16 19:23:12,Sejumlah pemuda di Kabupaten mendeklarasikan dukungan kepada Menteri BUMN Erick Thohir untuk maju di Pilpres 2024. https://t.co/bUVSiHLZ8B,5,2,1,1,2022-01-16,19,Sunday,7,6,3
1482792953793941516,2022-01-16 19:12:43,Liverpool mendominasi Brentford untuk memenangi pertandingan dengan skor telak 3-0. Liverpool akhirnya menyudahi puasa kemenangannya di Liga Inggris. https://t.co/J4nQ4VCKcE,2,0,0,0,2022-01-16,19,Sunday,7,2,0
1482791944770265088,2022-01-16 19:08:43,Beijing laporkan kasus transmisi lokal pertama Omicron di wilayahnya. Temuan kasus ini terjadi hanya beberapa minggu jelang dibukanya Olimpiade Musim Dingin. https://t.co/a4jbxWh8UZ,2,0,0,0,2022-01-16,19,Sunday,7,2,0
1482789000167444483,2022-01-16 18:57:01,Menkes Budi mengatakan vaksinasi booster untuk warga di wilayah Jabodetabek akan dipercepat. Ini sebagai upaya untuk menghadapi gelombang varian Omicron. https://t.co/UzcIBQC3LO,4,2,1,3,2022-01-16,18,Sunday,7,5,5
1482787352674242567,2022-01-16 18:50:28,"Tak hanya kasus Covid-19 varian Omicron, kasus flu burung di Korea Selatan juga mengalami kenaikan. Sekitar 33 ribu bebek di kawasan Yeongam terinfeksi flu. https://t.co/1YVHN5OuCz",1,0,0,1,2022-01-16,18,Sunday,7,1,1
1482784822619693063,2022-01-16 18:40:25,Liverpool menutup babak pertama duel kontra Brentford dengan skor 1-0. Pencetak golnya adalah Fabinho. https://t.co/mSqTBa1NrQ,8,0,0,0,2022-01-16,18,Sunday,7,8,0
1482783090028294145,2022-01-16 18:33:32,Pemerintah RI bakal membangun mercusuar sebagai tanda kedaulatan di wilayah Karang Singa dan Karang Selatan di Kepulauan Riau. https://t.co/U9QPImO1Ez,22,0,2,0,2022-01-16,18,Sunday,7,24,0
1482780175909756929,2022-01-16 18:21:57,"Angin puting beliung melanda permukiman padat penduduk di Pontianak, Kalimantan Barat. Akibatnya sejumlah rumah warga rusak. https://t.co/zM8gn6uagb",5,1,2,0,2022-01-16,18,Sunday,7,7,1
1482778660738326534,2022-01-16 18:15:56,Pemindahan napi kasus narkoba di Lapas Kedungpane Semarang itu dilakukan secara mendadak. Apa alasannya? https://t.co/IcrJwSn7yJ,5,0,4,0,2022-01-16,18,Sunday,7,9,0
1482777330636537861,2022-01-16 18:10:38,"Seperti ini cara daftar SNMPTN 2022 yang benar. Jika mengalami eror, ini sederet hal yang direkomendasikan para siswa yang sudah sukses melakukannya. https://t.co/msThJfohAz",1,0,2,0,2022-01-16,18,Sunday,7,3,0
1482775530168541185,2022-01-16 18:03:29,Kementerian Agama (Kemenag) mengevaluasi skema kebijakan satu pintu atau one gate policy (OGP) jemaah umrah karena terkait perkembangan Omicron. https://t.co/lYaRAHIqjM,6,0,2,0,2022-01-16,18,Sunday,7,8,0
1482774140398587907,2022-01-16 17:57:58,Erling Haaland mengaku ditekan Borussia Dortmund untuk menentukan masa depannya. Klub sendiri kaget mendengarnya. https://t.co/0oMIhj5ga1,4,0,1,0,2022-01-16,17,Sunday,7,5,0
1482771291757330442,2022-01-16 17:46:39,"Rider Gresini, Fabio Di Giannatonio, akan menjalani debut di MotoGP. Rekan setimnya, Enea Bastianini, memberi pesan untuk Diggia. https://t.co/stP9ezreWm",4,0,1,0,2022-01-16,17,Sunday,7,5,0
1482768031202045952,2022-01-16 17:33:41,"Liverpool memang berhasil mengalahkan Brentford 3-0. Tapi, Juergen Klopp mengakui Brentford membuat The Reds tidak bermain dengan nyaman. https://t.co/FF4iiZ3MZ7",7,0,1,0,2022-01-16,17,Sunday,7,8,0
1482765688817307661,2022-01-16 17:24:23,"Tisu magic banyak dijadikan opsi oleh pasangan agar sesi bercinta jadi lebih tahan lama. Tapi, bagaimana cara pakai tisu magic yang benar? Begini caranya: https://t.co/gf5PW5E9sr",20,2,8,1,2022-01-16,17,Sunday,7,28,3
1482761778010460163,2022-01-16 17:08:50,Sari Soraya Ruka (46) ditangkap setelah masuk dalam daftar pencarian orang (DPO) Kejati Bali kurang-lebih selama 2 tahun atas kasus perusakan vila. https://t.co/ONHobGMFjm,14,0,3,0,2022-01-16,17,Sunday,7,17,0
1482759750773350410,2022-01-16 17:00:47,"Pria di Banyuwangi memerkosa anak tiri hingga hamil. Lalu, pria tersebut memaksa korban menggugurkan kandungannya. https://t.co/NsYO8knE4z",9,3,2,0,2022-01-16,17,Sunday,7,11,3
1482759261121875975,2022-01-16 16:58:50,Elon Musk membagikan video jadul yang diambil pada tahun 1995 di mana Bill Gates diledek soal internet. #ElonMusk  https://t.co/HTAEAgXtm5,13,1,1,0,2022-01-16,16,Sunday,7,14,1
1482758763396407302,2022-01-16 16:56:52,Manchester United kian terpuruk di musim ini. Roy Keane sampai menyebut cuma ada 3 pemain yang pantas bertahan bermain untuk Setan Merah. https://t.co/bSYYFldxuw,7,0,0,1,2022-01-16,16,Sunday,7,7,1
1482758229029490693,2022-01-16 16:54:44,Video pemindahan jasad seorang guru ngaji di Subang viral di media sosial. Anehnya jasad kiai tersebut nampak masih utuh setelah 17 tahun terkubur. https://t.co/7jKICw3eWe,137,3,13,2,2022-01-16,16,Sunday,7,150,5
1482757979258736643,2022-01-16 16:53:45,"Penemuan mayat pria menggegerkan warga Kota Tangerang Selatan. Pasalnya, di kantong celana mayat pria tersebut terdapat uang senilai Rp 15,8 juta. https://t.co/W96j8zqfzi",3,0,1,0,2022-01-16,16,Sunday,7,4,0
1482757118109401093,2022-01-16 16:50:19,"Betapa kagetnya China National Space Administration (CNSA) saat mengeksplorasi sisi Bulan terjauh, tampak ada objek misterius berbentuk seperti 'rumah'. https://t.co/5peNnL8ePe",8,0,2,1,2022-01-16,16,Sunday,7,10,1
1482756597503991808,2022-01-16 16:48:15,"Rafael Benitez cuma bertahan tujuh bulan sebagai manajer Everton. Setelah serangkaian hasil buruk The Toffees, Benitez akhirnya dipecat. https://t.co/SluPQi4N58",7,0,0,0,2022-01-16,16,Sunday,7,7,0
1482755359794245635,2022-01-16 16:43:20,"Seorang mahasiswi di Sumatera Utara tewas saat mengejar pelaku jambret. Terbaru, dua pelaku jambret juga tewas diamuk massa. https://t.co/rxXLH297AL",37,4,6,0,2022-01-16,16,Sunday,7,43,4
1482754885506551808,2022-01-16 16:41:27,"Imam Syafi'ie atau Bang Pi'ie dikenal sebagai jagoan dari Pasar Senen, Jakarta. Terlibat perang melawan pasukan Sekutu dan Belanda. Ini kisahnya. https://t.co/flOL9dwBj4",23,0,3,1,2022-01-16,16,Sunday,7,26,1
1482754099057766406,2022-01-16 16:38:20,"Liverpool tampil dominan atas Brentford. Meski sempat kesulitan bikin gol, The Reds akhirnya menang tiga gol tanpa balas. https://t.co/GDNV9H8tS7",10,0,0,0,2022-01-16,16,Sunday,7,10,0
1482753506058645504,2022-01-16 16:35:58,Kemendagri mewanti-wanti soal bahaya sembarangan mengunggah foto KTP di internet. Ada ancaman hukuman bui 10 tahun menanti https://t.co/iXDquwc2a0,20,6,2,1,2022-01-16,16,Sunday,7,22,7
1482752720855572482,2022-01-16 16:32:51,"'Adu banteng' antara Mercy dengan motor terjadi di kawasan Pondok Indah, Jakarta Selatan. Sang pengemudi motor pun tewas di tempat akibat kecelakaan tersebut. https://t.co/ocSZoYAMIZ",12,2,2,5,2022-01-16,16,Sunday,7,14,7
1482752457059020803,2022-01-16 16:31:48,Hendra Setiawan/Mohammad Ahsan harus puas dengan hasil runner up di India Open 2022. Hendra/Ahsan mengaku sulit mengantisipasi serangan lawan. https://t.co/hHZczWAKwH,24,1,0,0,2022-01-16,16,Sunday,7,24,1
1482752101084192776,2022-01-16 16:30:23,Bos Garuda meminta snack bergambar ilustrasi Kaesang dalam paket makanan di pesawat Garuda Indonesia untuk ditarik. https://t.co/r3KwMye3Od,192,51,44,12,2022-01-16,16,Sunday,7,236,63
1482750682792923137,2022-01-16 16:24:45,"Seorang warga Serpong, Tangerang Selatan (Tangsel) ditemukan tewas gantung diri di kontrakannya. Pria tersebut berumur 20 tahun. https://t.co/KF9g8tprwP",15,1,2,0,2022-01-16,16,Sunday,7,17,1
1482750448306208768,2022-01-16 16:23:49,"Perayaan ulang tahun anjing bernama Hermes menghabiskan dana lebih dari Rp 100 juta. Pemilik anjing, Sherly Soegito membeberkan alasannya. https://t.co/u6t00BEkrQ",15,7,2,5,2022-01-16,16,Sunday,7,17,12
1482749702680592385,2022-01-16 16:20:51,"Sebuah penelitian mengungkap efektivitas vaksin Sinovac, CoronaVac, terhadap varian Omicron. Namun, penerima 2 dosis Sinovac masih tetap membutuhkan booster. https://t.co/e6EDIviwLV",17,0,2,0,2022-01-16,16,Sunday,7,19,0
1482748967255482370,2022-01-16 16:17:56,Selama pandemi yang hampir 2 tahun ini tidak ada warga Dukuh Janganmati Gunungkidul yang tercatat terpapar COVID-19. https://t.co/pTUI7VgSvn,27,2,4,0,2022-01-16,16,Sunday,7,31,2
1482748468837953546,2022-01-16 16:15:57,"KIP Kuliah akan tetap dilanjutkan di tahun 2022. Berikut adalah cara daftar, persyaratan, dan total bantuannya yang harus diketahui. https://t.co/qEBdn3DHWX",16,1,3,0,2022-01-16,16,Sunday,7,19,1
1482747940770914305,2022-01-16 16:13:51,PP PBSI akan mengumumkan daftar atlet bulutangkis Pelatnas 2022 pada akhir Januari. Kepastian itu diperoleh setelah Seleksi Nasional (Seleknas) rampung digelar. https://t.co/EzwgFIc1fW,3,1,0,0,2022-01-16,16,Sunday,7,3,1
1482747200346238981,2022-01-16 16:10:55,"Protokol kesehatan akan diperketat. Luhut mengatakan, hanya orang yang sudah divaksinasi dua dosis yang boleh beraktivitas di tempat publik. https://t.co/aiPDUewj6M",9,3,4,3,2022-01-16,16,Sunday,7,13,6
1482745426650533889,2022-01-16 16:03:52,"Viral di media sosial video dengan narasi penumpang dalam mobil meninggal lantaran tak diberi Jalan pengendara lain di Makassar, Sulawesi Selatan (Sulsel). https://t.co/ldqN2mTNDk",5,0,0,0,2022-01-16,16,Sunday,7,5,0
1482744487164223500,2022-01-16 16:00:08,"Sejumlah warga menceritakan kronologi kejadian pria bercelurit sambil melempari rumah warga dengan batu di Kampung Tipar Tengah, Cimanggis, Depok https://t.co/3PUn8SBoxH",7,2,1,0,2022-01-16,16,Sunday,7,8,2
1482743738355138562,2022-01-16 15:57:09,Seorang Mahasiswi korban penjambretan tewas setelah mengalami kecelakaan saat mengejar para pelakunya. Insiden itu memicu warga ikut mengejar kedua jambret. https://t.co/6y9E1UytaB,30,4,9,1,2022-01-16,15,Sunday,7,39,5
1482742742014992389,2022-01-16 15:53:12,"Cacing kremi adalah parasit yang bisa berkembang biak di dalam tubuh. Meski jarang terjadi, cacing kremi juga bisa masuk dan bersarang di Miss V. Ini tandanya. https://t.co/5pPEwf4DGZ",26,3,4,1,2022-01-16,15,Sunday,7,30,4
1482741751496515590,2022-01-16 15:49:16,"DKI Jakarta menjadi 'medan perang' pertama melawan varian Omicron. Menkes Budi G Sadikin menyebut, lebih dari 90 persen transmisi lokal terjadi di wilayah ini. https://t.co/FzGTjCrxGh",8,4,3,4,2022-01-16,15,Sunday,7,11,8
1482740731466952708,2022-01-16 15:45:13,Pengadilan Negeri (PN) Bekasi menjatuhkan hukuman 6 tahun penjara kepada Abdulrahman Yusuf dalam kasus investasi kripto EDCCash yang merugikan banyak nasabah. https://t.co/IpaveaWOrG,10,0,3,0,2022-01-16,15,Sunday,7,13,0
1482739986332061696,2022-01-16 15:42:15,Persiraja bermain imbang tanpa gol dengan Persipura di pekan ke-20 Liga 1 musim ini. Penalti Ferinando Pahabol di akhir babak kedua digagalkan Fakhrurrazi Quba. https://t.co/CeU12oYK3l,4,0,1,0,2022-01-16,15,Sunday,7,5,0
1482738231363915785,2022-01-16 15:35:16,"Warga Kota Makassar, dibikin geger dengan penemuan koper mencurigakan. Koper tersebut mulanya dikira berisi bom ternyata berisi selembar pakaian. https://t.co/wmobwmEcZK",6,0,1,1,2022-01-16,15,Sunday,7,7,1
1482737523248058372,2022-01-16 15:32:28,Puncak kasus varian Omicron diperkirakan terjadi pertengahan Februari hingga Maret 2022. Menkes menjelaskan perhitungan dan antisipasi yang akan dilakukan. https://t.co/5PJ5k9nzOl,94,71,40,26,2022-01-16,15,Sunday,7,134,97
1482736909344464899,2022-01-16 15:30:01,"Pada 13 November 1998, melalui Ketetapan Nomor 18 Tahun 1998, MPR telah mencabut Ketetapan tentang Pendoman Penghayatan dan Pengamalan Pancasila. https://t.co/SlQNYZBXOV",11,1,2,0,2022-01-16,15,Sunday,7,13,1
1482735505016033284,2022-01-16 15:24:26,"Sebanyak 43 sekolah dan 16 puskesmas di Pandeglang rusak akibat diguncang gempa 6,6 magnitudo Banten. https://t.co/Svhnb7lZAA",12,0,1,1,2022-01-16,15,Sunday,7,13,1
1482735010973114376,2022-01-16 15:22:29,"Polisi melakukan penyelidikan terkait kasus pengeroyokan anggota TNI AD atas nama Sahdi di Penjaringan, Jakarta Utara. Seorang pelaku pengeroyokan ditangkap. https://t.co/vjNlJO0WFT",3,2,2,1,2022-01-16,15,Sunday,7,5,3
1482733393611829256,2022-01-16 15:16:03,"Erupsi gunung api bawah laut di Tonga berdampak pada terjadinya tsunami. Tsunami tak hanya menerjang ibu kota Nuku'alofa, tapi juga merembet ke sejumlah negara. https://t.co/ftyjuoPID3",21,0,2,3,2022-01-16,15,Sunday,7,23,3
1482732591144972290,2022-01-16 15:12:52,"Persipura Jayapura ditahan Persiraja Banda Aceh di lanjutan Liga 1 2021/2022. Ferinando Pahabol gagal penalti, Mutiara Hitam seri 1-1 dengan Laskar Rencong. https://t.co/R0xDr4zWVS",4,1,2,0,2022-01-16,15,Sunday,7,6,1
1482732127577853952,2022-01-16 15:11:01,"Habib Luthfi mundur dari Mustasyar PBNU. Alasannya, ingin fokus sebagai Rais Aam di JATMAN. https://t.co/ZZRISVufFa",17,2,2,1,2022-01-16,15,Sunday,7,19,3
1482730616504336389,2022-01-16 15:05:01,Banding petenis Novak Djokovic ditolak dan membuat visanya dicabut. Ia pun dipastikan absen dari Australia Terbuka 2022 karena akan segera dideportasi. https://t.co/aOOXXXVh9q,15,2,2,0,2022-01-16,15,Sunday,7,17,2
1482729613646344197,2022-01-16 15:01:02,"Emmanuel Nwude termasuk salah satu penipu legendaris dunia. Dia berhasil menipu sebuah bank Brasil dan meraup uang sebesar Rp 3,6 triliun. https://t.co/662HA7eK7d",17,3,5,3,2022-01-16,15,Sunday,7,22,6
1482728381506535435,2022-01-16 14:56:08,Pemerintah melaporkan kasus harian positif Corona hari ini sebanyak 855 kasus. Provinsi yang melaporkan kasus tertinggi dalam 24 jam terakhir adalah Jakarta. https://t.co/gEdjqvBOaD,18,0,8,3,2022-01-16,14,Sunday,7,26,3
1482727373808230401,2022-01-16 14:52:08,"Ketiadaan telapak tangan dan kaki tak membuat Fitriani, bocah 8 tahun asal Polewali Mandar, bergantung pada orang lain. Kamu bisa bantu lewat https://t.co/gJZ8ovBbIQ https://t.co/adpXhj5mTD",63,4,20,1,2022-01-16,14,Sunday,7,83,5
1482726376469942277,2022-01-16 14:48:10,"Halil seorang atlet renang yang disabilitas, dalam menghidupi sehari-harinya bergelut dijalanan berjualan tisu. https://t.co/czWjcYQRab",132,9,39,3,2022-01-16,14,Sunday,7,171,12
1482725221358616579,2022-01-16 14:43:35,"Seorang anggota TNI AD bernama Sahdi (23) tewas akibat luka tusukan senjata tajam di Penjaringan, Jakarta Utara. Lokasi Sahdi tewas kini digaris polisi. https://t.co/ad97CteWax",20,7,2,1,2022-01-16,14,Sunday,7,22,8
1482723762181136391,2022-01-16 14:37:47,"Gara-gara video viral belatung muncul dari Miss V, banyak netizen penasaran mencari link untuk melihatnya. Psikolog menyarankan untuk tak ikut menyebarkannya. https://t.co/TgDr3uhLqx",37,15,10,3,2022-01-16,14,Sunday,7,47,18
1482723760423768068,2022-01-16 14:37:46,"Polda Metro Jaya resmi menggelar balapan sepeda motor bernama street race. Ratusan peserta menggeber motor balapnya di Ancol, Jakarta Utara. https://t.co/3ZLfZU0VFM",28,3,5,3,2022-01-16,14,Sunday,7,33,6
1482721744704221186,2022-01-16 14:29:46,"Gara-gara video viral belatung muncul dari Miss V, banyak netizen penasaran mencari link untuk melihatnya. Psikolog menyarankan untuk tak ikut menyebarkannya. https://t.co/icPVllpnGo",21,4,1,0,2022-01-16,14,Sunday,7,22,4
1482720725987385347,2022-01-16 14:25:43,Pemkab Klaten tetap membuka objek wisata meski ada sejumlah temuan kasus baru COVID-19 di daerah itu dalam beberapa waktu terakhir. https://t.co/ZNMdgEGDJl,31,3,7,1,2022-01-16,14,Sunday,7,38,4
1482719736190406658,2022-01-16 14:21:47,Mohammed Abad adalah salah satu pria di dunia yang memiliki penis bionik. Pasangannya menceritakan pengalaman mereka saat bercinta. Seperti apa ya? https://t.co/7EEqjTW3Lc,26,2,3,2,2022-01-16,14,Sunday,7,29,4
1482718932419190785,2022-01-16 14:18:35,Budi mengatakan puncak Corona varian Omicron di negara-negara lain naik cepat. Kenaikan kasus yang cepat ini terjadi dalam waktu antara 35 sampai 65 hari. https://t.co/Q0WHrEwUhW,21,2,3,1,2022-01-16,14,Sunday,7,24,3
1482717833222049793,2022-01-16 14:14:13,Fitriani tetap tegar mesti terlahir tanpa telapak tangan dan kaki. Kamu bisa membantu bocah 8 tahun ini lewat https://t.co/gJZ8ovBbIQ https://t.co/B1BwOERbHh,30,1,6,1,2022-01-16,14,Sunday,7,36,2
1482717241133223939,2022-01-16 14:11:52,"Mohamed Salah kabarnya meminta kenaikan gaji dalam negosisasi kontrak barunya di Liverpool. Kabar terbaru, The Reds tak menyanggupinya. https://t.co/AnCUEOVinF",22,5,1,4,2022-01-16,14,Sunday,7,23,9
1482716476968775686,2022-01-16 14:08:50,Menko Marves Luhut Binsar Pandjaitan mengungkapkan kasus COVID-19 varian Omicron berpotensi naik tinggi di Jakarta. Itu bisa terjadi kalau warga tak hati-hati. https://t.co/zyHuqyJfMv,21,25,4,8,2022-01-16,14,Sunday,7,25,33
1482715111353630724,2022-01-16 14:03:24,Indonesia Patriots mengawali IBL 2022 dengan hasil pahit. Mereka dikalahkan Bali United dengan skor 55-62 di laga perdana seri Jakarta. https://t.co/9yuwt9nlgk,15,1,1,1,2022-01-16,14,Sunday,7,16,2
1482715088872214534,2022-01-16 14:03:19,MotoGP Indonesia di Sirkuit Mandalika akan digeber pada Maret mendatang. Presiden Joko Widodo disebut menyetujui rencana menambah jumlah penonton. https://t.co/HShdyqlc6I,23,2,0,2,2022-01-16,14,Sunday,7,23,4
1482714469130244099,2022-01-16 14:00:51,Gairah seks pada wanita kerap dianggap lebih rumit jika dibandingkan dengan pria. Tapi benarkah demikian? Apa saja yang perlu diketahui soal libido pada wanita? #detikNetwork  https://t.co/dZizRmyDje,13,2,0,0,2022-01-16,14,Sunday,7,13,2
1482713443945828353,2022-01-16 13:56:47,"Mahasiswa Fispol, Universitas Sam Ratulangi (Unsrat), Manado, Sulut, Mineshia Lesawengen mengungkap pengalaman bisa lulus kuliah tanpa skripsi. https://t.co/miP7MH0D77",26,6,6,6,2022-01-16,13,Sunday,7,32,12
1482712665550114816,2022-01-16 13:53:41,"#Foto Staycation sedang ngetren di masa pandemi COVID-19. Buat yang mau staycation dengan nuansa klasik di Jakarta, hotel ini bisa menjadi pilihan kamu! https://t.co/xTbfsPFF0O",12,0,4,1,2022-01-16,13,Sunday,7,16,1
1482711633759719428,2022-01-16 13:49:35,Menko Marves Luhut Binsar Panjaitan meminta perkantoran tak terapkan WFO 100 persen. Kehadiran fisik karyawan di kantor diminta dikurangi menjadi 75 persen. https://t.co/jHSe9xJwWW,67,37,34,22,2022-01-16,13,Sunday,7,101,59
1482710826058489865,2022-01-16 13:46:23,Sebuah gedung PAUD di Kota Sukabumi diduga ditutup dan dirusak pengurus RW. Ketua RW setempat angkat bicara mengenai masalah tersebut. https://t.co/6xvNHfEMXQ,9,1,0,0,2022-01-16,13,Sunday,7,9,1
1482709934353666048,2022-01-16 13:42:50,"Kejujuran mereka bisa memberi teladan dari rakyat untuk pejabat, golongan yang kerap diberitakan tertangkap tangan karena korupsi. https://t.co/6WVQT0QkSf",43,3,8,0,2022-01-16,13,Sunday,7,51,3
1482708425150763013,2022-01-16 13:36:50,"Dari 5 RSDC di Jakarta, 2 RSDC mengalami kenaikan jumlah pasien rawat inap, lalu 2 lainnya mengalami penurunan, dan 1 lainnya berjumlah tetap https://t.co/sCeOAzaxZI",12,0,3,2,2022-01-16,13,Sunday,7,15,2
1482708158569234434,2022-01-16 13:35:47,Badan Pengawas Tenaga Nuklir (BAPETEN) menawarkan lowongan kerja untuk lulusan D3-S1 bidang IT. Ini informasi lengkapnya. https://t.co/tRsOMsN8pr,31,1,8,0,2022-01-16,13,Sunday,7,39,1
1482707417150410753,2022-01-16 13:32:50,Mualimatus Sholiha dilaporkan hilang dari rumah sudah 3 hari. Keberadaan Mualimatus masih menjadi teka-teki. https://t.co/wZbNd0Tbtl,16,1,6,2,2022-01-16,13,Sunday,7,22,3
1482707119057117186,2022-01-16 13:31:39,"Sebelum bisa jawab soal matematika ini, kamu harus terlebih dahulu bisa melihat angka yang ada. Ikuti tes buta warna sekaligus cerdas cermat ini yuk: https://t.co/M64aTnyDMd",17,8,1,0,2022-01-16,13,Sunday,7,18,8
1482706026784862211,2022-01-16 13:27:18,PKS menyebut Rancangan Undang-Undang Ibu Kota Negara (RUU IKN) dibahas secara kilat. PKS mempertanyakan motif ketergesaan dari pembentukan RUU tersebut. https://t.co/O74jBk3vOF,32,32,4,4,2022-01-16,13,Sunday,7,36,36
1482705039919652868,2022-01-16 13:23:23,Jenderal Andika Perkasa meminta penanganan kasus dugaan korupsi Tabungan Wajib Perumahan Angkatan Darat (TWP AD) periode 2013-2020 tidak lama-lama https://t.co/oDuCYkgsrn,34,2,4,0,2022-01-16,13,Sunday,7,38,2
1482704657143242755,2022-01-16 13:21:52,"Relawan Sahabat Ganjar memberikan sejumlah bantuan kepada masyarakat. Total ada tiga titik yang dikunjungi, yaitu Kota Depok, Bogor dan Sukabumi. https://t.co/aHCGx15bir",37,4,9,6,2022-01-16,13,Sunday,7,46,10
1482704320017494017,2022-01-16 13:20:31,Tim putri Jakarta Elektrik PLN telan kekalahan kedua di Proliga 2022. Kali ini mereka takluk dari Jakarta Pertamina Fastron 1-3. https://t.co/Zc8BhhJLDP,18,0,3,0,2022-01-16,13,Sunday,7,21,0
1482703437993324545,2022-01-16 13:17:01,"Luis Nani kembali main di Eropa usai tiga musim di MLS. Eks bintang Manchester United itu digaet Venezia, yang kini sedang berjuang menghindari degradasi. https://t.co/gJLYhsmcEF",18,1,2,0,2022-01-16,13,Sunday,7,20,1
1482702196546359300,2022-01-16 13:12:05,Kadiv Propam Polri Irjen Ferdy Sambo membeberkan Polda Sumut memiliki angka pelanggaran yang tinggi. Sambo mengingatkan Tuhan tidak buta dan tidak tuli. https://t.co/86EJmmiOP0,31,5,8,2,2022-01-16,13,Sunday,7,39,7
1482701128013955076,2022-01-16 13:07:50,#FOTO Han So Hee saat zaman sekolah ini bikin netizen gagal fokus. Ini dia pesona Han So Hee:  https://t.co/icTfs5WZEu,31,5,4,3,2022-01-16,13,Sunday,7,35,8
1482700117157330947,2022-01-16 13:03:49,Seorang anggota TNI AD tewas usai dikeroyok sejumlah orang di Muara Baru Jakarta Utara. Kejadian itu kini dalam penyelidikan polisi. https://t.co/j8gVUsj2Xr,24,1,5,2,2022-01-16,13,Sunday,7,29,3
1482699061446721540,2022-01-16 12:59:38,Menkes menyebut DKI Jakarta sebagai medan perang pertama dalam menghadapi COVID-19 varian Omicron. DKI Jakarta harus dipersiapkan khusus. https://t.co/0wgXSSTo21,36,17,11,8,2022-01-16,12,Sunday,7,47,25
1482698205817188352,2022-01-16 12:56:14,Ghozali Everyday sukses jadi buah bibir lantaran jual foto selfie-nya dengan total harga fantastis di OpenSea. Ini 5 pelajaran yang mungkin bisa dipetik dari fenomena itu: https://t.co/oSsfkUuqCo,31,1,3,0,2022-01-16,12,Sunday,7,34,1
1482697895635828742,2022-01-16 12:55:00,"Velline Chu, artis dangdut yang terjerat kasus penyalahgunaan narkotika resmi menjalani rehabilitasi di BNNK Jakarta Selatan https://t.co/hcdL2TiqWe",16,1,1,0,2022-01-16,12,Sunday,7,17,1
1482697385247657986,2022-01-16 12:52:58,Seorang pria di Kota Tasikmalaya tega menghantam istrinya sendiri dengan tabung gas 3 Kg. Aksi keji pelaku disebabkan masalah rumah tangga. https://t.co/ZuEAT4SP6p,32,8,4,2,2022-01-16,12,Sunday,7,36,10
1482696515592273925,2022-01-16 12:49:31,#Foto Ada yang berbeda dari Candi Borobudur. Candi ini punya wajah baru dengan menghadirkan concourse alias area terbuka yang cantik di zona 1. Lihat yuk! https://t.co/YA6fzzAK0v,25,1,3,0,2022-01-16,12,Sunday,7,28,1
1482695208932458499,2022-01-16 12:44:19,BPBD Kabupaten Lebak menyalurkan sebanyak 212 bantuan logistik untuk korban terdampak gempa Banten. Bantuan itu disebar ke 6 Kecamatan di daerah Lebak Selatan. https://t.co/lkNd80eslx,7,1,0,0,2022-01-16,12,Sunday,7,7,1
1482693265136701442,2022-01-16 12:36:36,Hari ini merupakan hari yang spesial bagi Hermes. Hermes merayakan ulang tahun pertamanya dengan menghabiskan uang ratusan juta Rupiah. https://t.co/nSnLycPNxM,22,10,1,13,2022-01-16,12,Sunday,7,23,23
1482692791734083588,2022-01-16 12:34:43,Kemlu mengimbau seluruh WNI meningkatkan kewaspadaan pasca tsunami di wilayah Tonga akibat adanya letusan gunung api bawah laut Hunga Tonga-Gunga Ha'apai. https://t.co/bO94NPDifB,25,0,5,1,2022-01-16,12,Sunday,7,30,1
1482691433177960448,2022-01-16 12:29:19,"Kemlu menyebut kelima WNI itu tinggal di Ibu Kota Tonga, Nuku'alofa. Namun kondisi mereka hingga kini belum diketahui. https://t.co/8PYvlsiaKY",12,0,5,1,2022-01-16,12,Sunday,7,17,1
1482691022509518855,2022-01-16 12:27:41,"Menteri Kesehatan RI Budi Gunadi Sadikin mengungkapkan obat COVID-19 besutan Pfizer, Paxlovid, sudah tiba ke Indonesia. Jumlahnya mencapai 400 ribu tablet. https://t.co/8c08SJhpaY",27,1,7,3,2022-01-16,12,Sunday,7,34,4
1482690466864930820,2022-01-16 12:25:29,"Bamsoet menyindir Ketua DPRD DKI Jakarta, Prasetio Edi terkait penyelenggaraan ajang balap internasional Formula E di Ancol, Jakarta Utara. Begini sindirannya. https://t.co/iwNRx9hKoM",16,6,0,0,2022-01-16,12,Sunday,7,16,6
1482690446149230596,2022-01-16 12:25:24,"Velline Chu, artis dangdut yang terjerat kasus penyalahgunaan narkotika resmi menjalani rehabilitasi di BNNK Jakarta Selatan https://t.co/rLe2SqVU1Z",10,1,0,0,2022-01-16,12,Sunday,7,10,1
1482690152757608449,2022-01-16 12:24:14,"James Milner, pemain veteran Liverpool, membahas seorang rekan satu timnya yang dia sebut seperti memiliki kaki lebih dari dua. Siapa dan kenapa? https://t.co/l9LYBbCNt5",12,0,0,0,2022-01-16,12,Sunday,7,12,0
1482689940374933509,2022-01-16 12:23:23,Hendra Setiawan/Mohammad Ahsan gagal menjuarai India Open 2022. Mereka kalah dari Satwiksairaj Rankireddy/Chirag Shetty 16-21 dan 24-.26 di final. https://t.co/GfvaLygeie,32,2,7,1,2022-01-16,12,Sunday,7,39,3
1482689911203536896,2022-01-16 12:23:16,Tebak-tebakan ini belum tentu bisa dijawab oleh orang cerdas sekalipun. Coba pecahkan teka-teki receh ini sambil melatih otak. https://t.co/ZX4tnlMNwk,180,191,15,1,2022-01-16,12,Sunday,7,195,192
1482688290109247491,2022-01-16 12:16:50,Polisi sudah memeriksa rekaman CCTV terkait tewasnya anggota TNI AD usai dikeroyok di Jakut. Apa hasilnya? https://t.co/bUfy4gSMHI,21,1,3,0,2022-01-16,12,Sunday,7,24,1
1482687715531534341,2022-01-16 12:14:33,Bocah berusia 10 tahun berinisial AP ditemukan tewas usai tenggelam di bekas galian bata di Cilegon. Korban dilaporkan tenggelam 2 jam sebelum ditemukan tewas. https://t.co/egv3xuWhNa,12,0,1,0,2022-01-16,12,Sunday,7,13,0
1482686374637707270,2022-01-16 12:09:13,Sejumlah pria di Kabupaten Cianjur memukuli ODGJ gegara diduga mengambil makanan di pasar. Kasus ini tengah diusut pihak kepolisian. https://t.co/C3FK0etJWL,20,2,2,2,2022-01-16,12,Sunday,7,22,4
1482685305257873409,2022-01-16 12:04:58,Menko Kemaritiman dan Investasi Luhut Binsar Pandjaitan menyampaikan kondisi terkini mengenai perkembangan kasus COVID-19 di Indonesia. https://t.co/f8o9bqFANp,20,13,3,2,2022-01-16,12,Sunday,7,23,15
1482684187211669506,2022-01-16 12:00:31,"Bappenas menyiapkan ibu kota baru dalam bentuk metaverse. Targetnya, proyek metaverse ini rampung dalam beberapa bulan ke depan. #CNNIndonesia #detikNetwork  https://t.co/dnjRYTaeyF",151,110,35,179,2022-01-16,12,Sunday,7,186,289
1482683144918925314,2022-01-16 11:56:23,"Indonesia mencatat sebanyak 855 kasus baru COVID-19, Minggu (16/1/2022). DKI menyumbang kasus terbanyak dengan jumlah 566 kasus. https://t.co/QOaAsa6WvU",8,1,6,2,2022-01-16,11,Sunday,7,14,3
1482682402648559617,2022-01-16 11:53:26,"NFT mulai banyak dipakai orang di dunia maya. Oleh sebab itu, negara diminta hadir mengaturnya sebagai penyeimbang dunia transaksi digital. https://t.co/xeVxEH564D",35,9,11,4,2022-01-16,11,Sunday,7,46,13
1482681314973265920,2022-01-16 11:49:07,Menkes menyebut DKI Jakarta sebagai medan perang pertama melawan varian Omicron. Tak lain karena transmisi lokal paling banyak terjadi di wilayah ini. https://t.co/Hdr6tgLDMn,22,2,2,0,2022-01-16,11,Sunday,7,24,2
1482680538016198661,2022-01-16 11:46:01,Tisu magic sering digunakan oleh pria saat melakukan hubungan seksual. Benda ini biasa digunakan untuk menunda ejakulasi dini. Bagaimana efek sampingnya ya? https://t.co/DN3vtBBpUf,9,4,6,0,2022-01-16,11,Sunday,7,15,4
1482679528849825794,2022-01-16 11:42:01,Menkes Budi Gunadi Sadikin menyebut sudah lebih dari 500 orang varian Omicron yang dirawat di rumah sakit (RS). Sebagian besar sudah sembuh dan pulang. https://t.co/XJnLCZYZza,18,1,0,1,2022-01-16,11,Sunday,7,18,2
1482679138813157385,2022-01-16 11:40:28,"Jumlah kasus positif COVID-19 di Indonesia bertambah 855, Minggu (16/1/2022). Total kasus positif menjadi 4.271.649, sembuh 4.118.874, dan meninggal 144.170. https://t.co/UL1wTDnIAb",10,0,1,0,2022-01-16,11,Sunday,7,11,0
1482678961285091328,2022-01-16 11:39:45,"Musim lalu, Real Madrid gagal meraih trofi apa pun di semua kompetisi. Kini, Los Blancos berpotensi melepas dahaga tersebut. https://t.co/i9lUIM44Fp",16,0,1,0,2022-01-16,11,Sunday,7,17,0
1482678715645583361,2022-01-16 11:38:47,Peristiwa pohon tumbang rawan terjadi di Pasuruan. Sebuah pohon randu berukuran besar tumbang disapu angin kencang di Winongan. https://t.co/bPXPgyU9Hv,12,1,2,0,2022-01-16,11,Sunday,7,14,1
1482678188388069377,2022-01-16 11:36:41,Pemerintah kembali menerapkan asesmen PPKM mingguan menyusul melonjaknya kasus COVID-19 varian Omicron di Indonesia. https://t.co/nx4XpFlfek,220,104,56,84,2022-01-16,11,Sunday,7,276,188
1482677689219796995,2022-01-16 11:34:42,Luhut mengungkap hingga saat ini angka kasus kematian akibat Corona masih terjaga. Belum ada kematian diakibatkan Corona varian Omicron. https://t.co/2XMMbUZ6Va,20,5,1,2,2022-01-16,11,Sunday,7,21,7
1482677193012613120,2022-01-16 11:32:44,"Menjelang pembukaan beasiswa LPDP 2022, detikers bisa menyiapkan syarat beasiswa LPDP S1, S2, dan S3. Berikut syarat beasiswa LPDP.

via: detikedu https://t.co/hZc4WZWSPt",33,0,8,1,2022-01-16,11,Sunday,7,41,1
1482676580241522698,2022-01-16 11:30:18,#BeritaTerpopuler Andrew Garfield pernah menyelinap ke bioskop demi nonton Spider-Man. Kabar itu sempat menyita perhatian pembaca sepekan terakhir. https://t.co/A6GcYUQpPo,18,1,2,0,2022-01-16,11,Sunday,7,20,1
1482676255191404544,2022-01-16 11:29:00,"Seorang warga berinisial OA di Distrik Aifat Timur, Kabupaten Maybrat, Papua Barat, diduga tewas dibunuh KNPB pada akhir 2020 lalu. 1 DPO ditangkap polisi. https://t.co/jkdjLQ7xR3",6,1,1,0,2022-01-16,11,Sunday,7,7,1
1482676253958328320,2022-01-16 11:29:00,"Viral di media sosial pengendara motor di Makassar, Sulsel ditilang polisi saat mengawal mobil ambulans. Polisi memastikan ambulans itu sedang kosong. https://t.co/AiR0uydKsk",18,3,2,0,2022-01-16,11,Sunday,7,20,3
1482675511088275458,2022-01-16 11:26:03,Salah satu perusahaan pembuat kartu grafis tidak menyarankan konsumen untuk membeli kartu grafis yang sebelumnya dipakai untuk menambang kripto. Kenapa? https://t.co/FRbWAt0wPH,17,2,2,4,2022-01-16,11,Sunday,7,19,6
1482674273651240962,2022-01-16 11:21:08,"#Terpopuler Tiga pemuda di Yogyakarta yakni Venzha Christ, Erix Soekamti dan Grayce Soba membangun simulasi analog hidup di Mars. Keren!  https://t.co/5sK0VdLVKp",18,1,2,2,2022-01-16,11,Sunday,7,20,3
1482672860049068033,2022-01-16 11:15:31,"Ahmad Sahroni selaku ketua organizing committee Formula E punya mimpi besar, yakni setelah Formula E bukan tidak mungkin Jakarta menggelar Formula 1. https://t.co/bAK8FD0uC8",22,20,3,4,2022-01-16,11,Sunday,7,25,24
1482672844022722563,2022-01-16 11:15:27,Erupsi gunung api bawah laut Tonga memicu tsunami di banyak negara. Ini adalah yang pertama dalam sejarah. https://t.co/1tEYgKMtW7,54,9,16,1,2022-01-16,11,Sunday,7,70,10
1482671851729997829,2022-01-16 11:11:30,Sejumlah pasien COVID-19 mengalami beberapa gejala tak biasa saat terinfeksi virus Corona. Salah satunya ukuran penis menyusut. Berikut penjelasannya. https://t.co/G4to6HtefP,10,4,2,1,2022-01-16,11,Sunday,7,12,5
1482670267277221888,2022-01-16 11:05:13,"Delapan penumpang KM 3 Bersaudara yang dilaporkan tenggelam di Perairan Kepulauan Maluku, ditemukan selamat dan satu penumpang lainnya masih dalam pencarian. https://t.co/StAgDWcQCB",8,0,0,0,2022-01-16,11,Sunday,7,8,0
1482669746634072067,2022-01-16 11:03:08,"Jepang dilanda tsunami imbas letusan gunung berapi bawah laut di Tonga. Sejumlah kapal nelayan di Jepang sampai terbalik, tenggelam hingga hanyut. https://t.co/suCuzZqRyj",58,0,14,0,2022-01-16,11,Sunday,7,72,0
1482668828937134080,2022-01-16 10:59:30,"Ashanty memberikan kabar terkait kesehatannya. Setelah menjalani karantina di rumah sakit, ia dinyatakan negatif COVID-19. Alhamdulillah. https://t.co/doPG49qbcY",59,33,1,5,2022-01-16,10,Sunday,7,60,38
1482667828247506948,2022-01-16 10:55:31,"Nama daerah di Gunungkidul ini cukup aneh untuk diucapkan, Dukuh Janganmati. Bagaimana sejarahnya? https://t.co/gnDRBifhz2",19,7,6,1,2022-01-16,10,Sunday,7,25,8
1482666849263357956,2022-01-16 10:51:38,"Romelu Lukaku dan para pemain ofensif Chelsea lainnya dapat kritik keras dari sang manajer, Thomas Tuchel. Mereka diminta jangan unjuk gigi alih-alih sembunyi! https://t.co/MNW90Xw7QF",12,0,2,1,2022-01-16,10,Sunday,7,14,1
1482666085325361152,2022-01-16 10:48:36,Anthony Martial disebut Ralf Rangnick menolak masuk skuad saat Manchester United melawan Aston Villa. Striker Prancis membantahnya. https://t.co/vJYcrZvATJ,5,0,1,0,2022-01-16,10,Sunday,7,6,0
1482664324455874562,2022-01-16 10:41:36,"Jumlah kasus positif COVID-19 di Indonesia bertambah 855, Minggu (16/1/2022). Total kasus positif menjadi 4.271.649, sembuh 4.118.874, dan meninggal 144.170. https://t.co/n1Q3QHOv8t",10,2,4,3,2022-01-16,10,Sunday,7,14,5
1482663827288248321,2022-01-16 10:39:37,"""Hasil trajectory kasus Covid-19 di Afrika Selatan, puncak gelombang Omicron diperkirakan terjadi pada pertengahan Februari hingga awal Maret ini,"" kata Luhut. https://t.co/9ou8AA826D",16,8,4,1,2022-01-16,10,Sunday,7,20,9
1482663515668287492,2022-01-16 10:38:23,"Jumlah kasus positif COVID-19 di Indonesia bertambah 855, Minggu (16/1/2022). Total kasus positif menjadi 4.271.649, sembuh 4.118.874, dan meninggal 144.170. https://t.co/vrr3IHj8Aj",17,1,10,2,2022-01-16,10,Sunday,7,27,3
1482662512277528579,2022-01-16 10:34:24,"Waspada dengan infeksi cacing kremi, bisa menyerang tubuh manusia, tak terkecuali vagina. Begini cara mencegah gatal-gatal gegara parasit nakal. Catat! https://t.co/1WdxewmwBw",11,1,2,1,2022-01-16,10,Sunday,7,13,2
1482661728915709953,2022-01-16 10:31:17,"Detik-detik bencana longsor di Desa Ciherang, Sumedang, Jawa Barat pada Sabtu (15/1) pukul 16.30 WIB terekam kamera warga. Terjadi hujan deras di lokasi. https://t.co/t0dwKFppvW",21,1,3,0,2022-01-16,10,Sunday,7,24,1
1482661473444900864,2022-01-16 10:30:16,"""Benda itu pada dasarnya adalah struktur buatan yang dibangun oleh peradaban pintar dengan tujuan barangkali untuk mengumpulkan energi,"" kata NASA.  https://t.co/MRsl7NtTe0",17,1,1,1,2022-01-16,10,Sunday,7,18,2
1482658456662421505,2022-01-16 10:18:17,Bupati Bandung Dadang Supriatna akan melakukan relokasi kepada warga yang tinggal di sekitar lokasi longsor Pangalengan. https://t.co/a5Zoj7g0HO,11,0,1,0,2022-01-16,10,Sunday,7,12,0
1482657951252983811,2022-01-16 10:16:16,Apakah kamu termasuk orang yang kreatif? Bila iya maka teka-teki korek api ini mungkin bukan tantangan yang berarti. Coba buktikan dengan menjawabnya. https://t.co/kK58gu0nnV,2,1,1,0,2022-01-16,10,Sunday,7,3,1
1482657928872177665,2022-01-16 10:16:11,Aksi sebuah sedan berpelat merah lawan arah di Bekasi viral. Polisi bergerak melakukan penelusuran. https://t.co/FvhP7H2LoZ,9,0,2,0,2022-01-16,10,Sunday,7,11,0
1482657927576141835,2022-01-16 10:16:11,BPBD Jepara masih terus waspada mengingat cuaca masih mendung gelap dan berpotensi hujan deras. https://t.co/70YLP8JxaH,6,0,1,0,2022-01-16,10,Sunday,7,7,0
1482657447147880449,2022-01-16 10:14:16,"Krisis air terjadi di sejumlah wilayah di Jakarta Utara. Menanggapi hal itu, Wagub Riza berupaya pihaknya dapat memenuhi kebutuhan air bersih untuk warganya. https://t.co/GBVvLMRoH9",4,2,1,1,2022-01-16,10,Sunday,7,5,3
1482656954707234819,2022-01-16 10:12:19,"Usai laga Aston Villa vs MU, Bruno Fernandes rupanya menghampiri wasit dan dengan kesal menanyakan sesuatu yang ia yakini sebagai akal-akalan tim lawan. https://t.co/LbeJiufMY1",0,0,1,0,2022-01-16,10,Sunday,7,1,0
1482655950108598272,2022-01-16 10:08:19,Kapolda Metro Jaya Irjen Fadil Imran sudah berencana menggelar ajang serupa di tempat lain. Bulan depan rencananya ada di Bekasi hingga Serpong. https://t.co/0BXNurhDpO,8,1,1,0,2022-01-16,10,Sunday,7,9,1
1482655119032389633,2022-01-16 10:05:01,Kemenkes RI mengungkap hasil penelitian yang membandingkan efekivitas vaksin booster COVID-19 secara homolog dan heterolog. Bagaimana hasilnya? https://t.co/MLmkwllaho,8,1,0,1,2022-01-16,10,Sunday,7,8,2
1482654422937264130,2022-01-16 10:02:15,"Kota Beijing, China melaporkan kasus pertama transmisi lokal Covid-19 varian Omicron. Akibatnya kuil ditutup dan terjadi antrean Covid-19. https://t.co/mxbOf1gIjC",6,1,0,0,2022-01-16,10,Sunday,7,6,1
1482654065888743424,2022-01-16 10:00:50,KBRI Wellington menyampaikan ada empat WNI di Tonga yang tidak bisa dihubungi akibat putusnya kabel komunikasi bawah laut. https://t.co/VPp3deeJDz,39,2,5,0,2022-01-16,10,Sunday,7,44,2
1482653555693654016,2022-01-16 09:58:48,Sejumlah peserta street race Polda Metro Jaya mengaku puas bisa geber laju sepeda motornya di depan petugas kepolisian. https://t.co/UaUdSNAJ0Y,6,2,0,0,2022-01-16,9,Sunday,7,6,2
1482652792259063808,2022-01-16 09:55:46,Kasal Laksamana TNI Yudo Margono meresmikan monumen pesawat tempur di Madiun. Pesawat tempur yang dibuat monumen jenis Nomad N-24 buatan Australia tahun 1984. https://t.co/5mfDbn0sUd,7,0,0,0,2022-01-16,9,Sunday,7,7,0
1482652068934569995,2022-01-16 09:52:54,"Usai laga Aston Villa vs MU, Bruno Fernandes rupanya menghampiri wasit dan dengan kesal menanyakan sesuatu yang ia yakini sebagai akal-akalan tim lawan. https://t.co/wuJwjakcUp",6,1,0,1,2022-01-16,9,Sunday,7,6,2
1482651797676343300,2022-01-16 09:51:49,Pemerintah Kabupaten Lebak resmi menetapkan status tanggap darurat bencana gempa selama 14 hari ke depan. https://t.co/gt4EO9Kj2B,10,0,2,0,2022-01-16,9,Sunday,7,12,0
1482651572207329282,2022-01-16 09:50:55,"Tutupnya pabrik Foxconn perakit iPhone di India ternyata menyimpan banyak masalah besar, yaitu buruknya kondisi kehidupan para buruh. https://t.co/7Nx78u4C5J",405,27,145,23,2022-01-16,9,Sunday,7,550,50
1482650549858230273,2022-01-16 09:46:52,"Sederet jurusan ini menjadi plihan favorit siswa IPA pada SNMPTN 2021. Jaminan masa depannya tinggi. Jurusan apa saja ya?

via: detikedu https://t.co/9WBa9yD4Fo",10,1,4,1,2022-01-16,9,Sunday,7,14,2
1482649316497973252,2022-01-16 09:41:58,"Snowdrop episode 10 membuat penontonnya terus dilanda kecemasan. Sebab Yoo In Na sebagai mata-mata Korea Utara, tega melakukan hal ini pada Jisoo Blackpink. https://t.co/I46oIclySG",9,2,3,0,2022-01-16,9,Sunday,7,12,2
1482648058441740290,2022-01-16 09:36:58,"Ketum JoMan Noel siap meminta Dosen UNJ Ubeidillah membeberkan data terkait laporanya soal Kaesang dan Gibran ke KPK. Noel ancam akan melaporkan balik Ubeidillah. Ubeidillah tak gentar, ia justru bertanya balik soal siapa Noel.

Menurut kalian, siapa pendapatnya yang lebih pas? https://t.co/Gb8Dsbi8RO",1343,568,307,114,2022-01-16,9,Sunday,7,1650,682
1482647061103321090,2022-01-16 09:33:00,"Youtuber sekaligus petinju kondang, yakni Logan Paul, telah rugi USD 3,5 juta atau sekitar Rp 50 miliar. Setelah ia memboyong kartu pokemon palsu. https://t.co/IyDtea4PDP",7,0,2,0,2022-01-16,9,Sunday,7,9,0
1482646242584936451,2022-01-16 09:29:45,Apa sebenarnya yang menyebabkan harga rumah sultan anjlok gila-gilaan? https://t.co/oEsx4YIeJH,9,0,4,0,2022-01-16,9,Sunday,7,13,0
1482644935086157831,2022-01-16 09:24:33,"Gempa M 4.5 terjadi di Pacitan, Jatim. Gempa hingga Bantul dan Gunung Kidul, Jateng, namun warga Pacitan tidak merasakannya. https://t.co/aZ9imIvnDD",30,4,10,1,2022-01-16,9,Sunday,7,40,5
1482643633815883776,2022-01-16 09:19:23,"Faisal tak menutup kemungkinan memberikan izin Doddy Sudrajat jika ingin ajak Gala Sky pergi. Tapi, ada pesan yang harus diingat Doddy. Apa itu? https://t.co/gsAAXpXR1R",11,2,3,0,2022-01-16,9,Sunday,7,14,2
1482643409202462722,2022-01-16 09:18:29,John Ausonius bisa dikenal sebagai perampok bank sekaligus pembunuh keji dari Swedia. Begini kisahnya. https://t.co/UtbCcAI08f,6,1,2,2,2022-01-16,9,Sunday,7,8,3
1482642379589185543,2022-01-16 09:14:24,"Warga mengungkap koper dikira berisi bom di Makassar, Sulsel diletakkan oleh dua orang anak kecil. Aksi dua bocah tersebut terekam kamera pengawas atau CCTV. https://t.co/BBlovCpXvx",9,0,3,0,2022-01-16,9,Sunday,7,12,0
1482641895125835779,2022-01-16 09:12:28,"Seperti halnya pisau, otak juga perlu diasah agar selalu tajam. Otak juga butuh diolahragakan agar lebih berstamina untuk menyambut awal pekan. Yuk dicoba! https://t.co/vYrDwuk5C5",18,14,3,0,2022-01-16,9,Sunday,7,21,14
1482640413429309440,2022-01-16 09:06:35,"Pihak Tan Paulin membantah semua tuduhan miring, pandangan dan pendapat yang mengatakan bahwa pihaknya adalah pelaku bisnis batubara yang melanggar aturan. https://t.co/yNN6MGUYvd",6,1,1,0,2022-01-16,9,Sunday,7,7,1
1482639076717219840,2022-01-16 09:01:16,"Adegan Kinan bongkar perselingkuhan Aris di Layangan Putus ternyata contoh sikap gaslighting, Bunda. Berikut ini penjelasannya menurut pakar psikologi. #detikNetwork  https://t.co/yTppFGK5PQ",12,0,11,3,2022-01-16,9,Sunday,7,23,3
1482637943009427461,2022-01-16 08:56:46,"A (12), bocah perempuan di Tangsel berhasil selamat dari penculikan usai lompat dari atas motor penculiknya. Simak kisah selengkapnya: https://t.co/Tbf5xgqAjE",20,0,4,0,2022-01-16,8,Sunday,7,24,0
1482636957066928128,2022-01-16 08:52:51,50 HP bakal diblokir oleh WhatsApp di 2022 ini lantaran perangkat tersebut tidak menjalankan sistem operasi yang disyaratkan. Ini daftarnya:  https://t.co/7z0VCUWivh,33,3,14,1,2022-01-16,8,Sunday,7,47,4
1482635870884745218,2022-01-16 08:48:32,"Warga Pondok Bambu, Jakarta Timur mengeluhkan persoalan banjir yang sering menghampiri. Mereka bahkan hingga harus 'patungan' beli 5 pompa air. https://t.co/EZXn7FsQPX",51,20,7,16,2022-01-16,8,Sunday,7,58,36
1482635617536200704,2022-01-16 08:47:31,Berakhir sudah usaha terakhir petenis Novak Djokovic untuk tetap di Australia. Bandingnya ditolak sehingga akan segera kena deportasi. https://t.co/3VGHLI4Uyu,9,1,0,3,2022-01-16,8,Sunday,7,9,4
1482634626917179396,2022-01-16 08:43:35,"Pakar infeksi AS, dr Faheem Younus, mengumumkan dirinya kena COVID-19. Dokter keturunan Pakistan ini sempat beken di Indonesia gara-gara 'Susu Beruang'. https://t.co/FENKsD7MYG",10,2,2,1,2022-01-16,8,Sunday,7,12,3
1482633526734372864,2022-01-16 08:39:13,"#Foto Kegiatan street race yang digagas Polda Metro Jaya berlangsung di Ancol, Jakarta Utara, hari ini. Seperti apa keseruannya? Lihat yuk! https://t.co/sMdA8vN8zf",9,0,1,1,2022-01-16,8,Sunday,7,10,1
1482631639142387714,2022-01-16 08:31:43,Fasial menyambut keinginan Doddy Sudrajat untuk kembali bersilaturahmi. Faisal tak menutup kemungkinan nanti Doddy bisa pergi dengan Gala Sky. https://t.co/iYM8VP63Wf,6,0,0,1,2022-01-16,8,Sunday,7,6,1
1482630586338529280,2022-01-16 08:27:32,#Terpopuler Shandy Purnamasari mengenakan busana adat Jawa di ulang tahun ke-5 MS Glow. Seperti apa gaya Shandy saat memadukan hijab dengan paes Jawa? https://t.co/nDkQ6kVr73 https://t.co/vE0fLMabOf,36,1,2,1,2022-01-16,8,Sunday,7,38,2
1482628746414854144,2022-01-16 08:20:13,Jembatan Penyeberangan Orang (JPO) di Jalan Sudirman tepatnya di dekat Halte Transjakarta Karet ini didesain unik seperti kapal pinisi. Bagaimana tanggapan warga? https://t.co/PEqV1dNv56,102,29,30,4,2022-01-16,8,Sunday,7,132,33
1482627345861206018,2022-01-16 08:14:39,"Pada masanya, BlackBerry digandrungi salah satunya karena keyboard fisik. Di kemudian hari, justru keyboard itu yang dinilai menjadi penyebab keruntuhannya. https://t.co/MsV0Hbkcss",9,1,2,0,2022-01-16,8,Sunday,7,11,1
1482626065281564675,2022-01-16 08:09:34,"Facebook berubah namanya menjadi Meta induk perusahaan yang menaungi Facebook, Instagram, WhatsApp, Oculus, dan lainnya. Ada kecurigaan di baliknya. https://t.co/I2I0pbHXGH",18,2,4,1,2022-01-16,8,Sunday,7,22,3
1482624526349664258,2022-01-16 08:03:27,Belakangan muncul deklarasi dukungan Prabowo-Jokowi di Pemilu 2024. Deklarasi tersebut lantas menuai respons dari kalangan politikus. https://t.co/XmOImZKpuy,11,10,1,3,2022-01-16,8,Sunday,7,12,13
1482623367043760128,2022-01-16 07:58:51,"#Foto Pernahkah kalian alami hal cukup unik, ketika bertemu orang lain yang memiliki perawakan dan pakaian yang serupa. Seperti yang dialami orang-orang ini. https://t.co/veztVMtMxU",6,0,1,0,2022-01-16,7,Sunday,7,7,0
1482622379952156677,2022-01-16 07:54:55,Kekayaan yang dihasilkan Elon Musk pada 2021 sangat mengejutkan karena adanya peningkatan yang signifikan. Segini jumlah kekayaan Elon Musk:  https://t.co/rWfpvwndAg,21,2,1,3,2022-01-16,7,Sunday,7,22,5
1482621354683899904,2022-01-16 07:50:51,James Ward-Prowse baru saja menambah koleksi gol dari tendangan bebas di Premier League. Jumlahnya kini cuma kalah dari David Beckham. Simak daftarnya! https://t.co/3dpBq6G86A,7,0,1,0,2022-01-16,7,Sunday,7,8,0
1482620105196552197,2022-01-16 07:45:53,"Tergiur dengan kesuksesan Ghozali yang menjual foto selfienya di NFT, beberapa orang ini ikutan dengan menjual gambar makanan. https://t.co/fZM4YLpPb5",25,4,2,4,2022-01-16,7,Sunday,7,27,8
1482619123255422980,2022-01-16 07:41:59,Kementerian Komunikasi dan Informatika pun buka suara soal fenomena orang RI ramai-ramai jual NFT foto selfie e-KTP. Ini kata Kominfo.  https://t.co/6vchhPWIwN,13,0,0,1,2022-01-16,7,Sunday,7,13,1
1482617749067255808,2022-01-16 07:36:31,"Varian Omicron kini sudah menyebar di Indonesia. Tak hanya lebih mudah menular, varian ini juga punya potensi kebal terhadap vaksin COVID-19, benarkah? https://t.co/eQxZmn9FWA",12,8,4,0,2022-01-16,7,Sunday,7,16,8
1482617502425305092,2022-01-16 07:35:32,"Detik-detik letusan Gunung Hunga Tonga-Hunga Ha'apai terekam Himawari-8, sebuah satelit yang dioperasikan oleh Badan Meteorologi Jepang. https://t.co/vbbkqiMyz8",30,0,14,0,2022-01-16,7,Sunday,7,44,0
1482617013205970944,2022-01-16 07:33:36,Banyak warga Indonesia yang salah kaprah menanggapi ramainya NFT. Tak sedikit mereka menjual foto selife e-KTP di platform jual beli NFT.  Ini lho bahayanya! https://t.co/grGwEAZomR,29,27,8,23,2022-01-16,7,Sunday,7,37,50
1482616137099718658,2022-01-16 07:30:07,"Ghozali Everyday mendapat Rp 1,5 miliar setelah menjual koleksi NFT foto selfie di OpenSea. Kenapa ya orang membeli NFT? Ini 5 alasannya.

via: detikedu https://t.co/y1xn4Zg2MN",43,2,5,1,2022-01-16,7,Sunday,7,48,3
1482615121906221062,2022-01-16 07:26:05,"Selama delapan tahun, seorang pria mencari hard disk berisi 7.500 Bitcoin di tumpukan sampah. Nilainya Rp 5 triliun!  https://t.co/S7URItJMm9",27,6,11,4,2022-01-16,7,Sunday,7,38,10
1482613065128587265,2022-01-16 07:17:55,#Foto Tonga berduka. Negara kecil ini diterjang tsunami karena adanya erupsi dari gunung bawah laut. Tahu nggak negara ini sangat indah. Lihat potretnya! #Tonga https://t.co/0R2uOpZ1hK,27,0,14,1,2022-01-16,7,Sunday,7,41,1
1482612065529384962,2022-01-16 07:13:56,"Tanggul beton di Pondok Bambu, Jaktim bikin resah warga karena menghalangi akses jalan. Tanggul itu kini sudah dirobohkan! https://t.co/TgKVF6AQO2",9,0,2,0,2022-01-16,7,Sunday,7,11,0
1482610673096040448,2022-01-16 07:08:24,Berikut detik-detik erupsi yang picu tsunami di Tonga. #Tsunami #Tonga https://t.co/DbAYNVDX8g,23,0,10,1,2022-01-16,7,Sunday,7,33,1
1482610282774024192,2022-01-16 07:06:51,Mahfud Md ungkap adanya dugaan pelanggaran hukum di balik proyek satelit di Kemhan pada 2015. Berikut 6 hal terbaru seputar penyidikan kasus tersebut. https://t.co/XFpNz7ZEsr,10,0,4,0,2022-01-16,7,Sunday,7,14,0
1482609988166168580,2022-01-16 07:05:41,"Ajang India Open 2022 sudah mencapai babak final. Indonesia menempatkan satu wakil di babak final, Hendra Setiawan/Mohammad Ahsan. Ini Jadwal bermainnya. https://t.co/4so46GyqZZ",15,0,3,0,2022-01-16,7,Sunday,7,18,0
1482608803719827463,2022-01-16 07:00:59,Dua torehan monumental Kadir akhirnya terkuak pada 1 Desember 2021. Pada hari tersebut FIFA merilis daftar pemain yang telah tampil sebanyak 100 kali bersama tim nasional di level A FIFA. #CNNIndonesia #detikNetwork  https://t.co/lmWD0ieUBI,5,0,2,0,2022-01-16,7,Sunday,7,7,0
1482608518662348800,2022-01-16 06:59:51,"Wakil Ketua PAC PDIP Kecamatan Temanggung, mendadak mengembalikan bantuan dari Gubernur Jawa Tengah Ganjar Pranowo. Begini kilas kasusnya. https://t.co/5MvrUnrq6m",11,0,1,0,2022-01-16,6,Sunday,7,12,0
1482607519038160896,2022-01-16 06:55:52,"Beredar video Bupati Penajam Paser Utara, Abdul Gafur di dalam sebuah pesawat jet pribadi. Tampak Gafur sedang makan disuapi oleh istrinya. https://t.co/0BpflDWtUT",13,0,3,0,2022-01-16,6,Sunday,7,16,0
1482606499914469376,2022-01-16 06:51:49,"Fico Fachriza menangis tersedu ketika dipeluk sang kakak, Ananta Rispo. Rispo yang memberi dukungan untuk Fico dalam menjalani proses hukum. #FicoFachriza https://t.co/KAarFofiax",7,1,0,0,2022-01-16,6,Sunday,7,7,1
1482605257930776576,2022-01-16 06:46:53,Kali ini tim d'House Hunter mendatangi Dramaga dan mencari rumah-rumah yang cocok untuk kamu yang lagi cari rumah di dekat IPB. Nih daftarnya: https://t.co/4rDXrEFNE9,5,1,3,0,2022-01-16,6,Sunday,7,8,1
1482603770651582466,2022-01-16 06:40:59,Akun Ghozali Everyday di OpenSea viral karena penjualan foto selfie NFT yang mencapai miliaran rupiah. Begini awal mulanya.... https://t.co/nF0kPW6vvX,37,3,4,1,2022-01-16,6,Sunday,7,41,4
1482602644535484416,2022-01-16 06:36:30,"Dari 748 kasus varian Omicron RI, 569 adalah kasus impor dari pelaku perjalanan luar negeri. Arab Saudi jadi negara yang paling banyak menyumbang kasus impor. https://t.co/aAumDJS5N4",45,18,19,6,2022-01-16,6,Sunday,7,64,24
1482601645309583360,2022-01-16 06:32:32,Heboh pelajar mesum di pinggir jalan di Makassar. Pelaku diselidiki polisi. https://t.co/F6MHirt0M8,5,1,3,2,2022-01-16,6,Sunday,7,8,3
1482600554480164864,2022-01-16 06:28:12,"Banting harga! Harga rumah mewah di Jakarta makin murah, jika dibandingkan dengan sebelum masa pandemi harganya mengalami terkoreksi. https://t.co/70RGaABXvF",9,0,3,1,2022-01-16,6,Sunday,7,12,1
1482599517061058561,2022-01-16 06:24:04,JPO di Jalan Sudirman tepatnya di dekat Halte Transjakarta Karet ini didesain unik seperti kapal pinisi. Bagaimana ya tanggapan warga? https://t.co/z3P6caI96H,43,13,7,4,2022-01-16,6,Sunday,7,50,17
1482598753190268928,2022-01-16 06:21:02,BMKG Jepang mengatakan setidaknya 210.000 warga diminta untuk menjauh dari pantai. #tsunami #jepang https://t.co/8th4qaIZpI,33,0,15,1,2022-01-16,6,Sunday,7,48,1
1482598003911364609,2022-01-16 06:18:04,Sering konsumsi junk food atau konsumsi secara berlebihan juga memicu risiko diabetes. Ini penjelasan ahli gizi: https://t.co/w54zVlSNUK,9,0,4,0,2022-01-16,6,Sunday,7,13,0
1482596979238744064,2022-01-16 06:13:59,"Dua pekerja di Bandara ini bukanlah pejabat kelas atas. Namun, kejujuran mereka jelas kelas atas. Berikut kabar inspiratif mengenai kejujuran dari dua bandara. https://t.co/emSK2vyEdJ",119,4,13,5,2022-01-16,6,Sunday,7,132,9
1482595959125299200,2022-01-16 06:09:56,"Mulai dari foto-foto makanan seperti kue lapis hingga foto KTP dijual dalam bentuk NFT. Warga mungkin berharap bisa seperti Ghozali yang meraup hingga Rp 1,5 miliar. https://t.co/Z2v42EBVS1",17,4,6,4,2022-01-16,6,Sunday,7,23,8
1482594462119473154,2022-01-16 06:03:59,"Jika kamu termasuk yang ingin lebih langsing, ini beberapa cara mengecilkan perut dengan cepat secara alami dan mudah dilakukan: https://t.co/I3MDwxtxnM",24,1,7,2,2022-01-16,6,Sunday,7,31,3
1482593560889339906,2022-01-16 06:00:24,"#Terpopuler Universitas Kyoto di Jepang tengah apes, karena mereka kehilangan data hasil penelitian penting sebesar 77TB. Kok bisa? https://t.co/syixXEHz9M",6,0,4,0,2022-01-16,6,Sunday,7,10,0
1482592520819380224,2022-01-16 05:56:16,Epidemiolog Dicky Budiman mengingatkan bahaya Omicron untuk anak-anak. Hak tersebut membuat pemberlakuan PTM disoroti. https://t.co/eAxNXMxAPq,22,5,5,0,2022-01-16,5,Sunday,7,27,5
1482591258979848203,2022-01-16 05:51:16,"Ada produk miras yang dibuat tanpa kandungan alkohol. Meskipun tidak mengandung alkohol, tapi miras ini tidak bisa mendapat sertifikat halal dari MUI. https://t.co/57KCihR8KT",25,4,4,8,2022-01-16,5,Sunday,7,29,12
1482590269723795461,2022-01-16 05:47:20,Tim patroli Perintis Presisi Polda Metro Jaya dibentuk kepolisian. Anggota tim patroli ini bakal menciptakan keamanan di DKI Jakarta supaya warga tidur nyenyak. https://t.co/FLtPxEMM5a,20,5,5,2,2022-01-16,5,Sunday,7,25,7
1482587141406445569,2022-01-16 05:34:54,Ralf Rangnick begitu kecewa Manchester United gagal menang usai sempat unggul dua gol dari Aston Villa. Ia menilai hasil imbang ini serasa seperti kekalahan. https://t.co/juseYZdDba,10,0,3,2,2022-01-16,5,Sunday,7,13,2
1482586148572704773,2022-01-16 05:30:57,"Paulo Dybala menegaskan selebrasi gol ke gawang Udinese bukan untuk petinggi Juventus. Andai tak ada yang percaya dengan klaim itu, La Joya juga tak peduli. https://t.co/kEoxk9HhQg",7,0,4,0,2022-01-16,5,Sunday,7,11,0
1482584884191375361,2022-01-16 05:25:56,Mantan ilmuwan NASA mengungkap rencananya untuk mengubah Mars jadi planet yang bisa dihuni oleh manusia. Ini caranya:  https://t.co/ziqUIBAIiP,16,1,7,1,2022-01-16,5,Sunday,7,23,2
1482583641859448842,2022-01-16 05:20:59,"Kasus COVID-19 ditemukan di belasan sekolah di Jakarta. Meski demikian, Pemprov DKI memastikan PTM 100 persen masih aman dijalankan. https://t.co/DLCpHIsEip",6,1,5,0,2022-01-16,5,Sunday,7,11,1
1482582148372746241,2022-01-16 05:15:03,Eks Ketua MK Jimly Asshiddiqie menyebut Ahok dan Anies adalah bangsa Indonesia asli. Ini ungkapannya.  https://t.co/eMR6tRaXPU,47,20,3,7,2022-01-16,5,Sunday,7,50,27
1482579669031530497,2022-01-16 05:05:12,"Ada banyak kekhawatiran di antara para orang tua yang menemani anaknya vaksin, salah satunya, apakah setelah vaksin boleh minum es? Simak di sini: https://t.co/nQVtv7FpNp",8,1,4,4,2022-01-16,5,Sunday,7,12,5
1482578341572091906,2022-01-16 04:59:56,Toyota Avanza kembali menyabet gelar mobil paling laris di Indonesia sepanjang tahun 2021. Ini 20 mobil terlaris di Indonesia. https://t.co/y7VVuC3bm6,9,0,2,1,2022-01-16,4,Sunday,7,11,1
1482576851558191105,2022-01-16 04:54:01,"#Foto Beginilah potret Bu Guru Ninuk sang pengajar di SLB Tunarungu Santi Rama, Jakarta Selatan. Dulunya, Ia juga sempat menjadi pelajar di sekolah tersebut. https://t.co/M55BHkhr66",20,0,6,1,2022-01-16,4,Sunday,7,26,1
1482575851631882240,2022-01-16 04:50:02,"Dari berbagai eksperimen yang dilakukan ilmuwan, yang satu ini terbilang unik. Ikan diajari cara menyetir mobil di darat. Bagaimana caranya? https://t.co/LxfkJDEFwW",5,0,3,2,2022-01-16,4,Sunday,7,8,2
1482574522117148679,2022-01-16 04:44:45,Berikut tiga cara membedakan STNK asli dan palsu biar kamu tidak tertipu saat membeli kendaraan bekas. Simak ya! https://t.co/itBrut1aJc,49,0,15,0,2022-01-16,4,Sunday,7,64,0
1482573284717867010,2022-01-16 04:39:50,"TNI AL resmi mengoperasikan dua Kapal Perang Republik Indonesia baru. Salah satu kapal tersebut, yakni KRI Golok-688 memiliki teknologi siluman. Mantap! https://t.co/oKLbT4rwUu",32,1,2,3,2022-01-16,4,Sunday,7,34,4
1482571791537254403,2022-01-16 04:33:54,"Jika kamu masih penasaran dengan sifat dan kepribadianmu yang sesungguhnya, coba #TesKepribadian yang satu ini yuk. Gambar hati atau wortel yang pertama kali kamu lihat? https://t.co/R6HFpb2Tld",7,1,1,0,2022-01-16,4,Sunday,7,8,1
1482570673973342212,2022-01-16 04:29:28,Tak ada nama Cristiano Ronaldo di starting XI maupun bench Manchester United dalam lawatan ke Aston Villa. Ini alasannya. https://t.co/7GaWskd0Pk,9,0,2,0,2022-01-16,4,Sunday,7,11,0
1482569190557032451,2022-01-16 04:23:34,CEO Dorna Sports Carmelo Ezpeleta sebut enggan tampil di suatu negara jika pemerintahnya menerapkan wajib karantina. Bagaimana MotoGP Mandalika? https://t.co/bVW0XbqQZN,74,35,14,6,2022-01-16,4,Sunday,7,88,41
1482567693291163653,2022-01-16 04:17:37,"#Terpopuler Tukul Arwana sedang berjuang sembuh usai mengalami perdarahan otak. Kini, ia rutin menjalani fisioterapi. https://t.co/8qFlAXflSh",66,7,6,2,2022-01-16,4,Sunday,7,72,9
1482566173455798275,2022-01-16 04:11:35,Smith Soapy adalah penipu legendaris yang berhasil menipu korbannya lewat lotere sabun. Ia berhasil menipu masyarakat dengan modus sabun berhadiah uang. https://t.co/IYJrEetUml,12,0,2,0,2022-01-16,4,Sunday,7,14,0
1482564893924593669,2022-01-16 04:06:30,Apindo resmi melayangkan gugatan kepada Anies Baswedan di Pengadilan Tata Usaha Negara (PTUN). Ini 3 faktanya: https://t.co/vFxJ3A5bZp,23,10,5,2,2022-01-16,4,Sunday,7,28,12
1482563617891434502,2022-01-16 04:01:25,Oka Antara menceritakan toleransi yang ada di keluarga besarnya nih. Salah satunya saat sang Bunda memutuskan untuk pindah agama dari Islam ke Hindu. #detikNetwork https://t.co/v4gnIP5Ibj,12,0,2,0,2022-01-16,4,Sunday,7,14,0
1482562077608792070,2022-01-16 03:55:18,Seorang remaja berusia 19 tahun bernama David Columbo memamerkan kesuksesannya meretas lebih dari 20 Tesla yang tersebar di 13 negara. https://t.co/EkTqP406uA,29,2,8,2,2022-01-16,3,Sunday,7,37,4
1482560453767225348,2022-01-16 03:48:51,"Dear Gemini, selalu lakukan perhitungan ya agar pengeluaran tetap bisa diminimalkan. Bagaimana dengan ramalan zodiak kamu hari ini? https://t.co/4uimdTkBll",8,0,3,1,2022-01-16,3,Sunday,7,11,1
1482558964818747396,2022-01-16 03:42:56,"#Foto Chelsea dikandaskan Manchester City 0-1 sehingga makin keteteran. Netizen pun ramai membahasnya, termasuk performa Lukaku yang bikin emosi. https://t.co/LdYdG9jA7v",11,1,1,0,2022-01-16,3,Sunday,7,12,1
1482557202871246855,2022-01-16 03:35:56,Pengemudi Mercedes Benz terlibat 'adu banteng' dengan pemotor di Jakarta Selatan. Kecelakaan tersebut menewaskan satu pengemudi motor. https://t.co/lvtCQCgf43,9,0,2,0,2022-01-16,3,Sunday,7,11,0
1482556713085677574,2022-01-16 03:33:59,Kemenkes RI mencatat jumlah kasus varian Omicron telah mencapai 748 kasus. Sebanyak 155 kasus di antaranya merupakan transmisi lokal.  https://t.co/Nhy2NKpBH6,45,9,29,12,2022-01-16,3,Sunday,7,74,21
1482555437820088323,2022-01-16 03:28:55,"Aset Hutomo Mandala Putra alias Tommy Soeharto senilai Rp 2,4 triliun yang dilelang negara, nggak laku. Inikah alasannya? #TommySoeharto https://t.co/v5a7JEurgd",19,0,4,0,2022-01-16,3,Sunday,7,23,0
1482554138177253379,2022-01-16 03:23:45,Fenomena Ghozali membuat banyak netizen ingin mencoba peruntungan di OpenSea walaupun NFT yang mereka jual sebagian tidak lazim. https://t.co/0LSv0tdMtv,30,5,3,7,2022-01-16,3,Sunday,7,33,12
1482553079488733185,2022-01-16 03:19:33,Erupsi gunung api bawah laut besar-besaran di Tonga begitu kuat hingga berdampak ke sejumlah negara lainnya. Mulai AS hingga Jepang. https://t.co/h9ctgyF7ea,113,2,24,4,2022-01-16,3,Sunday,7,137,6
1482551352689664003,2022-01-16 03:12:41,Ubedillah lalu mempertanyakan soal kapasitas dan kewenangan Noel untuk meminta data terkait laporannya ke Gibran dan Kaesang. https://t.co/r7JTtPEl33,182,62,26,8,2022-01-16,3,Sunday,7,208,70
1482550584653795330,2022-01-16 03:09:38,#BeritaTerpopuler Minggu ini adalah minggunya Ghozali Everyday. Dia meraup untung besar dari jualan foto selfie NFT. Inilah fakta-fakta pentingnya. https://t.co/S6JI1rqR1S,24,1,2,2,2022-01-16,3,Sunday,7,26,3
1482549594382811138,2022-01-16 03:05:42,"""Kami menyimpulkan bahwa Gala tinggal di tempat nyaman, oleh orang sekitar harus tinggal di tempat yang lebih aman,"" ujar Ketua Komnas PA. https://t.co/Bku2d0rhb3",11,5,1,0,2022-01-16,3,Sunday,7,12,5
1482548293209141249,2022-01-16 03:00:32,Selebrasi gol Paulo Dybala ke gawang Udinese penuh arti. Ada dugaan La Joya memelototi petinggi Juventus di tribune. https://t.co/xjMQHNyHco,9,0,1,1,2022-01-16,3,Sunday,7,10,1
1482547040945123332,2022-01-16 02:55:33,"Tak sedikit hotel indah di dunia yang populer di kalangan traveler. Di lingkup Asia, 5 hotel Bali ini berhasil masuk daftar terindah dan dicari di Instagram. Mantap, Bali! https://t.co/rAxrSs16Fv",26,0,4,3,2022-01-16,2,Sunday,7,30,3
1482545785665474560,2022-01-16 02:50:34,Sandiaga mengajak warga Indonesia berwisata di dalam negeri saja. Ini dilakukan agar pariwisata di Indonesia semakin bergeliat di tengah pandemi COVID-19. https://t.co/sLaQ0X3blN,19,9,2,0,2022-01-16,2,Sunday,7,21,9
1482544488891494402,2022-01-16 02:45:25,Gelombang tsunami menghantam wilayah Tonga akibat adanya letusan gunung api bawah laut. Hal ini membuat Raja Tonga Tupou VI dievakuasi oleh pasukan. https://t.co/NMKF3HM4PF,62,0,12,0,2022-01-16,2,Sunday,7,74,0
1482543237759971337,2022-01-16 02:40:26,Tiga rumah di Kabupaten Tangerang rusak akibat gempa yang terjadi pada Jumat lalu. Sejumlah warga pun mengungsi. https://t.co/2swIZUPPhH,7,0,1,0,2022-01-16,2,Sunday,7,8,0
1482542992061829120,2022-01-16 02:39:28,#Terpopuler Sebuah bayangan yang diduga berasal dari suatu obyek cukup besar wujudnya telah terekam di layanan peta Google Maps. Ini penampakannya:  https://t.co/3R70WkZUFb,28,2,4,0,2022-01-16,2,Sunday,7,32,2
1482541717425381378,2022-01-16 02:34:24,Nobu mengaku mendapatkan tekanan yang hebat usai kasus video syur dengan Gisel merebak. Ia mengaku stres dan depresi. https://t.co/2puk3ZiZJV,57,66,2,4,2022-01-16,2,Sunday,7,59,70
1482540687782518784,2022-01-16 02:30:18,"Di mana saja lokasi vaksin booster Tangerang? Cek di sini untuk mengetahui syarat, biaya, hingga cara mendaftarnya ya! https://t.co/y63z80FJ8f",18,6,2,0,2022-01-16,2,Sunday,7,20,6
1482539425141821440,2022-01-16 02:25:17,"Ganda campuran DKI Jakarta, Gibran/Aisyah, memenangkan Seleknas PBSI 2022. Keduanya menang atas wakil Jawa Tengah. https://t.co/fpZF4Y8ynm",12,0,2,1,2022-01-16,2,Sunday,7,14,1
1482539409014763525,2022-01-16 02:25:14,Yuk latih otak kamu agar bisa lancar memecahkan masalah. Teka-teki ini bisa membuktikan apakah kamu jenius. https://t.co/wi4I4zTiXP,115,77,9,4,2022-01-16,2,Sunday,7,124,81
1482537239171289088,2022-01-16 02:16:36,"Tsunami menghantam wilayah Tonga pada Sabtu (15/1) waktu setempat. Tsunami disebabkan oleh erupsi gunung api bawah laut, Hunga Tonga-Hunga Ha'apai. Berikut detik-detik kejadiannya. https://t.co/ZlDoQWlgbS",1033,56,406,10,2022-01-16,2,Sunday,7,1439,66
1482537176059502592,2022-01-16 02:16:21,Program tersebut sementara ini masih gratis. Namun dalam waktu dekat Kemenhub akan mulai memberlakukan tiket berbayar. https://t.co/YAYvXrqgNJ,21,2,2,1,2022-01-16,2,Sunday,7,23,3
1482535916191236100,2022-01-16 02:11:21,"Penjualan rumah di Pulau Karimunjawa, Jepara jadi sorotan di medsos. Rumah itu dijual murah kepada WNA dan menawarkan unit dengan akses pantai. https://t.co/1s6jJlCHa9",15,4,8,0,2022-01-16,2,Sunday,7,23,4
1482534897629679617,2022-01-16 02:07:18,"MotoGP Mandalika dihelat tidak lama lagi. Buat traveler yang akan menyaksikanya, ini deretan destinasi wisata di Lombok yang bisa disinggahi nanti. https://t.co/cTTZRGg0iC",16,1,4,2,2022-01-16,2,Sunday,7,20,3
1482533449621778435,2022-01-16 02:01:33,"Pihak Dikbud tidak berencana menutup opsi PTM kendati ditemukan Covid-19 varian Omicron, hanya mengimbau agar Satgas Covid-19 di daerah melakukan penelusuran kasus lebih lanjut agar penularan tidak menyebar. #CNNIndonesia #detikNetwork  https://t.co/RguoHCWtFR",13,4,3,1,2022-01-16,2,Sunday,7,16,5
1482531884546633730,2022-01-16 01:55:20,"Jumlah kasus varian Omicron di DKI Jakarta terus meningkat, saat ini total tercatat sebanyak 720 kasus. Sebanyak 153 kasus merupakan transmisi lokal. https://t.co/gBHDvBHdqH",3,2,3,0,2022-01-16,1,Sunday,7,6,2
1482530362186207232,2022-01-16 01:49:17,Letusan gunung bawah laut di Tonga memicu peringatan tsunami hingga ke Amerika Serikat. Seperti yang terjadi di pantai barat AS. Ini penampakannya. https://t.co/BTABkEMu4i,23,1,3,0,2022-01-16,1,Sunday,7,26,1
1482529080654319618,2022-01-16 01:44:11,Pria asal Purwakarta ini tak pernah menduga jodohnya adalah bule asal Jerman. Bagaimana ya keduanya bisa bertemu? Ini kisahnya.... https://t.co/I4D1qN1du7,40,4,3,3,2022-01-16,1,Sunday,7,43,7
1482527530385039360,2022-01-16 01:38:01,Elon Musk membagikan lima nasihat untuk anak muda yang ingin sukses di kehidupan. Ini nasehat dari orang terkaya di dunia:  https://t.co/KLDEACO6pw,40,6,5,1,2022-01-16,1,Sunday,7,45,7
1482525922804781056,2022-01-16 01:31:38,Viral video yang menunjukkan sejumlah belatung di bagian organ intim wanita yang membuat warganet jijik dan syok. Ini tips dari psikolog untuk mengatasinya. https://t.co/VYWJ9An5zZ,14,3,4,1,2022-01-16,1,Sunday,7,18,4
1482523896771452931,2022-01-16 01:23:35,"Selain digunakan untuk bumbu masakan, sereh juga dapat dibuat menjadi teh yang menyehatkan. Racikan teh sereh memiliki beragam manfaat untuk imunitas dan diet. https://t.co/V7vBbolKAi",48,0,13,0,2022-01-16,1,Sunday,7,61,0
1482521913121558528,2022-01-16 01:15:42,"Media sosial digemparkan video belatung di dalam Miss V muncul saat bercinta. Menurut dr Boyke, video tersebut tidak masuk akal. https://t.co/eLuKPp3bGs",14,2,4,1,2022-01-16,1,Sunday,7,18,3
1482519683899219972,2022-01-16 01:06:51,Sampah antariksa berpotensi membuyarkan mimpi Elon Musk untuk menmbangun kehidupan di planet lain dan membuat manusia terperangkap di Bumi. https://t.co/9DFAhaggKW,24,2,5,2,2022-01-16,1,Sunday,7,29,4
1482518143968886786,2022-01-16 01:00:44,Pasien positif COVID-19 varian Omicron di Jawa Timur kini berjumlah 8 orang. Sebanyak tiga di antaranya diketahui masih balita. https://t.co/EvKwyOMNZu,12,1,6,1,2022-01-16,1,Sunday,7,18,2
1482517503037353988,2022-01-16 00:58:11,Korban disekap selama beberapa hari dan diperkosa oleh ketiga pelaku secara bergiliran. Salah satu pelaku masih di bawah umur. https://t.co/oRiBNnL6dE,31,7,8,5,2022-01-16,0,Sunday,7,39,12
1482517485765238789,2022-01-16 00:58:07,Halil seorang atlet renang disabilitas yang berjualan tisu untuk memenuhi kebutuhan sehari-harinya. https://t.co/olr8IY38YE,38,1,7,0,2022-01-16,0,Sunday,7,45,1
1482517464474861569,2022-01-16 00:58:02,PKS berencana ingin membangun koalisi poros nasionalis-religius pada Pilpres 2024. Rencana itu kemudian disambut hangat Partai Golkar dan Demokrat. https://t.co/LE2NgrrlQ1,10,10,1,0,2022-01-16,0,Sunday,7,11,10
1482517004133273606,2022-01-16 00:56:12,Komika Fico Fachriza tertunduk lesu sambil menangis sesenggukan saat ditampilkan dalam jumpa pers di Polda Metro Jaya terkait kasus penyalahgunaan narkoba. https://t.co/MjcgibeIY8,20,12,1,5,2022-01-16,0,Sunday,7,21,17
1482516989574885381,2022-01-16 00:56:08,Pembahasan dugaan pelanggaran hukum pengadaan satelit Kemhan pada 2015 sudah dibahas sejak 2018. Lantas mengapa baru di tahun 2022 kasusnya diusut Kejagung? https://t.co/pqSp4AW8Ik,7,0,2,2,2022-01-16,0,Sunday,7,9,2
1482516629053485057,2022-01-16 00:54:42,"Tim SAR fokus mencari korban di titik koordinat 3°26' 22.47"" S - 127° 25' 52.54"" E, dan Heading 123,07° arah timur dari Pos SAR Namlea. https://t.co/h0Gr9RuubM",5,0,0,0,2022-01-16,0,Sunday,7,5,0
1482516381727870977,2022-01-16 00:53:43,Thomas Tuchel mengakui penampilan Chelsea tak cemerlang di markas Manchester City. Namun Chelsea merasa setidaknya pantas memetik satu poin. https://t.co/8lSuiz5IHy,3,1,1,0,2022-01-16,0,Sunday,7,4,1
1482516130551971844,2022-01-16 00:52:43,"Mefenamic acid adalah obat pereda rasa nyeri atau sakit yang tak tertahankan. Biasanya, obat ini digunakan untuk sakit gigi, sakit kepala, hingga nyeri haid. https://t.co/ObrkIn7Bie",21,0,4,0,2022-01-16,0,Sunday,7,25,0
1482515902990061571,2022-01-16 00:51:49,"Jumlah kasus varian Omicron di DKI Jakarta terus meningkat, saat ini total tercatat sebanyak 720 kasus. Sebanyak 153 kasus merupakan transmisi lokal. https://t.co/0dXpeU4SAk",9,1,3,0,2022-01-16,0,Sunday,7,12,1
1482515884656762880,2022-01-16 00:51:45,Mengeksplorasi wisata di Pangandaran seakan tiada habisnya. Salah satunya ialah Tanah Lot Jawa Barat di Pantai Batuhiu. Indahnya tak kalah dengan Bali. https://t.co/KjWdtHwlG9,1,0,0,0,2022-01-16,0,Sunday,7,1,0
1482515563972808709,2022-01-16 00:50:28,Philippe Coutinho masih memakai gelang pemberian Lionel Messi tiga tahun lalu. Hal itu terungkap dalam sesi foto The Little Magician bersama Aston Villa. https://t.co/DkMph0t6uG,22,1,1,0,2022-01-16,0,Sunday,7,23,1
1482515545551474690,2022-01-16 00:50:24,"Romelu Lukaku seakan menghilang dalam laga Manchester City vs Chelsea. Tampil selama 90 menit, ia minim kontribusi untuk The Blues. https://t.co/u8uBHAuvc4",5,0,2,1,2022-01-16,0,Sunday,7,7,1
1482514269228912641,2022-01-16 00:45:20,Aksinya sosialisasikan vaksinasi COVID-19 dengan Bahasa Kek (bahasa daerah China) tuai pro dan kontra. Polwan ini buka suara. https://t.co/9wj3NUT57P,14,12,0,0,2022-01-16,0,Sunday,7,14,12
1482513778273132547,2022-01-16 00:43:23,Kemnaker melibatkan unsur pekerja atau serikat pekerja melalui penerapan K3 yang terintegrasi dengan Sistem Manajemen K3 (SMK3). https://t.co/o7zSf6Sixs,3,0,1,0,2022-01-16,0,Sunday,7,4,0
1482513281973641218,2022-01-16 00:41:24,Tuduhan AS menyebut Rusia tengah mengirimkan para penyabot terlatih dalam bahan peledak untuk merekayasa alasan menginvasi wilayah Ukraina. https://t.co/QeidzWYDxq,3,0,0,1,2022-01-16,0,Sunday,7,3,1
1482512781089947649,2022-01-16 00:39:25,Polisi menyegel ruangan yang digunakan sebagai aksi striptis di cafe Banyuwangi. Ada dua ruangan karaoke langsung di police line usai menggelar rekonstruksi https://t.co/BYywhcSBtd,7,0,0,0,2022-01-16,0,Sunday,7,7,0
1482511177578074128,2022-01-16 00:33:03,Real Madrid dianggap cuma bisa mengandalkan serangan balik saat mengalahkan Barcelona di Piala Super Spanyol. Pelatih Ancelotti malah bangga dengan hal itu. https://t.co/V0E6VbRscy,7,0,0,0,2022-01-16,0,Sunday,7,7,0
1482510953480704004,2022-01-16 00:32:09,Pandemi COVID-19 yang masih berlangsung tak mengurangi rasa kepedulian polisi di Lamongan. Mereka turun ke desa-desa membagikan nasi dan masker https://t.co/J1CgZLJBmv,9,0,0,2,2022-01-16,0,Sunday,7,9,2
1482510159498858496,2022-01-16 00:29:00,"Speedboat yang diduga mengangkut 19 TKI ilegal asal Sumatera Utara hilang dihantam ombak di Perairan Pulau Rupat, Riau. Tiga orang kini masih dalam pencarian. https://t.co/K3LAF10iDO",11,1,0,1,2022-01-16,0,Sunday,7,11,2
1482509865465819137,2022-01-16 00:27:50,"Beginilah potret Bu Guru Ninuk sang pengajar di SLB Tunarungu Santi Rama, Jakarta Selatan. Dulunya, Ia juga sempat menjadi pelajar di sekolah tersebut. https://t.co/uN7pVSbtUq",17,0,2,0,2022-01-16,0,Sunday,7,19,0
1482508625453240321,2022-01-16 00:22:54,Manchester City masih belum terbendung. Kemenangan atas Chelsea bikin The Citizens makin nyaman di pucuk klasemen Liga Inggris. Persaingan sudah berakhir? https://t.co/LrWKpJMufU,9,1,1,0,2022-01-16,0,Sunday,7,10,1
1482508038540046336,2022-01-16 00:20:34,"Gempa magnitudo (M) 6,6 yang guncang Banten (14/1) menimbulkan berbagai dampak. Selain itu, gempa susulan juga tercatat beberapa kali terjadi. https://t.co/zGprAhnYyl",9,0,0,0,2022-01-16,0,Sunday,7,9,0
1482508037235609601,2022-01-16 00:20:34,"20Detik merangkum kejadian heboh dan menarik dalam sepekan ini. Apa saja, ya? Simak dalam video berikut ini! https://t.co/9FEmB3DxFd",2,1,0,0,2022-01-16,0,Sunday,7,2,1
1482507552843829250,2022-01-16 00:18:38,"Manchester City tampil dominan saat mengatasi Chelsea. Meski tak terlalu banyak bikin peluang bersih, tapi Man City merasa pantas meraih angka penuh. https://t.co/Waih3WN8Me",6,0,0,1,2022-01-16,0,Sunday,7,6,1
1482506804013809670,2022-01-16 00:15:40,Gorontalo memiliki objek wisata baru yang menawarkan suasana dan pemandangan persawahan yang dilengkapi berbagai fasilitas. Penasaran? https://t.co/jhvlhTuqr0,7,2,0,0,2022-01-16,0,Sunday,7,7,2
1482504596501237760,2022-01-16 00:06:54,"Rubbin Sarpong adalah penipu yang memanfaatkan situs kencan online. Tak main-main, pria asal Amerika Serikat ini bisa meraup uang hingga Rp 29 miliar. https://t.co/2nk7bQG0z9",4,0,1,0,2022-01-16,0,Sunday,7,5,0
1482502720405786630,2022-01-15 23:59:26,"Media sosial digemparkan video belatung di dalam Miss V muncul saat bercinta. Menurut dr Boyke Dian Nugraha, SpOG, video tersebut tidak masuk akal. https://t.co/mDgiQkwIrU",32,13,9,4,2022-01-15,23,Saturday,6,41,17
1482501474919800838,2022-01-15 23:54:29,Menko Marves Luhut Pandjaitan memperkirakan puncak kasus Omicron terjadi pada awal Februari. IDI meminta para tenaga kesehatan bersiap hadapi ancaman lonjakan. https://t.co/7WnFRrFPMc,34,34,8,8,2022-01-15,23,Saturday,6,42,42
1482500732834230275,2022-01-15 23:51:32,"Perbasi DKI Jakarta menyongsong semangat anyar di 2022. Induk organisasi basket tertinggi di Ibu Kota tersebut memiliki ketua umum baru, Lexyndo Hakim. https://t.co/q82u0251kH",4,0,0,0,2022-01-15,23,Saturday,6,4,0
1482499978417344513,2022-01-15 23:48:33,Dua orang kontak erat dengan pasien omicron di Kabupaten Malang menjalani isolasi di safe house Rusunawa Kepanjen. Dua orang itu memiliki gejala batuk-pilek. https://t.co/0by812uNrj,14,2,3,5,2022-01-15,23,Saturday,6,17,7
1482499432352526341,2022-01-15 23:46:22,Zahra Muzdalifah menegaskan Timnas Indonesia Wanita tak gentar melawan Australia di Piala Asia Wanita 2022. Negeri Kangguru akan menjadi lawan pertama di India. https://t.co/x3CN6LaNjx,93,3,7,2,2022-01-15,23,Saturday,6,100,5
1482498447479644162,2022-01-15 23:42:28,Persija Jakarta mengumumkan revisi skuad untuk putaran kedua BRI Liga 1 2021. Ada 35 pemain yang didaftarkan Macan Kemayoran untuk mengarungi sisa kompetisi. https://t.co/KCjWjZi9SB,8,0,1,0,2022-01-15,23,Saturday,6,9,0
1482497705691828232,2022-01-15 23:39:31,"Berhubungan seks saat hamil sangat boleh dilakukan, dengan catatan tetap memperhatikan posisi seks yang tepat dan aman. https://t.co/23Nt0Y9qMk",9,0,1,1,2022-01-15,23,Saturday,6,10,1
1482496389523423238,2022-01-15 23:34:17,Pemerintah melaporkan kasus harian positif Corona hari ini sebanyak 1.054 kasus. Paling banyak penambahan kasus baru Corona dilaporkan Provinsi DKI Jakarta. https://t.co/XbA1eYuefv,8,1,3,1,2022-01-15,23,Saturday,6,11,2
1482495889293905924,2022-01-15 23:32:18,"Hal tersebut disampaikan Ida saat mengunjungi Resto Jejamuran di Sleman, Yogyakarta. https://t.co/WFRPo3hIKC",7,3,2,2,2022-01-15,23,Saturday,6,9,5
1482494568000110593,2022-01-15 23:27:03,"Banyaknya sampah dari limbah rumah tangga yang terseret arus terlihat menumpuk di Pantai Dadap, Indramayu, Jawa Barat. https://t.co/kNA6jSJE2O",25,5,4,0,2022-01-15,23,Saturday,6,29,5
1482493325311721473,2022-01-15 23:22:06,"Kecelakaan beruntun libatkan 4 truk terjadi di Jalan Raya Ngawi-Mantingan KM 30-31. Tak ada korban jiwa dalam insiden tersebut, namun satu orang dilaporkan luka https://t.co/mxOqyloI4H",13,0,1,0,2022-01-15,23,Saturday,6,14,0
1482491923558457345,2022-01-15 23:16:32,"Hal itu dikatakan Bamsoet usai menjadi bintang tamu dalam program komedi televisi Klinik Tendean di Trans TV, Jumat (14/1). https://t.co/kzVpHlkmdH",19,2,2,4,2022-01-15,23,Saturday,6,21,6
1482490870515617793,2022-01-15 23:12:21,"Pemerintah Provinsi Jawa Timur kembali mendeteksi 7 pasien terkonfirmasi COVID-19 varian Omicron. Kini, total pasien Omicron tercatat ada 8 kasus. https://t.co/lh8btBAo5m",12,0,3,1,2022-01-15,23,Saturday,6,15,1
1482489720848457728,2022-01-15 23:07:47,Sebuah video memuat pengendara motor perempuan yang terkapar gegara kecelakaan di jalan raya viral di media sosial. Perempuan itu tampak mengerang kesakitan. https://t.co/GNkhW54Fb6,17,2,1,1,2022-01-15,23,Saturday,6,18,3
1482488250161893378,2022-01-15 23:01:56,Prabowo Subianto dan Joko Widodo (Jokowi) didorong maju kembali pada pilpres 2024. Lantas bagaimana tanggapan Gerindra Ketumnya didorong maju bersama Jokowi? https://t.co/HqoEW9qk2R,67,70,11,12,2022-01-15,23,Saturday,6,78,82
1482486490676580355,2022-01-15 22:54:57,"Wanita bernama Indah Safitri (27) tewas bersimbah darah di indekosnya, Kota Semarang, diduga dibunuh. Polisi saat ini memburu suami korban yang kabur. https://t.co/zG1M7xrtl6",4,0,2,2,2022-01-15,22,Saturday,6,6,2
1482485688453013508,2022-01-15 22:51:46,"Seorang ibu berinisial M tewas terlindas truk di Jalan Raya Dadap, Kosambi, Kabupaten Tangerang. M terjatuh dan terlindas truk saat akan menyalip. https://t.co/FgVnbx6kJj",6,0,2,1,2022-01-15,22,Saturday,6,8,1
1482485411976990724,2022-01-15 22:50:40,Juventus bertemu Udinese dalam lanjutan Liga Italia. Bianconeri sukses mengalahkan Le Zebrette 2-0. https://t.co/gqQ9cczhP0,6,0,2,0,2022-01-15,22,Saturday,6,8,0
1482484592510652416,2022-01-15 22:47:24,"Paris Saint-Germain meraih kemenangan 2-0 atas Brest di laga Ligue 1. Les Parisiens mampu meraih tiga angka, meski tanpa Neymar dan Lionel Messi. https://t.co/axuopkjNrS",3,0,1,0,2022-01-15,22,Saturday,6,4,0
1482484576987619330,2022-01-15 22:47:21,"Sepanjang kariernya di Premier League, Philippe Coutinho tak pernah bisa menjebol gawang Manchester United atau bahkan bikin assist. Itu berubah di Aston Villa. https://t.co/j4uEdLA2YV",47,4,7,3,2022-01-15,22,Saturday,6,54,7
1482483955718922243,2022-01-15 22:44:52,"Pohon-pohon di ruas Jl RS Fatmawati, Jaksel, ini bakal ditebang demi pelebaran jalan. Warga di lokasi menyampaikan pendapat. Ada yang setuju, ada yang tidak. https://t.co/mLQrSOd2pa",3,0,2,1,2022-01-15,22,Saturday,6,5,1
1482483432756236293,2022-01-15 22:42:48,Heboh video syur 61 detik disebut mirip artis Nagita Slavina. Polisi memastikan video tersebut palsu dan direkayasa. https://t.co/ev1gjV1Oue,19,0,4,1,2022-01-15,22,Saturday,6,23,1
1482482603898900484,2022-01-15 22:39:30,"Ketua Komisi E DPRD DKI, Iman Satria PTM 100 persen masih bisa berjalan meskipun ditemukan kasus COVID-19 di belasan sekolah. Dia meminta Disdik DKI memantau. https://t.co/6rJgHqQWzI",5,1,3,2,2022-01-15,22,Saturday,6,8,3
1482482319072149506,2022-01-15 22:38:22,Marc Marquez mengungkapkan pengalaman sebagai penderita diplopia. The Baby Alien merasakan ketidakpastian pemulihan gangguan penglihatan tersebut. https://t.co/Xmt9Pl0AZQ,4,0,2,0,2022-01-15,22,Saturday,6,6,0
1482480878047662081,2022-01-15 22:32:39,"Seorang ibu muda warga Desa Banjararum, Kecamatan Singosari, Kabupaten Malang, positif COVID-19 varian Omicron. Lockdwon lokal diberlakukan selama satu pekan. https://t.co/m3IVRVDv1c",21,1,3,3,2022-01-15,22,Saturday,6,24,4
1482479771745402883,2022-01-15 22:28:15,Obrolan Bamsoet dan Hendropriyono juga membahas berbagai kondisi terkini hingga memprediksi masa depan Indonesia. https://t.co/H7B04zoFmj,14,1,3,2,2022-01-15,22,Saturday,6,17,3
1482478370894098432,2022-01-15 22:22:41,"Pemerintah wanti-wanti gelombang ke-3 COVID-19 akibat varian Omicron. Bukannya gejala Omicron lebih ringan dari Delta? Tunggu dulu, begini catatan epidemiolog. https://t.co/tNXRyZIjVE",8,0,5,2,2022-01-15,22,Saturday,6,13,2
1482477241464414209,2022-01-15 22:18:12,Polda Jawa Tengah menilang 34.196 kendaraan selama 12 hari dengan Electronic Law Enforcement (ETLE). Pelanggar terbanyak ada di Kota Surakarta atau Solo. https://t.co/OFhDxWFE5P,6,1,2,1,2022-01-15,22,Saturday,6,8,2
1482476071614394368,2022-01-15 22:13:33,"Eks Juventus, Alessio Tacchinardi, menyamakan Rafael Leao dengan Thierry Henry. Gegara hal itu, dia kena bully di media sosial. https://t.co/ZyGTOtjPcO",3,0,0,0,2022-01-15,22,Saturday,6,3,0
1482474754519052289,2022-01-15 22:08:19,Pria asal Magelang itu dibacok oleh pria yang merupakan kekasih dari kawan chatting-nya. Pelaku beralasan korban mengirim gambar tak senonoh. https://t.co/X62f0mnMdZ,7,3,2,2,2022-01-15,22,Saturday,6,9,5
1482473623495577600,2022-01-15 22:03:49,"Dua studi terpisah menunjukkan bahwa tahun 2021 adalah salah satu tahun terpanas dalam sejarah pencatatan cuaca, yang dimulai pada tahun 1880. https://t.co/9KuXK7SRf4",13,0,4,1,2022-01-15,22,Saturday,6,17,1
1482472582410604546,2022-01-15 21:59:41,"Indonesia mencatat sebanyak 1.054 kasus baru COVID-19, Sabtu (15/1/2022). DKI menyumbang kasus terbanyak dengan jumlah 720. https://t.co/vjRynmjcFk",7,1,3,1,2022-01-15,21,Saturday,6,10,2
1482471841302200324,2022-01-15 21:56:44,Matchday kedua Grup D Piala Afrika 2021 telah tuntas. Nigeria ke 16 besar dan Mesir berhasil menjaga peluang. https://t.co/eRrvrmZZ2Z,7,0,1,0,2022-01-15,21,Saturday,6,8,0
1482469629507387392,2022-01-15 21:47:57,"Hujan deras disertai angin mengguyur Kecamatan Jetis, Ponorogo. Akibatnya, 7 rumah rusak. Lima rumah tertimpa pohon, sedangkan dua lainnya tertimpa antena radio https://t.co/TAHWwnXIOO",13,0,0,0,2022-01-15,21,Saturday,6,13,0
1482468251695296525,2022-01-15 21:42:28,Manchester City vs Chelsea jadi big match Liga Inggris seru malam ini. Kedua tim sudah merilis daftar susunan pemain. https://t.co/kTOTFbo3wG,7,4,1,1,2022-01-15,21,Saturday,6,8,5
1482466668295204864,2022-01-15 21:36:11,Aliana Deveza baru berusia 19 tahun saat merancang pertukaran organ yang menyelamatkan ibunda dan nyawa seseorang yang memerlukan liver untuk menyambung hidup. https://t.co/ChDqp7AC4C,13,0,3,0,2022-01-15,21,Saturday,6,16,0
1482463108237045770,2022-01-15 21:22:02,Wali Kota Surabaya Eri Cahyadi menyebut ada empat kasus Omicron baru di Kota Pahlawan. Keempat pasien tersebut dalam kondisi baik dan CT Valuenya tinggi. https://t.co/DtoRIiUjml,7,0,2,1,2022-01-15,21,Saturday,6,9,1
1482461798712455171,2022-01-15 21:16:50,Millenial Blitar mendeklarasikan Airlangga Hartarto sebagai Capres 2024. Mereka menamakan diri Sedulur Airlangga ini menilai sosok Menko tepat pimpin Indonesia. https://t.co/4Fk8OMgMvc,18,31,1,7,2022-01-15,21,Saturday,6,19,38
1482459808255168515,2022-01-15 21:08:55,"Gelandang Timnas Indonesia, Ricky Kambuaya, berbagi kesan soal Shin Tae-yong. Pelatih asal Korea Selatan itu diakuinya memberi banyak hal positif buat pemain. https://t.co/3tx42mMqBM",21,1,0,0,2022-01-15,21,Saturday,6,21,1
1482458818420396041,2022-01-15 21:04:59,Karim Benzema mengaku ikut serta mengembangkan Vinicius Junior di Real Madrid. Dia membimbing juniornya tersebut untuk bisa mengeluarkan performa terbaik. https://t.co/VTT16qLZhU,11,0,1,0,2022-01-15,21,Saturday,6,12,0
1482456845365256196,2022-01-15 20:57:09,Polisi bakal meningkatkan operasi yustisi selama PPKM level I mencegah penyebaran COVID-19. Terlebih saat ini ada laporan satu warga Madiun terdeteksi Omicron. https://t.co/V2P6TO7uu8,9,2,0,1,2022-01-15,20,Saturday,6,9,3
1482452029486284810,2022-01-15 20:38:01,Fico Fachriza ditangkap polisi terkait kasus narkoba tembakau sintetis. Fico sebelumnya kerap membuat pengakuan menggunakan narkoba di media sosial. https://t.co/le5kqMiSug,28,4,7,1,2022-01-15,20,Saturday,6,35,5
1482450505435652098,2022-01-15 20:31:57,"Penelitian menemukan perempuan yang menyusui lebih kecil kemungkinannya mengalami penyakit jantung, stroke, atau meninggal akibat penyakit kardiovaskular. https://t.co/BF1rRDz5qz",17,3,3,0,2022-01-15,20,Saturday,6,20,3
1482447102269661195,2022-01-15 20:18:26,"Polisi menangkap empat anggota gangster gegara membacok seorang pria di Neglasari, Kota Tangerang. Korban mengalami luka bacok di sekujur tubuh. https://t.co/mCYIHyybMW",8,0,1,1,2022-01-15,20,Saturday,6,9,1
1482443958101889024,2022-01-15 20:05:56,Tuntutan hukuman mati dan kebiri kimia bagi Herry Wirawan menuai pro dan kontra. Kaukus Perempuan Parlemen menyoroti soal derita korban. https://t.co/tLKUrjJBoC,10,2,1,2,2022-01-15,20,Saturday,6,11,4
1482441518594072576,2022-01-15 19:56:15,"Tanggul ini bukan berada di bantaran kali, melainkan melintang di tengah jalan perumahan. Tanggul ini mengganggu lalu lintas warga. https://t.co/5EboF1TP2M",7,2,1,3,2022-01-15,19,Saturday,6,8,5
1482437011432775681,2022-01-15 19:38:20,Manchester United membuang keunggulan dua gol dan menyaksikan kemenangan di depan mata sirna. Gol debut Philippe Coutinho buat Aston Villa memaksakan skor 2-2. https://t.co/tzxFkRsp7h,24,0,0,1,2022-01-15,19,Saturday,6,24,1
1482434875026292737,2022-01-15 19:29:51,Ketum PB IDI Daeng M Faqih mengatakan pihaknya telah meminta para tenaga kesehatan untuk bersiap menghadapi ancaman lonjakan kasus Omicron. https://t.co/ekHZqCWF25,15,23,7,5,2022-01-15,19,Saturday,6,22,28
1482433385402449921,2022-01-15 19:23:56,"Polisi akhirnya menahan Hadfana Firdaus, penendang sesajen di lokasi erupsi Semeru. Penahanan Hadfana dilakukan di Rutan Mapolda Jatim sejak Jumat (14/1) malam. https://t.co/0wYvUdfpkV",26,1,4,0,2022-01-15,19,Saturday,6,30,1
1482430843083763716,2022-01-15 19:13:49,"Sebuah truk mogok dari pagi di Jl Raya Tonjong, tepatnya di dekat SMPN 1 Bojong Gede, Kabupaten Bogor. Truk mogok disebabkan gardan roda truk tersebut patah. https://t.co/OiS2h17Eb6",6,0,0,1,2022-01-15,19,Saturday,6,6,1
1482425954056159238,2022-01-15 18:54:24,"BMKG peringatkan potensi gempa besar dari patahan megathrust di Selat Sunda, Banten bisa berkekuatan 8,7 M. BNPB menilai sebagai bahan edukasi mitigasi bencana https://t.co/PGzbcY67Ff",807,42,278,110,2022-01-15,18,Saturday,6,1085,152
1482424466516889602,2022-01-15 18:48:29,"Aplikasi satu ini memang menyajikan beragam fitur menarik. Namun di sisi lain, bahaya WhatsApp Aero juga tak boleh dikesampingkan. Ini bahayanya:  https://t.co/QKkeDnYwau",8,0,3,0,2022-01-15,18,Saturday,6,11,0
1482419765935316992,2022-01-15 18:29:48,Premier League malam ini menyajikan duel Aston Villa kontra Manchester United. Berikut ini link live streaming pertandingannya! https://t.co/cghns9QHiK,4,0,0,0,2022-01-15,18,Saturday,6,4,0
1482417226070253578,2022-01-15 18:19:43,Aktivitas seksual terkadang bisa terasa membosankan. Tidak jarang hal ini disebabkan oleh beberapa kesalahan wanita. Ini 5 kesalahan yang umum dilakukan.  https://t.co/APt4385iqW,6,0,0,0,2022-01-15,18,Saturday,6,6,0
1482415288381763586,2022-01-15 18:12:01,Tsunami menerjang pantai di Jepang. Gelombang dilaporkan terjadi dengan ketinggian 3 meter. https://t.co/Vc0Z6akggs,75,5,44,5,2022-01-15,18,Saturday,6,119,10
1482414817906462724,2022-01-15 18:10:09,Pemprov DKI berencana menebang pohon-pohon ini demi pelebaran Jl RS Fatmawati. Begini kondisi pohon-pohon yang seolah tinggal menghitung hari untuk digergaji. https://t.co/MZPx9v5jyz,32,36,4,9,2022-01-15,18,Saturday,6,36,45
1482413087311466504,2022-01-15 18:03:16,"Video belatung di vagina saat berhubungan seks heboh menuai ketakutan warganet. Ketakutan pasca terlanjur nonton, bagaimana mengatasinya? Ini saran psikolog. https://t.co/taBfnuWXqb",5,3,1,2,2022-01-15,18,Saturday,6,6,5
1482411302593122305,2022-01-15 17:56:11,"Enam nisan kuno ditemukan di kawasan Jembatan Ampera, Palembang. Belum sempat dilakukan penelitian sudah dikuburkan kembali. https://t.co/9UJJPWD20B",10,0,1,1,2022-01-15,17,Saturday,6,11,1
1482410301643444235,2022-01-15 17:52:12,Manchester City terus tak terbendung di Liga Inggris usai mengalahkan Chelsea. The Citizens mencatatkan 12 kemenangan secara beruntun. https://t.co/HeG1tGr4ev,9,0,1,1,2022-01-15,17,Saturday,6,10,1
1482407272525533190,2022-01-15 17:40:10,Viral video yang menunjukkan sejumlah belatung di bagian organ intim wanita. Hal ini membuat warganet jijik dan syok. Ini tips dari psikolog untuk mengatasinya.  https://t.co/NjkewOHpPi,28,11,7,4,2022-01-15,17,Saturday,6,35,15
1482400264376274952,2022-01-15 17:12:19,Masih ingat Suster Cecilia di telenovela Carita de Angel? Penampilan terbarunya jauh berbeda dengan perannya di cerita tersebut. Ini potretnya:  https://t.co/er9CUDfIWj,16,0,1,2,2022-01-15,17,Saturday,6,17,2
1482398388003954688,2022-01-15 17:04:51,"Setiap makhluk hidup, pasti akan mengalami kematian. Berikut ini beberapa tanda-tanda kematian yang menandakan ajal sudah dekat. https://t.co/ER2pRyHOXR",48,2,12,1,2022-01-15,17,Saturday,6,60,3
1482397042056040448,2022-01-15 16:59:31,"Taman nasional di Sidney, Australia, memiliki api yang menyala kurang lebih selama 6.000 tahun. Apa yang menyebabkannya menyala? https://t.co/t8gw83u079",24,2,3,0,2022-01-15,16,Saturday,6,27,2
1482395588645765126,2022-01-15 16:53:44,"#Terpopuler Universitas Kyoto di Jepang tengah apes, karena mereka kehilangan data hasil penelitian penting sebesar 77TB. Kok bisa? https://t.co/iizBLxTXwe",12,2,7,0,2022-01-15,16,Saturday,6,19,2
1482394316697919497,2022-01-15 16:48:41,Tebak-tebakan ini belum tentu bisa dijawab oleh orang cerdas sekalipun. Coba pecahkan teka-teki receh ini sambil melatih otak. https://t.co/3CDS0Hj10H,237,234,12,6,2022-01-15,16,Saturday,6,249,240
1482393035170369539,2022-01-15 16:43:35,"Aplikasi satu ini memang menyajikan beragam fitur menarik. Namun di sisi lain, bahaya WhatsApp Aero juga tak boleh dikesampingkan. Ini bahayanya:  https://t.co/0bL3kXYGyA",6,0,0,0,2022-01-15,16,Saturday,6,6,0
1482391790930046985,2022-01-15 16:38:39,Mohammed Abad adalah salah satu pria di dunia yang memiliki penis bionik. Pasangannya menceritakan pengalaman mereka saat bercinta. Seperti apa ya? https://t.co/p7b3aYfRHp,13,2,3,3,2022-01-15,16,Saturday,6,16,5
1482390494890057733,2022-01-15 16:33:30,Yuk latih otak kamu agar bisa lancar memecahkan masalah. Teka-teki ini bisa membuktikan apakah kamu jenius. https://t.co/I8u1zjJHy6,71,52,6,4,2022-01-15,16,Saturday,6,77,56
1482389222677958657,2022-01-15 16:28:26,Dibalik gambar ini ada sesuatu yang tersembunyi. Butuh ketelitian dan fokus yang tinggi untuk menebaknya. Yuk coba!  https://t.co/Qixf1Pbg5i,4,1,1,1,2022-01-15,16,Saturday,6,5,2
1482387966416801792,2022-01-15 16:23:27,"BMKG menyampaikan adanya potensi gempa besar dari megathrust Selat Sunda. Gempa itu berpotensi bermagnitudo (M) 8,7. Berikut adalah hal yang perlu diketahui.  https://t.co/5XSF0upD1D",980,51,412,105,2022-01-15,16,Saturday,6,1392,156
1482386711506259976,2022-01-15 16:18:28,Tisu magic sering digunakan oleh pria saat melakukan hubungan seksual. Benda ini biasa digunakan untuk menunda ejakulasi dini. Bagaimana efek sampingnya ya? https://t.co/nHJxg7IwrE,11,1,1,1,2022-01-15,16,Saturday,6,12,2
1482385530193129483,2022-01-15 16:13:46,PT PLN (Persero) mengumumkan saat ini pelanggan bisa mengajukan permohonan untuk pasang baru listrik melalui aplikasi PLN Mobile.  https://t.co/cB9lQIsVFO,28,2,10,1,2022-01-15,16,Saturday,6,38,3
1482384235172446208,2022-01-15 16:08:37,Peringatan tsunami diberlakukan untuk wilayah Pantai Barat AS. Peringatan ini diberlakukan usai erupsi gunung api bawah laut di Tonga. https://t.co/WBkyLezALd,35,1,7,1,2022-01-15,16,Saturday,6,42,2
1482382820446248961,2022-01-15 16:03:00,"Tak lama lagi, pengunjung Candi Borobudur bisa kembali naik menuju struktur bangunan candi. Hal itu disampaikan Menparekraf Sandiaga Uno.  https://t.co/IyTLEMSQ9O",12,1,2,0,2022-01-15,16,Saturday,6,14,1
1482381682665828356,2022-01-15 15:58:29,Viral video sekumpulan belatung keluar dari vagina saat berhubungan seksual bikin ngeri banyak warganet. Stop sebar-sebar! Begini pesan psikolog.  https://t.co/ysPSjiuGoX,29,10,5,7,2022-01-15,15,Saturday,6,34,17
1482380396839022594,2022-01-15 15:53:22,Pria berusia 30 tahun mengaku ukuran penisnya menyusut pasca terkena COVID-19. Mungkinkah gejala long COVID alias COVID-19 berkepanjangan? Begini penelitiannya.  https://t.co/T9vJax4Ikp,30,9,10,15,2022-01-15,15,Saturday,6,40,24
1482378906019811339,2022-01-15 15:47:27,Sambal pete yang satu ini bakal menambah selera makan. Renyah segar pete dibalut sambal super pedas dan ayam yang gurih. Mantul rasanya. https://t.co/spUP5tYFOq,21,1,3,1,2022-01-15,15,Saturday,6,24,2
1482377644364685314,2022-01-15 15:42:26,Sampah antariksa berpotensi membuyarkan mimpi Elon Musk untuk menmbangun kehidupan di planet lain dan membuat manusia terperangkap di Bumi. https://t.co/9umhohmAME,28,4,5,0,2022-01-15,15,Saturday,6,33,4
1482375527885324291,2022-01-15 15:34:01,"Tsunami menghantam wilayah Tonga pada Sabtu (15/1) waktu setempat. Tsunami disebabkan oleh erupsi gunung api bawah laut, Hunga Tonga-Hunga Ha'apai. https://t.co/rPhBd9LqQH",123,1,40,2,2022-01-15,15,Saturday,6,163,3
1482374988560838660,2022-01-15 15:31:53,Epidemiolog Dicky Budiman memberikan pandangan terkait PTM di tengah ancaman Omicron. Ada sejumlah hal yang harus diperhatikan.  https://t.co/M044Ivgcz2,21,4,6,0,2022-01-15,15,Saturday,6,27,4
1482373438522146816,2022-01-15 15:25:43,Jangan khawatir saat lapar kapanpun sepanjang hari. Ada beberapa rumah makan dengan rating tinggi yang sajikan puluhan enak 24 jam nonstop.  https://t.co/TUYY9MXmTC,42,0,5,0,2022-01-15,15,Saturday,6,47,0
1482372109607260160,2022-01-15 15:20:26,"Postingan terbaru orang terkaya dunia di Twitter, Elon Musk, membuat harga Dogecoin kembali melonjak sekitar 20% dan menyentuh USD 0,1987 per koin.  https://t.co/pZe9QmG6iU",53,7,8,3,2022-01-15,15,Saturday,6,61,10
1482370837550448642,2022-01-15 15:15:23,"Kemenkes melaporkan mayoritas pasien Omicron RI bergejala ringan batuk-pilek. Diyakini amat mirip, ini perbandingan gejala flu dan infeksi Omicron menurut CDC.  https://t.co/TQOSaViTxA",45,13,17,6,2022-01-15,15,Saturday,6,62,19
1482370836283727872,2022-01-15 15:15:23,"Kevin De Bruyne jadi pembeda di laga Manchester City vs Chelsea. Gol tunggalnya jadi kemenangan The Citizens, bukan sekadar indah tapi juga jenius!  https://t.co/SUYIYtyB5c",41,3,5,0,2022-01-15,15,Saturday,6,46,3
1482370563654008835,2022-01-15 15:14:18,"Stafsus Mensesneg Faldo Maldini angkat bicara soal laporan Ubedillah Badrun terhadap Gibran dan Kaesang. Dia menyebut, laporan tersebut hasil imajinasi. https://t.co/cUOZ7B5oE8",28,44,3,6,2022-01-15,15,Saturday,6,31,50
1482370053609820163,2022-01-15 15:12:16,Indonesia Mencari Bakat (IMB) 2021 tiba di malam puncaknya. Kali ini Ksatria menjadi juara pertama pada ajang pencarian bakat ini.  https://t.co/orAT6ntnA2,28,3,3,1,2022-01-15,15,Saturday,6,31,4
1482369262811496450,2022-01-15 15:09:08,Tidak ada pemenang dalam laga BRI Liga 1 antara Persela Lamongan kontra Persija Jakarta. Kedua kesebelasan bermain sama kuat 1-1.  https://t.co/savU97b7GW,8,0,0,0,2022-01-15,15,Saturday,6,8,0
1482369261595246592,2022-01-15 15:09:07,Premier League resmi menunda partai Tottenham Hotspur vs Arsenal akhir pekan ini. Mereka menerima pengajuan penundaan pertandingan dari The Gunners.  https://t.co/3Q4kUom2MO,13,0,0,0,2022-01-15,15,Saturday,6,13,0
1482367999524941828,2022-01-15 15:04:06,"Gempa bumi yang mengguncang Banten dengan magnitudo (M) 6,6 SR pada Jumat (14/1) lalu membuat sedikitnya 1.231 rumah rusak. https://t.co/yrhLNGygSe",77,2,16,3,2022-01-15,15,Saturday,6,93,5
1482367776450924546,2022-01-15 15:03:13,"Tisu magic banyak dijadikan opsi oleh pasangan agar sesi bercinta jadi lebih tahan lama. Tapi, bagaimana cara pakai tisu magic yang benar? Begini caranya: https://t.co/e78dEbXANF",19,4,3,5,2022-01-15,15,Saturday,6,22,9
1482366064591785987,2022-01-15 14:56:25,Premier League resmi menunda partai Tottenham Hotspur vs Arsenal akhir pekan ini. Mereka menerima pengajuan penundaan pertandingan dari The Gunners. https://t.co/JiiQCxSohz,17,1,2,0,2022-01-15,14,Saturday,6,19,1
1482364831059648516,2022-01-15 14:51:31,"Tanggul beton sepanjang 10 meter menutupi jalan di perumahan kawasan Pondok Bambu, Jakarta Timur. Tanggul itu menimbulkan keresahan warga. https://t.co/WQEUlBa64Z",17,2,2,1,2022-01-15,14,Saturday,6,19,3
1482363497577132034,2022-01-15 14:46:13,PDIP DKI meminta agar data tunjangan Gubernur Anies Baswedan dan Wakil Gubernur Ahmad Riza Patria dibuka secara transparan. Wagub menjawab permintaan itu.  https://t.co/rXJyxNebLz,37,12,4,1,2022-01-15,14,Saturday,6,41,13
1482362976795508739,2022-01-15 14:44:09,Manchester City vs Chelsea berlangsung di lanjutan Liga Inggris. Tuan rumah menang 1-0 via gol indah Kevin De Bruyne. https://t.co/gsWrt63LYr,21,0,3,0,2022-01-15,14,Saturday,6,24,0
1482362466696839177,2022-01-15 14:42:07,"Sukses menjalani bisnis kuliner mentai cake, gadis 19 tahun ini kerap mengalami jatuh bangun. Sempat ditipu hingga dapat omzet puluhan juta.  https://t.co/Fm7iaxiEFx",11,0,1,1,2022-01-15,14,Saturday,6,12,1
1482360971767209988,2022-01-15 14:36:11,Setiap usaha pasti membuahkan hasil. Seperti yang dirasakan pengantar makanan ini yang mempromosikan dagangannya dengan kertas yang ditempel pada tas makanan.  https://t.co/t5dC8Ujt78,11,0,1,0,2022-01-15,14,Saturday,6,12,0
1482358533345751042,2022-01-15 14:26:29,Manchester City vs Chelsea berlangsung di lanjutan Liga Inggris. Tuan rumah menang 1-0 via gol indah Kevin De Bruyne. https://t.co/JYBtMf4Vzs,25,0,2,0,2022-01-15,14,Saturday,6,27,0
1482357938991898627,2022-01-15 14:24:08,Badan Penanggulangan Bencana Daerah (BPBD) Provinsi Banten mencatat total 1.361 rumah warga terdampak akibat gempa Banten. https://t.co/BS3mLS9g4a,20,1,3,0,2022-01-15,14,Saturday,6,23,1
1482357331795001345,2022-01-15 14:21:43,"Tahukah kamu, 5 rekor sepanjang masa Barcelona hanya dipegang dua pemain ini. Mereka adalah Lionel Messi dan Philippe Coutinho.  https://t.co/p4gXlglQpD",16,0,1,0,2022-01-15,14,Saturday,6,17,0
1482355198123257858,2022-01-15 14:13:14,"Longsor yang terjadi di Pangalengan, Kabupaten Bandung menewaskan satu orang pada Sabtu (15/1/2021). Kejadian itu dipicu oleh hujan dengan intensitas tinggi https://t.co/fYvSgSFuQZ",5,1,1,0,2022-01-15,14,Saturday,6,6,1
1482355195904409608,2022-01-15 14:13:14,Gubernur Banten Wahidin Halim akan menerbitkan surat keputusan KLB bencana akibat gempa. Hal ini menunggu keputusan dari Pemkab Lebak-Pandeglang https://t.co/oUZNZqGfdB,6,0,0,0,2022-01-15,14,Saturday,6,6,0
1482354680827191300,2022-01-15 14:11:11,Ganjar Pranowo sempat memberi bantuan kepada seorang kader PDIP Temanggung Fajar Nugroho. Namun bantuan itu dikembalikan oleh Fajar. Ganjar mengaku dirinya mungkin melakukan kesalahan.  https://t.co/4D1emMQlPi,29,7,2,1,2022-01-15,14,Saturday,6,31,8
1482353368731463686,2022-01-15 14:05:58,Kasus Covid-19 di Indonesia per 15 Januari 2022 bertambah 1.054. Sementara kasus sembuh tambah 464 dan kematian tambah 4 pasien.  https://t.co/ESslqiL1q8,12,1,5,3,2022-01-15,14,Saturday,6,17,4
1482353349110513670,2022-01-15 14:05:53,"Selain membagikan sembako, pihaknya juga memberikan bantuan berupa uang tunai ke korban gempa Banten. https://t.co/SlyOKZXS8S",15,2,1,0,2022-01-15,14,Saturday,6,16,2
1482352328661520388,2022-01-15 14:01:50,"Longsor yang terjadi di Pangalengan, Kabupaten Bandung menewaskan satu orang pada Sabtu (15/1/2021). Kejadian itu dipicu oleh hujan dengan intensitas tinggi https://t.co/RRgFQhN7If",6,0,3,0,2022-01-15,14,Saturday,6,9,0
1482352023064481802,2022-01-15 14:00:37,"Kelurahan Krukut, Tamansari, Jakarta Barat memberlakukan mikro lockdown usai banyak warga terpapar Covid-19. Lurah menyebut para pasien masih menjalani karantina di rumah dan Wisma Atlet.  https://t.co/kO3vaGHHuj",6,0,1,0,2022-01-15,14,Saturday,6,7,0
1482351998804664322,2022-01-15 14:00:31,Bule Prancis yang menikah dengan pria Lombok baru saja dikaruani anak kedua nih. Kira-kira mirip siapa ya anak kedua mereka? Simak di sini yuk. #detikNetwork  https://t.co/0QclA71R7c,21,1,1,0,2022-01-15,14,Saturday,6,22,1
1482351721171066882,2022-01-15 13:59:25,"Peristiwa kecelakaan melibatkan pemotor dan truk terjadi di daerah Cilincing, Jakarta Utara. Pemotor seorang perempuan alami luka parah di tangan kanannya. https://t.co/kquC7SQX3U",23,2,2,0,2022-01-15,13,Saturday,6,25,2
1482351213844774913,2022-01-15 13:57:24,Tidak ada pemenang dalam laga BRI Liga 1 antara Persela Lamongan kontra Persija Jakarta. Kedua kesebelasan bermain sama kuat 1-1. https://t.co/wqw2FpLqcS,14,3,2,0,2022-01-15,13,Saturday,6,16,3
1482350725447442434,2022-01-15 13:55:28,"Pemerintah wanti-wanti gelombang ke-3 COVID-19 akibat varian Omicron. Bukannya gejala Omicron lebih ringan dari Delta? Tunggu dulu, begini catatan epidemiolog.  https://t.co/5g0yidNmjs",22,3,4,1,2022-01-15,13,Saturday,6,26,4
1482349349292199950,2022-01-15 13:50:00,"Ada banyak kekhawatiran di antara para orang tua yang menemani anaknya vaksin, salah satunya, apakah setelah vaksin boleh minum es? Simak di sini:  https://t.co/Hex3z31twr",15,1,4,0,2022-01-15,13,Saturday,6,19,1
1482348234211217409,2022-01-15 13:45:34,Penggunaan logo MotoGP hanya diperbolehkan bagi pihak-pihak yang berkontrak resmi dengan Dorna Sports.  https://t.co/CSICTgLOEp,30,0,4,0,2022-01-15,13,Saturday,6,34,0
1482347982175490056,2022-01-15 13:44:34,Tahapan SNMPTN 2022 telah memasuki masa registrasi akun LTMPT untuk siswa. Berikut ini serba-serbi informasi tentang akun LTMPT. Via: detikedu  https://t.co/ZcEODjrOPX,13,0,5,0,2022-01-15,13,Saturday,6,18,0
1482347240010174464,2022-01-15 13:41:37,Tasya Farasya viral karena dandan a la Rosalinda. Seperti ini kemiripan sang YouTuber dengan bintang telenovela yang buat netizen takjub.  https://t.co/TiJnc4Oaz1,39,1,1,0,2022-01-15,13,Saturday,6,40,1
1482345740248694787,2022-01-15 13:35:39,Viral video yang menunjukkan sejumlah belatung di bagian organ intim wanita. Hal ini membuat warganet jijik dan syok. Ini tips dari psikolog untuk mengatasinya. https://t.co/flJbbPYcwX,12,4,7,3,2022-01-15,13,Saturday,6,19,7
1482345409171402753,2022-01-15 13:34:20,"Longsor terjadi Bukit Bukit Leuweung Kadu, Desa Ciherang, Kabupaten Sumedang. Seorang petani nyaris tertimbun. https://t.co/Ore7kRh4Xu",8,0,3,1,2022-01-15,13,Saturday,6,11,1
1482343457804935171,2022-01-15 13:26:35,Api melalap bangunan SMPN 1 Cikelet Garut. Polisi turun tangan menyelidiki. https://t.co/Fby16bmR5n,3,0,1,1,2022-01-15,13,Saturday,6,4,1
1482342901208207364,2022-01-15 13:24:22,"Manajer interim Manchester United Ralf Rangnick, tak punya rencana untuk mengganti kapten. Rangnick masih percaya kepada Harry Maguire.  https://t.co/n03sCm1y7E",16,0,2,1,2022-01-15,13,Saturday,6,18,1
1482341745023197185,2022-01-15 13:19:47,"Daripada cuma rebahan dan nggak ada kegiatan, lebih baik jawab teka-teki ini untuk mengusir kebosanan di hari libur sekaligus melatih kemampuan berpikir.  https://t.co/47no2Mxz2T",10,1,1,1,2022-01-15,13,Saturday,6,11,2
1482340579761700871,2022-01-15 13:15:09,"Ubedillah Badrun laporkan dua putra Jokowi, Gibran Rakabuming dan Kaesang Pangarep, ke KPK. Atas hal itu, Ubedilah mengaku dapat telepon tak dikenal.  https://t.co/6XdtWLWwOX",33,39,11,5,2022-01-15,13,Saturday,6,44,44
1482340578532671489,2022-01-15 13:15:09,Pegulat wanita WWE yang eksis pada era '90-an Tammy Sytch namanya kini menjadi sorotan. Dia mengancam kekasihnya akan membunuhnya dengan gunting!  https://t.co/f514pDAo2b,4,2,3,3,2022-01-15,13,Saturday,6,7,5
1482339902306009088,2022-01-15 13:12:27,Polisi menangkap Fico Fachriza terkait narkoba. Sang komika ditetapkan sebagai tersangka karena kedapatan mengkonsumsi tembakau sintetis.  https://t.co/lc4IVEG8xN,29,7,4,1,2022-01-15,13,Saturday,6,33,8
1482339888255143939,2022-01-15 13:12:24,"Kasus harian COVID-19 pada hari Sabtu (15/1/2022), dilaporkan mencapai 1.054. Pertama kalinya COVID-19 Indonesia menembus angka 1.000 sejak Oktober 2021.  https://t.co/TdY9ptUPhn",37,2,19,5,2022-01-15,13,Saturday,6,56,7
1482339446209060867,2022-01-15 13:10:39,Ada yang menjual foto KTP sebagai NFT di OpenSea. Foto KTP yang dijual menunjukkan identitas lengkap sang pemilik.  https://t.co/WVjfR0Bhpq,10,5,3,4,2022-01-15,13,Saturday,6,13,9
1482339445009530884,2022-01-15 13:10:38,Kelompok Sekretariat Bersama Prabowo-Jokowi mendeklarasikan dukungan untuk Prabowo-Jokowi maju pada Pemilu 2024. Lantas apakah Jokowi memang bisa maju di 2024?  https://t.co/eD2VxZjBSV,5,12,2,2,2022-01-15,13,Saturday,6,7,14
1482338145765142537,2022-01-15 13:05:29,Erling Haaland menjadi incaran banyak klub top Eropa di bursa transfer. Striker Borussia Dortmund itu diminta segera menentukan masa depannya.  https://t.co/jLQE6VqhVL,14,0,2,0,2022-01-15,13,Saturday,6,16,0
1482337907998400512,2022-01-15 13:04:32,Andriy Shevchenko dipecat Genoa dari jabatan pelatih tim. Juru taktik Ukraina itu hanya bertahan dua bulan saja bersama salah satu klub tertua Italia tersebut.  https://t.co/8JZYLI0dba,6,0,2,1,2022-01-15,13,Saturday,6,8,1
1482337899802775553,2022-01-15 13:04:30,Arsenal bentrok dengan Tottenham Hotspur dalam Derby London Utara akhir pekan ini. Mikel Arteta melempar pujian kepada Antonio Conte sebelum pertandingan.  https://t.co/twPvu7iXcg,5,0,0,0,2022-01-15,13,Saturday,6,5,0
1482337885479223298,2022-01-15 13:04:27,"Ubedillah Badrun laporkan dua putra Presiden Jokowi, Gibran Rakabuming dan Kaesang Pangarep, ke KPK. Atas hal itu, Ubedilah mengaku dapat telepon tak dikenal. https://t.co/ykDTMdtwL3",57,48,15,7,2022-01-15,13,Saturday,6,72,55
1482337545719627779,2022-01-15 13:03:06,"Indonesia melaporkan 1.054 kasus COVID-19 pada Sabtu (15/1/2022). Total kasus positif menjadi 4.270.794, sembuh 4.118.164, dan meninggal 144.167.  https://t.co/ZFO0gcPO5O",15,2,7,3,2022-01-15,13,Saturday,6,22,5
1482337544390029312,2022-01-15 13:03:05,"Betapa kagetnya China National Space Administration (CNSA) saat mengeksplorasi sisi Bulan terjauh, tampak ada objek misterius berbentuk seperti 'rumah'. https://t.co/ODmGaKfJ15",19,6,4,3,2022-01-15,13,Saturday,6,23,9
1482336475983265792,2022-01-15 12:58:51,"Hari ini dilaporkan ada tambahan 1.054 kasus positif COVID-19 di Indonesia, di mana DKI Jakarta menyumbang kasus positif COVID-19 terbanyak dengan jumlah 345.  https://t.co/GQYwNq1tXC",16,0,10,3,2022-01-15,12,Saturday,6,26,3
1482335714398420994,2022-01-15 12:55:49,Tak hanya ayam geprek atau martabak saja yang jadi rajanya makanan kaki lima di aplikasi online. Banyak es campur kaki lima legendaris bisa dipesan di rumah.  https://t.co/vVH7rwv39o,8,2,3,0,2022-01-15,12,Saturday,6,11,2
1482334545940729859,2022-01-15 12:51:10,Ajang street race gagasan Polda Metro Jaya akan berlangsung di Kawasan Ancol pada Minggu (15/1). Diperkirakan ada 330 joki balap akan mengikuti ajang tersebut.  https://t.co/qc6hl1nug4,33,2,10,3,2022-01-15,12,Saturday,6,43,5
1482333899535667202,2022-01-15 12:48:36,Doddy Sudrajat absen untuk bertemu membahas perihal formulasi sebelum mediasi dengan Haji Faisal di Komnas PA.  https://t.co/nQsOsTJhQU,4,0,1,0,2022-01-15,12,Saturday,6,5,0
1482333879730114561,2022-01-15 12:48:32,"Kepala BNPB Letjen TNI Suharyanto meninjau lokasi terdampak gempa M 6,6 di Kecamatan Sumur, Pandeglang, Banten. https://t.co/QpL4Hgtxsy",5,0,2,1,2022-01-15,12,Saturday,6,7,1
1482333605485498369,2022-01-15 12:47:26,"DPRD DKI Jakarta meminta data uang tunjangan milik Gubernur dan Wakil Gubernur DKI Jakarta dibuka agar transparan. Terkait hal itu, Wakil Gubernur DKI Jakarta Ahmad Riza Patria mengaku tak masalah.  https://t.co/3LDJnlP50i",15,5,4,0,2022-01-15,12,Saturday,6,19,5
1482332101118771203,2022-01-15 12:41:27,"Ratusan demonstran antivaksin memenuhi jalanan pusat kota Sydney, Australia pada Sabtu (15/1). Mereka menentang vaksinasi Covid-19 untuk anak-anak.  https://t.co/34pfqE28IQ",16,2,4,0,2022-01-15,12,Saturday,6,20,2
1482331848621666305,2022-01-15 12:40:27,"Korea Utara (Korut) baru saja meluncurkan rudal balistik dari kereta api. Dilansir Associated Press, peluncuran rudal ini sebagai pembalasan terhadap saksi yang dijatuhkan Amerika Serikat.  https://t.co/163b9N6aG3",10,2,2,0,2022-01-15,12,Saturday,6,12,2
1482331847388450824,2022-01-15 12:40:27,Hannah jadi sorotan terlebih karena gayanya yang cantik meski bekerja sebagai pekerja bangungan. Sayangnya ia juga sering mendapat kritik.  https://t.co/1sjbYFBodI,6,0,1,0,2022-01-15,12,Saturday,6,7,0
1482330065325248512,2022-01-15 12:33:22,Ramalan zodiak cinta Sagitarius tunjukkan komitmen dan kesetiaan Anda kepadanya dengan berperilaku yang benar. Bagaimana ramalan zodiak cinta anda hari ini:  https://t.co/Pn4KVDrWPg,5,0,0,1,2022-01-15,12,Saturday,6,5,1
1482328565572153344,2022-01-15 12:27:25,Korut mengklaim sukses meluncurkan dua rudal balistik dari kereta api. Tonga yang terletak di Pasifik Selatan dilanda tsunami usai erupsi gunung api bawah laut. https://t.co/rcBr8c36wp,5,0,2,0,2022-01-15,12,Saturday,6,7,0
1482328332725280771,2022-01-15 12:26:29,"Semenjak kasus Covid-19 melonjak ditambah satu pasien terkonfirmasi positif Omicron, kawasan Krukut, Jakarta Barat, memberlakukan micro lockdown alias penguncian wilayah. Lalu seperti apa pembatasan mobilitas di sana?  https://t.co/Iw8KlZVO2L",4,0,2,0,2022-01-15,12,Saturday,6,6,0
1482328316963131399,2022-01-15 12:26:25,Menaker ikut keluar menuju halaman kantor Kemnaker guna memantau kondisi gedung serta jajarannya saat terjadi gempa kemarin. https://t.co/sqF1j7PHa4,6,0,1,0,2022-01-15,12,Saturday,6,7,0
1482327649854894089,2022-01-15 12:23:46,"Indonesia melaporkan 1.054 kasus COVID-19 pada Sabtu (15/1/2022). Total kasus positif menjadi 4.270.794, sembuh 4.118.164, dan meninggal 144.167. https://t.co/LxOrUxbhCI",18,0,14,5,2022-01-15,12,Saturday,6,32,5
1482327156592103430,2022-01-15 12:21:49,Lowongan kerja Astra Honda Motor (AHM) dibuka untuk mahasiswa semester akhir dan lulusan S1 berbagai jurusan. Cek posisi dan syaratnya berikut! Via: detikedu  https://t.co/7hX3NwqfH2,12,1,1,0,2022-01-15,12,Saturday,6,13,1
1482326910818471936,2022-01-15 12:20:50,"Wanita bernama Indah Safitri (27) ditemukan tewas bersimbah darah di indekosnya, Semarang. Saksi sempat mendengar korban bertengkar dan teriak minta tolong.  https://t.co/gFF8W67BhI",11,0,1,0,2022-01-15,12,Saturday,6,12,0
1482326888001544194,2022-01-15 12:20:45,"Ratusan demonstran antivaksin memenuhi jalanan pusat kota Sydney, Australia pada Sabtu (15/1). Mereka menentang vaksinasi Covid-19 untuk anak-anak. https://t.co/P1QQl7oZ4r",40,5,16,10,2022-01-15,12,Saturday,6,56,15
1482326369703010309,2022-01-15 12:18:41,Asosiasi Pengusaha Indonesia (Apindo) resmi melayangkan gugatan kepada Gubernur DKI Jakarta Anies Baswedan di Pengadilan Tata Usaha Negara (PTUN).  https://t.co/b4ndk5nGVc,45,21,10,0,2022-01-15,12,Saturday,6,55,21
1482325626681974786,2022-01-15 12:15:44,"Menteri BUMN Erick Thohir bicara alasan melaporkan bukti dugaan korupsi Garuda ke Kejaksaan Agung, bukan ke KPK.  https://t.co/S7TOx3woKM",16,2,3,2,2022-01-15,12,Saturday,6,19,4
1482325337128243202,2022-01-15 12:14:35,"Video sekumpulan belatung keluar dari vagina bikin geger warganet. Sudah tahu bikin ngeri, kenapa masih penasaran ingin nonton ya? Begini kata psikolog.  https://t.co/IPEHM7n53Z",8,0,1,0,2022-01-15,12,Saturday,6,9,0
1482325321890381831,2022-01-15 12:14:31,Kelompok Sekretariat Bersama Prabowo-Jokowi mendeklarasikan dukungan untuk Prabowo-Jokowi maju pada Pemilu 2024. Lantas apakah Jokowi memang bisa maju di 2024? https://t.co/Nn7ZXqey2t,16,27,4,7,2022-01-15,12,Saturday,6,20,34
1482325062510333963,2022-01-15 12:13:29,"Gelombang tsunami menerjang Tonga yang terletak di Pasifik Selatan. Tsunami ini menerjang usai terjadi erupsi gunung api bawah laut, Hunga Tonga-Hunga Ha'apai.  https://t.co/eLrYtiYX3z",67,4,37,2,2022-01-15,12,Saturday,6,104,6
1482325061277261828,2022-01-15 12:13:29,"""Benda itu pada dasarnya adalah struktur buatan yang dibangun oleh peradaban pintar dengan tujuan barangkali untuk mengumpulkan energi,"" kata NASA.  https://t.co/Z5Bcs7MxWi",8,1,3,1,2022-01-15,12,Saturday,6,11,2
1482323425112776704,2022-01-15 12:06:59,Kemnaker memberikan dukungan kepada TPA Sahabat Semut yang raih Predikat Tara Utama sebagai pelopor taman asuh ramah anak. https://t.co/6e15xLZ8eC,4,0,0,0,2022-01-15,12,Saturday,6,4,0
1482322920760295424,2022-01-15 12:04:59,Viral video sekumpulan belatung keluar dari vagina saat berhubungan seksual bikin ngeri banyak warganet. Stop sebar-sebar! Begini pesan psikolog. https://t.co/8F1E9Kytk9,51,21,6,3,2022-01-15,12,Saturday,6,57,24
1482322919254630400,2022-01-15 12:04:58,Kasal Laksamana TNI Yudo Margono meresmikan Monumen Kapal Selam Nanggala-402 di Markas Koarmada II. Peresmian bertepatan dengan Hari Peringatan Dharma Samudra. https://t.co/J9PaQWrcaQ,15,0,1,0,2022-01-15,12,Saturday,6,16,0
1482321813292134401,2022-01-15 12:00:35,Polri mengklaim rencana perubahan warna seragam Satuan Pengamanan (Satpam) dari cokelat muda menjadi krem merupakan aspirasi masyarakat. #CNNIndonesia #detikNetwork  https://t.co/4cF3ixXc47,34,68,3,12,2022-01-15,12,Saturday,6,37,80
1482321215087951874,2022-01-15 11:58:12,Seorang tahanan narkoba Polres Metro Jakarta Selatan meninggal dunia. Tahanan itu meninggal saat dirawat di RS Polri. https://t.co/UT7S6nCEOr,10,0,2,0,2022-01-15,11,Saturday,6,12,0
1482319240397037571,2022-01-15 11:50:21,"Dinkes Kabupaten Malang melakukan tracing kontak erat positif Omicron. Selain keluarganya, dinkes juga testing warga Desa Banjararum, Kecamatan Singosari. https://t.co/4V0m0t9XKr",9,0,1,1,2022-01-15,11,Saturday,6,10,1
1482317977437581315,2022-01-15 11:45:20,"Pada masanya, BlackBerry digandrungi salah satunya karena keyboard fisik. Di kemudian hari, justru keyboard itu yang dinilai menjadi penyebab keruntuhannya. https://t.co/Ji3yY8N2Rz",19,1,2,2,2022-01-15,11,Saturday,6,21,3
1482316102701142016,2022-01-15 11:37:53,"Pasar Galekan Bajulmati di Desa Bajulmati, Kecamatan Wongsorejo, Banyuwangi, terbakar dini hari. Sekitar 170 kios dilaporkan terbakar. Ini respons Bupati Ipuk. https://t.co/VfDKWKfQjX",6,1,3,0,2022-01-15,11,Saturday,6,9,1
1482315101772341248,2022-01-15 11:33:55,Jalan di perumahan kawasan Pondok Bambu Jakarta Timur ini tertutup tanggul beton. Warga membuat tanggul ini lantaran sering kebanjiran. Begini penjelasan warga. https://t.co/HvSbUaoGVl,10,2,1,1,2022-01-15,11,Saturday,6,11,3
1482314169365921795,2022-01-15 11:30:12,#FOTO Han So Hee saat zaman sekolah ini bikin netizen gagal fokus. Ini dia pesona Han So Hee:  https://t.co/sA3U8bzbqg,18,0,6,0,2022-01-15,11,Saturday,6,24,0
1482312815121686531,2022-01-15 11:24:49,"Politisi PDIP, Hendrawan Supratikno menilai deklarasi Prabowo-Jokowi maju di Pemilu 2024. boleh-boleh saja dilakukan. Tapi dia pesimistis itu terlaksana. https://t.co/E4xmmQAiIJ",8,6,2,1,2022-01-15,11,Saturday,6,10,7
1482312262568353797,2022-01-15 11:22:38,Seorang tahanan narkoba Polres Metro Jakarta Selatan meninggal dunia. Tahanan itu meninggal saat dirawat di RS Polri. https://t.co/1DUdYTjxOr,3,1,2,0,2022-01-15,11,Saturday,6,5,1
1482311022375587843,2022-01-15 11:17:42,Salah satu warga Tonga menuturkan teriakan orang-orang bisa terdengar saat tsunami menerjang. https://t.co/HHDDID4TWW,31,1,8,1,2022-01-15,11,Saturday,6,39,2
1482310422409658372,2022-01-15 11:15:19,Pemkab Berau dan jajaran Forkopimda juga diminta menyelesaikan permasalahan tanah warga terkait sengketa dengan perusahaan tambang. https://t.co/FXox393Nm6,2,0,0,0,2022-01-15,11,Saturday,6,2,0
1482309369920466953,2022-01-15 11:11:08,"Wakil Ketua Komisi VIII DPR, Ace Hasan Syadzily, meminta pemda untuk tanggap soal BMKG sebut potensi gempa bumi M 8,7 di zona megathrust Selat Sunda. https://t.co/rlHKlfHYNp",20,2,9,3,2022-01-15,11,Saturday,6,29,5
1482308346963271684,2022-01-15 11:07:04,Manchester City vs Chelsea akan berlangsung malam ini dalam lanjutan Liga Inggris. Berikut link live streaming-nya.  https://t.co/7eUPJ628B5,7,0,1,1,2022-01-15,11,Saturday,6,8,1
1482308259306512385,2022-01-15 11:06:43,"Video sekumpulan belatung keluar dari vagina bikin geger warganet. Sudah tahu bikin ngeri, kenapa masih penasaran ingin nonton ya? Begini kata psikolog. https://t.co/wA1N1xJd4X",9,4,0,1,2022-01-15,11,Saturday,6,9,5
1482307778538618883,2022-01-15 11:04:49,Komnas PA menyebut merekomendasikan Gala untuk tetap tinggal bersama keluarga Bibi Ardiansyah bukan karena pihaknya tidak netral.  https://t.co/F0SX5XnsI3,37,12,1,7,2022-01-15,11,Saturday,6,38,19
1482307270725754884,2022-01-15 11:02:47,Unpar mencantumkan sanksi bagi mahasiswa yang tidak hadir dalam acara kuliah dari Jokowi pada Senin 17 Desember 2022.  https://t.co/0NoSAUTAdU,106,57,26,40,2022-01-15,11,Saturday,6,132,97
1482307010926366722,2022-01-15 11:01:45,Dia menekankan tujuan penggunaan Bahasa Kek adalah untuk menyampaikan pesan edukatif terkait vaksin COVID-19 kepada lansia di Singkawang.  https://t.co/foNaJyRxhU,14,3,2,2,2022-01-15,11,Saturday,6,16,5
1482306994895732741,2022-01-15 11:01:42,"Facebook berubah namanya menjadi Meta induk perusahaan yang menaungi Facebook, Instagram, WhatsApp, Oculus, dan lainnya. Ada kecurigaan di baliknya. https://t.co/pNoyZcwpYd",10,1,2,1,2022-01-15,11,Saturday,6,12,2
1482306138267963399,2022-01-15 10:58:17,"Aston Villa sudah mendatangkan Philippe Coutinho dan Lucas Digne. Manajer Steven Gerrad belum berhenti belanja, ada satu pemain lagi yang diincarnya!  https://t.co/vaMHhZ3uok",13,1,0,0,2022-01-15,10,Saturday,6,13,1
1482306117443198977,2022-01-15 10:58:12,Ni Wayan Sujiati melihat I Ketut Candra Suratana tergantung dengan kondisi mulut tertutup kain berwarna cokelat dan di sampingnya terdapat sebuah kursi kayu. https://t.co/AcTcxMXljX,5,0,1,1,2022-01-15,10,Saturday,6,6,1
1482305607881433093,2022-01-15 10:56:11,"Rosalinda membuat netizen terkejut dengan transformasinya. Sebelumnya terlihat seperti nenek, ia kemudian berubah menjadi mirip Rihanna ketika sudah dipoles.  https://t.co/HHlM5dRk7B",5,0,0,1,2022-01-15,10,Saturday,6,5,1
1482305583529213952,2022-01-15 10:56:05,"Pasar Bajulmati Banyuwangi, hangus terbakar. Peristiwa kebakaran mengakibatkan ratusan kios ludes dilalap api. Kebakaran diduga akibat korsleting listrik. https://t.co/nMrmnCO9l9",5,0,1,0,2022-01-15,10,Saturday,6,6,0
1482305582279372804,2022-01-15 10:56:05,Unpar mencantumkan sanksi bagi mahasiswa yang tidak hadir dalam acara kuliah dari Presiden Jokowi pada Senin 17 Desember 2022. https://t.co/iAMZi39LMX,19,15,10,6,2022-01-15,10,Saturday,6,29,21
1482304819880763393,2022-01-15 10:53:03,"Juventus sepertinya akan ditinggal Paulo Dybala, yang belum juga memperpanjang kontrak. Si Nyonya Tua ambil ancang-ancang, rumornya akan rekrut Paul Pogba.  https://t.co/9VLvHb9vF2",4,0,1,0,2022-01-15,10,Saturday,6,5,0
1482304271005724672,2022-01-15 10:50:52,"Makin tua, Cristiano Ronaldo makin tajir. Buktinya, pendapatan CR7 tiap tahun selalu naik dan angkanya wow banget!  https://t.co/2wdIxKV8CH",19,0,2,0,2022-01-15,10,Saturday,6,21,0
1482303277769318405,2022-01-15 10:46:55,Kekayaan yang dihasilkan Elon Musk pada 2021 sangat mengejutkan karena adanya peningkatan yang signifikan. Segini jumlah kekayaan Elon Musk:  https://t.co/0AwNymtDHl,18,2,4,0,2022-01-15,10,Saturday,6,22,2
1482303257938739209,2022-01-15 10:46:51,Pengakuan seorang selebgram pun jadi sorotan karena mengaku Omicron juga bikin nafsu makan meningkat.  https://t.co/o5diP66mvy,5,0,0,2,2022-01-15,10,Saturday,6,5,2
1482301740183699456,2022-01-15 10:40:49,"Sekber Prabowo-Jokowi mendeklarasikan dukungan untuk pasangan capres-cawapres Prabowo-Jokowi maju di Pemilu 2024. Namun, PKS sangsi.  https://t.co/pfxskpJFSC",1,2,0,0,2022-01-15,10,Saturday,6,1,2
1482301738912829442,2022-01-15 10:40:49,Masih ingat Suster Cecilia di telenovela Carita de Angel? Penampilan terbarunya jauh berbeda dengan perannya di cerita tersebut. Ini potretnya:  https://t.co/NYNi18E8mz,12,2,3,1,2022-01-15,10,Saturday,6,15,3
1482299697406648320,2022-01-15 10:32:42,"Ellen Plaissaer Sjair (80) mendapatkan banyak dukungan dari berbagai pihak, termasuk dari para mantan murid yang pernah diajarinya ketika muda. https://t.co/IMIDbV9FBI",18,0,6,1,2022-01-15,10,Saturday,6,24,1
1482299341427650560,2022-01-15 10:31:17,"Sekber Prabowo-Jokowi mendeklarasikan dukungan untuk pasangan capres-cawapres Prabowo-Jokowi maju di Pemilu 2024. Namun, PKS sangsi. https://t.co/koTwhGAOjO",6,3,1,0,2022-01-15,10,Saturday,6,7,3
1482297955327647744,2022-01-15 10:25:46,"Tutupnya pabrik Foxconn perakit iPhone di India ternyata menyimpan banyak masalah besar, yaitu buruknya kondisi kehidupan para buruh. https://t.co/Or1ggP4gQ0",40,2,15,1,2022-01-15,10,Saturday,6,55,3
1482297684635656195,2022-01-15 10:24:42,"Gelombang tsunami menerjang Tonga yang terletak di Pasifik Selatan. Tsunami ini menerjang usai terjadi erupsi gunung api bawah laut, Hunga Tonga-Hunga Ha'apai. https://t.co/2oMF2Z9RqX",13,0,7,0,2022-01-15,10,Saturday,6,20,0
1482296438478585860,2022-01-15 10:19:45,"Selama delapan tahun, seorang pria mencari hard disk berisi 7.500 Bitcoin di tumpukan sampah. Nilainya Rp 5 triliun!   https://t.co/eMtv8nv1hm",68,8,12,1,2022-01-15,10,Saturday,6,80,9
1482294103379484673,2022-01-15 10:10:28,Ketua Institute Harkat Negeri (IHN) Sudirman Said menganggap kekuasaan masih dianggap sebagai kekuatan di kala pejabat banyak kena OTT KPK https://t.co/QJfz2Qiov5,13,1,4,1,2022-01-15,10,Saturday,6,17,2
1482293077247152135,2022-01-15 10:06:23,"Gempa M 4.1 mengguncang Bangkalan, Madura hingga terasa di Surabaya. BMKG mengimbau masyarakat tetap tenang. Gempa Bangkalan ini juga tidak menimbulkan tsunami. https://t.co/yPRXWpR2Xp",32,2,7,3,2022-01-15,10,Saturday,6,39,5
1482291766791479297,2022-01-15 10:01:11,"Video belatung di vagina saat berhubungan seks heboh menuai ketakutan warganet. Ketakutan pasca terlanjur nonton, bagaimana mengatasinya? Ini saran psikolog.  https://t.co/mTcBGLDgkA",13,6,3,2,2022-01-15,10,Saturday,6,16,8
1482291750983114754,2022-01-15 10:01:07,"Aset Tommy Soeharto yang dilelang negara senilai Rp 2,4 triliun nggak laku. Ini pernyataan dari Tommy.  https://t.co/1OnSbdNbFp",6,3,1,1,2022-01-15,10,Saturday,6,7,4
1482291424280428545,2022-01-15 09:59:49,"Gempa magnitudo 4.1 mengguncang Bangkalan, Madura hingga terasa di Surabaya. Gempa ini tidak menimbulkan tsunami. https://t.co/THWG6gJR47",8,1,3,1,2022-01-15,9,Saturday,6,11,2
1482290423691460608,2022-01-15 09:55:51,"Gempa magnitudo 4.1 mengguncang Bangkalan, Madura. Usai gempa hingga dirasakan warga Surabaya ini, tidak terjadi lagi gempa susulan. https://t.co/7RyBwvJT3G",14,0,3,1,2022-01-15,9,Saturday,6,17,1
1482289952146837506,2022-01-15 09:53:58,"Tukul Arwana sedang berjuang sembuh usai mengalami perdarahan otak. Kini, ia rutin menjalani fisioterapi. https://t.co/YZHe6mMdrB",31,0,4,0,2022-01-15,9,Saturday,6,35,0
1482288402997334016,2022-01-15 09:47:49,"Gempa magnitudo 4.1 mengguncang Bangkalan, Madura. Usai gempa hingga dirasakan warga Surabaya ini, tidak terjadi lagi gempa susulan. https://t.co/LMDmMQXWtX",29,2,7,4,2022-01-15,9,Saturday,6,36,6
1482286372694200322,2022-01-15 09:39:45,"Gempa magnitudo 4.1 mengguncang Bangkalan, Madura, terasa hingga Surabaya. Gempa ini merupakan gempa bumi dangkal akibat patahan lokal. https://t.co/cnbnceGS1D",19,2,1,3,2022-01-15,9,Saturday,6,20,5
1482285119725572099,2022-01-15 09:34:46,Warga yang tinggal di pesisir selatan Pandeglang mulai beraktivitas normal kembali. Mereka terlihat membersihkan puing-puing reruntuhan di rumah usai gempa. https://t.co/SMnRkqN7qy,11,1,0,0,2022-01-15,9,Saturday,6,11,1
1482284900065628162,2022-01-15 09:33:54,Ini deretan aktris Korea yang jadi istri konglomerat dan punya harta berlimpah:   https://t.co/zVSk5sYdwX,14,1,1,0,2022-01-15,9,Saturday,6,15,1
1482283105448771584,2022-01-15 09:26:46,"Gempa magnitudo 4.1 mengguncang Bangkalan, Pulau Madura, Jawa Timur. Gempa Bangkalan terjadi pukul 15:18:09 WIB. https://t.co/Zu0idGpIvW",24,0,15,3,2022-01-15,9,Saturday,6,39,3
1482281638985936896,2022-01-15 09:20:56,Salah satu perusahaan pembuat kartu grafis tidak menyarankan konsumen untuk membeli kartu grafis yang sebelumnya dipakai untuk menambang kripto. Kenapa? https://t.co/0S9n6wJN30,6,2,4,0,2022-01-15,9,Saturday,6,10,2
1482280339980656643,2022-01-15 09:15:47,Taemin SHINee pindah tugas saat wajib militer karena mengalami gejala depresi dan gangguan kecemasan.  https://t.co/p1ubXjppRJ,17,1,2,2,2022-01-15,9,Saturday,6,19,3
1482279820990062592,2022-01-15 09:13:43,"Polisi telah memastikan video syur 61 detik mirip Nagita Slavina palsu. Meski begitu, KPI selaku pihak pelapor meminta proses penyelidikan tidak berhenti. https://t.co/Mlu2h5aJIT",52,9,3,0,2022-01-15,9,Saturday,6,55,9
1482279326011867138,2022-01-15 09:11:45,"Gempa bumi bermagnitudo 4.1 mengguncang wilayah Bangkalan, Madura, Jawa Timur. Gempa ini terjadi pukul 15:18:09 WIB. Gempa dirasakan hingga Kota Surabaya. https://t.co/idcQC4Z9X6",31,5,12,3,2022-01-15,9,Saturday,6,43,8
1482278818123497473,2022-01-15 09:09:44,"Sosok Bripka Mernawati, polisi wanita (polwan) yang bertugas di Bagian Administrasi Satbinmas Polres Singkawang viral di media sosial. Ini penyebabnya!  https://t.co/cAHbVktRQO",17,4,1,1,2022-01-15,9,Saturday,6,18,5
1482278323581505540,2022-01-15 09:07:46,"Seorang PNS Sulut di Jakarta, Heince J Keintjem yang dikabarkan menghilang menyatakan dia kabur dari rumah karena cekcok dengan istri. Simak pengakuannya!  https://t.co/goK8gmon8W",8,3,1,1,2022-01-15,9,Saturday,6,9,4
1482278303474098176,2022-01-15 09:07:41,"Polisi telah memastikan video syur 61 detik mirip Nagita Slavina palsu. Meski begitu, KPI selaku pihak pelapor meminta proses penyelidikan tidak berhenti. https://t.co/NJJDBiTVgg",5,1,0,1,2022-01-15,9,Saturday,6,5,2
1482277819514331136,2022-01-15 09:05:46,Cuitan Fico Fachriza jadi sorotan lagi soal narkoba. Ada cuitan Fico yang kembali jadi sorotan soal kehedonannya pakai narkoba.  https://t.co/D1PRkUeC5J,9,5,0,2,2022-01-15,9,Saturday,6,9,7
1482277572381708289,2022-01-15 09:04:47,Hanggini ngaku pernah mengunduh aplikasi kencan online. Ternyata dia hanya bertahan 5 menit mempunyai aplikasi tersebut.  https://t.co/XrsfWl29i8,16,5,2,2,2022-01-15,9,Saturday,6,18,7
1482277251794276352,2022-01-15 09:03:30,Vidi Aldiano dan Shelia Dara Aisha menjawab alasan pemilihan mahar dengan mata uang asing serta tanggal pernikahan. Jawaban keduanya nyeleneh dan sederhana.  https://t.co/AJA1NoAo6H,10,0,1,1,2022-01-15,9,Saturday,6,11,1
1482276986768789506,2022-01-15 09:02:27,"Gempa bumi bermagnitudo 4,1 guncang Bangkalan, Madura. Gempa berkekuatan 4.1 ini terjadi pukul 15:18:09 WIB https://t.co/IZ1gpw5atN",14,0,2,0,2022-01-15,9,Saturday,6,16,0
1482276474497507329,2022-01-15 09:00:25,Sebanyak 4 artis ditangkap karena kasus narkoba sejauh ini hingga pertengahan Januari 2022.  https://t.co/4enqa7p6Ab,7,1,3,1,2022-01-15,9,Saturday,6,10,2
1482273687348957189,2022-01-15 08:49:21,Dirjen Hubdat Kemenhub Budi Setiyadi menjelaskan pihaknya sudah berkoordinasi dengan Kementerian Keuangan (Kemenkeu) mengenai tiket berbayar.  https://t.co/acYZnHdOc5,9,0,1,0,2022-01-15,8,Saturday,6,10,0
1482272174601916417,2022-01-15 08:43:20,"Banyak tempat asyik untuk ngumpul di Tangerang Selatan, salah satunya tempat ini. Di sini kamu bisa ngumpul, ngopi dan juga main panahan.  https://t.co/VtLitKMf5h",10,0,0,0,2022-01-15,8,Saturday,6,10,0
1482270156927741952,2022-01-15 08:35:19,"Menurut kami, inilah satu-satunya destinasi wisata di atas bukit dengan pemandangan laut dan itu terbaik. https://t.co/3pLWBK3iei",22,3,1,2,2022-01-15,8,Saturday,6,23,5
1482268812472954882,2022-01-15 08:29:58,Warga Jatim yang terpapar positif COVID-19 varian Omicron bertambah. Kali ini warga Madiun berjenis kelamin perempuan usia 25 tahun.  https://t.co/ny6h5IiUJ4,15,3,6,1,2022-01-15,8,Saturday,6,21,4
1482267519268405252,2022-01-15 08:24:50,Jadwal BRI Liga 1 hari ini ada duel Persela Lamongan Vs Persija Jakarta. Tiga poin bakal ketat diperebutkan kedua tim demi menjaga misi masing-masing.  https://t.co/5uWumlivfv,8,0,0,0,2022-01-15,8,Saturday,6,8,0
1482266767921762306,2022-01-15 08:21:51,Indonesia berencana mengekspor listrik ke Singapura. Listrik yang dihasilkan bersumber dari energi baru terbarukan (EBT).  https://t.co/xU21wTrbMx,11,1,0,1,2022-01-15,8,Saturday,6,11,2
1482266490430754818,2022-01-15 08:20:45,"Tak lama lagi, pengunjung Candi Borobudur akan kembali naik menuju struktur bangunan candi. Sebelumnya mereka hanya menikmati candi dari pelataran di zona 1.  https://t.co/sxXRuVKGwg",9,0,0,1,2022-01-15,8,Saturday,6,9,1
1482266234137858050,2022-01-15 08:19:44,Aset NFT seperti yang dimiliki Ghozali maupun aset digital lainnya wajib dilaporkan di SPT Tahunan.  https://t.co/xNdHV6nRkM,16,11,4,0,2022-01-15,8,Saturday,6,20,11
1482265988641042433,2022-01-15 08:18:45,Di media sosial viral video yang menunjukkan vagina berisi belatung. Netizen yang syok penasaran apakah hal tersebut mungkin terjadi.  https://t.co/4c0qzLBTEW,99,27,28,9,2022-01-15,8,Saturday,6,127,36
1482265676760944640,2022-01-15 08:17:31,"RI mencatat total 572 kasus varian Omicron, mayoritas bergejala ringan batuk- pilek. Amat mirip, ini perbedaan paling mencolok gejala Omicron dengan flu biasa.  https://t.co/5YRHRNqnUv",6,0,3,0,2022-01-15,8,Saturday,6,9,0
1482265433004814338,2022-01-15 08:16:33,"Ralf Rangnick memuji komitmen Marcus Rashford di sesi latihan Manchester United. Namun, Rangnick juga menuntut Rashford menunjukkan performanya di lapangan.  https://t.co/gsgsKeS3b3",2,0,0,0,2022-01-15,8,Saturday,6,2,0
1482264130782380033,2022-01-15 08:11:22,"Tampak biasa bahkan sepi, tetapi warung ayam geprek ini ternyata memiliki rating tinggi di setiap aplikasi makanan online. Hampir selalu banjir orderan online.  https://t.co/RiAPYFuFzG",9,2,4,1,2022-01-15,8,Saturday,6,13,3
1482264109005561857,2022-01-15 08:11:17,"Philippe Coutinho sudah dilepas Barcelona. Belum selesai, beberapa pemain lain akan dilepas juga dan salah satunya adalah Sergino Dest.  https://t.co/5W26EcDMk8",2,0,0,0,2022-01-15,8,Saturday,6,2,0
1482263607828230145,2022-01-15 08:09:17,Kevin De Bruyne antusias menyambut laga Manchester City vs Chelsea. De Bruyne memprediksi pertandingan melawan Chelsea akan seru!  https://t.co/lvwBEPtS3s,10,0,1,0,2022-01-15,8,Saturday,6,11,0
1482263116952084481,2022-01-15 08:07:20,#Terpopuler Kondisi kesehatan Pak Ogah menurun. Dalam media sosial miliknya terlihat Pak Ogah mulai ngaco bicara. Ia pun mengatakan ingin terus pulang. https://t.co/8eo5wWDJkN,16,3,1,1,2022-01-15,8,Saturday,6,17,4
1482262618740043776,2022-01-15 08:05:22,"Perempuan warga Jember meninggal usai 3 hari divaksin. Dinkes Jember menyebut, perempuan yang karib disapa Mak Sri (60) itu memiliki riwayat sakit darah tinggi.  https://t.co/MnQDwAecHp",15,13,7,0,2022-01-15,8,Saturday,6,22,13
1482262366087749633,2022-01-15 08:04:21,"Polisi menetapkan Hadfana Firdaus, pria tendang sesajen di lokasi erupsi Semeru sebagai tersangka. Seluruh proses hukum Hadfana dilakukan di Mapolda Jatim.  https://t.co/Odc4EW1ewC",4,3,2,2,2022-01-15,8,Saturday,6,6,5
1482261715559538689,2022-01-15 08:01:46,"Ibu muda warga Desa Banjararum, Kecamatan Singosari, Kabupaten Malang, positif Omicron. Kini, pasien berinisial L usia 30 tahun diisolasi di Rusunawa Kepanjen.  https://t.co/aID2nT3Ips",17,0,2,1,2022-01-15,8,Saturday,6,19,1
1482261702615908357,2022-01-15 08:01:43,"Kasus positif COVID-19 varian Omicron muncul di Malang. Pasien yang terpapar berjenis kelamin perempuan dengan inisial L (29), warga Banjararum, Kec Singosari.  https://t.co/YjRqztLpaX",33,6,15,16,2022-01-15,8,Saturday,6,48,22
1482261085352869888,2022-01-15 07:59:16,Seorang perempuan warga Jember meninggal setelah 3 hari divaksin. Belum diketahui secara pasti penyebab meninggalnya perempuan berusia 60 tahun tersebut.  https://t.co/1CRIV7AF7f,17,5,6,1,2022-01-15,7,Saturday,6,23,6
1482261067891892228,2022-01-15 07:59:12,Vidi Aldiano meminang Sheila Dara dengan mahar uang 1.000 USD dan 501 pound sterling. Nilai dan mata uang yang dipilih memiliki makna tersendiri bagi pengantin baru tersebut. Apa artinya?  https://t.co/wmnkDSwEW3,238,6,32,5,2022-01-15,7,Saturday,6,270,11
1482259351930818562,2022-01-15 07:52:23,Ada 5 film yang bisa jadi ditonton akhir pekan ini di bioskop. Berikut film-filmnya.  https://t.co/HNev9P3EBN,4,0,2,0,2022-01-15,7,Saturday,6,6,0
1482257764516835332,2022-01-15 07:46:04,"Permintaan kopi jenis robusta asal Desa Cigemblong, Lebak terus meningkat sejak dirilis tahun 2020 lalu. Bubuk kopi ini merambah ke Jabodetabek.  https://t.co/y9CRQeFD9m",12,0,3,1,2022-01-15,7,Saturday,6,15,1
1482256514186461184,2022-01-15 07:41:06,Satgas Penanganan COVID-19 sedang mengkaji adanya penggunaan gelang yang mengandung chip untuk memonitor orang yang sedang melakukan karantina.  https://t.co/nKsFpaA9T9,3,2,1,4,2022-01-15,7,Saturday,6,4,6
1482256498113798144,2022-01-15 07:41:02,"Pembangunan Jakarta International Stadium (JIS) sudah mencapai 93,85%. Meski belum rampung, kawasan JIS sudah bisa dikunjungi oleh masyarakat umum.  https://t.co/wCYSt8z04w",13,2,4,3,2022-01-15,7,Saturday,6,17,5
1482255320118345729,2022-01-15 07:36:21,"Ada momen yang unik di pernikahan Vidi Aldiano dan Sheila Dara. Usai akad nikah, Sheila diberikan kejutan berupa trofi The Survival dari ayah Vidi, Harry Kiss. Apa makna piala penghargaan tersebut?  https://t.co/yhPPfADfpi",4,0,2,0,2022-01-15,7,Saturday,6,6,0
1482255074961276928,2022-01-15 07:35:23,"Epidemiolog Universitas Griffith Australia, Dicky Budiman, menilai penutupan pintu masuk internasional kurang tepat untuk mencegah Omicron. Kenapa?  https://t.co/ftsM5kMj9n",7,0,1,0,2022-01-15,7,Saturday,6,8,0
1482254574039801857,2022-01-15 07:33:24,Sebuah kapal ikan asing berbendera Malaysia ditangkap di Selat Malaka pada Kamis (13/1). Ini momennya!  https://t.co/FlFUUyAGfZ,7,1,1,0,2022-01-15,7,Saturday,6,8,1
1482254024179163136,2022-01-15 07:31:12,"Gempa kembali mengguncang wilayah Banten. Gempa kali ini berkekuatan magnitudo (M) 4,7.  https://t.co/1QipAXKMU2",17,0,12,3,2022-01-15,7,Saturday,6,29,3
1482254010455318528,2022-01-15 07:31:09,Kasus varian Omicron di Indonesia saat ini tembus 572 orang. Ini 3 gejalanya yang kerap dialami pasien Omicron Indonesia.  https://t.co/r2cFcrMCpF,7,1,2,0,2022-01-15,7,Saturday,6,9,1
1482253779953143809,2022-01-15 07:30:14,"Partai Gerindra menghormati rencana Demokrat, PKS, dan Golkar yang akan berkoalisi nasionalis religius di Pilpres 2024. Gerindra juga bakal buka komunikasi.  https://t.co/0ylmSdDFNY",2,2,3,0,2022-01-15,7,Saturday,6,5,2
1482252762071154688,2022-01-15 07:26:12,"Ellen berharap jeritannya bisa didengarkan Jokowi, Ridwan Kamil dan Hengky Kurniawan.  https://t.co/2OFt4ULLWB",22,28,8,0,2022-01-15,7,Saturday,6,30,28
1482252257785782275,2022-01-15 07:24:11,"Seperti halnya pisau, otak juga perlu diasah agar selalu tajam. Otak juga butuh diolahragakan agar lebih berstamina untuk menyambut awal pekan. Yuk dicoba! https://t.co/FjDtpxpAsB",84,55,5,3,2022-01-15,7,Saturday,6,89,58
1482251503863742467,2022-01-15 07:21:12,Ketua Pelaksana LTMPT Budi Prasetyo merespons sejumlah kendala yang terjadi saat portal LTMPT eror di masa daftar akun SNMPTN 2022. Berikut responsnya. Via: detikedu  https://t.co/vXOtHBXhRt,3,0,0,0,2022-01-15,7,Saturday,6,3,0
1482249434603925506,2022-01-15 07:12:58,"Dari berbagai eksperimen yang dilakukan ilmuwan, yang satu ini terbilang unik. Ikan diajari cara menyetir mobil di darat. Bagaimana caranya? https://t.co/qMnVjXLsA2",7,2,1,3,2022-01-15,7,Saturday,6,8,5
1482247945168826372,2022-01-15 07:07:03,Mantan ilmuwan NASA mengungkap rencananya untuk mengubah Mars jadi planet yang bisa dihuni oleh manusia. Ini caranya:   https://t.co/6UMYgZIEnA,20,2,4,1,2022-01-15,7,Saturday,6,24,3
1482246440390959108,2022-01-15 07:01:04,"KFC cabang Kota Palopo, Sulawesi Selatan, digugat ke Pengadilan Negeri (PN) Palopo dengan dugaan pembohongan publik atas pengantaran pesanan yang tidak sesuai di aplikasi. #CNNIndonesia #detikNetwork  https://t.co/MCQPeIZVwJ",28,14,5,1,2022-01-15,7,Saturday,6,33,15
1482244811344257027,2022-01-15 06:54:36,"BMKG menyebut adanya potensi gempa sebesar magnitudo 8,7 di Banten. Namun potensi tersebut tidak dapat diprediksi.  https://t.co/J8x0MiDZkq",137,23,73,36,2022-01-15,6,Saturday,6,210,59
1482243158821982209,2022-01-15 06:48:02,Stasiun kereta api (KA) yang menghubungkan jalur Cijulang-Banjar-Pangandaran kini tak terawat. Bangunannya pun hampir roboh termakan usia  https://t.co/wOIUlWiIkI,8,0,5,1,2022-01-15,6,Saturday,6,13,1
1482241658062348290,2022-01-15 06:42:04,"Duel sengit antara Manchester City Vs Chelsea akan tersaji malam nanti , Sabtu (15/1). The Blues diprediksi akan menurunkan Romelu Lukaku sejak menit awal pertandingan.  https://t.co/VH2MNyTNYX",8,0,0,0,2022-01-15,6,Saturday,6,8,0
1482240428111970304,2022-01-15 06:37:11,Demokrat dan Golkar tertarik dengan usulan PKS untuk bangun koalisi poros nasionalis-religius. PPP menilai koalisi tersebut hanya akan berakhir sebagai wacana.  https://t.co/IQ0hm4GSDK,11,5,2,0,2022-01-15,6,Saturday,6,13,5
1482238796410273794,2022-01-15 06:30:42,"Masyarakat adat Baduy sempat merasakan guncangan gempa M 6,6 di Banten yang terjadi pada Jumat kemarin namun dipastikan tidak ada satupun rumah di sana yang rusak. Ini rahasianya!  https://t.co/Vsvt2Oc0iP",20,0,6,1,2022-01-15,6,Saturday,6,26,1
1482238038784757765,2022-01-15 06:27:41,Mbappe mungkin saja bertahan di PSG musim depan. Penyerang 23 tahun tersebut diketahui sedang menjalani negosiasi perpanjangan kontrak dengan Les Parisiens.  https://t.co/KuVq0BR748,14,0,1,0,2022-01-15,6,Saturday,6,15,0
1482236228011446272,2022-01-15 06:20:30,IU iuterkenal dengan pola dietnya yang ekstrem. Dahulu ia bisa menurunkan berat badan hingga 5 kilogram (kg) dalam lima hari dengan konsumsi makanan ini.  https://t.co/g0tRzV85IG,14,0,3,0,2022-01-15,6,Saturday,6,17,0
1482236211485892609,2022-01-15 06:20:26,Air mata Nenek Ellen menetes ketika menceritakan pahitnya kehidupan. Ia ditipu cucunya yang membuatnya terancam terusir dari rumah peninggalan suaminya.  https://t.co/Cmg8b3OTtx,23,2,7,4,2022-01-15,6,Saturday,6,30,6
1482235693539680262,2022-01-15 06:18:22,"BMKG mencatat ada 32 kali gempa susulan yang terjadi di Banten sejak gempa magnitudo (M) 6,6 kemarin. Gempa susulan paling besar adalah M 5,7.  https://t.co/b85qp6iTYe",16,1,14,2,2022-01-15,6,Saturday,6,30,3
1482235416862461953,2022-01-15 06:17:16,"BPBD Lebak mencatat data terbaru jumlah kecamatan terdampak akibat gempa M 6,6 di Banten.  https://t.co/lOSVouoA2W",3,1,2,0,2022-01-15,6,Saturday,6,5,1
1482235399946788868,2022-01-15 06:17:12,YouTuber Nex Carlos mengajak Erick Thohir mencicipi kuliner Betawi. Momen ini juga jadi pengalaman pertama Erick Thohir mencoba pecak gurame.  https://t.co/7EB5wYXSjV,22,2,5,1,2022-01-15,6,Saturday,6,27,3
1482235154269716483,2022-01-15 06:16:14,Bukan hanya Lesti Kejora dan Rizky Billar yang bahagia menyambut lahirnya Baby L. Tapi juga fansnya yang bahkan membuat nasi kuning syukuran kelahiran Baby L.  https://t.co/z1g7nVIzGY,16,0,2,2,2022-01-15,6,Saturday,6,18,2
1482235137756741632,2022-01-15 06:16:10,"Sejak kepergian Vanessa Angel &amp; Bibi Ardiansyah, nama Fuji seringkali menjadi sorotan. Kali ini Fuji kembali disorot usai video pemotretan dirinya beredar luas.  https://t.co/5fyqnGU8wo",20,7,5,1,2022-01-15,6,Saturday,6,25,8
1482233844342394881,2022-01-15 06:11:01,Semifinal India Open 2022 akan digelar hari ini. Berikut jadwal lengkapnya.  https://t.co/RKEC2jR1Y6,14,0,2,0,2022-01-15,6,Saturday,6,16,0
1482233223530876928,2022-01-15 06:08:33,Puan Maharani terlihat duduk bersama tamu undangan yang hadir dalam pernikahan Vidi Aldiano dan Sheila Dara Aisha.  https://t.co/i1rZ4C11Mb,15,1,2,0,2022-01-15,6,Saturday,6,17,1
1482232972510220288,2022-01-15 06:07:33,"Taqy Malik melelang jam Rolex untuk membangun masjid. Gilang Juragan 99 memenangkan lelang dan bayar tunai Rp 1,15 miliar.  https://t.co/OCwqWCzv8y",116,21,11,4,2022-01-15,6,Saturday,6,127,25
1482232731987816450,2022-01-15 06:06:36,Sheila Dara Aisha terlebih dulu memohon doa dan restu sebelum menikah dengan Vidi Aldiano. Sheila tampak tegar.  https://t.co/KvgMqSDklP,21,0,3,2,2022-01-15,6,Saturday,6,24,2
1482232448327065602,2022-01-15 06:05:28,Status Ardhito Pramono sudah beristri bikin kaget netizen. Diam-diam Ardhito Pramono memang sudah nikah dengan Jeanneta Sanfadelia.  https://t.co/PABszTMsfZ,7,1,2,2,2022-01-15,6,Saturday,6,9,3
1482232446905114624,2022-01-15 06:05:28,Kadinkes DKI Widyastuti mengatakan sebagian besar pasien kasus Omicron bergejala ringan. Kini keterisian tempat tidur di DKI Jakarta baru terisi 12 persen.  https://t.co/O8sO5MNUJU,8,1,3,2,2022-01-15,6,Saturday,6,11,3
1482231695759888384,2022-01-15 06:02:29,Ramalan zodiak Cancer kelola waktu dengan setepat mungkin sehingga tidak terjadi penumpukan pekerjaan. Berikut ramalan zodiak hari ini:  https://t.co/JhmOIveLoU,5,0,3,0,2022-01-15,6,Saturday,6,8,0
1482231673077084161,2022-01-15 06:02:24,Kalina Oktarani mengklaim pernikahannya dengan Vicky Prasetyo sudah selesai. Kalina menegaskan pernikahannya dengan Vicky bukan setting-an.  https://t.co/PEfnbPGWdV,5,1,2,0,2022-01-15,6,Saturday,6,7,1
1482231332214296584,2022-01-15 06:01:02,"Sempat putus sambung, akhirnya Vidi Aldiano resmi menikahi Sheila Dara Aisha. Keduanya kini, sudah bisa tertawa lepas menyangdang status suami dan istri.  https://t.co/hkA5Pd2sIB",6,0,5,0,2022-01-15,6,Saturday,6,11,0
1482231324538720259,2022-01-15 06:01:00,Di media sosial ramai soal video viral belatung. Netizen syok dengan video yang tampak menunjukkan vagina berisi belatung hidup.  https://t.co/O04RZG2abz,10,9,4,0,2022-01-15,6,Saturday,6,14,9
1482230245092691974,2022-01-15 05:56:43,Di Sukabumi ada angkot 'sultan' yang melayani perjalanan dari Cicurug-Kota Bogor. Di dalamnya penumpang diperlakukan seperti VIP.  https://t.co/9j7U0ViW6q,20,4,4,4,2022-01-15,5,Saturday,6,24,8
1482229958051303424,2022-01-15 05:55:35,Arsenal meminta laga melawan Tottenham Hotspur akhir pekan ini ditunda. Sang tetangga rupanya tak senang dengan langkah tersebut.  https://t.co/BYn1HGhJxh,3,0,0,0,2022-01-15,5,Saturday,6,3,0
1482228689538535424,2022-01-15 05:50:32,"Siswa SMA mencoba berbagai cara membuat akun LTMPT untuk SNMPTN 2022 kendati kerap error. Berikut cara mengatasi portal LTMPT error versi siswa. 
Via: detikedu  https://t.co/QhrbOa1YUH",9,0,2,0,2022-01-15,5,Saturday,6,11,0
1482227521655648257,2022-01-15 05:45:54,Liga Inggris malam ini akan menyajikan big match Manchester City vs Chelsea. Jadwal Liga Inggris selengkapnya untuk nanti malam bisa disimak di sini.  https://t.co/EI2lDJH6MO,7,0,0,1,2022-01-15,5,Saturday,6,7,1
1482226259862208512,2022-01-15 05:40:53,"Real Madrid lagi galak musim ini. Madrid memimpin Liga Spanyol, melangkah ke final Piala Super Spanyol, dan menjaga kans di Liga Champions. Apa rahasianya?  https://t.co/vRYzRcyU0f",7,0,2,1,2022-01-15,5,Saturday,6,9,1
1482224422555734016,2022-01-15 05:33:35,Snack untuk diet punya rasa yang tak kalah enak dari camilan biasa dan bisa mengganjal perut di sela-sela jam makan sehingga kamu tidak perlu kelaparan.  https://t.co/ae2vSimMsP,9,0,0,0,2022-01-15,5,Saturday,6,9,0
1482224074843738113,2022-01-15 05:32:12,"Kelompok ini mendukung Prabowo-Jokowi maju sebagai pasangan Calon Presiden dan Calon Wakil Presiden di Pemilu 2024. Simak alasan mereka, selengkapnya.  https://t.co/NSJzBX5lHF",41,61,8,34,2022-01-15,5,Saturday,6,49,95
1482222995607281665,2022-01-15 05:27:55,"Tertarik ingin jual beli NFT setelah melihat hype Ghozali Everyday? Jangan asal-asalan, intip dulu saran dari Chef Arnold Poernomo berikut ini.  https://t.co/u0LwNgEhJs",15,1,2,0,2022-01-15,5,Saturday,6,17,1
1482221442485952516,2022-01-15 05:21:44,Nasabah prioritas BCA sempat ramai di media sosial TikTok sampai Instagram!  https://t.co/hOUW60BXGV,9,0,2,0,2022-01-15,5,Saturday,6,11,0
1482219982570364928,2022-01-15 05:15:56,"Cristiano Ronaldo harus berpikir ulang jika ingin meninggalkan Manchester United. Sebab, pacarnya Georgina Rodriguez mengaku betah tinggal di Manchester.  https://t.co/fhuEV0oQWK",19,1,1,2,2022-01-15,5,Saturday,6,20,3
1482218705723478016,2022-01-15 05:10:52,"Lorenzo Insigne akan meninggalkan Napoli secara gratis di akhir musim ini. Adiknya, Roberto Insigne menyebut hal tersebut bukanlah kesalahan abangnya.  https://t.co/Foe5c2m1u9",6,1,0,1,2022-01-15,5,Saturday,6,6,2
1482218405553967112,2022-01-15 05:09:40,Jokowi mencabut 192 izin pemanfaatan hutan. Salah satu yang terkena adalah PT Barito Pacific (Tbk) yang dikelola oleh PT Rimba Equator Permai (REP) yang izinnya dicabut per tanggal 6 Januari 2022.  https://t.co/1euWJnQzFy,75,10,10,5,2022-01-15,5,Saturday,6,85,15
1482217419456274437,2022-01-15 05:05:45,"Ketua Bappilu Demokrat Andi Arief mengungkap prediksi 3 koalisi besar di Pilpres 2024. Salah satunya koalisi religius-nasionalis Demokrat, PKS, dan Golkar.  https://t.co/YEru3YIE48",6,2,0,1,2022-01-15,5,Saturday,6,6,3
1482217418239926273,2022-01-15 05:05:45,"Dalam penemuan terbaru yang mengejutkan, para ilmuwan menjumpai koloni ikan di balik lapisan es di Antartika. Jumlahnya luar biasa banyak.  https://t.co/QjBudozu5E",12,0,4,0,2022-01-15,5,Saturday,6,16,0
1482216386562863105,2022-01-15 05:01:39,"Prakirawan BMKG melaporkan secara umum wilayah Indonesia berpotensi hujan. Simak prakiraan cuaca selengkapnya yang berlaku untuk hari Sabtu, 15 Januari 2022.  https://t.co/SEUakiHz0w",7,1,1,2,2022-01-15,5,Saturday,6,8,3
1482214802273587203,2022-01-15 04:55:21,Ubedillah Badrun mengatakan JoMan tak berhak melaporkan dia ke polisi terkait fitnah kepada Gibran Rakabuming dan Kaesang Pangarep. JoMan berkata sebaliknya!  https://t.co/FyDJN1ME1d,17,22,6,3,2022-01-15,4,Saturday,6,23,25
1482214801006743554,2022-01-15 04:55:21,"Sudah sejak lama suara misterius di alam semesta menjadi pertanyaan menarik para ilmuwan. Kini, ilmuwan mulai menemui titik terang.  https://t.co/aTYwWrBZ5Q",23,1,5,0,2022-01-15,4,Saturday,6,28,1
1482213800849903620,2022-01-15 04:51:22,"BPBD Banten merilis dampak gempa M 6,6. Ada tiga kabupaten yang terdampak khususnya yang mengakibatkan rumah rusak baik ringan maupun berat.  https://t.co/j1mQnruQYu",10,0,4,1,2022-01-15,4,Saturday,6,14,1
1482212555967897603,2022-01-15 04:46:26,Sebuah bayangan yang diduga berasal dari suatu obyek cukup besar wujudnya telah terekam di layanan peta Google Maps. Ini penampakannya:  https://t.co/LxVGusSh1i,21,3,6,2,2022-01-15,4,Saturday,6,27,5
1482211056437104641,2022-01-15 04:40:28,Manchester United belum beranjak jauh dari posisi saat Ralf Rangnick datang sebagai manajer anyar. Progres 'Setan Merah' diakui cukup lambat.  https://t.co/LFbsxz2yar,7,1,0,0,2022-01-15,4,Saturday,6,7,1
1482211026812735488,2022-01-15 04:40:21,Sistem ganjil genap untuk kendaraan di Kota Bogor kembali diberlakukan mulai hari ini hingga Minggu besok.  https://t.co/nZykiFdYZn,6,0,2,1,2022-01-15,4,Saturday,6,8,1
1482210490906464256,2022-01-15 04:38:13,Polisi menerangkan pelaku menendang bola yang disimpan korban dalam kaos korban lantaran kesal tak dipinjamkan bola.  https://t.co/KEVtaRYtxV,9,0,1,1,2022-01-15,4,Saturday,6,10,1
1482209998742732800,2022-01-15 04:36:16,"Direktur Utama bank Seba yang berbasis di Swiss, Guido Buhler, meramal nilai Bitcoin tahun ini bakal memecahkan rekor. Berapa?  https://t.co/xuSTSDyI9v",14,0,4,2,2022-01-15,4,Saturday,6,18,2
1482208673292247044,2022-01-15 04:31:00,"Thariq Halilintar tidak merasakan yang terlalu parah. Menurut dia, gejala COVID-19 yang dialaminya kali ini hampir tidak ada.  https://t.co/GOyKSDJhJT",10,2,1,4,2022-01-15,4,Saturday,6,11,6
1482207401961046022,2022-01-15 04:25:57,"Bill Gates meramalkan bahwa usai Omicron, COVID-19 kemungkinan akan berakhir mirip flu musiman.  https://t.co/rSGTzbUfg1",99,39,27,14,2022-01-15,4,Saturday,6,126,53
1482206076007297024,2022-01-15 04:20:41,Manajer Chelsea Thomas Tuchel tak keberatan mengakui Manchester City tim terbaik di Inggris saat ini. Juara bertahan Premier League itu adalah tolok ukur.  https://t.co/qt1WjdGSXX,6,0,0,1,2022-01-15,4,Saturday,6,6,1
1482204840231116800,2022-01-15 04:15:46,"Empat tahanan di Polsek Cikalongwetan, Kabupaten Bandung Barat (KBB), melarikan diri lewat atap. Dua orang sudah ditangkap.  https://t.co/AKk02PGWl5",7,1,3,0,2022-01-15,4,Saturday,6,10,1
1482204368975892481,2022-01-15 04:13:54,"Urusan makeup, tidak diragukan lagi jika Tasya Farasya memang ahlinya. Dalam unggahan terbarunya,Tasya mengkreasikan makeup ala Telenovela Rosalinda! https://t.co/oQWXnho9uu",12,0,2,1,2022-01-15,4,Saturday,6,14,1
1482204348021190667,2022-01-15 04:13:49,JoMan membuka peluang cabut laporan jika Ubedillah Badrun meminta maaf ke publik. Ubedillah pastikan tidak akan minta maaf!  https://t.co/pBHbGP86gy,534,119,82,30,2022-01-15,4,Saturday,6,616,149
1482203510980722692,2022-01-15 04:10:29,"Gempa bumi dengan magnitudo (M) 6,6 mengguncang Banten pada Jumat (14/1). Ribuan rumah dilaporkan rusak.  https://t.co/usvh3RsbNn",11,0,5,0,2022-01-15,4,Saturday,6,16,0
1482203277324599297,2022-01-15 04:09:33,"Vidi Aldiano dan Sheila Dara Aisha resmi menikah hari ini, Sabtu (15/1). Prosesi akad nikah dihadiri sejumlah tamu pejabat, salah satunya ada Ketua DPR RI Puan Maharani.   https://t.co/wLEdXtvPIl",13,3,3,0,2022-01-15,4,Saturday,6,16,3
1482203275860529155,2022-01-15 04:09:33,Masa depan Donny van de Beek dan Dean Henderson di Manchester United serba tak menentu. Kedua pemain ini dikabarkan sudah tak betah dan ingin pergi.  https://t.co/89pJahvZ14,10,2,2,0,2022-01-15,4,Saturday,6,12,2
1482202760854523906,2022-01-15 04:07:30,Vidi Aldiano resmi menikahi Sheila Dara Aisha hari ini (15/1) dengan mahar berupa uang sebesar 1.000 USD dan 501 Pound Sterling. Begini momen ijab kabulnya.  https://t.co/H57T8HqUPA,33,1,4,0,2022-01-15,4,Saturday,6,37,1
1482202277574230019,2022-01-15 04:05:35,"Ghozali Everyday, menyampaikan siap membayar pajak, setelah diberi ucapan selamat oleh Dirjen Pajak, terkait foto selfie dirinya terjual hingga miliaran Rupiah.  https://t.co/u4vhkZFnlw",222,49,45,19,2022-01-15,4,Saturday,6,267,68
1482201246274621445,2022-01-15 04:01:29,"Web series Layangan Putus kini sudah mencapai episode kesembilan. Di episode ini, Aris enggan minta maaf pada Kinan atas apa yang sudah dilakukannya. #detikNetwork  https://t.co/YQGo3NzPaN",7,0,3,0,2022-01-15,4,Saturday,6,10,0
1482200090412568583,2022-01-15 03:56:54,"Belasan sekolah di Jakarta memberhentikan PTM 100 persen setelah adanya temuan kasus positif COVID-19 pada warga sekolah. Ini daftar lengkapnya. 
Via: detikedu  https://t.co/lontsQTh2n",44,14,17,8,2022-01-15,3,Saturday,6,61,22
1482199573976297477,2022-01-15 03:54:51,Video syur berdurasi 61 detik yang dikaitkan dengan artis Nagita Slavina sempat membuat heboh. Polisi telah memastikan video itu hasil rekayasa!  https://t.co/EnOB5H0iFO,12,4,1,1,2022-01-15,3,Saturday,6,13,5
1482198986090061824,2022-01-15 03:52:30,"Setiap makhluk hidup, pasti akan mengalami kematian. Berikut ini beberapa tanda-tanda kematian yang menandakan ajal sudah dekat. https://t.co/7eZ1KbblYO",28,8,6,4,2022-01-15,3,Saturday,6,34,12
1482198967815450627,2022-01-15 03:52:26,"Lukisan NFT (Non-fungible token) karya Gubernur Jabar Ridwan Kamil dibeli crazy rich asal Bangka, Lanang Cikal Narendra!  https://t.co/FPMmEmSbmD",533,114,86,313,2022-01-15,3,Saturday,6,619,427
1482197909550551040,2022-01-15 03:48:14,"Pria tendang dan membuang sesajen di lokasi erupsi Semeru, Hadfana Firdaus ditetapkan tersangka. Hadfana meminta maaf ke seluruh masyarakat Indonesia.  https://t.co/yGHZdfI0yK",14,7,4,1,2022-01-15,3,Saturday,6,18,8
1482197555626790917,2022-01-15 03:46:49,Beredar video belatung di Tiktok dan Twitter yang membuat heboh netizen. Pasalnya belatung tersebut tampak ditemukan di dalam vagina!  https://t.co/VszlWLQ0Hd,170,65,31,15,2022-01-15,3,Saturday,6,201,80
1482197426786164737,2022-01-15 03:46:19,"Jokowi kembali mengajak masyarakat untuk bangga bergaya dengan produk buatan anak Bangsa. Kali ini, saat ia menjajal Jalan Bypass BIL-Mandalika Lombok.  https://t.co/Ntg7GbZmUf",12,0,1,0,2022-01-15,3,Saturday,6,13,0
1482197407207247879,2022-01-15 03:46:14,"Dalam sepekan, wilayah Jawa Timur diguncang 24 kali gempa bumi. Namun, hanya satu gempa bumi yang bisa dirasakan masyarakat.  https://t.co/4MBTf86FWx",12,0,2,1,2022-01-15,3,Saturday,6,14,1
1482195921819611139,2022-01-15 03:40:20,Rose Nora Anna disebut sebagai reinkarnasi Putri Diana karena kemiripannya. Inilah potret cantik Rose Nora.  https://t.co/3ZHUHhIH10,17,1,3,4,2022-01-15,3,Saturday,6,20,5
1482193089271902211,2022-01-15 03:29:04,Pemain timnas Indonesia yang berlaga untuk Piala AFF 2020 masih jadi sorotan. Potret mereka bersama pasangan pun mengundang penasaran publik. Intip foto-fotonya  https://t.co/z3ZLtVrhZ2,6,0,1,0,2022-01-15,3,Saturday,6,7,0
1482192345496002569,2022-01-15 03:26:07,"Polisi menjelaskan alasan pecahnya tangisan komika itu. Fico menyesal karena kasus ini berdampak pada kehidupannya, termasuk karier yang dirintisnya selama ini.  https://t.co/HeLv8C15Xs",100,66,8,14,2022-01-15,3,Saturday,6,108,80
1482191595453788166,2022-01-15 03:23:08,"Kedua pasangan pengantin ini tidak menyangka jika jodohnya adalah tetangganya sendiri, seperti apa kisahnya?  https://t.co/2roJvur1no",9,0,3,1,2022-01-15,3,Saturday,6,12,1
1482190070241181696,2022-01-15 03:17:05,"Jika masih belum memikirkan kata-kata undangan pernikahan bahasa Inggris, berikut contoh undangan pernikahan bahasa Inggris yang bisa ditiru.  https://t.co/BTFdB5PnG7",18,5,2,1,2022-01-15,3,Saturday,6,20,6
1482188617976012808,2022-01-15 03:11:18,Viral aksi MUA yang berhasil membuat seorang nenek jadi tampak lebih muda dengan teknik makeup memakai lakban. Seperti apa?  https://t.co/5sSb8mQ3TM,16,5,6,2,2022-01-15,3,Saturday,6,22,7
1482188051904356360,2022-01-15 03:09:03,"Pagi ini, kawasan laut dekat Selat Sunda kembali diguncang gempa. Gempa bermagnitudo (M) 4,7.  https://t.co/AkdyFLMOwG",21,1,12,1,2022-01-15,3,Saturday,6,33,2
1482187402550595586,2022-01-15 03:06:29,Korut mengklaim sukses meluncurkan dua rudal taktis dari kereta api. Ini menjadi uji coba senjata balistik ketiga yang digelar Korut pada bulan Januari ini.  https://t.co/m1hyoi6mq7,4,0,1,0,2022-01-15,3,Saturday,6,5,0
1482186065091960835,2022-01-15 03:01:10,"Sebagai cara membuat Bitcoin tetap bernilai, Satoshi Nakamoto selaku penciptanya yang misterius membatasi suplainya. Tepatnya, hanya ada 21 juta koin Bitcoin.  https://t.co/BNcJkjv0nL",4,1,2,0,2022-01-15,3,Saturday,6,6,1
1482185784610463747,2022-01-15 03:00:03,Rumah mewah di Jakarta harganya masih akan terus terkoreksi. Segini Harganya.  https://t.co/QrlnqxC2Lr,34,8,8,7,2022-01-15,3,Saturday,6,42,15
1482185770647621632,2022-01-15 03:00:00,Harga emas hari ini turun lagi. Harga emas Antam 24 karat hari ini turun Rp 1.000 per gram menjadi Rp 938.000 per gram.  https://t.co/KLy6RQ3tks,10,0,1,0,2022-01-15,3,Saturday,6,11,0
1482185486085013506,2022-01-15 02:58:52,Harga emas hari ini turun lagi. Harga emas Antam turun Rp 1.000 per gram menjadi Rp 938.000 per gram.  https://t.co/HdDbxiSI5G,3,1,1,0,2022-01-15,2,Saturday,6,4,1
1482185205876146180,2022-01-15 02:57:45,"Aset Hutomo Mandala Putra alias Tommy Soeharto yang dilelang pada Rabu (12/1) dengan harga Rp 2,4 triliun tak laku. Ternyata ini penyebabnya!  https://t.co/uFweZGaKqk",68,11,13,6,2022-01-15,2,Saturday,6,81,17
1482184418882162690,2022-01-15 02:54:37,"Petaka menimpa seorang santri asal Filipina bernama Cosain Abdul Jamil (15) di Kota Bekasi, Jawa Barat. Cosain tewas dalam peristiwa ledakan tabung gas!  https://t.co/1re1ZgXDQ9",2,1,3,1,2022-01-15,2,Saturday,6,5,2
1482183844832980995,2022-01-15 02:52:20,Viral kisah pria yang berhasil kembali setelah diculik selama 30 tahun. Ia kembali berkat peta kampung halamannya yang ia buat. https://t.co/UGmd1OXWrR,23,0,4,0,2022-01-15,2,Saturday,6,27,0
1482181799447040004,2022-01-15 02:44:13,"Tiga pemuda di Yogyakarta yakni Venzha Christ, Erix Soekamti dan Grayce Soba membangun simulasi analog hidup di Mars. Keren!  https://t.co/Po7a5Za08e",17,5,3,3,2022-01-15,2,Saturday,6,20,8
1482180135067471872,2022-01-15 02:37:36,Laju stabil Manchester City diuji Chelsea akhir pekan ini. Manajer Man City Pep Guardiola mengantisipasi perubahan gaya bermain The Blues.  https://t.co/BOUnY5r8eH,8,2,1,1,2022-01-15,2,Saturday,6,9,3
1482178461292806144,2022-01-15 02:30:57,Rispo datang untuk memberi dukungan kepada adiknya agar terus menjalani prosedur yang ada. Ia menegaskan semuanya harus tetap diproses.  https://t.co/4OAI0hdoEZ,17,1,1,1,2022-01-15,2,Saturday,6,18,2
1482177429686861827,2022-01-15 02:26:51,PKS menyambut baik respons Golkar dan Demokrat terkait koalisi nasionalis-religius. PKS akan mencari titik temu untuk mengusung capres-cawapres.  https://t.co/MRYcT7cPl4,17,6,6,5,2022-01-15,2,Saturday,6,23,11
1482177119824326658,2022-01-15 02:25:37,Kasus COVID-19 varian Omicron di Indonesia terus bertambah. Hingga kini sudah terdeteksi lebih dari 500 kasus Omicron di Tanah Air.  https://t.co/esR3IG1PGV,8,7,4,1,2022-01-15,2,Saturday,6,12,8
1482176874696560643,2022-01-15 02:24:39,"Ribuan rumah warga mengalami kerusakan akibat gempa M 6,6. Sebarannya berada di 28 kecamatan yang bernaung di Kabupaten Pandeglang.  https://t.co/E0cgLhuxsF",10,0,1,0,2022-01-15,2,Saturday,6,11,0
1482176629170442243,2022-01-15 02:23:40,"Ubedillah mengaku heran dengan laporan Ketua Umum JoMan, Immannuel Ebenezer terhadapnya. Dia mempertanyakan apakah Noel korban pelaporannya.  https://t.co/ttdv7QfmpH",17,21,5,3,2022-01-15,2,Saturday,6,22,24
1482176627903766529,2022-01-15 02:23:40,AC Milan mendapat kabar buruk di balik kelolosan mereka ke perempatfinal Coppa Italia. Fikayo Tomori mungkin harus absen beberapa pekan karena cedera lutut.  https://t.co/kTT5tnU2PX,4,0,0,1,2022-01-15,2,Saturday,6,4,1
1482176580512329729,2022-01-15 02:23:28,Vidi Aldiano mengucap ijab kabul dengan lancar saat menikahi Sheila Dara Aisha. Kini keduanya pun sudah sah menjadi suami dan istri.  https://t.co/HfFbOgaJPQ,169,1,28,8,2022-01-15,2,Saturday,6,197,9
1482175882613694465,2022-01-15 02:20:42,Indonesia mulai menjalankan program dosis Ke-3 vaksin COVID-19 atau disebut juga vaksin booster. Simak syarat lengkap vaksin booster ini.  https://t.co/JKNZk3Nzqg,3,0,4,0,2022-01-15,2,Saturday,6,7,0
1482175137663356932,2022-01-15 02:17:44,"Coutinho berpeluang debut bareng Aston Villa menghadapi Manchester United akhir pekan ini. Namun manajer The Villans, Steven Gerrard, enggan memberi jaminan.  https://t.co/Cnm9X92kOT",5,0,0,0,2022-01-15,2,Saturday,6,5,0
1482174608505720833,2022-01-15 02:15:38,Kasus antara Lee Jinglei dan Wang Leehom kian panas. Apalagi setelah mantan istrinya itu menuding jika Leehom memaksa masuk ke rumahnya!  https://t.co/Rxhak3SRP8,2,0,0,0,2022-01-15,2,Saturday,6,2,0
1482173782110441474,2022-01-15 02:12:21,"Arsenal tak kuasa menahan badai virus corona di tubuh klub saat ini. Maka dari itu, The Gunners meminta duel kontra Tottenham Hotspur ditunda.  https://t.co/dNagk64td5",1,0,0,1,2022-01-15,2,Saturday,6,1,1
1482173301980073989,2022-01-15 02:10:27,"Seorang polisi di Polsek Cileungsi, berinisial Aipda AS dihukum demosi karena AS diduga 'cueki' laporan driver ojol bernama Charly yang kehilangan motor.  https://t.co/kc2BnmuBL5",91,15,16,9,2022-01-15,2,Saturday,6,107,24
1482172806737674243,2022-01-15 02:08:29,"Satu hari sebelum menikah, Vidi Aldiano mendapat kejutan dari para sahabatnya. Kejutan itu cukup membuat Vidi Aldiano terkejut.  https://t.co/Xq2SfcSci1",37,12,6,4,2022-01-15,2,Saturday,6,43,16
1482172047568605190,2022-01-15 02:05:28,Borussia Dortmund meraih kemenangan besar saat menjamu Freiburg di lanjutan Liga Jerman. Die Borussen yang tampil dominan menang 5-1.  https://t.co/b33cXCvU9m,5,0,1,0,2022-01-15,2,Saturday,6,6,0
1482170757799190533,2022-01-15 02:00:20,"Tempat paling populer adalah OpenSea, namun ada juga marketplace lain mulai dari Rarible hingga khusus game dan metaverse macam Axie Infinity dan Decentraland. #CNNIndonesia #detikNetwork  https://t.co/SSldE6dwyw",38,9,14,1,2022-01-15,2,Saturday,6,52,10
1482170226858942466,2022-01-15 01:58:14,"Lionel Messi sempat positif virus corona. Akibat COVID-19, striker itu masih akan absen membela Paris Saint-Germain akhir pekan ini.  https://t.co/hPw7hLXZEq",7,0,3,0,2022-01-15,1,Saturday,6,10,0
1482169727778799617,2022-01-15 01:56:15,"Manchester City akan menjamu Chelsea di Etihad Stadium pada lanjutan liga inggris, sabtu (15/1). Pertandingan diprediksi akan berjalan sangat ketat karena The Blues ingin memangkas poin dengan Manchester City di puncak klasemen.  https://t.co/xzcTXsPkk6",4,0,0,0,2022-01-15,1,Saturday,6,4,0
1482168385030995968,2022-01-15 01:50:55,Komika Fico Fachriza diamankan pihak kepolisian atas kasus narkoba. Ia diamankan dalam kondisi terpengaruh tembakau sintetis atau Gorila. Berikut rangkuman terkait kasus narkoba yang menjerat Fico Fachriza.  https://t.co/ySq5XumV6b,10,2,1,0,2022-01-15,1,Saturday,6,11,2
1482168115890905089,2022-01-15 01:49:50,"Gempa M 6,6 di Barat Daya Pandeglang, Banten pada Jumat (14/1), sekitar pukul 16.00 WIB, ikut dirasakan di wilayah Jabodetabek. Gempa itu juga mengakibatkan sejumlah bangunan mengalami kerusakan.  https://t.co/avFFRUxduF",12,0,3,0,2022-01-15,1,Saturday,6,15,0
1482167122709123074,2022-01-15 01:45:54,Gempa kuat telah mengguncang Jakarta. Gempa ini berpusat di lautan sekitar Selat Sunda. Berikut serba-serbi gempa ini.  https://t.co/fOkuqaoj4z,11,0,3,0,2022-01-15,1,Saturday,6,14,0
1482166631119958021,2022-01-15 01:43:56,Elon Musk membagikan lima nasihat untuk anak muda yang ingin sukses di kehidupan. Ini nasehat dari orang terkaya di dunia:  https://t.co/SqdLVfYBBE,48,4,12,4,2022-01-15,1,Saturday,6,60,8
1482165161049866241,2022-01-15 01:38:06,Hangat. Kata tersebut cocok menggambarkan pertemuan Prabowo Subianto dan SBY. Keduanya bersalaman hingga saling hormat.  https://t.co/BLdr3hvy5O,34,1,3,0,2022-01-15,1,Saturday,6,37,1
1482163405842751495,2022-01-15 01:31:07,Komedian Fico Fachriza ditetapkan sebagai tersangka penyalahgunaan narkoba. Ia terbukti mengkonsumsi tembakau gorila atau ganja sintetis.  https://t.co/orMqTiEEpK,14,2,2,0,2022-01-15,1,Saturday,6,16,2
1482162623345008640,2022-01-15 01:28:01,"BMKG melaporkan gempa berkekuatan 6,7 M terjadi di Sumur, Banten, pada Jumat (14/1). Saat terjadi gempa, apa yang sebaiknya dilakukan? Berikut penjelasannya.  https://t.co/4O0FVa25JI",4,0,3,0,2022-01-15,1,Saturday,6,7,0
1482161579332452354,2022-01-15 01:23:52,Pasien Omicron yang sembuh dikhawatirkan masih bisa mengalami gejala jangka panjang atau long Covid. Berikut deretan gejala long Covid yang perlu diwaspadai.  https://t.co/zgqCJCdAcW,4,0,2,0,2022-01-15,1,Saturday,6,6,0
1482159669548359689,2022-01-15 01:16:17,CDC memperbarui pedoman memakai masker. Hal ini dilakukan di tengah gelombang COVID-19 yang dihadapi Amerika Serikat akibat varian Omicron.  https://t.co/P16kPCOAxt,6,0,2,0,2022-01-15,1,Saturday,6,8,0
1482157073173561347,2022-01-15 01:05:58,"""Nanti Dewan Kehormatan yang akan memberikan pernyataan resmi. Bang Hinca (Pandjaitan),"" kata Kepala Badan Hukum dan Pengamanan PD, Ardy Mbalembout soal nasib Bupati PPU yang terkena kasus korupsi.  https://t.co/mrGKG67Fxz",8,0,0,0,2022-01-15,1,Saturday,6,8,0
1482156784878067720,2022-01-15 01:04:49,"Komika Fico Fachriza menjadi tersangka kasus tembakau sintetis Gorilla. Dari hasil tes urine, Fico terbukti dinyatakan positif narkoba.  https://t.co/Lf8dxlJvo4",5,1,1,0,2022-01-15,1,Saturday,6,6,1
1482156034332450816,2022-01-15 01:01:50,"Lorenzo Insigne akan meninggalkan Napoli secara gratis di akhir musim ini. Adiknya, Roberto Insigne menyebut hal tersebut bukanlah kesalahan abangnya. https://t.co/P8XDRPe1tL",4,0,0,0,2022-01-15,1,Saturday,6,4,0
1482155962823761921,2022-01-15 01:01:33,"Rumah rusak di Kabupaten Pandeglang, Banten, akibat gempa magnitudo (M) 6,6 bertambah. Semula tercatat 263 unit rumah rusak, kini menjadi 738 unit!  https://t.co/jK7Wkte5Vx",16,2,10,0,2022-01-15,1,Saturday,6,26,2
1482155416058478603,2022-01-15 00:59:22,Banyak laga Liga Inggris tertunda belakangan ini karena badai COVID-19. Manajer Chelsea Thomas Tuchel bakal marah besar jika klub berdalih seperti itu lagi. https://t.co/e3GDAw7bbc,4,2,0,1,2022-01-15,0,Saturday,6,4,3
1482154859830915074,2022-01-15 00:57:10,Sejumlah pejabat kepolisian Polrestabes Medan disebut menerima suap dari istri bandar narkoba. Senayan pun beramai-ramai mendukung kasus suap itu dibongkar. https://t.co/KNmOUaIaZn,93,28,19,4,2022-01-15,0,Saturday,6,112,32
1482154585838039040,2022-01-15 00:56:05,"Golkar dan Demokrat terbuka berkoalisi dengan PKS di Pilpres 2024. Lantas, pasangan capres-cawapres terkuat jika koalisi ini terbentuk siapa? https://t.co/ft8fiaXqSb",19,16,3,4,2022-01-15,0,Saturday,6,22,20
1482154347140194305,2022-01-15 00:55:08,"Ajang street race gagasan Polda Metro Jaya bakal digelar di kawasan Ancol, akhir pekan ini. Hingga kini sudah ada 200 orang joki balap liar yang sudah daftar. https://t.co/CatXbxObAs",11,3,5,1,2022-01-15,0,Saturday,6,16,4
1482153855353769987,2022-01-15 00:53:10,Manchester United belum beranjak jauh dari posisi saat Ralf Rangnick datang sebagai manajer anyar. Progres 'Setan Merah' diakui cukup lambat. https://t.co/Np4hmcw7Sj,3,0,0,1,2022-01-15,0,Saturday,6,3,1
1482153346014363656,2022-01-15 00:51:09,Komedian Fico Fachriza ditetapkan sebagai tersangka penyalahgunaan narkoba. Ia terbukti mengkonsumsi tembakau gorila atau ganja sintetis. https://t.co/sjSqofpoxD,4,0,0,2,2022-01-15,0,Saturday,6,4,2
1482152854240608259,2022-01-15 00:49:12,"Cristiano Ronaldo harus berpikir ulang jika ingin meninggalkan Manchester United. Sebab, pacarnya Georgina Rodriguez mengaku betah tinggal di Manchester. https://t.co/aHETQKv7iy",4,1,0,2,2022-01-15,0,Saturday,6,4,3
1482152589529694209,2022-01-15 00:48:09,Kemenkes RI melaporkan 66 kasus baru varian Omicron di Indonesia. Berikut kronologi penemuan kasus Omicron pertama hingga tembus 572 kasus. https://t.co/7owNaHwAPm,8,9,1,3,2022-01-15,0,Saturday,6,9,12
1482152318187544576,2022-01-15 00:47:04,"Masih banyak misteri yang belum terungkap di Antartika. Dalam penemuan terbaru, para ilmuwan menjumpai bahwa di balik lapisan es. https://t.co/Yoy0ZyNPwR",23,6,1,5,2022-01-15,0,Saturday,6,24,11
1482151563506470913,2022-01-15 00:44:04,WHO menambahkan 2 obat baru ke dalam pedoman perawatan COVID-19. Obat baricitinib untuk mengobati rematik sangat dianjurkan untuk pasien COVID-19 gejala parah. https://t.co/p4ZRAicAwG,4,0,1,2,2022-01-15,0,Saturday,6,5,2
1482151264167280645,2022-01-15 00:42:53,Prakiraan cuaca besok 15 Januari 2022 sudah disampaikan oleh BMKG. Berikut prakiraan cuaca besok untuk Jakarta dan sekitarnya https://t.co/ftYYtBKrns,2,0,0,1,2022-01-15,0,Saturday,6,2,1
1482150789640597504,2022-01-15 00:40:59,"Seorang pria di Deli Serdang, Sumatera Utara, berinisial MS (50) ditangkap polisi setelah memperkosa adik dari menantunya sendiri belasan kali. https://t.co/1fXZQDnliC",8,1,1,2,2022-01-15,0,Saturday,6,9,3
1482150765946974208,2022-01-15 00:40:54,Kejagung menyebut belum ada rencana meminta keterangan mantan Menteri Pertahanan Ryamizard Ryacudu dalam kasus dugaan korupsi satelit Kementerian Pertahanan. https://t.co/WWormmYYmZ,12,4,2,0,2022-01-15,0,Saturday,6,14,4
1482149182102253570,2022-01-15 00:34:36,"Rumah rusak di Kabupaten Pandeglang, Banten, akibat gempa magnitudo (M) 6,6 bertambah. Semula tercatat 263 unit rumah rusak, kini menjadi 738 unit. https://t.co/NFMIuEWdPQ",17,4,14,1,2022-01-15,0,Saturday,6,31,5
1482148699547516937,2022-01-15 00:32:41,"Ledakan di Rumah Tahfiz Annur, Jatiasih, Kota Bekasi, Jawa Barat, menewaskan seorang santri WN Filipina bernama Abdul Jamil (15). Begini sosok Abdul Jamil. https://t.co/AqPhKUj9Fv",6,0,2,0,2022-01-15,0,Saturday,6,8,0
1482148155697373185,2022-01-15 00:30:31,"Dua pemancing menemukan sesosok mayat bayi di Sungai Brantas, Jombang. Bayi laki-laki itu ditemukan tanpa baju dan tali pusar. https://t.co/mmV7iCmVTN",6,2,1,0,2022-01-15,0,Saturday,6,7,2
1482147634831839234,2022-01-15 00:28:27,"Polisi menutup lalu lintas di Jl Medan Merdeka Timur, Jakarta Pusat, malam ini. Penutupan arus lalu lintas untuk mencegah aksi balapan liar. https://t.co/iqd2pieCrn",3,0,1,0,2022-01-15,0,Saturday,6,4,0
1482147613449367552,2022-01-15 00:28:22,Menteri Pertahanan Prabowo Subianto disuntik Vaksin Nusantara oleh dr Terawan. Ini fakta terkait Vaksin Nusantara:  https://t.co/GIb2Broij3,15,4,2,1,2022-01-15,0,Saturday,6,17,5
1482147114700394505,2022-01-15 00:26:23,Daud 'Cino' Yordan mematok target juara saat menghadapi petinju Korea Selatan Hwang Kil Kim. Dia bakal terapkan ini supaya menang. https://t.co/EDZwi3A4tv,6,2,0,0,2022-01-15,0,Saturday,6,6,2
1482146599275057158,2022-01-15 00:24:20,"Polisi membongkar pertunjukan striptis di sebuah kafe di Banyuwangi. Untuk mendapatkan sajian striptis itu, pengunjung harus membayar sejumlah uang. Berapa? https://t.co/bWll6oMQcD",13,4,4,1,2022-01-15,0,Saturday,6,17,5
1482146346102665218,2022-01-15 00:23:20,Marc Marquez berbicara banyak mengenai gangguan penglihatan yang dialaminya. The Baby Alien mengaku kondisinya saat ini sudah jauh lebih baik. https://t.co/nfF2ekcHvU,10,0,1,0,2022-01-15,0,Saturday,6,11,0
1482145844296142850,2022-01-15 00:21:20,OTT KPK belum lama ini membuat sejumlah urusan di Pemkab Penajam Paser Utara terganggu. Di antaranya adalah pelantikan kepala desa. https://t.co/63bK0qNkJU,2,2,1,1,2022-01-15,0,Saturday,6,3,3
1482145349414408194,2022-01-15 00:19:22,Upah kerja di restoran Australia sedang meroket karena pemilik bisnis sulit dapat pekerja. Meningkatnya kasus Omicron menyebabkan banyak pekerja restoran sakit. https://t.co/jADpmkgkHO,19,2,5,1,2022-01-15,0,Saturday,6,24,3
1482144032184807429,2022-01-15 00:14:08,"""Nanti Dewan Kehormatan yang akan memberikan pernyataan resmi. Bang Hinca (Pandjaitan),"" kata Kepala Badan Hukum dan Pengamanan PD, Ardy Mbalembout. https://t.co/d5YYuxEQ8h",1,1,0,0,2022-01-15,0,Saturday,6,1,1
1482143562884124672,2022-01-15 00:12:16,Pemerintah melaporkan kasus positif Corona hari ini sebanyak 850 kasus. Provinsi yang melaporkan kasus tertinggi dalam 24 jam terakhir adalah DKI Jakarta. https://t.co/PjGKzSJBT5,9,0,4,2,2022-01-15,0,Saturday,6,13,2
1482143078920110080,2022-01-15 00:10:21,Vaksinasi Corona dosis ketiga atau booster telah dimulai. Warga lanjut usia (lansia) yang diprioritaskan pun rela menunggu demi mendapat vaksinasi ketiga. https://t.co/wVqrSYDvDc,8,1,3,0,2022-01-15,0,Saturday,6,11,1
1482141491455840257,2022-01-15 00:04:03,Semifinal India Open 2022 akan digelar hari ini. Berikut jadwal lengkapnya. https://t.co/oWYaZcLwle,6,0,1,0,2022-01-15,0,Saturday,6,7,0
1482141490176475145,2022-01-15 00:04:02,"Di pilpres 2024, PKS berencana ingin membangun koalisi poros nasionalis-religius. Rencana itu lantas disambut hangat oleh Demokrat dan Golkar. https://t.co/amPzCSZM1E",21,17,4,2,2022-01-15,0,Saturday,6,25,19
1482141251910647809,2022-01-15 00:03:05,"""Itu hanya mimpinya gubernur saja. Yo nggak popo, wong mimpi saja moso nggak boleh,"" kata Ketua Fraksi PDIP DPRD DKI Jakarta, Gembong Warsono. https://t.co/RgigRlhmym",19,35,1,2,2022-01-15,0,Saturday,6,20,37
1482141013208674309,2022-01-15 00:02:09,Komika Fico Fachriza membeli tembakau sintetis Gorilla melalui media sosial. Ia membelinya seharga Rp 300 ribu. https://t.co/JqxuiBFnGJ,6,2,2,1,2022-01-15,0,Saturday,6,8,3
1488300726900113411,2022-01-31 23:58:39,Anggota DPR RI Dedi Mulyadi angkat bicara terkait rekomendasi IPB untuk menjadikan sawit sebagai tanaman hutan. https://t.co/uhdeZAvsNK,10,2,1,2,2022-01-31,23,Monday,1,11,4
1488300186464104448,2022-01-31 23:56:30,PKS mengkritik BNPT karena mengungkap data soal 198 ponpes terafiliasi jaringan teroris. PKS mengingatkan BNPT agar tak mengumbar info yang memicu kegaduhan. https://t.co/p8ZsCi8eD2,139,96,19,18,2022-01-31,23,Monday,1,158,114
1488299387960926211,2022-01-31 23:53:20,"LPSK mempertanyakan status kerangkeng manusia di rumah Bupati Langkat nonaktif. Pasalnya, hingga kini kerangkeng tersebut belum dipasangi garis polisi. https://t.co/aKCjR5f87d",5,1,1,0,2022-01-31,23,Monday,1,6,1
1488298568280866817,2022-01-31 23:50:04,"Juventus memboyong bek anyar. Federico Gatti dibeli dari klub Serie B, Frosinone. https://t.co/iHEansSMH2",4,0,2,0,2022-01-31,23,Monday,1,6,0
1488298059805114369,2022-01-31 23:48:03,"Pengacara Edy Mulyadi, Herman Kadir bersikukuh chanel YouTube 'bang edy chanel' produk jurnalistik. Dia mengklaim chanel itu sudah terdaftar di Dewan Pers. https://t.co/fPjCBam4Sm",6,8,2,1,2022-01-31,23,Monday,1,8,9
1488297278649552896,2022-01-31 23:44:57,"Artis Cynthia Lamusu berhasil menurunkan berat badan hingga 19 kg. Hanya dalam 4 bulan, ternyata ini 5 rahasianya termasuk melakukan diet real food. https://t.co/QyvKdtdQ4D",6,1,3,0,2022-01-31,23,Monday,1,9,1
1488296541416742915,2022-01-31 23:42:01,"Edy Mulyadi ditahan Bareskrim Polri. Sebelum ditahan polisi, Edy sudah bersiap dengan membawa baju ganti saat memenuhi panggilan pemeriksaan. https://t.co/ogLaysGoDA",8,2,3,0,2022-01-31,23,Monday,1,11,2
1488295484770983937,2022-01-31 23:37:49,"Malam pergantian tahun baru Imlek 2573 dilakukan dengan ibadah sembahyang di Kelenteng Fuk Ling Miao, Gondomonan, Yogyakarta. https://t.co/m3RyYJhhFn",12,0,2,0,2022-01-31,23,Monday,1,14,0
1488294962571665411,2022-01-31 23:35:44,"#terpopuler Selama pandemi, banyak orang yang mencari aktivitas baru di rumah. Seperti wanita ini yang menemukan keahliannya melukis di atas kulit pisang!  https://t.co/6KfzI6Z3jQ",19,1,2,0,2022-01-31,23,Monday,1,21,1
1488293980907393026,2022-01-31 23:31:50,Para pelaku sempat pesta miras sebelum memperkosa korban. Korban yang juga pengamen jalanan diperkosa dengan ancaman beling. https://t.co/qq5LKlkzLC,7,6,3,0,2022-01-31,23,Monday,1,10,6
1488292981383868419,2022-01-31 23:27:52,"Presiden Amerika Serikat (AS), Joe Biden memperingatkan Rusia bahwa AS siap atas apa pun ancaman yang terjadi ke Ukraina, https://t.co/pkaKPItQBv",12,1,3,0,2022-01-31,23,Monday,1,15,1
1488292968733810689,2022-01-31 23:27:49,Gambar-gambar yang tidak biasa diduga diambil dari peluncuran misil Korea Utara yang paling kuat dalam lima tahun terakhir. https://t.co/AU9ZLolmh4,6,0,2,0,2022-01-31,23,Monday,1,8,0
1488291057565589512,2022-01-31 23:20:13,Pemerintah kembali memperbaharui aturan PPKM berlevel di Indonesia. DKI Jakarta masih bertahan di level 2 untuk sepekan ke depan. Ini daftar selengkapnya. https://t.co/FEk0tyceBa,6,0,6,2,2022-01-31,23,Monday,1,12,2
1488290015272710145,2022-01-31 23:16:05,"#terpopuler Meski bertani di lahan sempit, milenial ini bisa meraup untung hingga puluhan juta rupiah lho setiap bulannya karena menanam 'buah surga'. Apa sih tipsnya?  https://t.co/FfN7h8tNuG",12,1,5,0,2022-01-31,23,Monday,1,17,1
1488288632251289604,2022-01-31 23:10:35,Gubernur Jawa Tengah Ganjar Pranowo meminta para tenaga kesehatan melakukan deteksi dini terhadap penyakit kusta https://t.co/yPcnn544hB,11,1,6,0,2022-01-31,23,Monday,1,17,1
1488287631716847619,2022-01-31 23:06:37,Warganet melaporkan gangguan saat menggunakan aplikasi PeduliLindungi berupa status vaksin saat hendak scan QR code untuk masuk ke suatu tempat. https://t.co/x3UWBJoOd6,5,1,3,1,2022-01-31,23,Monday,1,8,2
1488286551524130818,2022-01-31 23:02:19,"LPSK mempertanyakan status kerangkeng manusia di rumah Bupati Langkat nonaktif. Pasalnya, hingga kini kerangkeng tersebut belum dipasangi garis polisi. https://t.co/1uygj3qV2f",10,0,4,1,2022-01-31,23,Monday,1,14,1
1488285636335443973,2022-01-31 22:58:41,Ada beberapa makanan yang dapat tahan lama hingga bertahun-tahun jika disimpan dengan benar. Apa saja? https://t.co/UykK1RwjuR,13,0,4,1,2022-01-31,22,Monday,1,17,1
1488283277668626433,2022-01-31 22:49:19,"Raja Keraton Tayan, Kalimantan Barat (Kalbar), Gusti Yusri, mendukung langkah Bareskrim Polri menersangkakan dan menahan Edy Mulyadi. https://t.co/WfKyaBLol3",60,4,6,1,2022-01-31,22,Monday,1,66,5
1488282304355217410,2022-01-31 22:45:26,Everton mendapatkan Donny van de Beek dari Manchester United. Gelandang asal Belanda itu didatangkan dengan status pinjaman. https://t.co/RXUrHfTxEw,5,0,2,0,2022-01-31,22,Monday,1,7,0
1488280844389298178,2022-01-31 22:39:38,PSKC Cimahi dikaitkan dengan komedian Entis Sutisna alias Sule. Dia menyiratkan akan membeli Laskar Sangkuriang. https://t.co/IpCDSOw1kw,12,0,3,1,2022-01-31,22,Monday,1,15,1
1488279809184735233,2022-01-31 22:35:32,"#terpopuler Perancang Istana Negara IKN, I Nyoman Nuarta, menyebut ongkos mengangkut material pembangunan IKN dari Jawa ke Kaltim menelan biaya Rp 50 juta per truk!  https://t.co/0xwE49KwKB",7,4,1,1,2022-01-31,22,Monday,1,8,5
1488278365681377282,2022-01-31 22:29:47,"BMKG merilis prakiraan cuaca di DKI Jakarta hari ini. Hujan kilat dan angin kencang akan terjadi di Jakbar, Jaksel, Jaktim siang ini. https://t.co/X93Sek81yg",11,0,2,1,2022-01-31,22,Monday,1,13,1
1488277507744874505,2022-01-31 22:26:23,Suporter meminta Walkot Bobby Nasution mengambil alih PSMS Medan. Bobby mengatakan dirinya bakal berbicara dulu dengan pemilik PSMS Medan. https://t.co/qb29wR512s,14,5,1,0,2022-01-31,22,Monday,1,15,5
1488276473064701961,2022-01-31 22:22:16,Covid Omicron gejalanya apa saja? Hal ini perlu diketahui masyarakat agar bisa melakukan pencegahan dari ciri-ciri varian omicron. https://t.co/G4IMXeWNmG,10,1,5,0,2022-01-31,22,Monday,1,15,1
1488275182338953223,2022-01-31 22:17:08,Edy Mulyadi ditahan setelah diperiksa hari ini. Akun YouTube Edy Mulyadi jadi barang bukti dan kini disita polisi. https://t.co/XkWbY0ZveN,24,1,3,0,2022-01-31,22,Monday,1,27,1
1488274076850393090,2022-01-31 22:12:45,Pemerintah buka-bukaan data hingga status vaksinasi pasien Omicron bergejala berat. Ada 63 persen pasien gejala berat berasal dari kelompok ini. https://t.co/VlNdWyNKCk,15,1,6,1,2022-01-31,22,Monday,1,21,2
1488272974189056001,2022-01-31 22:08:22,Minyak goreng di Malaysia harganya cuma Rp 8.500 per liter. Jumlah itu jelas jauh lebih murah dibandingkan dengan harga yang ada di Indonesia. Kok bisa?  https://t.co/SL2bGK5fps,96,43,33,12,2022-01-31,22,Monday,1,129,55
1488269965773918213,2022-01-31 21:56:25,"Umpatan seorang konsumen membuat massa dari ojek online (ojol) menggeruduk Balai Desa Jadimulya, Kabupaten Cirebon. https://t.co/uKtfknaB06",10,4,2,0,2022-01-31,21,Monday,1,12,4
1488266820347994118,2022-01-31 21:43:55,Boy William positif COVID-19 lagi. Ini kali kedua dirinya terpapar COVID-19 sejak awal tahun lalu. Ia meminta masyarakat mewaspadai varian Omicron. https://t.co/AuAjUoR6h7,8,3,5,1,2022-01-31,21,Monday,1,13,4
1488265529785819138,2022-01-31 21:38:47,10 rumah semi permanen di Jambi ludes terbakar. Api berhasil dipadamkan tim damkar dibantu warga dan TNI-Polri selama kurang lebih dua jam. https://t.co/wvFcT8EXo4,7,0,0,0,2022-01-31,21,Monday,1,7,0
1488263888785358850,2022-01-31 21:32:16,Lingard sudah mendapat restu dari Rangnick untuk meninggalkan MU. West Ham dan Newcastle kini bersaing untuk meminjam pemain 29 tahun itu. https://t.co/PC6TSPZV2q,5,0,0,0,2022-01-31,21,Monday,1,5,0
1488262460176011267,2022-01-31 21:26:35,"Gubernur DKI Jakarta Anies Baswedan menghadiri Muskerwil DPW PPP DIY di Bantul. Setelah itu, Anies naik andong menuju JEC untuk menemui kader PPP. https://t.co/jCBJDo8QXa",19,5,4,1,2022-01-31,21,Monday,1,23,6
1488261377571573764,2022-01-31 21:22:17,COVID-19 varian Omicron bisa menimbulkan berbagai macam gejala. Para ahli melihat ada gejala khas yang bisa muncul saat bangun tidur dan buang air besar. https://t.co/O4UNxGgjRq,6,0,1,1,2022-01-31,21,Monday,1,7,1
1488259008733585414,2022-01-31 21:12:52,"PAN DKI menilai studi banding Formula ke Diriyah diperlukan. Jika ada yang mempermasalahkan, menurut PAN, karena kondisi perpolitikan di Ibu Kota tak wajar. https://t.co/rPDrTGduNC",4,10,1,4,2022-01-31,21,Monday,1,5,14
1488256167801466901,2022-01-31 21:01:35,Dinkes DKI Jakarta mengungkap kasus positif COVID-19 kini didominasi oleh kelompok usia 21-30 tahun. Apa sebabnya? https://t.co/024jRPgYMc,11,0,8,3,2022-01-31,21,Monday,1,19,3
1488254694879281155,2022-01-31 20:55:44,"Perwakilan Partai Ummat, Mustofa Nahrawardaya, bertanya-tanya mengapa partai yang memiliki kader tersandung kasus korupsi tetap memiliki elektabilitas tinggi. https://t.co/5qWbiNy5yJ",37,65,4,11,2022-01-31,20,Monday,1,41,76
1488252853261062146,2022-01-31 20:48:25,Polda Metro Jaya menjelaskan kronologi detil terkait Bripka Asep Nuroni dkk diamankan warga Pandeglang saat hendak mengamankan motor hasil curian https://t.co/LgkW9P8T5n,7,1,1,1,2022-01-31,20,Monday,1,8,2
1488251674628083716,2022-01-31 20:43:44,Apple membuka iOS 15.4 untuk pengguna yang tak sabar mencicipinya. Tertarik? Begini cara download iOS 15.4 public beta. https://t.co/QvCpWEthQY,4,0,3,0,2022-01-31,20,Monday,1,7,0
1488250420283723778,2022-01-31 20:38:45,"Bicara soal Gundam, karakter robot ini adalah franchise yang diciptakan oleh Yoshiyuki Tomino dan perusahaan Sunrise di Jepang. Simak selengkapnya: https://t.co/hIQk7x5PBn",8,0,3,0,2022-01-31,20,Monday,1,11,0
1488248576157401093,2022-01-31 20:31:25,"Positivity rate COVID-19 meningkat, salah satunya karena pemeriksaan tengah digencarkan. Pemerintah mendorong untuk tes COVID-19 jika mengalami gejala ini. https://t.co/M64LP7TpO8",6,0,2,0,2022-01-31,20,Monday,1,8,0
1488247673509584907,2022-01-31 20:27:50,"#terpopuler Nama Prilly Latuconsina jadi sorotan. Di usianya yang masih muda, Prilly sudah mampu untuk membeli sebuah klub sepak bola. Darimana duitnya?  https://t.co/xEmTexGlOZ",9,0,2,0,2022-01-31,20,Monday,1,11,0
1488245198731853830,2022-01-31 20:18:00,"Ketua panitia raker KONI Kaltim, Muslimin angkat bicara terkait tudingan rekayasa dan Pembiaran atas insiden pemukulan terhadap Sugung berujung saling lapor. https://t.co/WoudyJLNJa",2,0,1,0,2022-01-31,20,Monday,1,3,0
1488243569357897733,2022-01-31 20:11:31,Sebuah rumah di Tambora Jakbar Terbakar. Kebakaran terjadi akibat ada warga yang sedang membakar angpao. https://t.co/CfOHbwVUbW,8,0,3,0,2022-01-31,20,Monday,1,11,0
1488243053060104194,2022-01-31 20:09:28,MA menyatakan tindakan Mujono bukanlah perbuatan korupsi. https://t.co/DRAXpNuB7x,2,0,1,1,2022-01-31,20,Monday,1,3,1
1488242063338573825,2022-01-31 20:05:32,"Trust Indonesia merilis hasil survei elektabilitas hingga popularitas parpol. Hasilnya, elektabilitas PDIP tertinggi, Golkar partai terpopuler. https://t.co/wpXE5bqMtH",5,20,1,3,2022-01-31,20,Monday,1,6,23
1488240903802310658,2022-01-31 20:00:56,"#terpopuler Bereksperimen dengan kepala babi, food Vlogger ini coba buktikan daging babi yang dianggap mengandung cacing. Minuman soda digunakan untuk merendam kepala babi!  https://t.co/Mw8FBRoQCg",3,8,1,0,2022-01-31,20,Monday,1,4,8
1488239802910715904,2022-01-31 19:56:33,Luhut mengatakan selama ini ekonomi Bali cukup terdampak pandemi. Pintu internasional di Bali akan dibuka secara bertahap dan berlanjut. https://t.co/02ZRm7yQvo,4,13,2,1,2022-01-31,19,Monday,1,6,14
1488238706167324674,2022-01-31 19:52:12,"Selain Zulhas, PAN juga mempertimbangkan beberapa nama mulai dari Puan hingga Ganjar. https://t.co/rv4ZbP918W",0,2,1,0,2022-01-31,19,Monday,1,1,2
1488237350257938436,2022-01-31 19:46:49,"Ketua panitia raker KONI Kaltim, Muslimin angkat bicara terkait tudingan rekayasa dan Pembiaran atas insiden pemukulan terhadap Sugung berujung saling lapor. https://t.co/IzjfFBc2rL",1,0,0,0,2022-01-31,19,Monday,1,1,0
1488236027772817412,2022-01-31 19:41:33,"Pajak tahunan mobil listrik di Jakarta murah banget. Per tahun, pajak mobil listrik nggak sampai Rp 1 juta! https://t.co/iTun9cRWJS",3,0,1,0,2022-01-31,19,Monday,1,4,0
1488233237671460867,2022-01-31 19:30:28,Wapres Ma'ruf Amin berharap PKS dapat menjadi motor penggerak ekonomi hingga benteng pertahanan dalam menangkal terorisme. https://t.co/Bicm97Qmws,2,0,1,3,2022-01-31,19,Monday,1,3,3
1488230632966836231,2022-01-31 19:20:07,Arsenal dan Barcelona dikabarkan gagal sepakat soal transfer Pierre-Emerick Aubameyang. Striker Gabon itu disebut balik ke London meski sudah sampai Spanyol. https://t.co/wW6U5CIKVu,4,0,1,0,2022-01-31,19,Monday,1,5,0
1488229330341830656,2022-01-31 19:14:56,"Di tengah pandemi yang belum usai, ilmuwan di China mengungkap temuan NeoCov yang diklaim sebagai varian baru COVID-19. Berikut ini fakta-fakta NeoCov. https://t.co/xk30mXDRnB",7,3,4,5,2022-01-31,19,Monday,1,11,8
1488227792839974920,2022-01-31 19:08:50,Agus Salim (50) ditangkap polisi. Ia ditangkap usai membakar 2 anak kandungnya karena cemburu dengan istri. https://t.co/3LKlxuhGbe,5,0,1,0,2022-01-31,19,Monday,1,6,0
1488226480760971267,2022-01-31 19:03:37,Denis Zakaria telah resmi menjadi pemain Juventus. Gelandang bertahan Timnas Swiss itu dikontrak sampai Juni 2026. https://t.co/XHQNJ2tW9t,6,0,1,0,2022-01-31,19,Monday,1,7,0
1488224249500348423,2022-01-31 18:54:45,"Tren penggunaan Vespa matic kian meningkat. Nah, dealer spesialis Vespa matic bekas berbagi tips untuk membeli Vespa matic bekas. Apa aja yang harus diperhatikan? Simak yuk! https://t.co/HWUVtgH1xA",5,0,1,0,2022-01-31,18,Monday,1,6,0
1488222785524666370,2022-01-31 18:48:56,Pusat Pelaporan Analisis dan Transaksi Keuangan (PPATK) mengungkapkan penyimpangan aliran uang dalam jumlah besar dari pejabat negara ke pacar. https://t.co/0kK6jem2Ub,20,9,4,1,2022-01-31,18,Monday,1,24,10
1488221504743645185,2022-01-31 18:43:51,"Kemenparekraf menyebut penyebab permasalahan ini hanya miskomunikasi antara hotel dengan turis Ukraina, bukan jebakan karantina seperti yang diduga Sandiaga. https://t.co/BS0tKJFd8q",2,0,0,0,2022-01-31,18,Monday,1,2,0
1488220584269987849,2022-01-31 18:40:11,Air mata Azis jatuh ketika menyinggung masa kecilnya. https://t.co/piqDYDvNPh,7,10,0,1,2022-01-31,18,Monday,1,7,11
1488218499768008705,2022-01-31 18:31:54,Adya Paramita Prabandari menilai perjanjian Indonesia-Singapura bisa disebut melanggar UU Penerbangan. Namun ada hal positif yang bisa dipetik. https://t.co/o6GT23bkOI,5,1,0,0,2022-01-31,18,Monday,1,5,1
1488217231414734853,2022-01-31 18:26:52,Ular sanca sepanjang 5 meter membuat geger warga di Makassar. Ular ini nyaris diamankan saat berusaha masuk ke dalam showroom mobil. https://t.co/5EGX372s4A,4,1,0,0,2022-01-31,18,Monday,1,4,1
1488215894010609667,2022-01-31 18:21:33,Lembaga Trust Indonesia merilis survei elektabilitas simulasi pasangan calon presiden dan calon wakil presiden 2024. Hasilnya berikut ini. https://t.co/GBNgYms3sw,5,5,0,2,2022-01-31,18,Monday,1,5,7
1488214582049095680,2022-01-31 18:16:20,"Polisi menetapkan tiga orang tersangka terkait pinjol ilegal yang dipimpin pria asal China, YXC (38) di Penjaringan, Jakarta Utara. https://t.co/gzbWa86lsd",9,1,0,0,2022-01-31,18,Monday,1,9,1
1488212974942707713,2022-01-31 18:09:57,"Jusuf Kalla berbicara soal sistem keadilan di Tanah Air. Jusuf Kalla mengatakan Indonesia, termasuk negara dengan tingkat ketidakadilan agak tinggi. https://t.co/EhtkpZxAaF",1351,400,314,105,2022-01-31,18,Monday,1,1665,505
1488211002076418049,2022-01-31 18:02:07,Tanguy Ndombele resmi dipinjam Lyon dari Tottenham Hotspur. Gelandang asal Prancis itu akan bertahan hingga akhir musim dengan opsi dipermanenkan. https://t.co/pDD52IOnKw,4,1,0,0,2022-01-31,18,Monday,1,4,1
1488209648570314756,2022-01-31 17:56:44,5 perusahaan tambang yang dilaporkan Pemkab Morowali terkait kasus pemalsuan tanda tangan bakal melapor balik ke polisi. https://t.co/mJN1uMhbT8,7,3,2,1,2022-01-31,17,Monday,1,9,4
1488209647173574671,2022-01-31 17:56:44,Sejumlah nelayan di Bengkulu berencana menemui Presiden Joko Widodo (Jokowi). Mereka menolak keberadaan kapal trawl yang meresahkan nelayan tradisonal. https://t.co/Uchh2aZV8g,9,1,1,2,2022-01-31,17,Monday,1,10,3
1488208428057124870,2022-01-31 17:51:53,"Berikut ada 20 ucapan Imlek 2022 yang bisa kamu gunakan untuk dipajang akun media sosial seperti WhatsApp, Twitter hingga Instagram! https://t.co/oup6onfa06",4,0,2,0,2022-01-31,17,Monday,1,6,0
1488206672984264707,2022-01-31 17:44:55,"Bagi banyak orang, perbedaan antara pria dan perempuan tampaknya jelas. Tapi sebenarnya seberapa besar? Dan apa konsekuensinya bagi tingkah laku mereka? https://t.co/PYjZwqRDqR",5,0,2,0,2022-01-31,17,Monday,1,7,0
1488205429658243076,2022-01-31 17:39:58,"Menkes Budi memastikan stok obat-obatan, termasuk antivirus untuk pasien COVID-19 sudah lengkap. Ia menegaskan agar masyarakat tidak menimbunnya di rumah. https://t.co/wDIlYYgENo",8,0,2,0,2022-01-31,17,Monday,1,10,0
1488203742382067714,2022-01-31 17:33:16,"Polisi memastikan, pinjol yang berlokasi di PIK, Penjaringan, Jakarta Utara ini tidak terdaftar di OJK alias ilegal. https://t.co/Udaqxfusd8",7,0,1,0,2022-01-31,17,Monday,1,8,0
1488202400129335300,2022-01-31 17:27:56,5 perusahaan tambang yang dilaporkan Pemkab Morowali terkait kasus pemalsuan tanda tangan bakal melapor balik ke polisi. https://t.co/uJ6Lqdsyn5,9,0,0,0,2022-01-31,17,Monday,1,9,0
1488199528633274373,2022-01-31 17:16:31,Biadab! Kakek uzur di Serang mencabuli gadis difabel hingga hamil. Kakek cabul tersebut melakukan aksi bejatnya aksinya di kandang kambing. https://t.co/tA6QE7XBRc,8,0,2,4,2022-01-31,17,Monday,1,10,4
1488198817329651716,2022-01-31 17:13:42,Presiden Jokowi mengungkap alasan memakai sarung di acara pengukuhan kepengurusan PBNU masa khidmat 2022-2027. Bagaimana ceritanya? https://t.co/WMfNx5Ry95,22,0,0,0,2022-01-31,17,Monday,1,22,0
1488197447595737088,2022-01-31 17:08:15,"Dejan Kulusevski resmi hijrah ke Tottenham Hotspur. Gelandang asal Swedia itu pindah dengan status pinjaman, namun dengan opsi dipermanenkan. https://t.co/R0Ydv1dEkJ",9,0,0,0,2022-01-31,17,Monday,1,9,0
1488195930990030850,2022-01-31 17:02:13,Tanggal merah 2022 sudah resmi ditetapkan pemerintah. Dalam kalender 2022 terdapat sejumlah hari besar nasional yang dijadikan tanggal merah di tahun ini. https://t.co/SA3oEbH9ST,8,0,4,1,2022-01-31,17,Monday,1,12,1
1488194952412680193,2022-01-31 16:58:20,Wakepsek di Sulsel dianiaya ortu salah satu siswanya yang tak terima putranya dihukum menghisap batang rokok yang telah dilumuri dengan kotoran ayam. https://t.co/UI4jAmPN5I,14,9,0,2,2022-01-31,16,Monday,1,14,11
1488192741003730947,2022-01-31 16:49:33,Foto AHY jogging menggunakan rompi 'militer' viral di media sosial. Apa sih manfaat olahraga pakai weight vest seperti itu? Dokter olahraga angkat bicara. https://t.co/i6l7r8YuAf,8,0,1,0,2022-01-31,16,Monday,1,9,0
1488191764079034370,2022-01-31 16:45:40,Rompi beban atau weighted body vest ala militer yang dipakai AHY viral gara-gara disangka rompi antipeluru. Ini manfaat pakai rompi seperti AHY:  https://t.co/Em0gyQhn7f,27,2,5,2,2022-01-31,16,Monday,1,32,4
1488190993631432705,2022-01-31 16:42:36,Berakhir sudah perjalanan empat setengah musim Rodrigo Bentancur di Juventus. Gelandang asal Uruguay itu dilepas ke Tottenham Hotspur. https://t.co/eDgIMAtMKM,4,0,1,0,2022-01-31,16,Monday,1,5,0
1488190677930459136,2022-01-31 16:41:21,COVID-19 varian Omicron bisa menimbulkan berbagai macam gejala. Para ahli melihat ada gejala khas yang bisa muncul saat bangun tidur dan buang air besar. https://t.co/NLDEr1k2vm,8,10,1,1,2022-01-31,16,Monday,1,9,11
1488189690184450048,2022-01-31 16:37:26,"Gejala COVID-19 Omicron yang ringan cenderung muncul dalam bentuk batuk dan sakit tenggorokan. Namun, kadang bisa juga muncul gejala pada mata dan telinga. https://t.co/RbMBH9VKzk",8,0,3,1,2022-01-31,16,Monday,1,11,1
1488187485066825729,2022-01-31 16:28:40,Imlek identik dengan kue keranjang atau nian gao. Di Sidoarjo ada Tok Swie Giok (82) yang menjadi produsen kue keranjang. Simak kisahnya: https://t.co/GzZ2V2xemy,11,0,1,0,2022-01-31,16,Monday,1,12,0
1488185623651442697,2022-01-31 16:21:16,"Satpol PP langsung mengamankan 6 anak punk di Depok, Jawa Barat, yang bikin resah itu. https://t.co/IxdRbh7tJE",4,0,0,2,2022-01-31,16,Monday,1,4,2
1488185324048199684,2022-01-31 16:20:05,Jia mengidap penyakit penyakit bladder exrophy atau ekstrofi kandung kemih. Penyakit ini diderita Jia sejak lahir dan termasuk langka. https://t.co/4HIvdpbS9B,5,0,0,0,2022-01-31,16,Monday,1,5,0
1488184418007138306,2022-01-31 16:16:29,Dorce Gamalama kembali bicara setelah keinginannya dimakamkan sebagai perempuan tuai kontroversi. Dia berpesan untuk tetap urus jenazahnya kelak. https://t.co/iGGxc3aouF,10,1,1,0,2022-01-31,16,Monday,1,11,1
1488183454625894406,2022-01-31 16:12:39,Pacitan menyimpan catatan kehidupan keturunan Tionghoa lengkap dengan tradisinya yang tergambar dari sebutan 'Kelenteng'. Bagaimana ceritanya? https://t.co/978z5tnTBm,8,0,0,0,2022-01-31,16,Monday,1,8,0
1488182103502118914,2022-01-31 16:07:17,"Perjuangannya dalam mendirikan NU cukup panjang, sehingga namanya terus dikenang oleh masyarakat NU. https://t.co/RUeRiaNtri",16,0,4,0,2022-01-31,16,Monday,1,20,0
1488181171594752010,2022-01-31 16:03:35,Kemenhub mengatakan kritik dan saran terkait perjanjian ruang udara Indonesia dan Singapura harus berdasar. https://t.co/n4fIyn3M4E,15,3,3,1,2022-01-31,16,Monday,1,18,4
1488179895112978443,2022-01-31 15:58:30,Dokter paru mengungkap ternyata demam bukanlah gejala awal dari Omicron. Ini gejala awal pasien terinfeksi Omicron:  https://t.co/pGJk2w5j6L,39,11,16,0,2022-01-31,15,Monday,1,55,11
1488179218731122688,2022-01-31 15:55:49,Kebakaran tersebut diduga dipicu kebocoran gas di rumah konveksi. https://t.co/okbFqiqWeb,6,1,2,0,2022-01-31,15,Monday,1,8,1
1488177836624130048,2022-01-31 15:50:19,Upaya Barcelona untuk menjual Ousmane Dembele belum juga membuahkan hasil. Negosiasi antara Barcelona dan PSG untuk transfer Dembele tidak mencapai titik temu! https://t.co/MllmtXnryh,7,0,2,0,2022-01-31,15,Monday,1,9,0
1488177106626437120,2022-01-31 15:47:25,"Banyak investor kripto yang berpendapat bahwa Bitcoin itu sebetulnya memiliki posisi yang setara dengan emas, namun dalam bentuk digital.  https://t.co/JSTzxv0DBd",4,2,0,0,2022-01-31,15,Monday,1,4,2
1488175786976849925,2022-01-31 15:42:11,"Polisi mengungkap, pelaku modus 'tabrak lari' di Jakarta Timur tengah menjalani terapi metadon. Apa sih itu terapi metadon? Ini fakta-faktanya:  https://t.co/xh5MfRgAeY",6,0,1,0,2022-01-31,15,Monday,1,7,0
1488174910178574337,2022-01-31 15:38:42,"Seperti flu biasa, infeksi Omicron memicu gejala hidung mampet, meler, dan batuk. Batuk seperti apa yang menandakan infeksi Omicron? Ini penjelasan dokter paru:  https://t.co/wVlLYYDTe1",28,6,10,1,2022-01-31,15,Monday,1,38,7
1488173891356868608,2022-01-31 15:34:39,Saat bercinta perempuan cenderung sulit untuk dipahami apakah sudah merasa terpuaskan atau belum. Tak perlu khawatir karena tanda-tandanya bisa dilihat. https://t.co/ldkQhnRcMC,16,2,3,1,2022-01-31,15,Monday,1,19,3
1488173094422429701,2022-01-31 15:31:29,Beberapa negara termasuk Indonesia kini tengah menghadang lonjakan kasus varian Omicron. Ini 7 cara mencegah varian Omicron yang bisa dilakukan: https://t.co/I3of29AwVK,11,1,1,0,2022-01-31,15,Monday,1,12,1
1488171639389011974,2022-01-31 15:25:42,Kerusakan paru-paru oleh COVID-19 dapat bertahan lama. Hal ini terjadi bahkan pada pasien yang saat terinfeksi hanya mengalami gejala ringan. https://t.co/8NJChqjSbn,45,11,21,2,2022-01-31,15,Monday,1,66,13
1488171285041537027,2022-01-31 15:24:17,"Sudah berada di Barcelona, Pierre-Emerick Aubameyang dilaporkan segera menuntaskan transfer ke Barcelona! https://t.co/G6mGkzpfIQ",10,0,0,0,2022-01-31,15,Monday,1,10,0
1488169052858114050,2022-01-31 15:15:25,"Presiden Joko Widodo bertemu dengan sejumlah tokoh adat Kalimantan Timur. Dalam pertemuan itu, topik utama pembahasan yakni terkait ibu kota negara (IKN). https://t.co/d0HjEbcyeO",19,1,3,0,2022-01-31,15,Monday,1,22,1
1488168472605511681,2022-01-31 15:13:07,Imlek selalu dirayakan dengan meriah. Bahkan ada perayaan yang sampai memecahkan rekor dunia. Termasuk kue keranjang terbanyak dan terbesar untuk Imlek!  https://t.co/0KcwV7G44O,5,1,1,0,2022-01-31,15,Monday,1,6,1
1488167305972441097,2022-01-31 15:08:29,Pemain sinetron Ganteng-Ganteng Serigala Aliando Syarief dikabarkan mengidap obsessive-compulsive disorder (OCD). Ini ciri-ciri seseorang yang mengidap OCD: https://t.co/9WTllPLDEH,16,2,3,0,2022-01-31,15,Monday,1,19,2
1488166306562068485,2022-01-31 15:04:30,Ucapan Imlek 2022 bisa dibagikan melalui media sosial untuk sanak saudara. Berikut contoh-contohnya! #Imlek2022 https://t.co/lTXV5F3v4N,4,0,1,0,2022-01-31,15,Monday,1,5,0
1488166029192843265,2022-01-31 15:03:24,Pemkot menerapkan bekerja dari rumah atau WFH kembali untuk menjaga situasi kesehatan masyarakat. https://t.co/AkZVDBOK58,11,5,4,3,2022-01-31,15,Monday,1,15,8
1488165178277613574,2022-01-31 15:00:01,Manchester United belum juga melepas Jesse Lingard. Bahkan Lingard kabarnya sampai memohon-mohon kepada Ralf Rangnick untuk melepasnya. https://t.co/0b2krj9BuR,8,1,1,1,2022-01-31,15,Monday,1,9,2
1488164431393611779,2022-01-31 14:57:03,"Berbeda dengan se'i kekinian lainnya. Di restoran ini, se'i sapi dipanggang di dalam bambu selama lima jam, dengan rempah dan sambal kecap yang manis pedas.  https://t.co/318tyhCBuX",6,0,0,0,2022-01-31,14,Monday,1,6,0
1488163617761644555,2022-01-31 14:53:49,Inter Milan menyambut gembira kabar Christian Eriksen bergabung dengan Brentford. https://t.co/CgoxWgZ5bu,9,0,0,0,2022-01-31,14,Monday,1,9,0
1488163207231557635,2022-01-31 14:52:11,Akun Instagram Mason Greenwood menjadi sasaran hujatan para netizen setelah ia diduga menganiaya mantan kekasihnya. Simak di sini: https://t.co/p6RiTdKKwX,5,0,0,0,2022-01-31,14,Monday,1,5,0
1488162439569055757,2022-01-31 14:49:08,Manchester City menggaet Julian Alvarez dari River Plate. Pria asal Argentina itu resmi diikat kontrak selama lima setengah tahun. https://t.co/USGBgM8rT0,11,0,0,0,2022-01-31,14,Monday,1,11,0
1488161686834106368,2022-01-31 14:46:09,"Ikan dikenal sebagai sumber protein penting. Tapi ada lho, jenis ikan yang disebut-sebut bisa memicu kanker. Yak betul, ikan asin! https://t.co/Zo7BYwwCSu",15,5,3,1,2022-01-31,14,Monday,1,18,6
1488160884228861952,2022-01-31 14:42:58,"Untuk menjawab teka-teki gambar ini, kamu nggak perlu berpikir panjang. Kurang dari satu menit pasti langsung terjawab semua. https://t.co/vo7001eu8z",46,32,2,3,2022-01-31,14,Monday,1,48,35
1488159777788248068,2022-01-31 14:38:34,"Frank Lampard akhirnya diresmikan sebagai manajer baru Everton. Lampard dikontrak 2,5 musim oleh The Toffees! https://t.co/i5XYee6TxG",7,0,0,0,2022-01-31,14,Monday,1,7,0
1488159758217588736,2022-01-31 14:38:29,Setiap pelaku Holokos yang masih buron setidaknya kini berusia sembilan puluhan. Mengapa pemburu Nazi begitu fokus untuk menyeret mereka ke pengadilan? https://t.co/PO1S8HdGr9,16,1,2,0,2022-01-31,14,Monday,1,18,1
1488158470629380098,2022-01-31 14:33:22,"Setelah muncul varian Delta kini COVID-19 muncul varian lainnya yakni Omicron. Meski begitu, varian Omicron dinilai lebih ringan dari Delta. 
https://t.co/6oEJBEpgF3",3,0,1,2,2022-01-31,14,Monday,1,4,2
1488157808642060292,2022-01-31 14:30:44,Varian baru Omicron diteliti memiliki tingkat penularan sangat cepat dan sulit dicegah atau dihindari. Kondisi tingginya tingkat penularan virus Omicron terlihat pada penambahan kasus COVID-19 di Inggris yang mencapai 70.000 kasus per hari. https://t.co/xxJ72bPxD3,6,0,5,2,2022-01-31,14,Monday,1,11,2
1488157788090028036,2022-01-31 14:30:39,KPK memeriksa 3 saksi terkait kasus dugaan suap menjerat Bupati Langkat Terbit Rencana. KPK mendalami pemberian fee atas pengaturan pemenangan proyek. https://t.co/tPfrHED9I6,1,1,1,1,2022-01-31,14,Monday,1,2,2
1488156720308359171,2022-01-31 14:26:25,Praktek penyalahgunaan itu terungkap dari keluhan para petani yang tidak memperoleh pupuk bersubsidi. https://t.co/tTBlz8i7ne,8,0,3,1,2022-01-31,14,Monday,1,11,1
1488155625708265478,2022-01-31 14:22:04,"Komnas HAM mengungkap temuan baru dalam penyelidikan peristiwa kerangkeng manusia di rumah Bupati Langkat nonaktif, Terbit Rencana Perangin Angin. Apa saja? https://t.co/kWpwZ9SqTe",3,3,1,0,2022-01-31,14,Monday,1,4,3
1488154880518799361,2022-01-31 14:19:06,"Sebuah studi tentang spesies yang punah mengungkapkan, peristiwa kepunahan massal keenam dalam sejarah planet kita sedang berlangsung. Sadarlah wahai manusia! https://t.co/Hl408fQR51",40,9,14,2,2022-01-31,14,Monday,1,54,11
1488154144586313731,2022-01-31 14:16:11,"Elon Musk kembali koar-koar soal proyek robot Tesla. Ia mengatakan robot ini akan jadi produk Tesla yang paling penting tahun ini, menyaingi bisnis mobilnya. https://t.co/ulfgeqOr2K",12,0,1,0,2022-01-31,14,Monday,1,13,0
1488153155103858689,2022-01-31 14:12:15,"Kapal yang melayani penyeberangan Ketapang-Lombok akan ditambah. Kini, kapal-kapal mulai perawatan. https://t.co/7d0phcLNcg",9,0,0,0,2022-01-31,14,Monday,1,9,0
1488152211242819589,2022-01-31 14:08:30,Belasan kapal di Pelabuhan Kota Tegal terbakar pada Sabtu (29/1) hingga Minggu (30/1) kemarin. Peristiwa serupa pernah terjadi November 2011 lalu. https://t.co/HLifL1IDzH,14,1,0,0,2022-01-31,14,Monday,1,14,1
1488152187859570689,2022-01-31 14:08:24,"Dengan teknologi artificial intelligent (AI), kita bisa melihat bagaimana wujud dari karakter tokoh animasi populer di dunia nyata. Dari Moana hingga Aladdin. Mana favoritmu? https://t.co/NBp3e0V4l1",7,2,1,1,2022-01-31,14,Monday,1,8,3
1488150152921686017,2022-01-31 14:00:19,"Saat bayi, Rohana ditinggalkan oleh Bunda kandungnya dan ditemui oleh wanita keturunan Tionghoa. Ia dirawat dengan ajaran agama Islam, lho. Simak kisahnya, yuk! #detikNetwork  https://t.co/FxQZrDtnC4",41,4,6,0,2022-01-31,14,Monday,1,47,4
1488150115667824652,2022-01-31 14:00:10,"Polisi melakukan patroli rutin di wilayah Bekasi, Jawa Barat. Polisi kemudian menangkap 6 ABG anggota geng motor. https://t.co/0A7D4ZWdvO",9,1,2,0,2022-01-31,14,Monday,1,11,1
1488149455404773382,2022-01-31 13:57:33,Pegadaian mewanti-wanti masyarakat agar hati-hati dan waspada terhadap upaya penipuan dengan modus rekrutmen karyawan  https://t.co/xtWufR3PNd,8,0,3,0,2022-01-31,13,Monday,1,11,0
1488148548835328001,2022-01-31 13:53:57,"Meloxicam merupakan obat untuk mengurangi rasa nyeri, bengkak, dan kaku pada sendi. Kenali dosis, efek samping dan interaksi obat lainnya di sini. https://t.co/MUnysJohE1",11,0,3,0,2022-01-31,13,Monday,1,14,0
1488147586657792006,2022-01-31 13:50:07,"Christian Eriksen resmi bergabung dengan Brentford, ia mengaku senang bisa bermain lagi dan tak sabar unjuk aksi di depan fans. https://t.co/k0gOPhoTCK",9,0,0,0,2022-01-31,13,Monday,1,9,0
1488145301114441730,2022-01-31 13:41:02,Arema FC akan melawan tim papan bawah Persela Lamongan di lanjutan BRI Liga 1 2021/2022. Singo Edan tak mau melihat posisi di klasemen Liga 1. https://t.co/Ac4adlRxxK,7,0,0,0,2022-01-31,13,Monday,1,7,0
1488143705311698946,2022-01-31 13:34:42,"Tiga kejadian kebakaran melanda permukiman padat penduduk di Tambora, Jakbar dalam sepekan. Ada dugaan penyebabnya adalah warga bandel soal urusan kabel. https://t.co/e02BZUXSCf",8,0,1,1,2022-01-31,13,Monday,1,9,1
1488142809420939264,2022-01-31 13:31:08,"Ada sejumlah beasiswa luar negeri yang menawarkan tunjangan hidup dengan besaran di atas Rp 10 juta. Apa saja ya?

via: detikedu  https://t.co/LNTnBQkBSp",11,0,1,0,2022-01-31,13,Monday,1,12,0
1488140662398664708,2022-01-31 13:22:36,KPK mendalami saksi soal aliran uang suap serta asal usul uang yang diamankan saat operasi tangkap tangan (OTT) Abdul Gafur Mas'ud (AGM) https://t.co/MIrpbItj1Z,6,1,2,0,2022-01-31,13,Monday,1,8,1
1488140323578683400,2022-01-31 13:21:16,Menteri Investasi/Kepala Badan Koordinasi Penanaman Modal (BKPM) Bahlil Lahadalia menargetkan mencabut 2.343 izin usaha pertambangan (IUP).  https://t.co/RJFIm4H6Nh,22,0,3,1,2022-01-31,13,Monday,1,25,1
1488140311721390088,2022-01-31 13:21:13,"Dinilai sudah masuk gelombang ketiga, harian Omicron di Indonesia diperkirakan sebenarnya sudah menyentuh 100 hingga 200 ribu. Bagaimana proyeksinya? https://t.co/qWapWYnHrh",15,13,7,1,2022-01-31,13,Monday,1,22,14
1488139374143365123,2022-01-31 13:17:29,"Kasus COVID-19 RI kini melonjak tajam di tengah merebaknya Omicron. Jika mengalami gejala-gejala ini, ingat baik-baik pesan Luhut agar pandemi terkendali. https://t.co/stm62yuNBj",15,19,6,11,2022-01-31,13,Monday,1,21,30
1488139061378400261,2022-01-31 13:16:15,"Jokowi membagikan BLT sebesar Rp 1,2 juta kepada para pedagang yang terdampak pandemi COVID-19 dalam kunjungannya ke Balikpapan, Kaltim hari ini.  https://t.co/9iLRtUq8T2",14,0,0,0,2022-01-31,13,Monday,1,14,0
1488138673086414851,2022-01-31 13:14:42,"Nama Ainun Najib tengah ramai di momen Pengukuhan Pengurus Besar dan Harlah ke-96 NU di Balikpapan, Senin (31/1/2022). Siapa dia?

via: detikedu  https://t.co/qRZizMZXCP",13,1,4,1,2022-01-31,13,Monday,1,17,2
1488138091223298060,2022-01-31 13:12:23,"Perjalanan asmara Mason Greenwood dan Harriet Robson sedang jadi sorotan, lantaran dugaan tindak penganiayaan yang dilakukan si pesepakbola kepada kekasihnya! https://t.co/ofEBkQC5dq",7,0,0,0,2022-01-31,13,Monday,1,7,0
1488136483173187585,2022-01-31 13:06:00,"Temannya ulang tahun, pria ini punya cara unik sekaligus kocak untuk memberikan kejutan spesial kepada temannya. Seperti memberikan hadiah nasi Padang!  https://t.co/OJIEVVGwI2",9,2,5,0,2022-01-31,13,Monday,1,14,2
1488136254004895748,2022-01-31 13:05:05,Seorang wasit futsal di Timika Papua dianiaya pemain saat pertandingan. Korban mengalami luka di bagian mulut. https://t.co/ydLsewBPAN,7,0,0,0,2022-01-31,13,Monday,1,7,0
1488135613429735428,2022-01-31 13:02:33,Berikut deretan kue Imlek pelambang keberuntungaan. Komen di bawah untuk makanan lain yang wajib ada di Hari Raya Imlek ya detikers! https://t.co/etibRE4REt,13,0,3,0,2022-01-31,13,Monday,1,16,0
1488135204841607174,2022-01-31 13:00:55,Faisal Basri memprediksi pemerintahan Presiden Joko Widodo (Jokowi) akan ambruk secara moral sebelum 2024. Siapa dia? Ini sosoknya. https://t.co/BOQ6cveL3Q,34,22,10,3,2022-01-31,13,Monday,1,44,25
1488134484931317772,2022-01-31 12:58:04,Thomas Tuchel enggan memandang sebelah mata Piala Dunia Antarklub. Ia memburu gelar ketiganya bersama Chelsea di ajang tersebut! https://t.co/j11E11FIBe,5,0,0,0,2022-01-31,12,Monday,1,5,0
1488133251805990913,2022-01-31 12:53:10,Para pesohor Indonesia berbondong-bondong terjun ke bisnis klub sepak bola dan basket. Fenomena sebelumnya pernah terjadi yaitu demam bisnis kue artis.  https://t.co/WnSfqobasT,38,10,4,2,2022-01-31,12,Monday,1,42,12
1488133250430210053,2022-01-31 12:53:09,Beredar cerita viral netizen yang model gundamnya diambil oleh ponakan. Psikolog menyinggung masalah personal boundaries atau batasan pribadi di keluarga RI. https://t.co/qJJEQbNFwE,22,1,17,14,2022-01-31,12,Monday,1,39,15
1488132507023388672,2022-01-31 12:50:12,Xavi Hernandez jadi salah satu faktor kunci di balik keputusan Adama Traore untuk kembali ke Barcelona dan ia siap menjawab kepercayaan Xavi. https://t.co/ZOOouorLGV,5,0,0,0,2022-01-31,12,Monday,1,5,0
1488132021897465857,2022-01-31 12:48:16,"Cerita kriminal mengerikan lainnya bisa kamu temukan di link berikut, dan tunggu utas #HitamnyaHitam setiap Kamis malam, hanya di @detikcom   

--
https://t.co/Ca13tAYrxF",6,0,3,0,2022-01-31,12,Monday,1,9,0
1488131905761517570,2022-01-31 12:47:49,Larangan makan di restoran setelah pukul 6 sore di Hong Kong membuat sejumlah resto memutar otak agar tak merugi. Poon choi bawa pulang pun jadi alternatif.  https://t.co/wGb99eqVtm,9,0,2,0,2022-01-31,12,Monday,1,11,0
1488131719035191298,2022-01-31 12:47:04,"Dalam program Hitamnya Hitam, detikcom menyuguhkan kumpulan cerita-cerita kriminal paling ngeri yang pernah menggegerkan dunia. Mulai dari kasus pembunuh berantai hingga sadisnya 'Malaikan Maut' pencabut nyawa. https://t.co/czAulnBZPO",6,1,4,0,2022-01-31,12,Monday,1,10,1
1488131609794846720,2022-01-31 12:46:38,"Obsesi Manson soal pemberontakan orang kulit hitam itu diwujudkan lewat pembunuhan sadis pada 1969. Ia merencanakan pembunuhan dengan meninggalkan bukti palsu yang membuat aksi keji itu seolah-olah dilakukan oleh Black Panthers, sebuah kelompok militan Afrika-Amerika.",2,1,1,0,2022-01-31,12,Monday,1,3,1
1488131546490224641,2022-01-31 12:46:23,"Ada lagi soal Charles Manson, yang menggemparkan publik karena membunuh aktris Hollywood, Sharon Tate, dengan sadis. Salah satu dorongan aksi keji ini adalah kekeliruan Manson memahami makna salah satu lagu The Beatles. https://t.co/mcH8ZtFAGW",0,1,1,0,2022-01-31,12,Monday,1,1,1
1488131439095074821,2022-01-31 12:45:57,"Mamoru Takuma mempunyai nama asli Kobayashi. Namun ia ingin dikenang sebagai Mamoru Takuma, bekas pasien sakit jiwa yang membunuh 8 anak dengan pisau daging di SD Osaka pada 2001. Peristiwa ini begitu mengguncang Jepang saat itu.",4,1,2,0,2022-01-31,12,Monday,1,6,1
1488131380018298881,2022-01-31 12:45:43,"Pernah dengar, cerita soal Mamoru Takuma?

Namanya tercatat sebagai salah satu pembunuh dan pedofil paling keji di Jepang. Setelah membunuh korbannya, ia mengirim foto mayatnya ke ibunya. https://t.co/ah9iJNi8Vp",4,1,2,0,2022-01-31,12,Monday,1,6,1
1488131257963884551,2022-01-31 12:45:14,Polisi menetapkan Edy Mulyadi sebagai tersangka kasus ujaran kebencian SARA terkait 'tempat jin buang anak'. Edy dijerat pasal berlapis. https://t.co/5FD7clsBKS,54,13,5,6,2022-01-31,12,Monday,1,59,19
1488131245116891137,2022-01-31 12:45:11,"Mau dengar cerita-cerita kriminal yang paling mengerikan, bahkan sampai menggegerkan dunia?

#THREAD",22,1,5,0,2022-01-31,12,Monday,1,27,1
1488131243829075969,2022-01-31 12:45:11,Di media sosial viral cerita seorang netizen yang mainan gundamnya diambil tanpa izin oleh ponakan. Bagaimana harusnya orang tua bersikap? Ini kata psikolog: https://t.co/XSCNhGD3WZ,14,0,5,3,2022-01-31,12,Monday,1,19,3
1488130386295152641,2022-01-31 12:41:46,Polri mengungkap kekhawatiran pelaku usaha terkait kebijakan tersebut yang berpotensi melakukan praktek penimbunan https://t.co/IUzrTeQmY1,3,3,2,0,2022-01-31,12,Monday,1,5,3
1488129409076838403,2022-01-31 12:37:53,Indonesia melaporkan 10.185 kasus baru COVID-19 pada 31 Januari 2022. Ini membuat kasus aktif terus merangkak naik ke angka 68.596. https://t.co/GLzn8HvKrq,11,2,3,3,2022-01-31,12,Monday,1,14,5
1488129055161520128,2022-01-31 12:36:29,Ada berbagai cara untuk membuat durasi seks lebih panjang dan tahan lama. Mulai dari olahraga hingga melakukan lebih banyak foreplay. https://t.co/231I3bDwob,20,2,6,0,2022-01-31,12,Monday,1,26,2
1488128265579606022,2022-01-31 12:33:21,"Pasien COVID-19 yang menjalani rawat inap di RSDC Wisma Atlet terus meningkat, menjadi 4.590 orang, tertinggi sejak Agustus. Begini pesan pakar epidemiolog. https://t.co/iGLNflBGPP",6,2,2,1,2022-01-31,12,Monday,1,8,3
1488128246063538176,2022-01-31 12:33:16,"Kantor pinjol yang dipimpin WN China ini berkantor di kawasan elite PIK, Penjaringan, Jakut. Ini alasan tersangka memilih kantor di sana. https://t.co/4SHuPcJFec",14,0,4,1,2022-01-31,12,Monday,1,18,1
1488127983785320448,2022-01-31 12:32:14,"Kalah 0-1 dari Persiraja Banda Aceh,  Macan Kemayoran kerap kesulitan menghadapi tim yang sedang terpuruk di zona degradasi! https://t.co/rAzOfjqlEw",5,1,1,0,2022-01-31,12,Monday,1,6,1
1488127658420580352,2022-01-31 12:30:56,"Foxconn, perusahaan perakit handphone iPhone dari Taiwan resmi investasi di Kawasan Industri Terpadu Batang, Jawa Tengah.  https://t.co/cC07Fgtae2",28,2,4,1,2022-01-31,12,Monday,1,32,3
1488127647880208386,2022-01-31 12:30:53,PPATK sedang mengupayakan agar bank yang memfasilitasi transaksi narkotika bisa dijerat dengan undang-undang tindak pidana.  https://t.co/vbnanqpu5G,7,0,2,0,2022-01-31,12,Monday,1,9,0
1488127272016097284,2022-01-31 12:29:24,"Apa saja perbedaan dari SNMPTN dan SBMPTN? Cari tahu lebih lanjut di sini.

via: detikedu  https://t.co/SGoYRsbrxw",8,0,3,1,2022-01-31,12,Monday,1,11,1
1488126913499516928,2022-01-31 12:27:58,"Persija Jakarta mengonfirmasi Maman Abdurrahman, terpapar COVID-19 dan sebelumnya sudah ada Riko Simanjuntak yang terpapar lebih dulu. https://t.co/3dv6ONWpV7",2,0,3,0,2022-01-31,12,Monday,1,5,0
1488126328180252673,2022-01-31 12:25:39,"NFT merupakan token digital yang diciptakan dalam jaringan blockchain, sebuah teknologi yang digunakan untuk membuat koin kripto seperti Bitcoin atau Ethereum.  https://t.co/maN4Km6IPO",7,2,5,0,2022-01-31,12,Monday,1,12,2
1488126317161758720,2022-01-31 12:25:36,Pusat Pelaporan dan Analisis Transaksi Keuangan (PPATK) mengungkap peredaran uang lewat pinjaman online (pinjol) ilegal mencapai Rp 6 triliun.  https://t.co/PuR1BxQ9SB,4,0,3,1,2022-01-31,12,Monday,1,7,1
1488126042049073157,2022-01-31 12:24:31,"Sebuah video viral menunjukkan emak-emak mengamuk di ruang sidang PN Jaksel. Namun, terdapat tagar 'KPK RI' di dalam video tersebut. Apa kata KPK? https://t.co/LXFlCd4141",14,0,3,0,2022-01-31,12,Monday,1,17,0
1488126023736696835,2022-01-31 12:24:26,Ada 11 aplikasi yang dikelola perusahaan pinjol yang dipimpin WN China di Jakut. Simak di sini daftarnya. https://t.co/noZNSJZb7h,6,0,4,0,2022-01-31,12,Monday,1,10,0
1488125729023877129,2022-01-31 12:23:16,"Memasuki bulan Februari 2022, permintaan tisu untuk AFH diprediksi semakin meningkat karena ada momen yang dapat mendongkrak aktivitas masyarakat di sana.  https://t.co/bgpvioIhDr",3,0,1,0,2022-01-31,12,Monday,1,4,0
1488125167452700675,2022-01-31 12:21:02,"""Pasien menuntut apa yang harus dan sudah mediasi tapi pasien ingin matanya sembuh normal. Apa yang harus kawan perawat lakukan?"" #detiksAdvocate https://t.co/rC94WrLQWQ",0,0,2,0,2022-01-31,12,Monday,1,2,0
1488125140047126530,2022-01-31 12:20:56,Masih banyak dari masyarakat Indonesia yang belum sadar bahwa broker binary option seperti Binomo dan kawan-kawannya mirip perjudian!  https://t.co/JaPRYkOb27,4,1,4,2,2022-01-31,12,Monday,1,8,3
1488124862887563264,2022-01-31 12:19:49,"PPATK meminta tambahan anggaran Rp 63,7 miliar untuk program kerja pada 2022 ini. Salah satunya untuk mencegah mengawasi pendanaan senjata pemusnah massal. https://t.co/VFJuuJZSVt",2,0,2,0,2022-01-31,12,Monday,1,4,0
1488124522570133505,2022-01-31 12:18:28,"Direktur Utama MIND ID, Hendi Prio Santoso tidak hadir dalam Rapat Dengar Pendapat (RDP) dengan Komisi VII DPR RI karena dinyatakan positif COVID-19.  https://t.co/ntIiWSFbjA",2,0,1,0,2022-01-31,12,Monday,1,3,0
1488124504782131212,2022-01-31 12:18:24,"Bahlil mengancam akan mencabut izin investasi mangkrak yang tidak dapat diselesaikan tahun ini. Dengan begitu, tidak ada lagi investasi mangkrak di tahun depan.  https://t.co/UezIWzEeL8",2,0,3,0,2022-01-31,12,Monday,1,5,0
1488123841784303617,2022-01-31 12:15:46,Kementerian Kelautan dan Perikanan (KKP) merancang kebijakan ataupun program kerja untuk mendorong pertumbuhan.  https://t.co/D9xWLJTZkT,2,1,2,0,2022-01-31,12,Monday,1,4,1
1488123536124354561,2022-01-31 12:14:33,Christian Eriksen resmi bergabung dengan Brentford di sisa musim 2021/2022. Dia mengaku senang bisa bermain lagi dan tak sabar unjuk aksi di depan fans. https://t.co/yitAAXDT0I,2,0,1,0,2022-01-31,12,Monday,1,3,0
1488123521159024640,2022-01-31 12:14:30,Menteri Perdagangan M. Lutfi percaya diri harga minyak goreng bakal menyesuaikan harga eceran tertinggi (HET) baru yang ditetapkan pemerintah.  https://t.co/BxCjb2XaMJ,2,2,2,0,2022-01-31,12,Monday,1,4,2
1488123223434801155,2022-01-31 12:13:19,Fuji dan Thariq Halilintar 'go public'. Keduanya tampak dalam jamuan makan malam yang digelar keluarga Atta-Aurel dengan suguhan hot pot.  https://t.co/27F1wSPeUL,4,2,4,2,2022-01-31,12,Monday,1,8,4
1488122413275664385,2022-01-31 12:10:05,Edy Mulyadi ditetapkan sebagai tersangka ujaran kebencian SARA terkait polemik 'tempat jin buang anak'. Edy Mulyadi telah ditahan. https://t.co/NkRLAO5I3i,672,379,153,91,2022-01-31,12,Monday,1,825,470
1488122387942023168,2022-01-31 12:09:59,"Seorang wanita bernama Kim baru saja membuat kesal seluruh pegawai Starbucks Aberdeen, Skotlandia. Ia memesan 100 kue saat 10 menit coffee shop ini akan tutup!  https://t.co/qvfzhPkEZy",4,0,3,0,2022-01-31,12,Monday,1,7,0
1488122387564576772,2022-01-31 12:09:59,"Kemenkes RI mengeluarkan aturan baru terkait vaksin booster COVID-19. Salah satunya yakni pelaksanaan tak perlu menunggu target capaian, ini selengkapnya. https://t.co/IcD97coM3j",3,2,3,0,2022-01-31,12,Monday,1,6,2
1488121796012478468,2022-01-31 12:07:38,"Perjalanan asmara Mason Greenwood dan Harriet Robson sedang jadi sorotan, lantaran dugaan tindak penganiayaan yang dilakukan si pesepakbola kepada kekasihnya. https://t.co/hYiQ265F97",10,3,2,1,2022-01-31,12,Monday,1,12,4
1488120880622448645,2022-01-31 12:04:00,"Jokowi meminta PBNU mau 'membajak' seorang praktisi teknologi di bidang data sains, Ainun Najib, dari perusahaan Singapura. Siapa sebenarnya Ainun Najib? https://t.co/r8n1oUPX0o",349,61,40,45,2022-01-31,12,Monday,1,389,106
1488120825110740997,2022-01-31 12:03:47,"""Harga-harga selama 2017-2020 itu harga minyak goreng itu flat, yang buat tinggi siapa? Yang membuat tinggi itu adalah Republik Indonesia,"" jelas Mendag https://t.co/NPiP8HbEUV",4,3,2,1,2022-01-31,12,Monday,1,6,4
1488120007682834433,2022-01-31 12:00:32,BPOM menilai migrasi bahan kimia Bisphenol A (BPA) pada kemasan air minum dalam kemasan berbahan polikarbonat mengkhawatirkan bagi kesehatan masyarakat. #CNNIndonesia #detikNetwork  https://t.co/fBzsvdP3d0,2,0,5,0,2022-01-31,12,Monday,1,7,0
1488119476134555658,2022-01-31 11:58:25,"Jelang libur Imlek 2022 yang jatuh pada Selasa (1/2/2022), bisa disimak fakta seputar angpau atau amplop merah ciri khas dalam perayaan Tahun Baru China ini.

via: detikedu  https://t.co/JPPzF5MY6r",2,0,2,0,2022-01-31,11,Monday,1,4,0
1488119240406282243,2022-01-31 11:57:29,"Harga minyak goreng di beberapa pasar daerah Jakarta Selatan, ternyata masih menyentuh Rp 40.000/liter!  https://t.co/Uy3DRJEq0u",4,7,3,1,2022-01-31,11,Monday,1,7,8
1488118567996473344,2022-01-31 11:54:49,"Umi Pipik sudah memberikan restu untuk hubungan Egy Maulana Vikri dan Adiba Khanza. Akan tetapi, sampai sekarang keduanya masih belum bicara pernikahan. https://t.co/pURkPNARXX",13,0,2,1,2022-01-31,11,Monday,1,15,1
1488117942533464067,2022-01-31 11:52:20,Sikap Mohamed Salah usai laga Mesir vs Maroko bikin kagum beberapa pihak. Ia menyemangati satu per satu pemain Maroko yang bersedih usai disingkirkan Mesir. https://t.co/ZZZmkWOgqy,7,0,0,0,2022-01-31,11,Monday,1,7,0
1488117920571998211,2022-01-31 11:52:14,"Jokowi menyampaikan empat arahan terkait evaluasi PPKM saat memimpin rapat terbatas melalui konferensi video dari Balikpapan, Kalimantan Timur. https://t.co/PGWplTK0dI",2,1,1,0,2022-01-31,11,Monday,1,3,1
1488117588509040643,2022-01-31 11:50:55,"RI kembali diterpa lonjakan COVID-19 akibat gelombang Omicron. Menkes prediksi puncak Corona tiba akhir Februari, bisa 2-3 kali lebih tinggi dari puncak Delta. https://t.co/RHLGL8n5jx",22,12,15,11,2022-01-31,11,Monday,1,37,23
1488117566518267906,2022-01-31 11:50:50,"""Kami menyadari bahwa PKS ini perolehannya baru 8,21%. Jadi tidak bisa dengan presidential threshold 20 persen tidak bisa mencalonkan sendiri,"" kata Syaikhu. https://t.co/3A8Jscspa7",8,5,3,0,2022-01-31,11,Monday,1,11,5
1488116888785805316,2022-01-31 11:48:08,Berikut 5 Inspirasi Fashion Imlek Kece dan Modis yang bisa kalian coba nih detikers! https://t.co/Kq5ut9l5aA,1,0,1,0,2022-01-31,11,Monday,1,2,0
1488116854019309568,2022-01-31 11:48:00,Dorce Gamalama buat heboh setelah menjawab pertanyaan dari Denny Sumargo. Dorce mengatakan dirinya ingin dimakamkan sebagai perempuan. https://t.co/lZmEQPsLBY,1,1,1,1,2022-01-31,11,Monday,1,2,2
1488116421238403076,2022-01-31 11:46:17,Menkes membawa kabar baik di tengah lonjakan kasus Omicron dan laporan lima pasien meninggal dunia. Disimak baik-baik ya. https://t.co/ikHj0mu9SW,3,2,1,0,2022-01-31,11,Monday,1,4,2
1488115854189502466,2022-01-31 11:44:02,"Biaya resmi pembuatan surat izin mengemudi (SIM) relatif tidak terlalu mahal, kok. Harga bikin SIM nggak sampai Rp 500.000! https://t.co/V2h9PzkUvr",64,43,25,3,2022-01-31,11,Monday,1,89,46
1488115526849208320,2022-01-31 11:42:44,Angka positif harian COVID-19 DKI Jakarta kembali mengalami lonjakan. Ketersediaan pasokan oksigen di seluruh fasilitas kesehatan Jakarta dilaporkan aman. https://t.co/keiIaZpG3A,8,4,1,2,2022-01-31,11,Monday,1,9,6
1488114023522521092,2022-01-31 11:36:45,Komisi Yudisial (KY) meloloskan 55 nama calon hakim agung. Siapa saja? https://t.co/UZKOBVG9fa,5,0,0,0,2022-01-31,11,Monday,1,5,0
1488112979866488835,2022-01-31 11:32:36,"Sepatu menjadi salah satu bagian yang tidak bisa dipisahkan dari penampilan. Selebgram Rani Ramadhina menjabarkan soal pemilihan sepatu yang nyaman untuk dipakai.
 https://t.co/Me137lAack",4,0,0,0,2022-01-31,11,Monday,1,4,0
1488111961300738053,2022-01-31 11:28:34,"Ini menjadi gelar juara kedua kalinya bagi mereka, pada bulan dan tahun yang sama. https://t.co/62f0xkt3an",10,0,3,1,2022-01-31,11,Monday,1,13,1
1488111395753369604,2022-01-31 11:26:19,Menteri Badan Usaha Milik Negara (BUMN) Erick Thohir melepas ekspor kopi 130 ton ke Mesir pada Minggu (30/1) di Lampung.  https://t.co/Vskv19k1zb,24,0,1,0,2022-01-31,11,Monday,1,25,0
1488109658002927618,2022-01-31 11:19:24,Presiden Jokowi mengenakan setelan jas dan peci serta sarung bermotif hijau merah di acara pengukuhan PBNU. Jokowi pun mengungkap alasannya. https://t.co/pDdHLjkrNd,11,1,0,1,2022-01-31,11,Monday,1,11,2
1488109460799295489,2022-01-31 11:18:37,"""Saya mendukung proses hukum terhadap Edy. Termasuk hukum adat dari masyarakat adat Kalimantan,"" tegas Gusti. https://t.co/poL0r5A2Pj",22,2,1,2,2022-01-31,11,Monday,1,23,4
1488108394326200322,2022-01-31 11:14:23,Baifern Luevisadpaibul bersemangat menyambut tahun baru Imlek 2022. Aktris Thailand tersebut melakukan pemotretan dengan gaun merah yang anggun. https://t.co/hE42vbaLJL,16,1,2,5,2022-01-31,11,Monday,1,18,6
1488107842473234437,2022-01-31 11:12:12,Sandiaga memastikan jebakan karantina terhadap turis Ukraina tetap diusut. Sandiaga menegaskan bakal memberi sanksi jika terbukti ada pelanggaran. https://t.co/FGNCJTZSlv,3,1,0,1,2022-01-31,11,Monday,1,3,2
1488107541905252355,2022-01-31 11:11:00,"Tak adanya akses lain, membuat warga berinisiatif untuk memasang dua bilah bambu sebagai pijakan yang dipasang pada sisa-sisa penyangga pada jembatan yang rusak. https://t.co/mVkZQz03gG",5,3,2,0,2022-01-31,11,Monday,1,7,3
1488106933076865027,2022-01-31 11:08:35,Edy bercanda dengan meminta agar jin ikut dimintai keterangan di persidangan kasus itu. https://t.co/VqZMht5A6W,24,24,1,4,2022-01-31,11,Monday,1,25,28
1488105987601055747,2022-01-31 11:04:49,"Belum mengklarifikasi, pemain Manchester United itu tutup komentar di Instagram. https://t.co/NSTFPmapBr",5,0,1,0,2022-01-31,11,Monday,1,6,0
1488105009438932997,2022-01-31 11:00:56,"Tahun Baru Imlek dirayakan di seluruh Asia dan dunia. Di China sendiri, sekolah dan kegiatan bisnis akan ditutup beberapa hari selama perayaan Imlek.

via: detikedu  https://t.co/YOkZfvqfWx",4,0,1,0,2022-01-31,11,Monday,1,5,0
1488104174013366276,2022-01-31 10:57:37,"Perkiraan cuaca besok 1 Februari 2022 untuk wilayah Jabodetabek sudah dirilis oleh BMKG. Lantas, bagaimana perkiraan cuaca besok untuk wilayah Jabodetabek? https://t.co/RU9nImZgYg",2,0,1,0,2022-01-31,10,Monday,1,3,0
1488103925660237827,2022-01-31 10:56:38,"COVID-19 menyerang di tiga kompetisi cabang olahraga yakni sepakbola, basket, dan voli. Perlukah liga olahraga di Indonesia dihentikan sementara? https://t.co/flG4GgeEMO",0,1,0,0,2022-01-31,10,Monday,1,0,1
1488102849104039938,2022-01-31 10:52:21,Seohyun makin fokus ke jalur akting dengan diumumkannya film Love and Leashes. Sang maknae SNSD ini memang makin hari makin bersinar! https://t.co/MhsQxBHS2d,10,0,1,0,2022-01-31,10,Monday,1,11,0
1488102829487230977,2022-01-31 10:52:16,"Penggugat presidential threshold agar menjadi 0% terus berdatangan ke MK. Terbaru, 4 orang ikut menggugat peraturan tersebut sehingga total menjadi 48 orang. https://t.co/gax9fOdBO1",12,1,2,0,2022-01-31,10,Monday,1,14,1
1488102520887160834,2022-01-31 10:51:03,"Maruli Simanjuntak resmi dilantik sebagai Pangkostrad. Maruli dilantik langsung oleh Kepala Staf Angkatan Darat (KSAD), Jenderal TNI Dudung Abdurachman. https://t.co/2kiQpCpFn9",5,1,1,0,2022-01-31,10,Monday,1,6,1
1488101676775002113,2022-01-31 10:47:41,"Vihara Dharma Bakti, Glodok, Tamansari, Jakarta Barat, meniadakan sembahyang malam Imlek tahun ini. https://t.co/AnBu0oG6Fc",8,0,0,0,2022-01-31,10,Monday,1,8,0
1488101466690789376,2022-01-31 10:46:51,Menkes Budi Gunadi Sadikin menyinggung soal jumlah pasien COVID-19 Omicron yang butuh perawatan di rumah sakit bisa lebih dari saat gelombang Delta. https://t.co/j9t47Zwh9m,2,0,3,0,2022-01-31,10,Monday,1,5,0
1488101445022986240,2022-01-31 10:46:46,Sikap Mohamed Salah usai laga Mesir vs Maroko bikin kagum beberapa pihak. Ia menyemangati satu per satu pemain Maroko yang bersedih usai disingkirkan Mesir. https://t.co/u3JjJX8OWz,11,1,3,2,2022-01-31,10,Monday,1,14,3
1488101084946178053,2022-01-31 10:45:20,"Kendaraan listrik di Jakarta mendapat keringanan pajak. Bahkan, kepemilikian kendaraan listrik kedua dan seterusnya tidak dikenakan pajak progresif! https://t.co/HtANT8FgN4",10,1,3,0,2022-01-31,10,Monday,1,13,1
1488101079283867650,2022-01-31 10:45:19,Mola TV tidak akan lagi menayangkan Liga Inggris untuk musim depan. Netizen Indonesia bingung cari cara nonton tim-tim Premier League berlaga... https://t.co/MoLb8p0sXz,4,4,0,2,2022-01-31,10,Monday,1,4,6
1488100192486404098,2022-01-31 10:41:48,Gempuran udara Israel itu dilaporkan menghantam pos terdepan militer dan depot senjata yang dioperasikan oleh Hizbullah di wilayah Suriah. https://t.co/Fcp3aJFnFK,7,0,0,1,2022-01-31,10,Monday,1,7,1
1488099887338172419,2022-01-31 10:40:35,Mantan Wakil Ketua DPR itu mengaku hidup susah ketika mengambil gelar master di Australia. Begini ceritanya! https://t.co/M7vXiGSgl7,10,9,2,8,2022-01-31,10,Monday,1,12,17
1488098952037732355,2022-01-31 10:36:52,Ia ingin target perdagangan US$ 60 miliar dengan AS dalam lima tahun ke depan bisa terealisasi.  https://t.co/agoTXp8qnC,5,0,0,1,2022-01-31,10,Monday,1,5,1
1488098410582396931,2022-01-31 10:34:43,"Berubah lagi, masa karantina kini dipangkas menjadi 5 hari. Berikut ketentuannya: https://t.co/yjTTXYqHKL",13,6,2,14,2022-01-31,10,Monday,1,15,20
1488097874680459266,2022-01-31 10:32:35,"Pria ini curhat di media sosial, mainan gundam miliknya diambil oleh keponakan dan dianggap mainan harga Rp50 ribu. Humm nyesek juga.... https://t.co/jeXsqbtXit",176,39,46,26,2022-01-31,10,Monday,1,222,65
1488096367645966344,2022-01-31 10:26:36,"Libur Imlek 2022 telah diputuskan akan dirayakan pada Selasa, 1 Februari 2022. Bagaimana imabauan pemerintah terhadap perayaan Imlek tahun ini? https://t.co/EYnqSOZ2Zq",6,3,2,3,2022-01-31,10,Monday,1,8,6
1488096348826128385,2022-01-31 10:26:31,Firli Bahuri menyebut KPK banyak diisi karakter Nahdliyin. Firli mengatakan Nahdliyin mempunyai kepribadian antikorupsi sehingga nilai itu melekat dengan KPK. https://t.co/5WIAhL4KsS,13,19,2,5,2022-01-31,10,Monday,1,15,24
1488095543469522944,2022-01-31 10:23:19,Persib Bandung mencatatkan clean sheet lagi pada lanjutan BRI Liga 1 2021/2022. Teja Paku Alam pun mendapatkan pujian! https://t.co/o6vciMt6Rg,8,0,1,0,2022-01-31,10,Monday,1,9,0
1488094223832432640,2022-01-31 10:18:05,"Hore! Kabar baik untuk para lansia, KAI memberikan potongan harga tiket Kereta Api Jarak Jauh sebesar 20%. Ini ketentuannya: https://t.co/ds7UGZbxi1",6,1,0,1,2022-01-31,10,Monday,1,6,2
1488093966079832069,2022-01-31 10:17:03,"Ririe Fairus bikin heboh saat duduki foto Nissa Sabyan. Eh, ada apa nih? https://t.co/BX50NbLFW1",3,0,0,0,2022-01-31,10,Monday,1,3,0
1488092691636363265,2022-01-31 10:11:59,#Foto Deretan artis Korea ini terlihat anggun di hari pernikahannya. Intip gaya Song Hye Kyo hingga Park Shin Hye dalam balutan gaun pengantin. Cantiknya.... https://t.co/GEx6zKfYdc,6,0,3,0,2022-01-31,10,Monday,1,9,0
1488092669742096388,2022-01-31 10:11:54,"Golkar meraih tingkat popularitas 93,9%, mengungguli PDIP (92,3%) dan Partai Gerindra (91,6%). https://t.co/ORVV9oe4yL",3,1,0,0,2022-01-31,10,Monday,1,3,1
1488091819825152001,2022-01-31 10:08:31,"Petugas polisi menangkap pengendara yang kedapatan melanggar lalu lintas, gilanya ternyata pengendara ini tidak pernah memiliki SIM selama 70 tahun! https://t.co/MXpa7A29MV",15,3,1,2,2022-01-31,10,Monday,1,16,5
1488091798308331529,2022-01-31 10:08:26,"Olivier Giroud sudah setengah tahun menjajal Serie A. Menurutnya, wasit di sana sering meniup peluit pelanggaran ketimbang di Premier League. https://t.co/E5TdGWEnP5",8,1,0,1,2022-01-31,10,Monday,1,8,2
1488090524733120515,2022-01-31 10:03:23,"Di pemakaman sang ayah, suami Arzeti Bilbina menangis ketika menyampaikan rasa penghormatannya. https://t.co/jPbDkcnrVf",1,0,0,0,2022-01-31,10,Monday,1,1,0
1488090241990860802,2022-01-31 10:02:15,"Seorang napi di Aceh Besar, ditangkap petugas karena diduga menyelundupkan sabu. Napi itu diduga meminta adiknya membawa roti selai isi sabu. https://t.co/bn0tZCbk88",4,1,0,1,2022-01-31,10,Monday,1,4,2
1488089875626827780,2022-01-31 10:00:48,Pemprov DKI Jakarta mulai menambah kapasitas tempat tidur di rumah sakit rujukan COVID-19. https://t.co/mAZLfVYsdk,4,2,0,1,2022-01-31,10,Monday,1,4,3
1488089565072089090,2022-01-31 09:59:34,Menkes menyebut sudah ada lima orang pasien Omicron di Indonesia yang meninggal dunia. Kasusnya didominasi oleh kelompok lansia. https://t.co/vFjpWMD4Bf,7,3,2,0,2022-01-31,9,Monday,1,9,3
1488089546248101888,2022-01-31 09:59:29,Jumlah kasus Corona saat ini masih jauh di bawah puncak kasus Delta. https://t.co/zYbp5NBFiP,5,6,0,0,2022-01-31,9,Monday,1,5,6
1488089275799379980,2022-01-31 09:58:25,Menkes Budi menyebut ada lima pasien Corona varian Omicron yang meninggal dunia. Dia mengatakan mayoritas pasien belum disuntik vaksin Corona. https://t.co/Qyb6w5NHpB,10,5,2,0,2022-01-31,9,Monday,1,12,5
1488089265254899715,2022-01-31 09:58:22,PDIP mewanti-wanti agar Anies tak mengurusi daerah lain. https://t.co/Le7mvFzPEW,30,48,2,5,2022-01-31,9,Monday,1,32,53
1488088959821533191,2022-01-31 09:57:10,"Setiap daerah punya makanan khas untuk merayakan Imlek. Bagi orang Hong Kong, Poon Choi harus selalu ada saat momen perayaan penting seperti Imlek.  https://t.co/mnbQ8KZX0I",1,0,1,2,2022-01-31,9,Monday,1,2,2
1488088947079143427,2022-01-31 09:57:06,"Kepala BPJT Kementerian PUPR Danang Parikesit mengatakan Tol Gedebage-Cilacap merupakan jalan tol terpanjang dengan ruas 206,65 kilometer (km).  https://t.co/myDzxrXV7b",0,2,1,0,2022-01-31,9,Monday,1,1,2
1488088679558094852,2022-01-31 09:56:03,"Polres Bogor tetap memberlakukan ganjil genap untuk membatasi kunjungan ke lokasi wisata Puncak, Kabupaten Bogor, saat libur Imlek, Selasa (1/2) besok. https://t.co/7XHRHGGTwj",6,0,0,0,2022-01-31,9,Monday,1,6,0
1488088660557897729,2022-01-31 09:55:58,Pemerintah sedang menyiapkan aturan baru tentang pajak penjualan atas barang mewah (PPnBM) untuk sektor otomotif dan properti.  https://t.co/jwD2CqSkLz,0,0,0,0,2022-01-31,9,Monday,1,0,0
1488088437261582336,2022-01-31 09:55:05,Indomie bisa dibuat lebih istimewa dengan penggunaan bahan-bahan tertentu. Seperti halnya Indomie pasta dengan tambahan cream cheese dan pasta tomat. Bikin yuk!  https://t.co/9xkhuyWSrA,6,0,1,1,2022-01-31,9,Monday,1,7,1
1488088418030698499,2022-01-31 09:55:00,"Sabrina Chairunnisa memberikan jawaban menohok usai dinyinyirin saat posting foto bareng Deddy Corbuzier. Duh, ada apa nih? https://t.co/vGSVDXBSRa",6,2,0,0,2022-01-31,9,Monday,1,6,2
1488088096927326210,2022-01-31 09:53:44,"Sebagian orang mungkin masih banyak kesulitan dalam membedakan antara teluk dan tanjung. Yuk, simak perbedaannya di sini!

via: detikedu  https://t.co/9ncGROXkBg",1,1,0,1,2022-01-31,9,Monday,1,1,2
1488088078820462592,2022-01-31 09:53:39,"Tak kalah populer dari cireng dan cilok. Cimol jadi camilan kekinian mudah didapatkan dan harganya murah. Mulai dari varian pedas, sampai isi keju mulur gurih. https://t.co/SyejkfEhX5",2,0,1,0,2022-01-31,9,Monday,1,3,0
1488087742194069506,2022-01-31 09:52:19,"Kasus Corona di RI menembus 10 ribu kasus. Kasus harian Corona ini tertinggi sejak pertengahan September, berikut riwayat penambahan kasus selama sepekan. https://t.co/MV37SwInTS",7,2,4,4,2022-01-31,9,Monday,1,11,6
1488087446730518528,2022-01-31 09:51:09,"Amanda Manopo terlihat bersama cowok baru. Di Instagram, ada netizen yang mengunggah foto Amanda Manopo bersama pria misterius itu. Siapa tuh? https://t.co/z6I4HkUauJ",2,0,0,0,2022-01-31,9,Monday,1,2,0
1488087435871412225,2022-01-31 09:51:06,"Kini berusia 55 tahun, kecantikan Paramitha Rusady tidak kunjung luntur. Meski sudah jarang main film dan sinetron, artis cantik ini tetap terlihat memesona. #detikNetwork  https://t.co/uFeIb30yHn",10,0,0,0,2022-01-31,9,Monday,1,10,0
1488087131801194497,2022-01-31 09:49:54,"Saat Imlek, menikmati makanan bersama keluarga dan kerabat adalah agenda wajib. Jika jamuannya formal, kamu perlu mengetahui beberapa etiket makan.  https://t.co/Ylgzoi0oA2",4,0,0,0,2022-01-31,9,Monday,1,4,0
1488086550290350081,2022-01-31 09:47:35,Pasien positif COVID di Wisma Atlet terus bertambah. Pihak RSDC Wisma Atlet bakal menambah nakes jika kasus terus melonjak. https://t.co/O7Uyg8h4Ct,1,5,1,0,2022-01-31,9,Monday,1,2,5
1488086525384478724,2022-01-31 09:47:29,Seragam satpam baru rencananya akan diganti karena dinilai terlalu mirip dengan seragam Polri.  https://t.co/myw8e7p1Pf,9,4,3,1,2022-01-31,9,Monday,1,12,5
1488085841868111874,2022-01-31 09:44:46,Pusat Pelaporan dan Analisis Transaksi Keuangan (PPATK) telah menerima 73 ribu laporan transaksi keuangan mencurigakan selama 2021. Jumlah itu sangat besar!  https://t.co/QB1RDnnYKK,5,0,4,0,2022-01-31,9,Monday,1,9,0
1488085808880009216,2022-01-31 09:44:38,"Jumlah kasus virus Corona COVID-19 bertambah 10.185 kasus pada Senin (31/1/2022). Pasien sembuh bertambah 3.290, meninggal 17. https://t.co/SNq6Ketd4L",6,1,7,1,2022-01-31,9,Monday,1,13,2
1488085587219423232,2022-01-31 09:43:45,Realisasi investasi di Kalimantan Timur sebagai lokasi ibu kota negara (IKN) baru berada di urutan keempat terbanyak pada triwulan IV-2021.  https://t.co/ub5Jg1hiuK,4,3,2,1,2022-01-31,9,Monday,1,6,4
1488085570207236097,2022-01-31 09:43:41,"Beberapa orang mungkin bertanya-tanya bagaimana bisa tertular Omicron, saat protokol kesehatan sudah dilakukan seketat mungkin. Catat 8 titik lengah ini: https://t.co/HXj1pwyu1Z",2,1,1,0,2022-01-31,9,Monday,1,3,1
1488085292695408640,2022-01-31 09:42:35,Imlek jadi hari libur nasional.. Tak sedikit gerai makanan dan minuman memeriahkan Imlek dengan berikan promo Imlek menarik! Ini daftarnya.  https://t.co/4sjxQC6Kj8,3,0,2,0,2022-01-31,9,Monday,1,5,0
1488084074036137984,2022-01-31 09:37:45,"Hanya karena makanan, banyak suami yang ngambek bahkan sampai marah besar ke istri mereka. Ada kisahnya yang lucu hingga bikin geleng kepala!  https://t.co/tG3GnRoXHB",1,0,2,0,2022-01-31,9,Monday,1,3,0
1488083893232312321,2022-01-31 09:37:02,"Selain Ki Hajar, ada beberapa tokoh pendidikan dan pejuang Indonesia yang dulu kuliah di bidang kedokteran. Siapa saja?

via: detikedu  https://t.co/sk2JQvVoFg",9,0,3,0,2022-01-31,9,Monday,1,12,0
1488083616328519686,2022-01-31 09:35:56,Nasib Phil Jones makin tak jelas saja setelah menolak pindah ke Bordeaux. Apakah Jones masih diterima di skuat Manchester United? https://t.co/6CFH634Qff,1,0,1,0,2022-01-31,9,Monday,1,2,0
1488082981604495365,2022-01-31 09:33:24,"KPK melakukan penggeledahan terkait kasus dugaan korupsi Bupati Langkat. Dari hasil penggeledahan, KPK menyita beberapa dokumen dan uang tunai sebesar Rp 2,1 miliar. https://t.co/LACpp8syLk",3,0,1,1,2022-01-31,9,Monday,1,4,1
1488082607325732864,2022-01-31 09:31:55,"""Kasus di luar Jawa-Bali terlihat kasus harian sudah meningkat ke 499 (kasus),"" kata Airlangga Hartarto. https://t.co/wKdP15VzS1",7,0,1,0,2022-01-31,9,Monday,1,8,0
1488082227233710083,2022-01-31 09:30:24,"Menteri Investasi/Kepala Badan Koordinasi Penanaman Modal (BKPM) Bahlil Lahadalia di DPR memamerkan realisasi investasi 2021 mencapai Rp 901,02 triliun.  https://t.co/oK53IMvfou",7,0,0,1,2022-01-31,9,Monday,1,7,1
1488082215452004354,2022-01-31 09:30:22,"Menkes Budi mengungkap varian baru Omicron sampai saat ini masih banyak ketidakpastian. Meski begitu, dia meminta masyarakat waspada. https://t.co/16PaP1zzpp",7,0,0,0,2022-01-31,9,Monday,1,7,0
1488081903299268610,2022-01-31 09:29:07,Tebak-tebakan bisa jadi cara asik untuk menguji ketajaman berpikir. Apakah kamu bisa menjawab teka-teki ini dan membuktikan kecerdasanmu? https://t.co/hUzDQQzRVF,3,1,1,1,2022-01-31,9,Monday,1,4,2
1488081886572384260,2022-01-31 09:29:03,Artis Dorce Gamalama bicara soal wasiat ketika sudah meninggal. Salah satunya dirinya ingin dimakamkan sebagai perempuan. Ketua MUI angkat bicara. https://t.co/qrLCV7cwco,13,21,2,2,2022-01-31,9,Monday,1,15,23
1488081613577674753,2022-01-31 09:27:58,Edy Mulyadi mendatangi Bareskrim Polri buntut ucapan Kalimantan sebagai tempat 'jin buang anak' sambil memakai iket Sunda. Majelis Adat Sunda pun bereaksi. https://t.co/DDUJmjIs47,18,18,10,5,2022-01-31,9,Monday,1,28,23
1488081598247575554,2022-01-31 09:27:54,Artis Randa Septian ditangkap di Bali gegara narkoba. Satres Narkoba Polresta Denpasar berhasil menyita ganja dan tembakau gorila. https://t.co/eyRS11AHv9,1,0,1,0,2022-01-31,9,Monday,1,2,0
1488081270525546497,2022-01-31 09:26:36,Anggota Komisi VI DPR Abdul Hakim Bafagih melaporkan soal modus judi yang berkedok investasi alias binary option. Ini kata Mendag M Lutfi.  https://t.co/FaI78w11yR,6,1,0,0,2022-01-31,9,Monday,1,6,1
1488081269313441792,2022-01-31 09:26:36,Tiga studi terbaru CDC AS menyoroti pentingnya mendapatkan suntikan booster yang berguna untuk memberikan perlindungan terbaik terhadap Omicron. Apa hasilnya? https://t.co/WmvREsXoBo,2,0,2,0,2022-01-31,9,Monday,1,4,0
1488080509452304387,2022-01-31 09:23:35,"Menteri Pekerjaan Umum dan Perumahan Rakyat (PUPR), Basuki Hadimuljono menekankan beberapa hal dalam pembangunan Jalan Tol Gedebage-Tasikmalaya-Cilacap.  https://t.co/NfwCShSeEk",4,1,1,0,2022-01-31,9,Monday,1,5,1
1488079979590176769,2022-01-31 09:21:28,"Ayah Harriet Robson bertutur mengenai situasi putrinya yang diduga menjadi korban penganiayaan sang kekasih, Mason Greenwood. HP Harriet kena hack? https://t.co/APclzqrAUI",4,0,1,0,2022-01-31,9,Monday,1,5,0
1488079717244837890,2022-01-31 09:20:26,"Jelang pengumuman PPKM, harian Corona melonjak. Kasus COVID-19 selama sepekan terakhir cenderung mengalami kenaikan. Berikut riwayat penambahan kasusnya: https://t.co/IuMHu00kXi",5,1,1,0,2022-01-31,9,Monday,1,6,1
1488079158525800452,2022-01-31 09:18:13,Adiba Khanza dan Egy Maulana Vikri sudah 4 tahun menjalin hubungan. Umi Pipik pun mengetahui hal tersebut. https://t.co/42ccmmGphW,5,0,1,0,2022-01-31,9,Monday,1,6,0
1488078908385861632,2022-01-31 09:17:13,Bagi masyarakat Jakarta yang ingin bepergian ke Tasikmalaya nanti bisa bablas melewati jalan tol. Ini daftar tolnya.  https://t.co/30wrStxSk6,8,0,0,2,2022-01-31,9,Monday,1,8,2
1488078287326924806,2022-01-31 09:14:45,"Memasuki bulan Februari 2022, ada drama Korea terbaru yang dibintangi Song Kang hingga Nam Joo Hyuk. Intip yuk sinopsis dan jadwal tayangnya. #drakor https://t.co/6cNAcHXU9T",3,0,1,0,2022-01-31,9,Monday,1,4,0
1488078268532150284,2022-01-31 09:14:41,"Sejumlah pendaftar yang lolos berasal dari berbagai bidang profesi mulai dari dosen, direksi BUMN, hingga purnawirawan Polri.  https://t.co/GSP4HzrGOA",2,0,0,1,2022-01-31,9,Monday,1,2,1
1488077688686493697,2022-01-31 09:12:22,"Masyarakat Indonesia bakal memiliki pilihan motor listrik baru nih, kerennya motor listrik ini bisa dipastikan made in Indonesia dan disapa 'Nusa'. https://t.co/MtNmBoRIIW",4,2,2,0,2022-01-31,9,Monday,1,6,2
1488077382871400449,2022-01-31 09:11:09,"Gabung Paris Saint-Germain, Sergio Ramos menegaskan tekad untuk bantu menjuarai Liga Champions. Tapi masa-masanya di Prancis malah dirundung cedera! https://t.co/VwbzrL1SRm",1,0,1,0,2022-01-31,9,Monday,1,2,0
1488077361308446721,2022-01-31 09:11:04,Menteri Perdagangan M Lutfi dan Eko Patrio debat panas soal hotline minyak goreng dalam rapat kerja Komisi VI DPR.  https://t.co/nNAbuJNEAh,4,0,0,0,2022-01-31,9,Monday,1,4,0
1488076453816188939,2022-01-31 09:07:28,"Jurusan hukum menjadi salah satu jurusan incaran mahasiswa karena prospek kerjanya yang luas. Berikut daftar kampus dengan jurusan hukum terbaik di dunia.

via: detikedu  https://t.co/Noim7CbSLX",6,0,0,0,2022-01-31,9,Monday,1,6,0
1488076154925981696,2022-01-31 09:06:17,"Sejak kemarin, Gundam menjadi trending Topic Twitter dan kini terpopuler dalam laman Google. Apa yang membuat Gundam tengah banyak dibicarakan di Indonesia?  https://t.co/JJTxTGZ6xJ",11,6,0,1,2022-01-31,9,Monday,1,11,7
1488076082343522305,2022-01-31 09:05:59,"Menjajal trading di Binomo benar-benar seperti judi. Modal Rp 140 ribu, tak sampai setengah hari sudah hampir ludes!  https://t.co/z6DuLA0Nyl",8,10,3,1,2022-01-31,9,Monday,1,11,11
1488075559615750147,2022-01-31 09:03:55,Dolorosa Sinaga punya banyak isu kritik sosial yang diangkat dalam berbagai karya seni. Termasuk patung yang dipamerkan dalam pameran di Galeri Nasional. https://t.co/OE7M7b7cWp,10,0,1,0,2022-01-31,9,Monday,1,11,0
1488075293571047425,2022-01-31 09:02:51,Pesinetron Randa Septian ditangkap di Bali gegara narkoba. Ia diciduk bersama temannya di salah satu hotel pada Jumat (7/1). https://t.co/wB8mEfEubv,9,3,0,2,2022-01-31,9,Monday,1,9,5
1488074878246965251,2022-01-31 09:01:12,Dorce Gamalama memberikan balasan pendapat tentang pandangan para ulama yang mengomentari keinginannya dimakamkan sebagai perempuan. https://t.co/gaqMgPlWWf,2,0,0,2,2022-01-31,9,Monday,1,2,2
1488074213172854784,2022-01-31 08:58:34,"Rafael Nadal jadi petenis putra pertama yang meraih 21 gelar Grand Slam. Dua rivalnya, Roger Federer dan Novak Djokovic, memberi selamat kepada Nadal. https://t.co/xbG6djVS1s",14,0,1,0,2022-01-31,8,Monday,1,15,0
1488073924512526338,2022-01-31 08:57:25,Sistem semi-bubble disebut masih menjadi format paling efektif dalam mencegah COVID-19 meluas di kompetisi bola voli nasional PLN Mobile Proliga 2022. https://t.co/Uq5crXCMOA,8,0,0,0,2022-01-31,8,Monday,1,8,0
1488073620362600448,2022-01-31 08:56:12,"Lembaga Trust Indonesia merilis survei elektabilitas calon presiden 2024. Hasilnya, nama Menteri Pertahanan Prabowo Subianto moncer di peringkat teratas. https://t.co/0jkV0sCMdi",12,29,4,0,2022-01-31,8,Monday,1,16,29
1488072811788869632,2022-01-31 08:53:00,KPK memeriksa Ketua DPRD Kota Bekasi Chairoman sebagai saksi kasus dugaan suap Wali Kota Rahmat Effendi atau Pepen. KPK menyita Rp 200 juta. https://t.co/CUSFz7oKwL,6,0,0,0,2022-01-31,8,Monday,1,6,0
1488072181313593344,2022-01-31 08:50:29,"Daftar peserta BI-FAST bertambah 21 bank dan 1 lembaga nonbank. Melalui kepesertaan BI-FAST, biaya transfer antar bank lebih murah, jadi Rp 2.500 per transaksi!  https://t.co/5j6NgSp9tp",7,0,3,1,2022-01-31,8,Monday,1,10,1
1488072180164403200,2022-01-31 08:50:29,"Pajak tahunan mobil listrik di Jakarta murah banget. Per tahun, pajak mobil listrik nggak sampai Rp 1 juta! https://t.co/OlSfZjgCfk",9,0,0,0,2022-01-31,8,Monday,1,9,0
1488071894792347650,2022-01-31 08:49:21,"Peserta BI-FAST kini berjumlah 42 bank dan 1 lembaga nonbank. Melalui kepesertaan BI-FAST, biaya transfer antar bank lebih murah jadi Rp 2.500 per transaksi.  https://t.co/TAukT6wopq",6,1,4,1,2022-01-31,8,Monday,1,10,2
1488071701044858882,2022-01-31 08:48:35,"Salah alamat, pengantar UberEats ini paksa penerima makanan untuk membayar. Berharap mendapatkan bantuan lewat TikTok, dirinya justru dibanjiri hujatan!  https://t.co/FRSCbylJS2",6,0,0,0,2022-01-31,8,Monday,1,6,0
1488071245019385862,2022-01-31 08:46:46,"Tak terasa Tahun Baru Imlek hampir tiba. Momen yang sering dinanti oleh masyarakat keturunan Tionghoa ini memang merupakan hari yang spesial.
https://t.co/ixQmNPqvBW",2,0,0,0,2022-01-31,8,Monday,1,2,0
1488070948024877058,2022-01-31 08:45:35,"Sambut Imlek dengan penampilan yang penuh totalitas! Di hari yang spesial tentu saja kamu ingin terlihat maksimal bukan? Sehingga penampilan dari ujung rambut hingga ujung kaki harus lebih diperhatikan.
https://t.co/gFknZLxiYR",0,0,0,0,2022-01-31,8,Monday,1,0,0
1488070720999546884,2022-01-31 08:44:41,Miss USA 2019 Cheslie Kryst dikenal sebagai wanita yang cerdas. Intip fakta-fakta wanita yang tewas di usia 30 tahun itu: https://t.co/CJ9AMoAIlA,1,1,0,1,2022-01-31,8,Monday,1,1,2
1488070184858525699,2022-01-31 08:42:33,Gus Yahya menyatakan siap melaksanakan uluran tangan Presiden Jokowi ke NU secara profesional. https://t.co/u4nbZpeSP1,8,0,0,2,2022-01-31,8,Monday,1,8,2
1488069803789201413,2022-01-31 08:41:02,Azis berjanji tak masuk ke dunia politik lagi. https://t.co/wOcqbnVqYG,13,3,1,1,2022-01-31,8,Monday,1,14,4
1488069214896336900,2022-01-31 08:38:42,"Anggota Komisi VI DPR, Mufti Anam meminta Mendag Muhammad Lutfi tidak hanya melakukan pencitraan semata dalam penetapan harga minyak goreng. https://t.co/EMn5Qxo9kM",4,2,0,1,2022-01-31,8,Monday,1,4,3
1488068437725302784,2022-01-31 08:35:37,Pria itu kini dirawat di RS Polri. Korban mengalami luka bakar 70 persen. https://t.co/yaJr849sbk,5,1,1,0,2022-01-31,8,Monday,1,6,1
1488068130274426882,2022-01-31 08:34:23,Ayah Harriet Robson angkat bicara dan menyebut Greenwood sudah amat dekat dengan keluarganya. https://t.co/E6wGnW8Xiv,8,0,0,0,2022-01-31,8,Monday,1,8,0
1488067229082173447,2022-01-31 08:30:49,Christian Eriksen resmi kembali ke Premier League! Setelah bergabung dengan Brentford di hari terakhir bursa transfer Januari. https://t.co/VFDupPjpp6,5,0,0,1,2022-01-31,8,Monday,1,5,1
1488066993072734210,2022-01-31 08:29:52,Randa Septian ditangkap karena narkoba di Bali. Ini sosok sang pesinetron: https://t.co/2ZFi5XT4bi,4,0,0,0,2022-01-31,8,Monday,1,4,0
1488066737690005508,2022-01-31 08:28:51,Luhut mengatakan kasus Corona bisa meningkat tiga kali lipat dari puncak kasus Delta bila masyarakat tidak berhati-hati. https://t.co/xlQPpcsecG,27,55,6,7,2022-01-31,8,Monday,1,33,62
1488066468843606020,2022-01-31 08:27:47,My Hero Academia kembali menuai prestasi dengan penjualan yang mengagumkan yakni 65 juta eksemplar di seluruh dunia. https://t.co/758FPD1fQG,8,1,1,0,2022-01-31,8,Monday,1,9,1
1488066132544299008,2022-01-31 08:26:27,Kecelakaan nahas terjadi di Padang Panjang. Sebuah bus menabrak flyover sampai atapnya terlepas. Sopir harusnya mengenali dimensi kendaraan! https://t.co/zbwXRT2tFj,2,1,0,0,2022-01-31,8,Monday,1,2,1
1488066115641262080,2022-01-31 08:26:23,Perubahan ini dilakukan karena perbedaan karakteristik COVID-19 varian Delta dan Omicron. https://t.co/iwmGIaP7mV,1,0,0,0,2022-01-31,8,Monday,1,1,0
1488065586773073925,2022-01-31 08:24:17,"Nampak dua orang berjaga-jaga di atas sepeda motor, dan dua orang lagi masuk ke dalam rumah yang diketahui kosong. https://t.co/1pF6xxb1E5",2,0,1,0,2022-01-31,8,Monday,1,3,0
1488065337702727681,2022-01-31 08:23:18,"""Saat ini juga positivity rate sudah berada di atas standar WHO yaitu 5%,"" kata Luhut Binsar Pandjaitan. https://t.co/r9aCFM84I9",7,2,1,0,2022-01-31,8,Monday,1,8,2
1488065317905612803,2022-01-31 08:23:13,Tottenham Hotspur segera mendapatkan dua pemain dari Juventus. Direktur Sepakbola Tottenham Fabio Paratici merekrut kembali pemain yang dulu pernah dia gaet! https://t.co/xR9eK3J5yk,0,0,0,1,2022-01-31,8,Monday,1,0,1
1488064795144331267,2022-01-31 08:21:08,Salah satu pertimbangan penataan organisasi PPATK tersebut terkait optimalisasi pencegahan pendanaan tindak pidana terorisme. https://t.co/nnoYHiHw80,7,0,0,0,2022-01-31,8,Monday,1,7,0
1488064248429359104,2022-01-31 08:18:58,KPK menerima adanya informasi dari masyarakat soal adanya dugaan pemanfaatan ruang di Danau Singkarak. KPK bakal kawal dugaan tersebut. https://t.co/9Yg5PG2hlG,4,0,1,0,2022-01-31,8,Monday,1,5,0
1488063747285565440,2022-01-31 08:16:58,"#Foto Dua barongsai wara-wiri di Stasiun Gubeng, Surabaya. Aksi Barongsai itu untuk menghibur penumpang sekaligus untuk menyambut Tahun Baru Imlek. https://t.co/T7pWfm2wAp",3,0,0,1,2022-01-31,8,Monday,1,3,1
1488063724804096003,2022-01-31 08:16:53,"Ketiga member VIVIZ dinyatakan positif COVID-19. Setelah Eunha dan Umji, kini SinB juga terinfeksi. https://t.co/v449PB1mfR",39,0,8,7,2022-01-31,8,Monday,1,47,7
1488063423841718274,2022-01-31 08:15:41,"Gejala COVID-19 Omicron disebut mirip flu dan bahkan masuk angin. Keluhannya relatif ringan, seperti batuk hingga pilek. Lalu bagaimana membedakannya? https://t.co/oFEKeRVbUv",88,85,36,11,2022-01-31,8,Monday,1,124,96
1488062933259194368,2022-01-31 08:13:44,"Pajak tahunan mobil listrik di Jakarta murah banget. Per tahun, pajak mobil listrik nggak sampai Rp 1 juta! https://t.co/wARSZmOsFR",16,5,2,0,2022-01-31,8,Monday,1,18,5
1488062251827449858,2022-01-31 08:11:02,"Harriet Robson menjadi bahan perbincangan setelah dirinya mengaku menjadi korban penganiayaan kekasihnya, Mason Greenwood. Ia mengaku mengalami pemukulan. https://t.co/QLXS9frR1t",3,0,2,1,2022-01-31,8,Monday,1,5,1
1488061418704408577,2022-01-31 08:07:43,"Keduanya ditangkap di Tapanuli Selatan dan Tapanuli Tengah, Sumatera Utara. https://t.co/TPgJ9Z2pyn",2,0,1,0,2022-01-31,8,Monday,1,3,0
1488061401658761216,2022-01-31 08:07:39,"Selebgram Zainnatun Sundus ditangkap bersama kekasihnya, Rio Emilio, di Bali. Mereka ditangkap terkait narkotika. https://t.co/J8IdnuR7c6",2,0,1,1,2022-01-31,8,Monday,1,3,1
1488060768532811776,2022-01-31 08:05:08,Christian Eriksen selangkah lagi comeback untuk kembali bermain bersama Brentford. Ia dilaporkan sukses menjalani tes medis untuk segera dikontrak The Bees! https://t.co/WkMkcEkbWp,6,0,0,0,2022-01-31,8,Monday,1,6,0
1488060491989721089,2022-01-31 08:04:02,"Satu persatu pemain di BRI Liga 1 terjangkit virus Corona. Kali ini, tiga pesepakbola PSS Sleman yang dinyatakan positif COVID-19! https://t.co/WhtQ812l9o",5,2,1,0,2022-01-31,8,Monday,1,6,2
1488059569347698689,2022-01-31 08:00:22,"Luis Diaz menjadi salah satu bintang baru sepakbola Eropa asal Kolombia, yang mengikuti jejak Radamel Falcao dan James Rodriguez! https://t.co/NYwgVWTEj5",5,0,1,0,2022-01-31,8,Monday,1,6,0
1488058818537959426,2022-01-31 07:57:23,David Beckham sempat dua kali menjalani masa peminjaman ke AC Milan pada bursa transfer musim dingin di bulan Januari. Berikut video nostalgianya! https://t.co/r42RpPLPR3,3,0,1,0,2022-01-31,7,Monday,1,4,0
1488057440864280578,2022-01-31 07:51:55,Prilly Latuconsina dan sejumlah seleb lainnya menjadi pemilik klub sepak bola. Pakar marketing singgung bisnis kue artis yang sempat hits!  https://t.co/pezmXWkXJO,5,2,2,1,2022-01-31,7,Monday,1,7,3
1488056893721526272,2022-01-31 07:49:44,Salah satu selebriti yang kembali terjerat narkoba adalah Randa Septian. Kolom komentar di Instagram Randa pun diserbu netizen. https://t.co/pXDtppv86u,3,1,0,4,2022-01-31,7,Monday,1,3,5
1488056402635632642,2022-01-31 07:47:47,Gus Miftah memberikan pandangan soal transgender dan kodrat. Operasi kelamin tidak mengubah kodrat transgender. https://t.co/f929RUBsrk,4,2,0,0,2022-01-31,7,Monday,1,4,2
1488055829161037826,2022-01-31 07:45:31,Tersangka kasus pemerasan bermodus pura-pura pincang oleh AF (46) disebut dilakukan lantaran membutuhkan uang untuk membeli obat-obatan dan terapi metadon. https://t.co/qgFY3UzPCe,6,0,0,1,2022-01-31,7,Monday,1,6,1
1488055326234583041,2022-01-31 07:43:31,"Mengubah menunya, sekolah ini sajikan kentang di kantin setiap hari. Hal ini memicu protes orang tua karena merasa anaknya tak mendapat makanan yang layak.  https://t.co/nr2U93AHzT",6,0,0,0,2022-01-31,7,Monday,1,6,0
1488054681368772610,2022-01-31 07:40:57,Mark NCT akan merilis lagu solo sebagai bagian dari proyek baru SM Entertainment bernama NCT LAB. Ia akan merilis lagu Child pada 4 Februari 2022. https://t.co/fgOhhYVmz6,5,1,1,0,2022-01-31,7,Monday,1,6,1
1488053905028272130,2022-01-31 07:37:52,"Pemerintah kembali menyesuaikan harga minyak goreng di Indonesia. Mulai 1 Februari, harga eceran tertinggi (HET) minyak goreng curah sebesar Rp 11.500 per liter. Hore! https://t.co/idq1J0LlNz",353,155,75,43,2022-01-31,7,Monday,1,428,198
1488053092272721923,2022-01-31 07:34:38,"Pakar IDI menilai Indonesia berhasil masuk gelombang ketiga COVID-19. Catat kenaikan kasus, BOR, hingga temuan klaster keluarga. https://t.co/dptPpZDnt2",10,11,2,6,2022-01-31,7,Monday,1,12,17
1488052648540520451,2022-01-31 07:32:52,Ada salah paham dari pelaku usaha mengenai Domestic Market Obligation (DMO) dan Domestic Price Obligation (DPO) minyak goreng sehingga petani sawit resah.  https://t.co/Pwp9fpH1UX,0,1,2,0,2022-01-31,7,Monday,1,2,1
1488051820157153280,2022-01-31 07:29:35,Pandemi COVID-19 kembali menyisakan dampak negatif bagi masyarakat miskin Singapura. Kenaikan biaya hidup membuat mereka semakin tercekik!  https://t.co/XtlKcT1KYm,12,2,6,1,2022-01-31,7,Monday,1,18,3
1488051069351612418,2022-01-31 07:26:36,Beredar video yang viral di media sosial menampilkan seorang emak-emak yang ngamuk di ruang sidang. Wanita itu tampak berteriak ke arah majelis hakim. Ada apa? https://t.co/HEnkSkOwaX,7,1,3,1,2022-01-31,7,Monday,1,10,2
1488050761380646913,2022-01-31 07:25:22,"Pandemi COVID-19 makin terkendali, penjualan truk dan bus Hino mencatatkan pertumbuhan hingga 51% di tahun 2021! https://t.co/ZpUDKFH3VF",6,0,1,0,2022-01-31,7,Monday,1,7,0
1488050267648049152,2022-01-31 07:23:25,"Prilly Latuconsina mengumumkan dirinya masuk ke jajaran pemilik Persikota Tangerang. Di samping itu, Prilly juga dikenal sebagai artis yang hobi masak.  https://t.co/BRaems1EFV",2,1,3,0,2022-01-31,7,Monday,1,5,1
1488049981541990401,2022-01-31 07:22:16,"Thariq Halilintar saat ini sudah resmi menjalin cinta dengan Fuji. Eh, tetapi ternyata Thariq sempat ditolak Fuji. https://t.co/grR97kmwjv",12,9,2,0,2022-01-31,7,Monday,1,14,9
1488049163623354368,2022-01-31 07:19:01,"Gundam tengah populer di jagat maya TikTok dan Twitter Indonesia. Berikut 5 fakta soal Gundam, mulai penciptanya yang raih penghargaan sampai patungnya: https://t.co/a74BDAiaZ2",9,0,3,1,2022-01-31,7,Monday,1,12,1
1488049138549862400,2022-01-31 07:18:55,"Bing Dwen Dwen, panda ceria, adalah maskot resmi untuk Olimpiade Beijing 2022, tetapi ada banyak sebelumnya. Yuk lihat potretnya! https://t.co/TxcBEvlZ71",5,0,0,0,2022-01-31,7,Monday,1,5,0
1488048641109598210,2022-01-31 07:16:57,"Kenalkan, ini Meet Methuselah yang menjadi ikan akuarium paling tua di dunia. Dia dibawa ke museum San Fransisco pada tahun 1938 dari Australia. https://t.co/XJ67u8RpTd",12,0,2,0,2022-01-31,7,Monday,1,14,0
1488048054125142017,2022-01-31 07:14:37,"Mason Greenwood dan Harriet Robson putus nyambung saat berpacaran. Terakhir, pemain Manchester United itu berjanji untuk menikahinya. https://t.co/dUbOz3wSzg",6,1,1,1,2022-01-31,7,Monday,1,7,2
1488048033178791937,2022-01-31 07:14:32,Ketegangan geopolitik antara Amerika Serikat (AS) dan China berdampak pada penyelenggaraan Olimpiade Beijing yang akan dilaksanakan bulan depan.  https://t.co/VeXVz77QAb,0,0,0,0,2022-01-31,7,Monday,1,0,0
1488047754098229250,2022-01-31 07:13:25,"Dokter paru bocorkan gejala awal infeksi Omicron yang paling banyak dialami pasien. Jangan tertukar dengan batuk-pilek ala flu biasa, begini pesan dokter paru: https://t.co/EgIKwJDUZ1",4,1,1,0,2022-01-31,7,Monday,1,5,1
1488047734229721088,2022-01-31 07:13:21,Indra mengatakan bahwa Binomo legal lantaran platform tersebut bekerjasama dengan Doku Wallet untuk deposit. Eh... DOKU-nya kasih tanggapan nih!  https://t.co/BALSskEE8X,2,0,1,0,2022-01-31,7,Monday,1,3,0
1488047183031148547,2022-01-31 07:11:09,Dinas Perhubungan Provinsi DKI Jakarta bersama PT Transportasi Jakarta bekerja sama dengan 11 Mitra Operator Bus Kecil menyediakan 60 unit Mikrotrans AC! https://t.co/J7jIJyoeor,8,3,2,2,2022-01-31,7,Monday,1,10,5
1488046950960226306,2022-01-31 07:10:14,"Restoran konsep 'All You Can Eat' (AYCE) kini banyak diminati. Namun, tahukah kamu bagaimana restoran AYCE mendapatkan untung?  https://t.co/nQWFBg2XwU",14,1,6,0,2022-01-31,7,Monday,1,20,1
1488046933033771009,2022-01-31 07:10:10,PBNU masa khidmat 2022-2027 resmi dikukuhkan. Gus Yahya melempar canda soal muktamar NU. https://t.co/BPYF8WqHR8,6,1,1,0,2022-01-31,7,Monday,1,7,1
1488045869953859589,2022-01-31 07:05:56,Yuswohady menilai artis Indonesia bisa membeli klub sepak bola atau basket dikarenakan channel YouTube yang memberikan penghasilan sangat besar!  https://t.co/8kbykLmtzd,5,0,2,1,2022-01-31,7,Monday,1,7,1
1488045575492804609,2022-01-31 07:04:46,"Tantangan 'One Chip', tantangan makan keripik super pedas sedang marak di media sosial. Tiga murid tergoda untuk ikutan dan berakhir dilarikan ke rumah sakit!  https://t.co/uuWzYHU0vY",3,2,2,1,2022-01-31,7,Monday,1,5,3
1488045227105521666,2022-01-31 07:03:23,"Liverpool tak cukup dengan kehadiran Luis Diaz saja dan tengah mengupayakan lagi kedatangan pemain muda Fulham, Fabio Carvalho! https://t.co/mEUbggvBIC",3,0,0,0,2022-01-31,7,Monday,1,3,0
1488044772845670403,2022-01-31 07:01:35,"Selain terkenal akan gua-nya, Pacitan juga memiliki pantai yang elok. Salah satunya Pantai Watukarang yang menjadi spot selancar terbaik di dunia. Wih keren! https://t.co/S9Fqe4fXWN",8,1,3,0,2022-01-31,7,Monday,1,11,1
1488044722493042688,2022-01-31 07:01:23,Ketua MUI Cholil Nafis menegaskan bahwa transgender yang meninggal dunia harus diurus berdasarkan jenis kelamin awal saat dilahirkan. #CNNIndonesia #detikNetwork  https://t.co/lsJBJuHg6d,10,2,1,0,2022-01-31,7,Monday,1,11,2
1488044334893178882,2022-01-31 06:59:50,"Tak hanya sepakbola dan basket, PLN Mobile Proliga 2022 juga diterpa badai virus Corona. Lima pemain Gresik Petrokimia Pupuk Indonesia positif COVID-19! https://t.co/lzTNBSNfso",3,0,0,0,2022-01-31,6,Monday,1,3,0
1488044313980329984,2022-01-31 06:59:45,"Benarkah siulan burung wiwik merupakan pembawa petaka buruk? Simak penjelasan dosen IPB berikut ini.

via: detikedu  https://t.co/pug4KkYSuS",11,1,2,0,2022-01-31,6,Monday,1,13,1
1488044007821352961,2022-01-31 06:58:32,Kementerian Perhubungan menilai bahwa sebagian besar kecelakaan truk maupun bus terjadi karena pengemudinya kurang terampil dan terlalu percaya diri. https://t.co/lARoid1N1Y,25,6,3,1,2022-01-31,6,Monday,1,28,7
1488043395410972673,2022-01-31 06:56:06,"Nama Prilly Latuconsina jadi sorotan. Di usianya yang masih muda, Prilly sudah mampu untuk membeli sebuah klub sepak bola.  https://t.co/UxSx3jRveK",18,0,1,2,2022-01-31,6,Monday,1,19,2
1488043382488371201,2022-01-31 06:56:03,Kebijakan minyak goreng satu harga Rp 14.000 per liter telah berjalan hampir dua pekan. Anggota Komisi VI DPR Mufti Anam menyatakan kebijakan ini gagal total!  https://t.co/bZtQMoJlOG,7,2,4,2,2022-01-31,6,Monday,1,11,4
1488043136018493446,2022-01-31 06:55:04,PT Jaya Real Property Tbk buka suara atas digeruduknya Bintaro Jaya Xchange Mall oleh sejumlah orang yang mengaku dari pihak ahli waris tanah.  https://t.co/DZgakqB0Zi,0,0,2,0,2022-01-31,6,Monday,1,2,0
1488043120893865986,2022-01-31 06:55:01,Adiba Khanza sudah 4 tahun dekat dengan Egy Maulana Vikri. Umi Pipik memberikan penegasan soal kabar sang putri dilamar Egy. https://t.co/VeTaDjpq8p,10,0,1,1,2022-01-31,6,Monday,1,11,1
1488042627027062784,2022-01-31 06:53:03,"Nama Ridwan Kamil dan Tri Rismaharini muncul dalam bursa calon Kepala Otorita IKN Nusantara. Ini berkat Presiden Jokowi yang menyinggung kriteria: eks kepala daerah berlatar belakang arsitek.

 https://t.co/zWyn9WK5gc",4,0,1,2,2022-01-31,6,Monday,1,5,2
1488042394331320321,2022-01-31 06:52:07,AHY hari ini diagendakan menghadiri pengukuhan kepengurusan PBNU di Kaltim. AHY juga mem-posting videonya bernyanyi mars Yaa Lal Wathon. https://t.co/KwdPyw44Pd,9,0,3,1,2022-01-31,6,Monday,1,12,1
1488042376933355522,2022-01-31 06:52:03,PT Bio Farma (Persero) tengah membuka banyak lowongan kerja terbaru 2022 untuk berbagai bidang. Simak syarat dan ketentuannya di sini.  https://t.co/2wYmR0OUy2,11,0,5,0,2022-01-31,6,Monday,1,16,0
1488042141934919683,2022-01-31 06:51:07,Mason Greenwood terancam kariernya di Manchester United gara-gara menganiaya pacar. Kasus ini menambah panjang deret kutukan seragam nomor 11 Setan Merah! https://t.co/hoqtVWS0gp,5,0,1,0,2022-01-31,6,Monday,1,6,0
1488042123316416512,2022-01-31 06:51:03,"Harga Minyak Goreng turun untuk kemasan curah menjadi Rp 11.500/liter, kemasan sederhana Rp 13.500/liter, dan kemasan premium Rp 14.000/liter.  https://t.co/pSESCzab2j",13,4,6,2,2022-01-31,6,Monday,1,19,6
1488041818948349952,2022-01-31 06:49:50,"Perancang Istana Negara IKN, I Nyoman Nuarta, menyebut ongkos mengangkut material pembangunan IKN dari Jawa ke Kaltim menelan biaya Rp 50 juta per truk!  https://t.co/38veyvexc2",241,191,78,109,2022-01-31,6,Monday,1,319,300
1488040880011608064,2022-01-31 06:46:06,"Nggak sembarang orang bisa jadi mitra driver @GrabID lho! Ada tahapan, diantaranya pelatihan standar pelayanan dan kode etik untuk mencegah terjadinya kekerasan pada penumpang dan mitra driver. 

#PercayaAman 
https://t.co/5XGg1Yefx5 https://t.co/nB3szrOa9h",5,2,1,3,2022-01-31,6,Monday,1,6,5
1488040841591599105,2022-01-31 06:45:57,"""Saya sekali lagi minta maaf kepada sultan-sultan. Sultan Kutai, Sultan Paser, Sultan Banjar, Sultan Pontianak, Sultan Melayu, atau apa sebagainya, termasuk suku-sukunya,"" kata Edy. https://t.co/CbOrjWUlak",43,76,3,5,2022-01-31,6,Monday,1,46,81
1488040593158815749,2022-01-31 06:44:58,"Masyarakat bakal memiliki pilihan baru motor listrik yang disapa 'Nusa'. Asli buatan industri otomotif Indonesia. Seri termahalnya, mencapai Rp 180 juta/unit https://t.co/PqMM53nfQi",4,0,1,0,2022-01-31,6,Monday,1,5,0
1488040022842482693,2022-01-31 06:42:42,BTS kembali membuktikan prestasi di Spotify. Mereka masuk dalam daftar 10 musisi yang paling banyak didengarkan di Spotify sepanjang sejarah. https://t.co/3WEaZVfZaJ,7,0,4,0,2022-01-31,6,Monday,1,11,0
1488039526199140353,2022-01-31 06:40:44,Park Shin Hye menggelar pesta baby gender reveal bersama teman-teman dekatnya. Jenis kelamin bayi di kandungannya pun terungkap. cwk apa cwk nih? https://t.co/spGj2zfINJ,13,2,1,1,2022-01-31,6,Monday,1,14,3
1488038408542953479,2022-01-31 06:36:17,"Badan bea cukai Amerika Serika (AS) telah melarang impor sarung tangan sekali pakai dari perusahaan Malaysia, YTY Industry Holdings Sdn Bhd. Ternyata ini penyebabnya!  https://t.co/vtqLM1RF48",2,0,1,0,2022-01-31,6,Monday,1,3,0
1488038402251542529,2022-01-31 06:36:16,Kematian Cheslie Kryst mengejutkan karena baru-baru ini masih cukup aktif dalam menyuarakan isu-isu sosial dan reformasi keadilan kriminal. https://t.co/AxUvfdmUKc,12,2,7,4,2022-01-31,6,Monday,1,19,6
1488037881847418880,2022-01-31 06:34:12,PT Astra Internasional Tbk saat ini tengah membuka lowongan kerja bagi lulusan Sarjana (S1) dari berbagai jurusan. Cek syarat dan ketentuannya.  https://t.co/P67Sl6nvaU,20,3,2,1,2022-01-31,6,Monday,1,22,4
1488037707506982913,2022-01-31 06:33:30,Minyak goreng di Malaysia harganya cuma Rp 8.500 per liter. Jumlah itu jelas jauh lebih murah dibandingkan dengan harga yang ada di Indonesia. Kok bisa?  https://t.co/NizlxfybpC,34,36,9,5,2022-01-31,6,Monday,1,43,41
1488037527995011073,2022-01-31 06:32:47,Penyelewengan pupuk subsidi membuat Toko Malindo Tani di Nganjuk diputus kontrak!  https://t.co/371Nv8E3me,8,1,0,1,2022-01-31,6,Monday,1,8,2
1488036931996983305,2022-01-31 06:30:25,Timnas Indonesia memetik kemenangan atas Timor Leste dalam dua pertandingan. Ricky Kambuaya bersinar dalam kemenangan Skuad Garuda! https://t.co/bGBiYDTHNr,8,0,0,0,2022-01-31,6,Monday,1,8,0
1488036837839015944,2022-01-31 06:30:03,Sejumlah pasar di daerah Jakarta Selatan masih menjual minyak goreng dengan harga yang tinggi!  https://t.co/2MGgJvAp3Q,4,5,1,0,2022-01-31,6,Monday,1,5,5
1488036409885798401,2022-01-31 06:28:21,Polisi menetapkan Ketum GMBI M Fauzan Rachman dan 11 anak buah menjadi tersangka kasus demo ricuh di Polda Jabar. Ini penampakan mereka saat berbaju tahanan. https://t.co/u5QnKBQw8i,4,3,0,0,2022-01-31,6,Monday,1,4,3
1488035715892281344,2022-01-31 06:25:35,"Tetap waspada, varian omicron sebabkan pertumbuhan kasus naik https://t.co/xxJ72byuB3",4,2,1,0,2022-01-31,6,Monday,1,5,2
1488035514603257858,2022-01-31 06:24:47,Aaron Ramsey belum juga meninggalkan Juventus karena menolak sejumlah tawaran dan Juventus kini berharap Ramsey mau menerima tawaran dari Wolverhampton. https://t.co/GBmIoRjiO1,3,0,1,1,2022-01-31,6,Monday,1,4,1
1488034699956015105,2022-01-31 06:21:33,"Di Indonesia sendiri, kasus omicron banyak yang tidak bergejala https://t.co/6oEJBE77qV",5,3,2,2,2022-01-31,6,Monday,1,7,5
1488034204487229442,2022-01-31 06:19:35,"Sepanjang 2021, Toyota Global berhasil menjual lebih dari 10 juta kendaraan. Hal ini membuatnya menjadi pabrikan mobil dengan penjualan mobil terbanyak di duni! https://t.co/TAr2hLzbbD",5,0,1,0,2022-01-31,6,Monday,1,6,0
1488033632031846402,2022-01-31 06:17:18,Inter Milan mendapat kabar bagus jelang derby akhir pekan ini. Simone Inzaghi sudah sembuh dari COVID-19 dan bisa mendampingi Inter! https://t.co/naLpTeeiP9,3,0,0,0,2022-01-31,6,Monday,1,3,0
1488033129420009473,2022-01-31 06:15:19,Berapa lama Titi Kamal menabung buat membangun rumah senilai Rp 20 miliar? Dia menjawab: sepanjang karier! Baca penuturan lengkapnya: https://t.co/vvrXV1tUqc,6,2,2,0,2022-01-31,6,Monday,1,8,2
1488032343025762307,2022-01-31 06:12:11,Ganjar Pranowo ngamuk saat mengecek sekolah yang baru dibangun di Tawangmang. Ganjar mendapati sekolah tersebut dibangun secara asal-asalan. https://t.co/zDAAfeAEz6,17,1,5,1,2022-01-31,6,Monday,1,22,2
1488031301076664325,2022-01-31 06:08:03,"Kyochon, ayam goreng tepung dengan saus asam, manis pedas khas Korea ini populer di restoran Korea. Kamu bisa bikin sendiri dengan resep ini.  https://t.co/S8XKgdP7qN",18,0,1,0,2022-01-31,6,Monday,1,19,0
1488030660363268099,2022-01-31 06:05:30,Kalina Oktarani mengaku sudah move on dari Vicky Prasetyo. Ia mengaku sudah tidak lagi memusingkan soal mantan suaminya itu. https://t.co/91K1HaHX41,13,3,1,2,2022-01-31,6,Monday,1,14,5
1488030131255918593,2022-01-31 06:03:24,Fariatun membuat tampilan kue pukis menjadi lebih modern untuk menyesuaikan selera konsumen dengan memberi variasi topping di atasnya.  https://t.co/lQvARS8eBx,12,0,2,5,2022-01-31,6,Monday,1,14,5
1488029530958835712,2022-01-31 06:01:01,Jokowi mengatakan bahwa Ainun Nadjib bisa diajak membangun NU jika yang berbicara kiai NU. https://t.co/LeyseD7pgx,11,1,3,1,2022-01-31,6,Monday,1,14,2
1488028668907724800,2022-01-31 05:57:35,"Skandal terkait perempuan kembali menimpa Mason Greenwood. Dulu ada model yang diajak 'ngamar', kini pemain Inggris dari MU itu diduga menghajar pacar. https://t.co/Juf5oprwbT",4,0,1,0,2022-01-31,5,Monday,1,5,0
1488028108049592320,2022-01-31 05:55:21,"Ada rekrutan baru di AS Roma. Bukan pemain, Roma mendatangkan mantan wasit untuk jadi analis pertandingan dan konsultan soal cara kerja VAR. https://t.co/iWQikgn2ou",8,0,2,0,2022-01-31,5,Monday,1,10,0
1488027609414127620,2022-01-31 05:53:22,"Pria di Medan bernama Rakesh kembali berulah. Dulu pernah menyiram petugas PPKM pakai air panas, terbaru menolak bermasker saat ditegur petugas. https://t.co/DSXJ65rB7b",4,2,1,0,2022-01-31,5,Monday,1,5,2
1488027365498363907,2022-01-31 05:52:24,"Titi Kamal curhat soal sosok suaminya, Christian Sugiono. Dia merasa suaminya adalah sosok yang aneh, namun romantis. https://t.co/TgxwniQb9M",6,0,0,1,2022-01-31,5,Monday,1,6,1
1488026738181513217,2022-01-31 05:49:55,"Mantan istri Kiwil, Rohimah, melewati hari yang berat akhir pekan ini. Dia mengabarkan berita duka soal kekasihnya, Rommi Halley, yang meninggal dunia. https://t.co/DqmaJMCwvH",7,0,0,0,2022-01-31,5,Monday,1,7,0
1488025237774024704,2022-01-31 05:43:57,PPP Jakarta menilai Anies berhasil membangun Jakarta menjadi lebih baik. https://t.co/nS7VBEWvJI,61,55,5,5,2022-01-31,5,Monday,1,66,60
1488024672113463297,2022-01-31 05:41:42,Kekayaan itu tentu bukan hasil pemberian Mason Greenwood. Harriet Robson mendapatkannya dari kerja kerasnya sebagai model dan endorse di Instagram. https://t.co/fOR0kImluC,10,0,0,0,2022-01-31,5,Monday,1,10,0
1488024100471771136,2022-01-31 05:39:26,"Modus tersangka adalah dengan mengajak para korban berinvestasi melalui koperasi. Semula, tersangka membentuk grup arisan di 2018. https://t.co/jH90qnj48J",19,1,4,6,2022-01-31,5,Monday,1,23,7
1488023850709360643,2022-01-31 05:38:26,"DKI mencatatkan kenaikan kasus Omicron. Meski Omicron masih didominasi pelaku perjalanan luar negeri, transmisi lokal tidak bisa dihindari. https://t.co/TYpI2a9G2f",5,1,1,0,2022-01-31,5,Monday,1,6,1
1488023111312285696,2022-01-31 05:35:30,Perusahaan startup kecantikan Buzzy Glossier memberhentikan sekitar sepertiga dari staf perusahaannya!  https://t.co/BDhGtUxfAi,4,0,0,0,2022-01-31,5,Monday,1,4,0
1488022815278350336,2022-01-31 05:34:19,Dia ditangkap Satres Narkoba Polresta Denpasar bersama temannya bernama Arthur Augoest H Aruan. https://t.co/5BG2aZkq7q,4,2,0,0,2022-01-31,5,Monday,1,4,2
1488022306811166722,2022-01-31 05:32:18,KPLP Direktorat Jenderal Perhubungan Laut Kementerian Perhubungan merupakan bagian yang menjadi gardan terdepan untuk menjaga laut dan pantai di Indonesia.  https://t.co/M6IKaLmz2m,6,2,1,0,2022-01-31,5,Monday,1,7,2
1488022032596021251,2022-01-31 05:31:13,"Sebelum jalani pemeriksaan, dia menegaskan tetap menolak IKN Nusantara. https://t.co/R5I0x1JiUa",25,49,0,4,2022-01-31,5,Monday,1,25,53
1488021494986911744,2022-01-31 05:29:05,Cumi-cumi merupakan jenis seafood populer selain udang. Olahan cumi-cumi ala warung tenda juga tak kalah lezat. Berikut ini 3 resep cumi yang populer lezatnya.  https://t.co/2WNzAnaIxA,9,0,1,0,2022-01-31,5,Monday,1,10,0
1488020745053741059,2022-01-31 05:26:06,Penjualan mobil di Indonesia sepanjang tahun 2021 tercatat paling banyak di Asia Tenggara! https://t.co/X0mLk97Dz4,5,1,2,2,2022-01-31,5,Monday,1,7,3
1488020156991291395,2022-01-31 05:23:46,Adiba Khanza merupakan putri mendiang Ustaz Jefri Al-Buchori atau Uje. Ia dikabarkan bakal segera dilamar oleh pesepakbola Egy Maulana Vikri. https://t.co/H3sgc3Lo3x,86,7,9,2,2022-01-31,5,Monday,1,95,9
1488019912383737857,2022-01-31 05:22:47,"Tiap warna pada baju pengantin punya arti tersendiri. Untuk calon pengantin yang ingin melangsungkan pernikahan, berikut lima arti warna baju pengantin. https://t.co/6gPjxaSeSE",7,1,2,0,2022-01-31,5,Monday,1,9,1
1488019659613949955,2022-01-31 05:21:47,"Kisah pengantar kulkas yang dipecat bikin miris. Kemudian ada rekomendasi nasi Padang di tempat tersembunyi, sampai buah penurun kolesterol yang sehat.  https://t.co/mHdQrmLu1c",6,0,2,0,2022-01-31,5,Monday,1,8,0
1488018650175098884,2022-01-31 05:17:46,Di pinggir kota Bogor ada warung bakso yang cukup tersohor. Bakso Pak H. Mien punya bakso rudal yang menjadi andalannya!  https://t.co/2D4ynjnPWh,11,0,0,1,2022-01-31,5,Monday,1,11,1
1488017902850695172,2022-01-31 05:14:48,"Sebuah bus menabrak flyover di Padang Panjang. Akibatnya, atap bus sampai terlepas dan sebanyak 17 penumpang terluka. https://t.co/AuHim9LO2D",6,1,1,1,2022-01-31,5,Monday,1,7,2
1488017395373559808,2022-01-31 05:12:47,Rieta Amalia dan Amy Qanita temu kangen. Netizen salah fokus pada sosok ini. https://t.co/HohaBfC9Az,2,0,0,0,2022-01-31,5,Monday,1,2,0
1488016273825009666,2022-01-31 05:08:20,"Waswas Omicron dikira flu biasa, dokter paru mengungkap gejala paling khas yang dialami oleh pasein COVID-19 Omicron. Ini gejalanya: https://t.co/SiIinQYxhN",18,8,12,1,2022-01-31,5,Monday,1,30,9
1488015493478891520,2022-01-31 05:05:14,Anies Baswedan dan Ridwan Kamil tampak semakin lekat. Momen keakraban keduanya tampak menjelang Pilpres 2024. https://t.co/JjRdTZE1Vj,33,19,3,7,2022-01-31,5,Monday,1,36,26
1488014721739595786,2022-01-31 05:02:10,Mertua Arzeti Bilbina meninggal dunia saat menghadiri sebuah acara. Arzeti terlihat terus menangis hadiri pemakaman ayah dari suaminya itu. https://t.co/CsIfU0wbJZ,6,0,0,0,2022-01-31,5,Monday,1,6,0
1488013807742033920,2022-01-31 04:58:32,Sebuah video yang menunjukkan seorang pria menolak pakai masker saat ada razia viral di media sosial. Pria itu menilai aturan penggunaan masker itu salah. https://t.co/u23lUrv3Gx,9,7,4,3,2022-01-31,4,Monday,1,13,10
1488012842653650944,2022-01-31 04:54:42,Putra April Jasmine dan Ustaz Solmed dilarikan ke rumah sakit karena panas tinggi. Begini penuturan selengkapnya: https://t.co/P99s6k55rh,7,1,0,0,2022-01-31,4,Monday,1,7,1
1488012106930831360,2022-01-31 04:51:46,Kesulitan Barcelona cukup berbanding lurus dengan performa Frenkie de Jong. Gelandang Belanda ini mengakui performanya naik-turun di musim ini! https://t.co/Y4PpZptiil,1,0,0,0,2022-01-31,4,Monday,1,1,0
1488011718425034757,2022-01-31 04:50:14,Kata MUI soal pengakuan Dorce yang mau dimakamkan sebagai perempuan. Begini penuturannya: https://t.co/NCN89keOFJ,43,38,17,5,2022-01-31,4,Monday,1,60,43
1488011700871864324,2022-01-31 04:50:10,"Dengan modal seadanya, Aniesah kemudian berinisiatif mendirikan usaha kuliner Ayam Geprek Empire Tambak Serang demi menyambung hidupnya, dan hasilnya...  https://t.co/KsdcKE7zfR",7,1,1,0,2022-01-31,4,Monday,1,8,1
1488011199228821508,2022-01-31 04:48:10,Untuk pertama kalinya polusi nanoplastik terdeteksi di daerah Kutub Utara dan Kutub Selatan hingga ke intinya. Kontaminasi plastik sudah sangat parah! :'( https://t.co/AB9067pUcI,7,0,5,1,2022-01-31,4,Monday,1,12,1
1488010898807611392,2022-01-31 04:46:58,Aliando didiagnosis gangguan mental obsessive compulsive disorder (OCD). Hal itu membuatnya kesulitan beraktivitas. Ini yang perlu diketahui dari OCD: https://t.co/HCw2HgXZhi,8,3,1,1,2022-01-31,4,Monday,1,9,4
1488010539079016449,2022-01-31 04:45:33,"Sudah dipotong, dibersihkan bahkan sudah dimasak ada beberapa potongan daging ikan sampai kodok yang bergerak. Bahkan ada yang hidup kembali!  https://t.co/7LfJ70p6IS",4,2,1,0,2022-01-31,4,Monday,1,5,2
1488010518740803584,2022-01-31 04:45:28,"Wanita RI, Mia, gagal menikah dengan sang mantan karena statusnya yang sudah punya anak. Namun, ia akhirnya dinikahi seorang bule. Intip kisahnya, yuk. #detikNetwork  https://t.co/6QneZ08DFA",3,0,1,2,2022-01-31,4,Monday,1,4,2
1488010276180049922,2022-01-31 04:44:30,Tim futsal putri Kota Bandung pada persiapan mengarungi event Porprov XIV Jabar 2022. Mereka berhasil menyapu bersih lima pertandingan uji coba. https://t.co/i65GubstBF,3,0,1,0,2022-01-31,4,Monday,1,4,0
1488009712394252291,2022-01-31 04:42:15,Mason Greenwood tengah jadi sorotan karena melakukan kekerasan terhadap pacarnya. Greenwood merupakan pemain muda yang koleksi mobil mewah! https://t.co/H89ekJ8td2,4,1,0,0,2022-01-31,4,Monday,1,4,1
1488008623355830273,2022-01-31 04:37:56,"Selain Imlek yang jatuh pada 1 Februari, masih banyak tanggal merah pada tahun 2022. Berikut ini daftarnya. Catat ya! https://t.co/ycjmHguRns",5,1,2,0,2022-01-31,4,Monday,1,7,1
1488008561472978945,2022-01-31 04:37:41,"Bereksperimen dengan kepala babi, food Vlogger ini coba buktikan daging babi yang dianggap mengandung cacing. Minuman soda digunakan untuk merendam kepala babi!  https://t.co/N7kAUHy3UF",2,1,0,0,2022-01-31,4,Monday,1,2,1
1488008129845600256,2022-01-31 04:35:58,"Mason Greenwood, di-unfollow beberapa pemain senior termasuk Cristiano Ronaldo. Kabar penganiayaan Greenwood terhadap kekasih menjadi pemicunya. https://t.co/LvDBhWnC8D",9,0,2,0,2022-01-31,4,Monday,1,11,0
1488008128725721090,2022-01-31 04:35:58,Komisi VI DPR memanggil Menteri Perdagangan untuk melakukan rapat kerja hari ini. Agenda utamanya adalah membahas stabilitas harga minyak goreng.  https://t.co/ZDtRZtorxf,3,0,3,1,2022-01-31,4,Monday,1,6,1
1488007882771677189,2022-01-31 04:34:59,Dunia tengah bergerak ke masa transisi energi. Perusahaan minyak dan gas sebagai penghasil energi fosil yang tidak ramah lingkungan pun jadi gelisah.  https://t.co/zvpQO6KYdu,5,3,3,0,2022-01-31,4,Monday,1,8,3
1488007869295439873,2022-01-31 04:34:56,Rafael Nadal merebut gelar juara Australian Open 2022 untuk menambah koleksi gelar Grand Slam-nya menjadi 21! https://t.co/kvN0mIwAbk,9,0,1,0,2022-01-31,4,Monday,1,10,0
1488007291412561924,2022-01-31 04:32:38,"Menpora Zainudin Amali terus mendukung bergulirnya kompetisi sepakbola, namun harus mampu menghasilkan pemain untuk Timnas Indonesia! https://t.co/B4tM2QUyXL",6,2,1,0,2022-01-31,4,Monday,1,7,2
1488007272622178304,2022-01-31 04:32:34,"Bagi kamu fresh graduate lulusan Diploma (D3) dari jurusan Material Metalurgi, simak nih lowongan kerja yang satu ini!  https://t.co/COIFdJzk6V",1,0,1,0,2022-01-31,4,Monday,1,2,0
1488006657942736899,2022-01-31 04:30:07,Sejumlah seleb Indonesia berbondong-bondong menjadi pemilik klun sepak bola dan basket. Terbaru ada Prilly Latuconsina jadi pemilik Persikota Tangerang!  https://t.co/clx2gxsmP7,13,6,2,1,2022-01-31,4,Monday,1,15,7
1488006639349346308,2022-01-31 04:30:03,"Tren penggunaan Vespa matic kian meningkat. Tak hanya di pasar barunya, pasar Vespa matic bekas juga menguat. Nah kali ini, Vescooter, dealer spesialis Vespa matic bekas berbagi tips untuk membeli Vespa matic bekas. Apa aja yang harus diperhatikan? Sima... https://t.co/qtG6GRqEfZ",6,1,3,0,2022-01-31,4,Monday,1,9,1
1488006203657670660,2022-01-31 04:28:19,Terdapat dua mantan pegawai KPK yang lolos dalam seleksi tahap I ini. https://t.co/E5koXoOgKw,6,0,2,0,2022-01-31,4,Monday,1,8,0
1488006185357918208,2022-01-31 04:28:15,"Para peneliti mengungkapkan Neocov bukan varian baru coronavirus diseases (COVID-19), namun masih kerabat dekat virus Middle East Respiratory Syndrome (MERS). https://t.co/ForqsW0woK",6,2,4,2,2022-01-31,4,Monday,1,10,4
1488005266541101059,2022-01-31 04:24:36,"Ketika Corona menyebar, kepulauan Pasifik Kiribati yang terpencil menutup perbatasannya, memastikan penyakit itu tidak mencapai pantainya selama hampir 2 tahun. https://t.co/mJef3AgVEE",14,1,3,0,2022-01-31,4,Monday,1,17,1
1488004776944091139,2022-01-31 04:22:39,"Menanggapi kasus Omicron naik lagi, Ahmad Riza Patria akan meningkatkan berbagai fasilitas hingga memperketat pengawasan. https://t.co/FdyIcUvS5B",3,0,3,0,2022-01-31,4,Monday,1,6,0
1488004251934674955,2022-01-31 04:20:34,"Setelah melalui interogasi awal, diketahui pelaku berdalih melancarkan modus 'tabrak lari' karena membutuhkan uang untuk beli obat. https://t.co/BODYGr5dJ8",2,2,3,0,2022-01-31,4,Monday,1,5,2
1488003731950129154,2022-01-31 04:18:30,UEFA melarang Carlo Ancelotti duduk di bench Real Madrid lagi. Ada satu hal yang mesti dilakukan Ancelotti agar bisa kembali duduk menemani timnya di lapangan. https://t.co/3K7pH0qp5P,5,2,1,3,2022-01-31,4,Monday,1,6,5
1488002967630405633,2022-01-31 04:15:27,Berikut adalah kumpulan ucapan Imlek 2022 dalam bahasa Inggris yang bisa jadi referensi untuk saling memberi harapan pada orang-orang terdekat. https://t.co/hnuDMVoZRm,2,0,1,0,2022-01-31,4,Monday,1,3,0
1488002700683919367,2022-01-31 04:14:24,Polres Metro Jakarta Timur menetapkan AF (46) sebagai tersangka fitnah dan pemerasan dalam kasus modus pura-pura pincang sebagai korban tabrak lari. Berikut fakta-fakta pelaku. https://t.co/oJwJZdkTS1,5,1,0,0,2022-01-31,4,Monday,1,5,1
1488001679458979846,2022-01-31 04:10:20,Shin Tae-yong mengakui belum pernah berkomunikasi dengan para pelatih di Liga 1 Indonesia. COVID-19 menjadi alasannya! https://t.co/JkNhbSvMp6,9,0,1,0,2022-01-31,4,Monday,1,10,0
1488000769752240134,2022-01-31 04:06:43,Marc Marquez terkesan dengan gelar juara bersejarah Rafael Nadal di Australian Open 2022 dan ingin meniru sang petenis jelang bergulirnya MotoGP 2022. https://t.co/zbCydjEP8w,6,0,0,0,2022-01-31,4,Monday,1,6,0
1488000505553068032,2022-01-31 04:05:40,Edy mengaku sudah membawa baju ganti karena merasa akan ditahan. Begini katanya: https://t.co/u2UIUPEAbV,25,12,5,0,2022-01-31,4,Monday,1,30,12
1487999031024435203,2022-01-31 03:59:49,Edy Mulyadi memenuhi panggilan Bareskrim Polri terkait polemik 'jin buang anak'. Ini merupakan panggilan kedua terhadap Edy Mulyadi. https://t.co/yhngFiRE6T,23,18,2,0,2022-01-31,3,Monday,1,25,18
1487998137750986752,2022-01-31 03:56:16,Tim Nasional Indonesia tak lama lagi tampil di Piala AFF U-23 Kamboja. Training camp (TC) dijadwalkan berlangsung di Bali mulai 3 sampai 8 Februari 2022. https://t.co/kP8NlJVNhx,8,0,1,0,2022-01-31,3,Monday,1,9,0
1487997322361507842,2022-01-31 03:53:01,Cerita NOAH garap project album Second Change untuk mengisi waktu luang karena tak manggung di acara Pemilu. https://t.co/7ePe6U4Zvg,11,0,1,0,2022-01-31,3,Monday,1,12,0
1487996778809118723,2022-01-31 03:50:52,"Kembalinya Ole Gunnar Solskjaer ke lapangan klub MU pada akhir pekan langsung menghadirkan torehan sejarah. Ole membuatnya bersama sang putri, Karna. https://t.co/jGJg2QHK39",7,0,1,1,2022-01-31,3,Monday,1,8,1
1487996039357415427,2022-01-31 03:47:56,"Selain makan bersama, Imlek juga jadi momen untuk saling memberi hadiah. Cake bertema Imlek yang cantik dan enak bisa jadi pilihan.  https://t.co/X3F6DjRqCx",8,0,3,0,2022-01-31,3,Monday,1,11,0
1487995718635823105,2022-01-31 03:46:39,Siapa yang zodiaknya Gemini? Hindari berlaku boros karena langkah ke depan masih cukup panjang. Coba lihat yuk kata ramalan zodiak lainnya: https://t.co/b6jJvTnjya,2,0,2,0,2022-01-31,3,Monday,1,4,0
1487995427102367745,2022-01-31 03:45:30,Peneliti Hong Kong menemukan bukti bahwa hamster dapat menyebarkan COVID-19 ke manusia. Hewan ini dianggap menjadi biang kerok penularan COVID-19 di Hong Kong. https://t.co/rD5Sl1EUBm,7,4,4,6,2022-01-31,3,Monday,1,11,10
1487994681791242242,2022-01-31 03:42:32,Pemerintah menegaskan keseriusannya dalam menindak pelanggaran truk ODOL (Over Dimension Over Load). Berikut strateginya! https://t.co/0ibJvCAJUW,8,0,1,1,2022-01-31,3,Monday,1,9,1
1487994144530251778,2022-01-31 03:40:24,Hayo siapa yang bisa jawab? https://t.co/6gMyhfb5FK,23,48,2,6,2022-01-31,3,Monday,1,25,54
1487993876791148547,2022-01-31 03:39:20,"Ketum PSSI Mochamad Iriawan memberi apresiasi buat Timnas Indonesia yang dua kali meraih kemenangan atas Timor Leste di laga uji coba, tetapi ia memberi catatan. https://t.co/n33x5QzeDS",9,0,0,2,2022-01-31,3,Monday,1,9,2
1487993124655976451,2022-01-31 03:36:21,"Sepanjang tahun 2021, Ducati berhasil menjual 59.447 motor ke seluruh dunia! https://t.co/SOXuNniJZh",8,0,0,0,2022-01-31,3,Monday,1,8,0
1487992608253222913,2022-01-31 03:34:18,"Kampus-kampus ini memiliki guru besar atau profesor terbanyak menurut Data Statistik Dikti 2020

via: detikedu  https://t.co/v193tmvXH9",3,1,0,0,2022-01-31,3,Monday,1,3,1
1487991453779480585,2022-01-31 03:29:42,Barcelona siap-siap melego Ousmane Dembele di bursa musim dingin dan dikabarkan telah setuju pindah ke Paris Saint-Germain. https://t.co/ESsn2oLVSI,6,2,1,0,2022-01-31,3,Monday,1,7,2
1487990621126152198,2022-01-31 03:26:24,Dugaan jebakan karantina oleh turis Ukraina membuat GIPI Bali kesal dan mempertanyakan efektivitas karantina di Jakarta padahal liburan ke Bali. Hmm.... https://t.co/wPvz3qwz2D,21,8,10,7,2022-01-31,3,Monday,1,31,15
1487989560617410563,2022-01-31 03:22:11,"Kasus aktif Corona di Indonesia terus mengalami peningkatan. Hampir setengahnya disumbang Provinsi DKI Jakarta, ini sebarannya: https://t.co/GmSqV3ekfi",19,5,14,8,2022-01-31,3,Monday,1,33,13
1487989231557517312,2022-01-31 03:20:52,Sebuah bus menabrak flyover di Padang Panjang hingga atap lepas dan melukai 17 penumpang. Polisi memburu sopir bus yang kabur usai terjadi kecelakaan. https://t.co/KLHE5zLgW8,3,2,0,0,2022-01-31,3,Monday,1,3,2
1487988984399765504,2022-01-31 03:19:54,"Desas-desus ruang ganti Manchester United terpolarisasi, Cristiano Ronaldo kemudian gabung grup WhatsApp untuk menyatukan tim! https://t.co/ql3GjPI7lg",33,3,2,1,2022-01-31,3,Monday,1,35,4
1487988250706911236,2022-01-31 03:16:59,Seorang pemuda tergeletak di Halte Bus GBK. Korban terlihat mengalami luka bacokan di kaki kanannya. https://t.co/AFbV16Jvza,3,0,1,0,2022-01-31,3,Monday,1,4,0
1487987494088056837,2022-01-31 03:13:58,Polisi menetapkan satu orang tersangka penganiayaan siswa di SMK Sekolah Penerbangan Nusantara Batam. Tersangkanya adalah Aiptu Erwin. https://t.co/GC1xgtpGbl,8,3,3,0,2022-01-31,3,Monday,1,11,3
1487986965941260320,2022-01-31 03:11:52,Juergen Klopp begitu girang setelah Luis Diaz berhasil diboyong dan mengaku sangat menginginkan Luis Diaz! https://t.co/SCVXi6x6vc,4,0,0,0,2022-01-31,3,Monday,1,4,0
1487985861308342276,2022-01-31 03:07:29,Youtuber Melanie Ham meninggal dunia. Sang suami membagikan foto kondisi terakhir istrinya sebelum meninggal. Kondisinya tampak begitu memprihatinkan. https://t.co/nFqdxNCyeL,7,0,2,0,2022-01-31,3,Monday,1,9,0
1487985418364719105,2022-01-31 03:05:43,Hari Raya Imlek atau Tahun Baru China jatuh di tanggal 1 Februari atau Selasa pekan ini. KRL tetap beroperasi biasa. Tetap jaga prokes ya! https://t.co/HINdgPx52V,11,0,2,0,2022-01-31,3,Monday,1,13,0
1487985417886793729,2022-01-31 03:05:43,"Grab Indonesia dan Good Doctor kembali bekerja sama dengan Kemenkes Republik Indonesia serta Pemerintah Provinsi Bali untuk mendistribusikan vaksinasi booster. #PercayaTerlindungi @GrabID

https://t.co/Sy0MwVyIoK",5,1,1,1,2022-01-31,3,Monday,1,6,2
1487984965568577536,2022-01-31 03:03:55,"#Foto Tujuh artis ini mengawali pagi mereka dengan rutinitas yang sehat bagi tubuh maupun jiwa. Kamu juga bisa tiru, lho! https://t.co/6KMEbviJlw",2,0,0,0,2022-01-31,3,Monday,1,2,0
1487984397445996554,2022-01-31 03:01:40,Line up baru Harley-Davidson 2022 ini diluncurkan bersama dengan peringatan ulang tahun Anak Elang Harley-Davidson yang ke-5. https://t.co/zdtaG6s2R2,2,0,3,0,2022-01-31,3,Monday,1,5,0
1487984369990053888,2022-01-31 03:01:33,Rupiah hari ini kebakaran. Kurs dolar Amerika Serikat (AS) terhadap rupiah pagi hari ini menguat terhadap rupiah!  https://t.co/Y91CHe2j3E,0,2,1,1,2022-01-31,3,Monday,1,1,3
1487983839058305031,2022-01-31 02:59:27,Nasi goreng spesial bisa jadi sarapan enak di hari libur. Kali ini dipadukan dengan ham dan telur yang super gurih. Dimakan selagi hangat makin mantap rasanya!  https://t.co/dJxoImDLI2,12,0,1,0,2022-01-31,2,Monday,1,13,0
1487983820158738435,2022-01-31 02:59:22,"Mason Greenwood tengah menjadi sorotan, bahkan hingga saat ini namanya masih berada di deretan atas trending topic media sosial. #MasonGreenwood https://t.co/BFJmUZBDU2",16,1,2,1,2022-01-31,2,Monday,1,18,2
1487983448136601607,2022-01-31 02:57:54,Bubur beras atau jenang putih khas Situbondo ini biasa dinikmati saat sarapan. Bubur diberi topping sayuran rebus dan siraman saus kacang. Unik!  https://t.co/idOPuQTJjv,4,0,2,0,2022-01-31,2,Monday,1,6,0
1487983065750192129,2022-01-31 02:56:22,"Minggu-minggu pertama 2022 menjadi kabar buruk bagi para orang terkaya di dunia, pasalnya kekayaan mereka anjlok. Tapi itu tidak terjadi pada Warren Buffett!  https://t.co/JEgXfZ0E3m",1,1,2,0,2022-01-31,2,Monday,1,3,1
1487982853287821314,2022-01-31 02:55:32,"Pasar mobil di Indonesia memang didominasi oleh tipe Multi Purpose Vehicle (MPV), tetapi hal berbanding terbalik saat bicara soal pasar ekspor Toyota Indonesia. https://t.co/dRjcp5vMjo",3,0,0,0,2022-01-31,2,Monday,1,3,0
1487982837588496386,2022-01-31 02:55:28,Pemerintah mulai menyusun peraturan turunan UU IKN. Salah satu aturan turunan tersebut akan mencakup soal kepala otorita. https://t.co/ZggdRiKQ4v,6,1,2,1,2022-01-31,2,Monday,1,8,2
1487982305452990466,2022-01-31 02:53:21,"Tidak hanya wortel, banyak makanan enak yang juga bermanfaat untuk kesehatan mata. Ada ubi, telur hingga pepaya semua dipercaya berkhasiat untuk jernihkan mata.  https://t.co/ZVWSS45eIj",7,0,3,0,2022-01-31,2,Monday,1,10,0
1487982003622395907,2022-01-31 02:52:09,"Perjalanan lima lady bikers dalam Srikandi Wonderful Ride mengunjungi berbagai destinasi pariwisata di Jawa Barat, sekaligus mempromosikan MotoGP Mandalika. https://t.co/UaKt3415AA",9,0,0,0,2022-01-31,2,Monday,1,9,0
1487981710184796160,2022-01-31 02:50:59,"Serah terima jabatan dilakukan oleh Marsda TNI Tatang Harlyansyah selaku Dankodiklat AU lama ke Marsda TNI Nanang Santoso, sebagai Dankodiklat AU baru. https://t.co/DHg8Eclubl",2,0,0,0,2022-01-31,2,Monday,1,2,0
1487981197611479040,2022-01-31 02:48:57,Perempatfinal Piala Afrika 2021 telah tuntas dan empat negara kontestan di semifinal pun sudah didapatkan. https://t.co/BPyLK1qVGx,6,0,0,1,2022-01-31,2,Monday,1,6,1
1487980672799150085,2022-01-31 02:46:52,"Heboh modus penipu pura-pura jadi korban tabrak lari di Jakarta Timur. Lalu, apa yang harus kita lakukan jika terjebak dalam situasi seperti itu? https://t.co/ngPYcXiPFD",8,1,8,1,2022-01-31,2,Monday,1,16,2
1487980416724353026,2022-01-31 02:45:51,"Enzy Storia mengumumkan dirinya positif Covid-19. Wanita pembawa acara ini punya banyak momen saat kulineran, ia punya gaya modis saat menikmati puding.  https://t.co/3HXznKd899",5,0,1,0,2022-01-31,2,Monday,1,6,0
1487979887633776651,2022-01-31 02:43:45,"Jangan panik! Menkes menyebut kenaikan kasus COVID-19 ini dipengaruhi oleh penularan Omicron, namun varian ini cepat naik tapi cepat turun. https://t.co/FSFa49sNH3",15,2,2,1,2022-01-31,2,Monday,1,17,3
1487979063931195392,2022-01-31 02:40:28,Jokowi mengenakan setelan jas dan peci serta sarung bermotif hijau merah. Seperti apa? https://t.co/0OCL0KFcIv,14,0,1,0,2022-01-31,2,Monday,1,15,0
1487979046717775876,2022-01-31 02:40:24,Marshel Widianto diperiksa Direktorat Reserse Narkoba atas permintaan sendiri untuk memastikan dirinya bersih dari narkoba. Iapun ramai diperbincangkan netizen. Ini gayanya saat kulineran.  https://t.co/8oiLTiZeOQ,7,2,0,0,2022-01-31,2,Monday,1,7,2
1487978554985955328,2022-01-31 02:38:27,"Permukiman padat di Tambora, Jakarta Barat dilanda kebakaran. Hingga kini, api masih menyala. #Kebakaran #Tambora https://t.co/qYhzst87nB",6,0,1,1,2022-01-31,2,Monday,1,7,1
1487978041208983555,2022-01-31 02:36:24,"Selama pandemi, banyak orang yang mencari aktivitas baru di rumah. Seperti wanita ini yang menemukan keahliannya melukis di atas kulit pisang!  https://t.co/tehn4SZn8T",4,1,1,0,2022-01-31,2,Monday,1,5,1
1487977953136885765,2022-01-31 02:36:03,Wanita ini mendapati mobilnya tenggelam dalam genangan banjir.Namun ia masih santai makan ayam goreng dari restoran favoritnya!  https://t.co/kTv1znvvy0,1,0,1,0,2022-01-31,2,Monday,1,2,0
1487977001231478784,2022-01-31 02:32:17,"Mereka semua berharap dan berdoa agar pandemi ini segera berakhir. Agar bisa kembali menjalani kehidupan seperti semula. Pak ading (67) salah satu Tukang jahit baju barong/liong pun berharap demikian.

-- https://t.co/TKwDQXzSXd",4,0,0,0,2022-01-31,2,Monday,1,4,0
1487976874437398531,2022-01-31 02:31:46,Harga emas batangan Antam hari ini turun Rp 1.000. Harga emas Antam dijual Rp 927.000 per gram jelang libur Imlek.  https://t.co/JY4cNdun2x,6,1,2,0,2022-01-31,2,Monday,1,8,1
1487976868619984896,2022-01-31 02:31:45,Evergrande Group mengumumkan akan melepas tanah di distrik pedesaan Hong Kong yang belum dikembangkan sebagai jaminan utang!  https://t.co/LifXsRGsGN,3,1,4,0,2022-01-31,2,Monday,1,7,1
1487976831940640769,2022-01-31 02:31:36,Di kawasan tempat tinggalnya kini sudah ada beberapa kelompok kesenian Liong dan Barongsai. https://t.co/gvlAsv7voW,5,2,0,0,2022-01-31,2,Monday,1,5,2
1487976649702666242,2022-01-31 02:30:53,"Kawasan Pulo Geulis yang merupakan kawasan pecinan di Kota Bogor, sangat erat dengan nuansa dan budaya Tionghoa. https://t.co/q17EcuM0Be",10,2,1,0,2022-01-31,2,Monday,1,11,2
1487976254942986240,2022-01-31 02:29:19,Binomo kerap kali diblokir dan dicap ilegal di Indonesia. Namun sayang masih banyak masyarakat yang masuk dalam jebakan broker trading yang mirip judi tersebut.  https://t.co/D1S5ejVFPa,18,0,5,0,2022-01-31,2,Monday,1,23,0
1487976110269034497,2022-01-31 02:28:44,"Dengan kualitas hasil yang sangat baik, tidak sedikit orang yang memesan Liong dan Barongsai kepada dirinya. Lily tercatat sudah 22 tahun menggeluti profesi sebagai pengrajin Liong dan Barongsai. https://t.co/nprUwL2pJf",5,1,0,0,2022-01-31,2,Monday,1,5,1
1487975799198142464,2022-01-31 02:27:30,"Biasanya, untuk membuat 1 Liong, ia membutuhkan waktu 2-3 minggu sedangkan untuk membuat Barongsai dibutuhkan waktu sekitar 2 minggu. Hampir sebagian barang-barang untuk membuat Liong dan Barongsai itu ia dapatkan dari luar negeri. https://t.co/AKu1tXJsdI",4,1,0,0,2022-01-31,2,Monday,1,4,1
1487975577176870912,2022-01-31 02:26:37,"Menjelang imlek, biasanya permintaan Liong dan Barongsai itu sangat banyak. Namun, sejak 2 tahun terkahir ini mengalami penurunan yang cukup signifikan karena pandemi dan adanya larangan untuk berkerumun dan mencipta keramaian. https://t.co/NJH5izPda0",5,1,0,0,2022-01-31,2,Monday,1,5,1
1487975453503545349,2022-01-31 02:26:08,"Lily merupakan putra asli dari Pulo Geulis, Bogor, Jawa Barat. Usaha pembuatan Barongsai dan Liong itu sudah dirintisnya dengan bantuan 20 pekerja yang juga masih kerabatnya. https://t.co/CUja6LpH4K",3,1,0,0,2022-01-31,2,Monday,1,3,1
1487975427381600256,2022-01-31 02:26:01,IHSG diprediksi menguat di kisaran 6.589-6.673. Simak rekomendasi saham hari ini.  https://t.co/yFGDK3GEKC,2,0,0,0,2022-01-31,2,Monday,1,2,0
1487975317683638272,2022-01-31 02:25:35,"Hampir semua kelompok kesenian Liong dan Barongsai dari Sabang-Marauke pernah memesan hasil karyanya kepada Lily. Tidak hanya di dalam negeri, Liong dan Barongsai ciptaannya itu juga sudah pernah dipesan sampai ke luar negeri. https://t.co/VAcsQFc6ha",2,1,0,0,2022-01-31,2,Monday,1,2,1
1487975159340404736,2022-01-31 02:24:57,Beberapa transaksi unik yang menggunakan QRIS kini masif di beberapa daerah mulai dari becak motor hingga voting pemilihan Putri Indonesia!  https://t.co/Z4sxaU9dzu,5,0,1,0,2022-01-31,2,Monday,1,6,0
1487975093158674433,2022-01-31 02:24:42,"Kesenian Liong dan Barongsai mulai kembali dikenalkan kepada masyarakat saat Presiden ke 3 Indonesia Abdurahman Wahid. Sebelum Gusdur menjabat jadi Presiden, lebih dari 30 tahun kesenian dan budaya tionghoa ini dilarang saat masa orde baru dibawah Pemerintahan Soeharto. https://t.co/mKMDgXngyK",5,3,3,0,2022-01-31,2,Monday,1,8,3
1487974911117119491,2022-01-31 02:23:58,"Awalnya ia juga merupakan seorang pemain Liong. Ketika melihat adanya peluang untuk mencoba membuat Liong dan Barongsai, akhirnya keterusan sampai sekarang. https://t.co/CEj1YQiRzm",3,1,0,0,2022-01-31,2,Monday,1,3,1
1487974788262170625,2022-01-31 02:23:29,"Di kota Hujan, Bogor, Jawa Barat ada juga pengrajin Liong dan Barongsai yang masih bertahan hingga kini. Ia adalah Lily Hambali pria kelahiran 1972 yang kini bermukim di gg roda, Babakan Pasar, Kota Bogor, Jawa Barat. Ia sudah memulai menekuni usaha pembuatan ini sejak 1998. https://t.co/T9tDEloMqn",3,1,1,0,2022-01-31,2,Monday,1,4,1
1487974383096254464,2022-01-31 02:21:52,"Tahun Baru Imlek memiliki berbagai bentuk perayaan yang unik di tiap daerah dan etnisnya. Namun, ada banyak kegiatan yang hampir sama dilakukan dan menjadi tradisi seperti mengunjungi anggota keluarga, mendekorasi, hingga melakukan beberapa praktik keagamaan. https://t.co/ci2h8SL1DB",4,1,1,0,2022-01-31,2,Monday,1,5,1
1487974125427920900,2022-01-31 02:20:51,Masyarakat China tradisional yakin bahwa pertunjukan tarian naga atau singa (selama Festival Musim Semi) merupakan salah satu cara untuk berdoa. Tujuannya untuk keberuntungan dan mengusir roh jahat. https://t.co/KhTNI6sJ7E,4,2,0,0,2022-01-31,2,Monday,1,4,2
1487974061212897283,2022-01-31 02:20:36,Ada 155 nama yang lolos dalam seleksi administratif tersebut. Sejumlah nama yang tak asing ditemui dalam daftar hasil seleksi tersebut.  https://t.co/23XGVFdCyv,2,1,1,0,2022-01-31,2,Monday,1,3,1
1487973973845737472,2022-01-31 02:20:15,"Perayaan Tahun Baru Imlek tak bisa lepas dari kehadiran Barongsai dan Liang Liong. 

Namun detikers tahu nggak sih, apa makna sebenernya Barongsai dan Liang Liong itu?

#THREAD",15,3,6,0,2022-01-31,2,Monday,1,21,3
1487972801550110723,2022-01-31 02:15:35,"Berikut 11 ciri-ciri orang cerdas dengan IQ tinggi dan pengendalian emosi baik, apakah kamu punya salah satunya? Cerdas tidak selalu identik dengan IQ tinggi.

via: detikedu  https://t.co/ADHAUNfuGP",12,0,4,0,2022-01-31,2,Monday,1,16,0
1487972787818049538,2022-01-31 02:15:32,"Buat yang masih ragu untuk membeli rumah di Bogor, kamu perlu tahu apa saja yang tersedia di Kota Hujan tersebut.  https://t.co/VnNAzxVQyM",10,0,1,0,2022-01-31,2,Monday,1,11,0
1487972272812044289,2022-01-31 02:13:29,"Gabungan jumlah kekayaan 18 orang terkaya Afrika tidak lebih besar dari orang-orang terkaya di Asia, bahkan jika dibandingkan untuk 1 orang saja!  https://t.co/92oDMRZGxT",3,2,2,0,2022-01-31,2,Monday,1,5,2
1487972271528583170,2022-01-31 02:13:29,Thailand bakal mengakui kripto sebagai mata uang. Aset-aset kripto bakal bisa digunakan untuk alat pembayaran yang sah!  https://t.co/hDzayU082F,4,0,2,1,2022-01-31,2,Monday,1,6,1
1487972008377868291,2022-01-31 02:12:26,"Sebuah desa di Tuban sempat menyita perhatian publik, bagaimana tidak warga-warganya sempat menjadi miliarder dadakan. Kini hidupnya ngenes!  https://t.co/QvWLnHExVP",5,3,1,0,2022-01-31,2,Monday,1,6,3
1487971987746140162,2022-01-31 02:12:21,Masih banyak dari masyarakat Indonesia yang belum sadar bahwa broker binary option seperti Binomo dan kawan-kawannya mirip perjudian!  https://t.co/GZ6bxuUbso,3,0,2,1,2022-01-31,2,Monday,1,5,1
1487971757978001414,2022-01-31 02:11:26,"Yang unik, pemerintah sudah menjabarkan sederet transportasi canggih yang bakal dibikin di ibu kota baru. Mau tahu apa saja? Simak daftarnya di bawah ini.  https://t.co/V7wn2cgIkj",3,5,3,0,2022-01-31,2,Monday,1,6,5
1487971741532106752,2022-01-31 02:11:23,Mobil mewah berjejer di garasi atau liburan mewah penuh gengsi dibalut gaya trendi pakaian bermerek jadi pemandangan jamak yang kerap dipertontonkan influencer.  https://t.co/KwkNjJlzW8,7,1,1,0,2022-01-31,2,Monday,1,8,1
1487971222612848642,2022-01-31 02:09:19,"Crazy Rich dari Medan, Indra Kenz pernah bilang broker binary option Binomo legal. Ini buktinya:   https://t.co/YsSoMfUor6",95,49,26,10,2022-01-31,2,Monday,1,121,59
1487971211946729478,2022-01-31 02:09:16,"Bila orang kaya tanggung hoby flexing, orang kaya beneran malah ogah tampil kaya. Contohnya adalah Calvin Harris yang pernah jadi musisi termahal dunia!  https://t.co/yGRMyHQnj8",17,5,6,1,2022-01-31,2,Monday,1,23,6
1487970416870178816,2022-01-31 02:06:07,"QRIS sendiri diluncurkan oleh BI untuk memungkinkan semua orang yang punya alat pembayaran baik e-wallet sampai mobile banking bisa melakukan transaksi, termasuk juru parkir di Bali ini!  https://t.co/bo1h5mXT7N",1,1,2,2,2022-01-31,2,Monday,1,3,3
1487970404010496001,2022-01-31 02:06:04,"Kebijakan harga eceran tertinggi (HET) untuk minyak goreng curah, kemasan sederhana, dan premium akan kembali berubah mulai 1 Februari 2022.  https://t.co/6FyAakz8FS",6,6,2,0,2022-01-31,2,Monday,1,8,6
1487969712386494464,2022-01-31 02:03:19,Nama Otto Toto Sugiri menggema setelah masuk dalam jajaran 50 daftar orang terkaya Indonesia. Nantikan obrolan bersama 'Bill Gates' Indonesia ini di Ask d'boss.  https://t.co/plkqnxH0lK,6,1,1,0,2022-01-31,2,Monday,1,7,1
1487968979616473088,2022-01-31 02:00:24,"Investasi tanah kian menggiurkan karena harganya selalu naik setiap tahun. Namun, melalukan investasi perlu persiapan yang matang. Berikut yang harus dipersiapkan sebelum membeli tanah untuk investasi. #CNNIndonesia #detiknetwork  https://t.co/nQmyQWSu5U",12,1,3,0,2022-01-31,2,Monday,1,15,1
1487967725045653504,2022-01-31 01:55:25,"Masyarakat mengalami kesulitan mencari minyak goreng dengan harga murah. Sudah dibikin murah, minyak gorengnya malah langka!  https://t.co/5m4zMe6lf4",66,26,38,11,2022-01-31,1,Monday,1,104,37
1487957731222896644,2022-01-31 01:15:42,Dusan Vlahovic menjadi pemain Juventus terbaru yang dibajak dari Fiorentina. Ultras Bianconeri pun kini mengejek La Viola sebagai 'klub penyuplai'! https://t.co/y3qVLEnb7g,4,1,0,0,2022-01-31,1,Monday,1,4,1
1487955697501417473,2022-01-31 01:07:37,Donny van de Beek kian dekat ke pintu keluar Manchester United dan dilaporkan memilih bergabung dengan Everton. https://t.co/VINPjy2EXi,6,0,0,0,2022-01-31,1,Monday,1,6,0
1487954705192034307,2022-01-31 01:03:41,"Juventus mengutak-atik komposisi lini tengah, Bentancur dan Kulusevski dilepas, dan Denis Zakaria dan Nahitan Nandez tengah diburu! https://t.co/8EPcjOR0Lu",5,2,1,0,2022-01-31,1,Monday,1,6,2
1487954073303371782,2022-01-31 01:01:10,Pengamat Transportasi Djoko Setijowarno menilai dashboard camera atau dashcam penting guna mengantisipasi adanya modus 'tabrak lari'. https://t.co/1FN8cKI9GE,10,1,2,2,2022-01-31,1,Monday,1,12,3
1487953572910313475,2022-01-31 00:59:11,Terkuaknya ada korban jiwa dalam kerangkeng manusia di rumah Bupati Langkat nonaktif Terbit Rencana Perangin Angin membuat polisi bergerak. https://t.co/zEz9L6FbtK,10,2,0,2,2022-01-31,0,Monday,1,10,4
1487953074224345090,2022-01-31 00:57:12,"Rudal Korea Utara kembali mengudara. Selama sebulan terakhir, sudah 7 kali Korut meluncurkan rudalnya. https://t.co/eAZDJok1rP",3,0,0,0,2022-01-31,0,Monday,1,3,0
1487952559755169804,2022-01-31 00:55:09,Komisi III DPR menilai Edy tak sedang bertugas jurnalistik saat bicara 'jin buang anak' terkait pemindahan Ibu Kota Negara (IKN) beberapa waktu lalu. https://t.co/hXHmuThXow,15,2,2,1,2022-01-31,0,Monday,1,17,3
1487952320713396225,2022-01-31 00:54:12,"Imlek dirayakan sejak kedatangan orang China ke nusantara, namun dihentikan 30 tahun di masa Orde Baru. Berikut sejarah imlek hingga jadi hari libur nasional. https://t.co/Iq43Nw6qRN",148,10,25,1,2022-01-31,0,Monday,1,173,11
1487951807884279810,2022-01-31 00:52:10,Ketua Umum PBNU Yahya Cholil Staquf bercerita terselip nama 'NU' disingkatan Nusantara. Apa katanya? https://t.co/arOxbNgCAf,15,1,3,1,2022-01-31,0,Monday,1,18,2
1487951329993670660,2022-01-31 00:50:16,Raffi Ahmad beri kelas bisnis untuk karyawan. Ia nggak pandang bulu. https://t.co/PsjXCvJ14W,12,1,1,1,2022-01-31,0,Monday,1,13,2
1487951312264257541,2022-01-31 00:50:12,"Fakta baru perampok bengis berinisial AD (37) yang menembak mati mahasiswi di Lampung Timur terungkap. AD ternyata napi yang kabur dari Lapas Kendal, Jateng. https://t.co/aDF5shV3II",8,1,0,1,2022-01-31,0,Monday,1,8,2
1487950819790147592,2022-01-31 00:48:14,Polres Bekasi Kota menggelar kegiatan razia prokes di sejumlah tempat hiburan malam. Polisi menemukan kafe yang kucing-kucingan atau sembunyi dari petugas. https://t.co/OZA4YCoApU,6,0,0,0,2022-01-31,0,Monday,1,6,0
1487950567355949057,2022-01-31 00:47:14,Puasa Senin Kamis adalah salah satu ibadah sunah yang jarang ditinggalkan Nabi Muhammad SAW. Berikut alasan kenapa Rasulullah SAW puasa Senin Kamis rutin. https://t.co/cWHo1F9Lvt,74,2,23,1,2022-01-31,0,Monday,1,97,3
1487950077440237574,2022-01-31 00:45:17,"Ketua Pelaksana LTMPT mengatakan, peserta SNMPTN 2022 diseleksi tiap PTN berdasarkan data dari LTMPT. Berikut cara menghitung peluang lolos SNMPTN 2022. https://t.co/8rQWBakGad",2,0,0,0,2022-01-31,0,Monday,1,2,0
1487949828294336518,2022-01-31 00:44:18,Kemenkes menyebut persentase kenaikan kasus di Indonesia masih lebih rendah dibandingkan negara tetangga dan lebih terkendali dibandingkan beberapa negara Asia. https://t.co/7xT0ZjWc7H,1,1,0,1,2022-01-31,0,Monday,1,1,2
1487948979203715074,2022-01-31 00:40:56,Gubernur DKI Jakarta Anies Baswedan mengenang momen ketika dia diusung oleh almarhum politikus PPP Abraham Lunggana alias Haji Lulung. https://t.co/pdSbSDtyAZ,16,1,2,0,2022-01-31,0,Monday,1,18,1
1487948959989518342,2022-01-31 00:40:51,"Mencetak assist dan gol, Mohamed Salah menjadi bintang Mesir saat mengalahkan Maroko 2-1 di perempatfinal Piala Afrika 2021.  https://t.co/AxzsZUUU2s",8,0,1,0,2022-01-31,0,Monday,1,9,0
1487948314196721668,2022-01-31 00:38:17,Dusan Vlahovic menjadi pemain Juventus terbaru yang dibajak dari Fiorentina. Ultras Bianconeri pun kini mengejek La Viola sebagai 'klub penyuplai'. https://t.co/xcyOIsN2jL,3,0,0,0,2022-01-31,0,Monday,1,3,0
1487947837447024640,2022-01-31 00:36:23,Timnas Indonesia cuma menggunakan lima pemain cadangan saat melawan Timor Leste. Hal itu dikarenakan banyak pemain Indonesia yang terpapar virus Corona! https://t.co/CTc2K4jSeU,12,0,1,0,2022-01-31,0,Monday,1,13,0
1487947823760957447,2022-01-31 00:36:20,"Komnas Perempuan menyebut hukuman bagi Bayu Tamtomo, pemerkosa mahasiswi di Banjarmasin, tidak maksimal https://t.co/cjiIY3y5Zp",9,0,0,0,2022-01-31,0,Monday,1,9,0
1487947059034472449,2022-01-31 00:33:18,Mason Greenwood ditahan polisi karena diduga melakukan kekerasan terhadap pacarnya dan dibekukan dari skuad Manchester United! https://t.co/mFV5OHJLz7,27,0,1,3,2022-01-31,0,Monday,1,28,3
1487947046556520448,2022-01-31 00:33:15,Rafael Nadal merebut gelar juara Australian Open 2022 dan mengukir sejarah dengan gelar Grand Slam-nya menjadi 21.  https://t.co/csENOXyvk5,6,0,0,0,2022-01-31,0,Monday,1,6,0
1487946482636492801,2022-01-31 00:31:00,"Polres Jaktim menetapkan AF (46) sebagai tersangka fitnah dan pemerasan dalam kasus modus pura-pura pincang sebagai korban tabrak lari di Pasar Rebo, Jaktim. https://t.co/j5l3O6JkKS",15,4,1,1,2022-01-31,0,Monday,1,16,5
1487945987465297927,2022-01-31 00:29:02,Aksi pemerasan modus 'tabrak lari' yang dilakukan oleh seorang pria di Jaktim dirilis polisi. Simak fakta-faktanya sebagai berikut: https://t.co/7DgDrVuWuw,18,0,2,0,2022-01-31,0,Monday,1,20,0
1487945736306270217,2022-01-31 00:28:02,Pemain yang diajukan oleh Shin Tae-yong agar dinaturalisasi menjadi warga Indonesia belum juga terwujud. https://t.co/iugHNh8eAC,9,0,0,0,2022-01-31,0,Monday,1,9,0
1487944996418424834,2022-01-31 00:25:06,Kampus-kampus ini memiliki guru besar atau profesor terbanyak menurut Data Statistik Dikti 2020 https://t.co/TLIaSXo42n,12,2,0,0,2022-01-31,0,Monday,1,12,2
1487944424315408386,2022-01-31 00:22:50,"Temuan virus baru NeoCoV bikin gempar. Sejenis dengan SARS-CoV-2 penyebab COVID-19. Tapi tenang, NeoCoV tidak menyerang manusia. Setidaknya, sampai saat ini. https://t.co/tEs1nWhJa4",13,1,2,2,2022-01-31,0,Monday,1,15,3
1487943644652920834,2022-01-31 00:19:44,Bareskrim telah melayangkan surat panggilan pemeriksaan Edy Mulyadi terkait polemik 'tempat jin buang anak'. Edy Mulyadi mengaku bakal memenuhi panggilan itu. https://t.co/orUGRnN1k2,8,4,0,0,2022-01-31,0,Monday,1,8,4
1487943124672552963,2022-01-31 00:17:40,"Ekonom senior, Faisal Basri meramalkan pemerintahan akan ambruk secara moral sebelum 2024. PPP dan PKS angkat bicara terkait prediksi Faisal Basri. https://t.co/rNdEn0dGux",31,37,1,6,2022-01-31,0,Monday,1,32,43
1487941843635609602,2022-01-31 00:12:34,Pelaku melakukan pembobolan bangunan kosong atau pada saat dini hari. Pelaku diketahui mencungkil pintu target sasarannya lalu menyatroni isi di dalamnya. https://t.co/0FKN34OCrb,3,0,0,0,2022-01-31,0,Monday,1,3,0
1487941093442428931,2022-01-31 00:09:35,"COVID-19 Omicron subvarian BA.2 disebut-sebut sebagai Omicron 'siluman'. Punya mutasi yang berbeda, tes PCR SGTF untuk Omicron biasa tidak bisa mendeteksinya. https://t.co/4d7Eds4S4d",7,4,4,4,2022-01-31,0,Monday,1,11,8
1487940099740512257,2022-01-31 00:05:39,Shin Tae-yong berharap Jordi Amat dan Sandy Walsh bisa segera menjadi WNI. Dua pemain tersebut memang sudah diajukan PSSI ke Kemenpora untuk jadi WNI. https://t.co/O9eOQpxA46,7,1,0,0,2022-01-31,0,Monday,1,7,1
1487939347076636673,2022-01-31 00:02:39,Juergen Klopp mengatakan sudah lama mengincar Luis Diaz. Ia semakin kesengsem dengan Diaz usai Liverpool berjumpa dengan FC Porto di Liga Champions musim ini. https://t.co/6ZwPkV4NW3,5,0,0,1,2022-01-31,0,Monday,1,5,1
1487938841403084804,2022-01-31 00:00:39,"Frenkie de Jong mengakui Barcelona bukan lagi klub terbaik di dunia saat ini. Menurut De Jong, musim ini Barca juga sudah gagal. https://t.co/ZY5jR6auEI",14,0,0,1,2022-01-31,0,Monday,1,14,1
1487938209409552390,2022-01-30 23:58:08,Pemerintah bakal mengevaluasi status PPKM di wilayah Jawa dan Bali hari ini. Begini rekap data lonjakan kasus Corona sepekan terakhir. https://t.co/rA2qwEpvAs,12,4,3,0,2022-01-30,23,Sunday,7,15,4
1487937185491959808,2022-01-30 23:54:04,Pesinetron Aliando Syarief baru-baru ini mengaku mengidap OCD atau Obsessive Compulsive Disorder. Kondisi semacam apa sih itu? https://t.co/908rQSkinP,2,0,1,0,2022-01-30,23,Sunday,7,3,0
1487936661564669956,2022-01-30 23:51:59,"Dokter paru yang menangani kasus Omicron membeberkan gejala yang dialami para pasien. Umumnya tergolong ringan, bahkan mirip seperti flu dan masuk angin. https://t.co/82nBZtYZaS",12,0,10,0,2022-01-30,23,Sunday,7,22,0
1487935669586513926,2022-01-30 23:48:02,"Wakil Ketua MPR dari Fraksi Partai Demokrat, Syarief Hasan soroti perjanjian ruang udara atau Flight Information Region (FIR) Indonesia dan Singapura. https://t.co/mOMqmQuybW",5,2,2,1,2022-01-30,23,Sunday,7,7,3
1487934668720775168,2022-01-30 23:44:04,Hal ini ia lakukan semata-mata karena tidak ada lagi yang bisa ia lakukan selain menunggu paggilan pentas dan seseorang membeli tehyan buatannya. https://t.co/xYOTlGz6A6,9,0,2,0,2022-01-30,23,Sunday,7,11,0
1487933740856786945,2022-01-30 23:40:22,"Badai menerjang Jerman, Poldandi, dan Republik Ceko. Angin kencang itu bahkan menumbangkan pepohonan dan membuat kekacauan perjalanan hingga ada 3 orang tewas. https://t.co/27zIg6hwEN",5,0,1,0,2022-01-30,23,Sunday,7,6,0
1487932953606905860,2022-01-30 23:37:15,Karina Nadila kini sudah legowo dan menerima keadaan soal dirinya yang tidak pernah bertemu dengan ayah kandungnya. https://t.co/M7RjCP4V66,6,0,0,0,2022-01-30,23,Sunday,7,6,0
1487931949524172803,2022-01-30 23:33:15,Mak Odah tinggal di rumah bilik bambu dengan anak yang sakit tumor. Mak Odah kini sakit katarak. Mari bantu Mak Odah terus berjuang lewat https://t.co/gJZ8ovBbIQ https://t.co/7fB6AerQcB,6,0,1,0,2022-01-30,23,Sunday,7,7,0
1487930673897816070,2022-01-30 23:28:11,Masa depan Pierre-Emerick Aubameyang sedikit menemui titik terang. Barcelona mencapai kesepakatan dengan Arsenal untuk membawa striker asal Gabon itu. https://t.co/y253MIToGJ,3,0,0,0,2022-01-30,23,Sunday,7,3,0
1487929444325113865,2022-01-30 23:23:18,"MAF, bocah berusia 6 tahun di Cianjur, Jawa Barat, doyan memakan kertas papir atau kertas rokok. KPAI menyatakan MAF adalah korban pengasuhan yang salah. https://t.co/3pwXKIH4Do",4,1,4,2,2022-01-30,23,Sunday,7,8,3
1487928928547348488,2022-01-30 23:21:15,Tingkat keterisian tempat tidur RS Rujukan COVID-19 di Jakarta terus meningkat seiring tambahan kasus positif Corona yang kembali melonjak. https://t.co/QLczesf5Ii,16,1,5,0,2022-01-30,23,Sunday,7,21,1
1487928384785207296,2022-01-30 23:19:05,"Komunitas Indonesia Animals Hope Shelter menduga pencuri anjing yang disiksa di Minahasa Utara, Sulut, ialah kelompok spesialis doger atau pencuri anjing. https://t.co/TuHNYu25Qp",9,2,3,0,2022-01-30,23,Sunday,7,12,2
1487928095827021824,2022-01-30 23:17:57,"Bek klub Belanda FC Twente, Mees Hilgers, kembali bicara seputar kemungkinannya membela timnas Indonesia. https://t.co/dnf8K1J8jX",8,0,0,0,2022-01-30,23,Sunday,7,8,0
1487927061809446913,2022-01-30 23:13:50,Rekam jejak kejahatan AD (37) cukup mencolok. Pria asal Ogan Komering Ulu (OKU) Timur itu kabur dari penjara hingga membunuh dua orang. https://t.co/EKdgLsnJaw,3,0,0,0,2022-01-30,23,Sunday,7,3,0
1487925838985191429,2022-01-30 23:08:58,Turki akan segera mengganti nama resmi negara. Presiden Reccep Tayyip Erdogan mengatakan nama negeri itu akan berubah dari Turkey menjadi 'Turkiye'. Kenapa ya? https://t.co/5yC5B2QCLs,18,2,9,2,2022-01-30,23,Sunday,7,27,4
1487924554768998400,2022-01-30 23:03:52,Proyek pesawat tempur kolaborasi Korea Selatan dan Indonesia terus digarap. Pesawat prototipe bernama KF-21 Boramae itu sedang dirakit di Korea Selatan. Begini potretnya. https://t.co/XnI6dki4i8,12,0,6,0,2022-01-30,23,Sunday,7,18,0
1487922631378677762,2022-01-30 22:56:14,Rafael Nadal merebut gelar juara Australian Open 2022 untuk menambah koleksi gelar Grand Slam-nya menjadi 21. Nadal mengukir sejarah dengan keberhasilan itu. https://t.co/YBMw47G1Ul,5,1,1,0,2022-01-30,22,Sunday,7,6,1
1487921515320553477,2022-01-30 22:51:48,Seks oral termasuk salah satu variasi bercinta terpopuler di kalangan suami istri. Ini sejumlah manfaat seks oral yang bisa didapatkan selain biar tidak bosan. https://t.co/MIYbJjykpj,7,0,1,1,2022-01-30,22,Sunday,7,8,1
1487919501144375296,2022-01-30 22:43:47,"Ditreskrimsus Polda Sumut mengamankan delapan unit truk di Desa Lalang, Kecamatan Medang Deras, Batubara. Truk itu menyelundupkan barang dari Malaysia. https://t.co/ICoAaR3c7H",3,0,2,0,2022-01-30,22,Sunday,7,5,0
1487916314673008644,2022-01-30 22:31:08,Badai salju yang melanda AS berdampak pada stasiun kereta bawah tanah di Kota New York. Stasiun subway di kota itu tampak memutih karena diselimuti salju tebal. https://t.co/U1Hk9g8KyU,11,2,1,3,2022-01-30,22,Sunday,7,12,5
1487915404475473923,2022-01-30 22:27:31,Terowongan air Tirtapala berperan penting dalam kehidupan warga di kaki Gunung Slamet. Terowongan itu merupakan sumber kehidupan warga di sekitar gunung itu. https://t.co/eQyCyMydQP,19,1,3,0,2022-01-30,22,Sunday,7,22,1
1487914385901334533,2022-01-30 22:23:28,"Simpati dan dukungan untuk Agus Mustofa (28), warga Bandung Barat terus mengalir dari berbagai pihak termasuk dari komunitas Agus Agus Beraudara Indonesia. https://t.co/offNSMxCEZ",11,2,3,0,2022-01-30,22,Sunday,7,14,2
1487912801389658120,2022-01-30 22:17:10,Polresta Tangerang mengerahkan sebanyak 124 personel dalam pelaksanaan pengamanan perayaan ibadah dan Tahun Baru Imlek 2573 yang jatuh pada 1 Februari 2022. https://t.co/PiA7LtveNc,5,0,2,1,2022-01-30,22,Sunday,7,7,1
1487911755464552450,2022-01-30 22:13:01,"Tisu magic banyak dijadikan opsi oleh pasangan agar sesi bercinta jadi lebih tahan lama. Tapi, bagaimana cara pakai tisu magic yang benar? Begini caranya: https://t.co/3owGEB5Ayp",11,1,1,1,2022-01-30,22,Sunday,7,12,2
1487910208508682249,2022-01-30 22:06:52,"Ganjar Pranowo ngamuk saat mengecek sekolah yang baru dibangun di Kecamatan Tawangmangu, Kabupaten Karanganyar. Ia menendang tembok yang terbuat dari hardboard. https://t.co/TckMvO3oaM",340,192,53,66,2022-01-30,22,Sunday,7,393,258
1487909150638190599,2022-01-30 22:02:40,Raffi Ahmad dikenal sebagai salah satu artis Indonesia yang mudah bergaul dengan siapa pun. Ia tidak pernah membedakan orang-orang yang ada di sekitarnya. https://t.co/nwwU8h4qdf,18,2,0,1,2022-01-30,22,Sunday,7,18,3
1487908098119512064,2022-01-30 21:58:29,"Luas rumahnya satu petak saja. Tak ada kasur. Kamar mandi di belakang tanpa daun pintu. Mari bertamu di gubuk Sutrisno, lansia penuh semangat dan tidak mellow. https://t.co/rwkZRTrmdX",9,1,3,2,2022-01-30,21,Sunday,7,12,3
1487905701582278657,2022-01-30 21:48:57,"BMKG memprediksi hujan disertai petir dan angin kencang akan terjadi di Jakbar, Jaksel dan Jaktim pada hari ini. https://t.co/tZdQBi64Yc",12,0,1,0,2022-01-30,21,Sunday,7,13,0
1487904926206418944,2022-01-30 21:45:53,Duel sengit tercipta di Final Australian Open 2022. Rafael Nadal comeback untuk mengalahkan Daniil Medvedev dan menjadi juara. https://t.co/PSn33rPm2Y,5,0,1,0,2022-01-30,21,Sunday,7,6,0
1487903428521205762,2022-01-30 21:39:55,Jason Momoa resmi bergabung ke waralaba Fast and Furious! https://t.co/lPPbcy0ARS,12,6,4,2,2022-01-30,21,Sunday,7,16,8
1487901618662264840,2022-01-30 21:32:44,"Saat istigasah dan doa bersama almarhum Haji Lulung, anak Lulung mendoakan Anies Baswedan jadi presiden. https://t.co/XqCwPwSMaA",61,52,2,5,2022-01-30,21,Sunday,7,63,57
1487900088563294223,2022-01-30 21:26:39,Komnas HAM mengungkap istilah-istilah khusus dalam kekerasan kerangkeng manusia di rumah Bupati Langkat nonaktif Terbit Rencana Perangin Angin. Apa saja? https://t.co/EO3ABW4Ckk,6,0,1,0,2022-01-30,21,Sunday,7,7,0
1487898770465603585,2022-01-30 21:21:25,Timnas Indonesia unggul 2-0 atas Timor Leste di babak pertama. Gol lahir dari Terens Puhiri dan sepakan jarak jauh Ramai Rumakiek. https://t.co/CTca18HpiE,12,0,0,0,2022-01-30,21,Sunday,7,12,0
1487897521980592129,2022-01-30 21:16:27,"Ketua PWI Kalsel, Zainal Helmi menyayangkan sikap Edy Mulyadi yang melibatkan status profesi wartawan dalam kasus 'jin buang anak'. https://t.co/p8TAJ5qdFq",10,5,2,1,2022-01-30,21,Sunday,7,12,6
1487896523866316803,2022-01-30 21:12:29,Tersangka modus 'tabrak lari' di Jaktim disebut polisi beraksi lantaran harus beli obat dan terapi di RSKO Cibubur. https://t.co/z3AV2YVQk8,11,2,1,3,2022-01-30,21,Sunday,7,12,5
1487894897873068037,2022-01-30 21:06:02,"Gempa magnitudo (M) 5,2 terjadi di timur laut Kabupaten Sabu Raijua, Nusa Tenggara Timur (NTT). Gempa tersebut tidak berpotensi tsunami. https://t.co/I1RXrxsAor",4,0,2,0,2022-01-30,21,Sunday,7,6,0
1487893531456901127,2022-01-30 21:00:36,"Ketua Umum PBNU, Yahya Cholil Staquf, mengungkap alasan pengukungan pengurus PBNU periode 2022-2027 digelar di Balikpapan, Kalimantan Timur. https://t.co/LOGGyZHBFs",9,0,1,0,2022-01-30,21,Sunday,7,10,0
1487891684717477889,2022-01-30 20:53:15,Dulunya Madelene Wright rutin beraksi di lapangan hijau bermain sepakbola. Kini ia eksis lewat foto-foto dengan beragam pose seksi yang lantas dijualnya. https://t.co/Guoa1SkBAG,8,0,0,0,2022-01-30,20,Sunday,7,8,0
1487889475338440704,2022-01-30 20:44:29,"Gubernur Sulawesi Utara, Olly Dondokambey, meresmikan Gereja Sion Tomohon setelah ditetapkan sebagai situs cagar budaya peringkat nasional. https://t.co/uQBwXBwcmB",6,0,1,0,2022-01-30,20,Sunday,7,7,0
1487889211692883972,2022-01-30 20:43:26,"Mason Greenwood kini harus berurusan dengan kepolisian setelah diduga melakukan penganiayaan terhadap kekasihnya, Harriet Robson. https://t.co/PGWHLfg8kF",7,0,0,0,2022-01-30,20,Sunday,7,7,0
1487888056518590466,2022-01-30 20:38:50,Ketua MPR Bambang Soesatyo mengapresiasi peluncuran buku 'Dudung Abdurachman: Membongkar Operasi Psikologi Gerakan Toleransi' yang ditulis oleh Raylis Sumitra. https://t.co/9HWXc3D8Zl,11,3,2,0,2022-01-30,20,Sunday,7,13,3
1487887040612118528,2022-01-30 20:34:48,"""Sebentar lagi Bapak-Ibu sekalian akan jadi orang-orang ibu kota dan orang Jakarta ini akan gantian menjadi orang daerah,"" ujar Gus Yahya. https://t.co/VUiID3ohAt",55,20,3,7,2022-01-30,20,Sunday,7,58,27
1487885159571640323,2022-01-30 20:27:20,Timnas Indonesia terpaksa hanya memiliki lima pemain cadangan saat melawan Timor Leste. Shin Tae-yong mengungkap bahwa 8 pemain Timnas Indonesia positif Corona. https://t.co/1rn1HD1hg4,9,0,1,1,2022-01-30,20,Sunday,7,10,1
1487883361498583042,2022-01-30 20:20:11,"Di tengah amukan Omicron, dunia dihebohkan temuan virus NeoCov. Masih kerabat virus Corona, namun benarkah bakal lebih kalah menular dan mematikan? https://t.co/uH6nWT6SCZ",16,9,4,4,2022-01-30,20,Sunday,7,20,13
1487881530257125378,2022-01-30 20:12:54,Anies Baswedan dan Ridwan Kamil (RK) terlihat 'mesra' tampil bareng. Doktor Ilmu Politik Universitas Paramadina menilai ada kendala keduanya duet di 2024. https://t.co/eetfBZil5X,39,10,4,5,2022-01-30,20,Sunday,7,43,15
1487880213572857858,2022-01-30 20:07:41,Pemerintah melaporkan kasus harian positif Corona hari ini sebanyak 12.422 kasus. Provinsi yang melaporkan kasus tertinggi adalah DKI Jakarta. https://t.co/Q2r4TmK1fi,7,2,1,0,2022-01-30,20,Sunday,7,8,2
1487878640062943235,2022-01-30 20:01:25,Said Didu 'dijewer' Menko Polhukam Mahfud Md gara-gara cuitan 'beruntung' terkait gugurnya 3 prajurit TNI di Papua. Said Didu pun memberi penjelasan. https://t.co/nLlyajr6Xd,4,2,1,0,2022-01-30,20,Sunday,7,5,2
1487876986412404742,2022-01-30 19:54:51,Tentara Prancis menyebut hampir 60 'teroris' di Burkina Faso tewas saat pemberontakan berdarah berkecamuk. https://t.co/Skk97OUPeo,6,0,0,1,2022-01-30,19,Sunday,7,6,1
1487875991338897416,2022-01-30 19:50:54,Newcastle United akhirnya dapat pemain baru lagi. Bruno Guimaraes resmi didatangkan dari Lyon. https://t.co/6FcLeopbL6,4,0,0,0,2022-01-30,19,Sunday,7,4,0
1487874149922095107,2022-01-30 19:43:35,"Mason Greenwood ditahan polisi karena diduga melakukan kekerasan terhadap pacarnya. Akibatnya, ia dibekukan dari skuad Manchester United. https://t.co/bqD5Ato8Bo",6,1,0,0,2022-01-30,19,Sunday,7,6,1
1487872977593155595,2022-01-30 19:38:55,Kecelakaan tunggal kembali terjadi di Tol Cisumdawu. Sebuah minibis menabrak pembatas jalan hingga bagian depan mengalami kerusakan parah. https://t.co/da01NnQdw3,2,0,0,0,2022-01-30,19,Sunday,7,2,0
1487870520443949064,2022-01-30 19:29:10,"Salah satu peserta seleksi KPU RI 2022-2027, Musa Darwin Pane menggugat UU Nomor 7 Tahun 2017 tentang Pemilu, khususnya soal syarat usia anggota Bawaslu. https://t.co/XicwHMb7Qj",5,0,0,0,2022-01-30,19,Sunday,7,5,0
1487868779950448643,2022-01-30 19:22:15,Masyarakat Kaltim mengusulkan bahwa putra daerah harus mendapat kesempatan jadi kepala otorita IKN karena dinilai lebih tahu permasalahan di Kaltim. https://t.co/hG2mZsa1Sx,86,56,10,7,2022-01-30,19,Sunday,7,96,63
1487867706447704065,2022-01-30 19:17:59,"Aliando Syarief alami OCD sejak kelas 2 SD. Pada siswa sekolah, sejumlah tanda ini bisa membantu mengenali OCD sehingga dapat segera konsultasi ke dokter. https://t.co/jYfv1cpIQb",4,0,2,0,2022-01-30,19,Sunday,7,6,0
1487865130289446917,2022-01-30 19:07:44,"Bocah 12 tahun asal Bontang diserang buaya 4 meter saat berenang di Pantai Teluk Lombok, Kutai Timur. Korban RP selamat meski sempat ditarik buaya 50 meter. https://t.co/VvTvN3lPFt",13,0,4,2,2022-01-30,19,Sunday,7,17,2
1487863454476247045,2022-01-30 19:01:05,Gelandang Belanda Donny van de Beek kian dekat ke pintu keluar Manchester United di bursa musim dingin. Van de Beek dilaporkan memilih bergabung dengan Everton. https://t.co/rQA8dYEZyC,4,2,0,0,2022-01-30,19,Sunday,7,4,2
1487862372492578818,2022-01-30 18:56:47,Dua kecelakaan tunggal terjadi di Tol Cisumdawu usai 6 hari dioperasikan pada Selasa (25/1/2022) lalu. Kecelakaan itu terjadi antara Km 165 dan Km 166. https://t.co/mBLUP8bP1D,4,0,1,1,2022-01-30,18,Sunday,7,5,1
1487860089293783042,2022-01-30 18:47:43,Rusia memperlihatkan kemampuan jet tempur Sukhoi SU-30SM2 keluaran terbaru negara itu pada Minggu (30/1). 4 Unit Sukhoi SU-30SM2 dikerahkan ke Kaliningrad. https://t.co/aXSsbBbEYF,10,1,2,1,2022-01-30,18,Sunday,7,12,2
1487857332772085762,2022-01-30 18:36:45,"Gejala Omicron sangat mirip flu, seperti batuk disertai hidung meler dan mampet. Waswas Omicron dikira flu biasa, ini gejala Omicron paling khas menurut dokter. https://t.co/Pgq6C8l5NF",12,2,8,2,2022-01-30,18,Sunday,7,20,4
1487856259604922383,2022-01-30 18:32:29,Manchester United tak mau berkomentar banyak soal kasus penganiayaan yang melibatkan Mason Greenwood. Setan Merah akan menunggu hasil penyelidikan. https://t.co/LwOZK8oipO,1,0,1,1,2022-01-30,18,Sunday,7,2,1
1487854949513973760,2022-01-30 18:27:17,Mesir sukses mengalahkan Maroko 2-1 di perempatfinal Piala Afrika 2021. Mohamed Salah menjadi bintang kemenangan dengan torehan satu gol dan satu assist-nya. https://t.co/j4izpGCOYW,8,0,2,0,2022-01-30,18,Sunday,7,10,0
1487853899893641218,2022-01-30 18:23:07,"Ketentuan UKT atau Uang Kuliah Tunggal telah diatur dalam Permendikbud 25/2020. Bagi calon mahasiswa Unair, UGM, dan UB, cek info UKT di sini ya! https://t.co/4jd56ZWlnL",7,0,1,0,2022-01-30,18,Sunday,7,8,0
1487852766475210764,2022-01-30 18:18:37,Menko Polhukam Mahfud Md 'menjewer' Said Didu gara-gara cuitannya soal gugurnya 3 prajurit TNI yang ditembak oleh KKB di Papua. https://t.co/eUG7bf1SbB,10,1,0,1,2022-01-30,18,Sunday,7,10,2
1487850006845526022,2022-01-30 18:07:39,Belasan kilogram sabu terkuak saat tiga pengedar sabu jaringan Internasional dibekuk petugas gabungan Polres Mesuji. Para pengedar ditangkap di tengah jalan. https://t.co/lPV1WXpDbW,18,0,1,0,2022-01-30,18,Sunday,7,19,0
1487847839145287697,2022-01-30 17:59:02,Edy Mulyadi berlindung dengan UU Pers atas kasus yang menjeratnya di Bareskrim Polri. Sikap Edy Mulyadi itu disorot banyak pihak karena dianggap tak tepat. https://t.co/b3qCweUygS,11,8,0,3,2022-01-30,17,Sunday,7,11,11
1487846049473605638,2022-01-30 17:51:55,Timnas Indonesia cuma menggunakan lima pemain cadangan saat melawan Timor Leste. Hal itu dikarenakan banyak pemain Indonesia yang terpapar virus Corona. https://t.co/fFlnjsJb2i,17,1,2,0,2022-01-30,17,Sunday,7,19,1
1487844980571971595,2022-01-30 17:47:40,Seorang seniman asal Kanada membangun patung logam besar yang menggambarkan naga paling tangguh dalam seri HBO. https://t.co/lCemADuFlu,23,0,2,0,2022-01-30,17,Sunday,7,25,0
1487843150404202500,2022-01-30 17:40:24,"Selain batuk-pilek, gejala nyeri kepala, tubuh lemas, diare, dan mual juga banyak dikeluhkan pasien Omicron. Awas, kerap disangka masuk angin! https://t.co/Xaq0pCMS2X",66,34,26,7,2022-01-30,17,Sunday,7,92,41
1487841018263314435,2022-01-30 17:31:56,Pasukan keamanan Sudan membunuh seorang warga sipil yang berdemonstrasi anti-kudeta militer. https://t.co/0ghYSSJpPt,9,0,1,0,2022-01-30,17,Sunday,7,10,0
1487840124511604743,2022-01-30 17:28:23,Seragam baru petugas satpam berwarna krem akan diperkenalkan pada HUT satpam ke-41 yang akan digelar pada 2 Februari 2022. https://t.co/umeqTDPX6e,17,2,6,2,2022-01-30,17,Sunday,7,23,4
1487838838231810055,2022-01-30 17:23:16,IBL 2022 terganggu oleh kasus COVID-19. Sudah ada tiga pertandingan seri kedua di Bandung yang harus ditunda. https://t.co/e5D8pUYSid,11,1,3,0,2022-01-30,17,Sunday,7,14,1
1487836208503959555,2022-01-30 17:12:49,Masuknya artis Prilly Latuconsina memberi semangat baru buat Persikota Tangerang. Bayi Ajaib bertekad membuat sejumlah gebrakan. https://t.co/MC2AT5hto2,6,0,6,0,2022-01-30,17,Sunday,7,12,0
1487834777243865088,2022-01-30 17:07:08,"Setelah ASIX yang menggarap game P2E kripto, kini Anang Hermansyah juga merambah NFT lain. Ia jadikan foto cantik Ashanty NFT. https://t.co/X5T7ICBogF",4,0,1,0,2022-01-30,17,Sunday,7,5,0
1487833668773191685,2022-01-30 17:02:43,Raffi Ahmad beri kelas bisnis untuk karyawan. Ia nggak pandang bulu. https://t.co/i0pIs3hJaf,18,1,1,0,2022-01-30,17,Sunday,7,19,1
1487831890614792192,2022-01-30 16:55:39,"Kejati Sumut menangkap buronan berinisial WA, eks Kepala Cabang Bank Syariah Mandiri (BSM) Medan, Sumut, terkait dugaan korupsi kredit fiktif Rp 27 miliar. https://t.co/0Tpf9gCOKd",8,0,5,0,2022-01-30,16,Sunday,7,13,0
1487831042656514052,2022-01-30 16:52:17,Ulah hacker yang menyusup di sesi video conference atau Zoombombing terjadi lagi. Kali ini saat webinar Riset Pengembangan Vaksin COVID-19 yang digelar BRIN.  https://t.co/sUSYiBnWxQ,59,22,27,12,2022-01-30,16,Sunday,7,86,34
1487828736703614986,2022-01-30 16:43:08,"Tersangka pemerasan AF modus 'tabrak lari' dibenarkan polisi punya luka di kaki. Namun ternyata, luka itu merupakan luka lama tahun 2012. https://t.co/XmBDgwdJJA",17,15,4,8,2022-01-30,16,Sunday,7,21,23
1487827540366475271,2022-01-30 16:38:22,Kadang hal yang tampak sederhana bisa jadi jebakan yang mengecoh logika. Buktikan kecerdasan kamu dengan menjawab teka-teki ini. https://t.co/DsNhLZp9Fs,107,82,16,9,2022-01-30,16,Sunday,7,123,91
1487826462124253191,2022-01-30 16:34:05,#FOTO Atta Halilinta makin percaya diri dengan penampilan barunya. Ia mulai meninggalkan bandana yang selama ini jadi ciri khasnya. Ini potret Atta:  https://t.co/nuRyRbSCs1,10,5,1,3,2022-01-30,16,Sunday,7,11,8
1487825253011177477,2022-01-30 16:29:17,"2 tahun Aliando Syarief menghilang dari dunia hiburan. Kini, Aliando muncul dan mengumumkan dirinya tengah mengidap OCD.  https://t.co/2zbMcurDnH",14,2,0,2,2022-01-30,16,Sunday,7,14,4
1487824430030106626,2022-01-30 16:26:01,"#FOTO Fenomena langka terjadi di Gurun Sahara. Di gurun pasir terbesar dunia yang biasanya tandus dan diliputi pasir tersebut, turun salju. Ini potretnya:  https://t.co/29HsW5aZVI",17,3,2,0,2022-01-30,16,Sunday,7,19,3
1487823561825959936,2022-01-30 16:22:34,"Blora, Jawa Tengah memiliki tempat wisata kuliner baru. Di Dukuh Pilang, Desa Nglanjuk, Kecamatan Cepu, sekarang hadir 'Pasar Tiban Pinggir Sawah'. https://t.co/NSsuSPKV82",11,3,2,0,2022-01-30,16,Sunday,7,13,3
1487822263592361993,2022-01-30 16:17:24,"Penganiayaan terhadap anjing hingga mati terjadi di Kabupaten Minahasa Utara (Minut), Sulawesi Utara. Aksi keji penyiksaan hewan terekam kamera CCTV. Polisi telah melakukan penyelidikan terhadap kasus ini. https://t.co/tVaB8lYImd",24,25,5,7,2022-01-30,16,Sunday,7,29,32
1487820684701184002,2022-01-30 16:11:08,"Tempat ngopi yang berada di kawasan Garut ini lagi hits di kalangan anak muda. Pasalnya, kedai kopi ini berada di tempat terbuka dan dikeliling hutan pinus. https://t.co/VU51ZdRqvh",12,0,2,0,2022-01-30,16,Sunday,7,14,0
1487819247682207752,2022-01-30 16:05:25,"Crazy Rich dari Medan, Indra Kenz pernah bilang broker binary option Binomo legal. Ini buktinya:  https://t.co/7bJN2p73uo",64,22,18,7,2022-01-30,16,Sunday,7,82,29
1487818409027018757,2022-01-30 16:02:05,Ray J buka suara soal kabar video seks kedua antara dirinya dan Kim Kardashian. Ia memohon agar Kim tak lagi membahas hal itu.  https://t.co/VtZgahEFYy,4,0,1,0,2022-01-30,16,Sunday,7,5,0
1487817323419475968,2022-01-30 15:57:46,Yuk latih otak kamu agar bisa lancar memecahkan masalah. Teka-teki ini bisa membuktikan apakah kamu jenius. https://t.co/7l5Ly82vKC,28,29,1,0,2022-01-30,15,Sunday,7,29,29
1487815651188252672,2022-01-30 15:51:08,Tebak-tebakan ini akan menguji kemampuan dasar berhitung kamu. Cocok buat yang ngaku jago matematika dan ingin membuktikannya. https://t.co/o7nO56sSVT,8,9,1,1,2022-01-30,15,Sunday,7,9,10
1487814550170869762,2022-01-30 15:46:45,"Jeff Bezos kabarnya akan jadi pemilik baru kapal pesiar mewah senilai Rp 7,1 triliun. Seperti ini wujud kapal pesiar mewah yang diduga pesanannya:  https://t.co/4y22E1E8Cz",4,1,1,2,2022-01-30,15,Sunday,7,5,3
1487813391527952385,2022-01-30 15:42:09,"Para bintang TikTok semakin kaya raya, bahkan pendapatan sebagian dari mereka disebut telah menyamai bahkan melebihi penghasilan CEO di perusahaan top. https://t.co/Y427iC8bg5",6,1,0,0,2022-01-30,15,Sunday,7,6,1
1487812205961785348,2022-01-30 15:37:26,Dorce ingin dimakamkan sebagai perempuan. Denny Sumargo ungkap itu pesannya dia. https://t.co/mNbzMVySyD,7,3,1,1,2022-01-30,15,Sunday,7,8,4
1487811078981668867,2022-01-30 15:32:58,Sertifikat vaksin Covid-19 internasional yang dikeluarkan oleh Kemenkes dapat diakses melalui aplikasi PeduliLindungi. Begini cara download sertifikatnya:   https://t.co/pquMmcTlQt,21,2,9,0,2022-01-30,15,Sunday,7,30,2
1487809617560313856,2022-01-30 15:27:09,Dinar Candy akan nge-DJ di Double O Sorong. Ia bakal antisipasi kalau ada kerusuhan lagi. https://t.co/lZ3Nj8xRGe,3,0,0,1,2022-01-30,15,Sunday,7,3,1
1487808012999962636,2022-01-30 15:20:47,"Ketua Kwartir Nasional Gerakan Pramuka Budi Waseso menyatakan pesawat Sky Ranger 912 FASI yang diawaki dua orang jatuh di lokasi perkemahan Cibubur, Jakarta. https://t.co/0Ll7xuaAla",5,0,1,0,2022-01-30,15,Sunday,7,6,0
1487807125103411200,2022-01-30 15:17:15,"Setelah wawancara Ririe Fairus bersama Maia Estianty viral, cuplikan video pendek dari Nissa Sabyan saat ditanya soal poligami jadi sorotan. https://t.co/XdgOQAbhOy",12,3,0,1,2022-01-30,15,Sunday,7,12,4
1487806042331353088,2022-01-30 15:12:57,"Mengikuti jejak Raffi Ahmad dan Atta Halilintar, kini Prilly Latuconsina juga bergabung dalam jajaran pemilik klub sepakbola. Secara resmi Prilly mengumumkan bahwa ia bergabung dengan Persikota Tangerang sebagai pemilik. https://t.co/rIthqeXDOM",61,4,8,7,2022-01-30,15,Sunday,7,69,11
1487804854181502977,2022-01-30 15:08:13,"Inilah daftar paspor yang benar-benar sakti. Karena, berkas ini yang mampu membuka semua pintu negara. Apa saja ya? https://t.co/rxgxbYNf0J",38,1,8,1,2022-01-30,15,Sunday,7,46,2
1487803938325905410,2022-01-30 15:04:35,#Terpopuler Pencarian terhadap makhluk hidup atau alien di luar Bumi makin diintensifkan. Lembaga antariksa NASA dan SETI Institute berharap akan ada titik terang. https://t.co/LQrjaovcvL,21,3,8,6,2022-01-30,15,Sunday,7,29,9
1487803213332066311,2022-01-30 15:01:42,"Persija Jakarta tumbang 1-0 dari tim juru kunci Persiraja Banda Aceh, Macan Kemayoran punya peluang menyamakan kedudukan tapi penalti Tony Sucipto gagal. https://t.co/g4M5XMzxKk",8,0,0,0,2022-01-30,15,Sunday,7,8,0
1487802561495244800,2022-01-30 14:59:07,"Adama Traore resmi kembali ke Barcelona, tempatnya merintis dan mengawali karier profesional. Ia kini juga bukan Adama yang dulu lagi, khususnya soal fisik. https://t.co/cgGb82ykXr",4,0,0,0,2022-01-30,14,Sunday,7,4,0
1487801612601106435,2022-01-30 14:55:21,"Jumlah pasien COVID-19 varian Omicron di RSDC Wisma Atlet Kemayoran, Jakarta, kini ada 1.033. Dari total kasus Omicron itu, 995 di antaranya sudah sembuh. https://t.co/NAOJ199eCq",17,3,3,0,2022-01-30,14,Sunday,7,20,3
1487800531900895232,2022-01-30 14:51:03,Komnas HAM menemukan ada kekerasan samai hilangkan nyawa dalam kerangkeng manusia di rumah Bupati Langkat Terbit Rencana Perangin Angin.  https://t.co/ZqGdzlrtbS,17,3,3,1,2022-01-30,14,Sunday,7,20,4
1487800512258977793,2022-01-30 14:50:58,Prilly Latuconsina mendeklarasikan dirinya kini adalah pemilik klub bola Persikota Tangerang. Ini cerita Prilly:  https://t.co/XaclHmBJDz,15,1,1,0,2022-01-30,14,Sunday,7,16,1
1487800480453570561,2022-01-30 14:50:51,"Seorang bocah 12 tahun berinisial RP diserang buaya berukuran 4 meter saat di pinggir Pantai Teluk Lombok, Kutai Timur, Kalimantan Timur. Namun, selamat. https://t.co/7G7PSrI5vT",8,4,2,0,2022-01-30,14,Sunday,7,10,4
1487799103899770882,2022-01-30 14:45:22,Komisi Pemilihan Umum telah menetapkan Pemilu 2024 digelar pada bulan Februari. Komisioner KPU Ilham Saputra membeberkan sejumlah alasan ini:  https://t.co/y0rIDFZiXz,1,0,0,1,2022-01-30,14,Sunday,7,1,1
1487798294373875715,2022-01-30 14:42:09,"Polres Jakarta Timur menetapkan AF sebagai tersangka fitnah dan pemerasan dalam kasus modus tabrak lari di Pasar Rebo, Jaktim. Pelaku dijerat dua pasal sekaligus dengan ancaman penjara paling lama 4 tahun. https://t.co/kIznYRjsV3",18,3,0,1,2022-01-30,14,Sunday,7,18,4
1487797215578009607,2022-01-30 14:37:52,Mason Greenwood dalam masalah besar. Penyerang Manchester United itu diklaim memukul pacarnya hingga babak belur. https://t.co/UYXqDjeTS4,16,0,2,2,2022-01-30,14,Sunday,7,18,2
1487796546557128709,2022-01-30 14:35:13,Adele membatalkan konser di Las Vegas hanya dalam hitungan kurang dari 24 jam sebelum acara itu seharusnya dimulai. Ada yang bilang karena dia galau soal pacar. https://t.co/DCoLNqxRuH,27,9,5,5,2022-01-30,14,Sunday,7,32,14
1487795502531948547,2022-01-30 14:31:04,Pengusaha menegaskan tidak ada upaya penimbunan stok minyak goreng di seluruh toko-toko ritel yang ada di Indonesia dan menyebabkan kelangkaan pasokan. https://t.co/xBBCZyem22,15,10,2,4,2022-01-30,14,Sunday,7,17,14
1487795211526889477,2022-01-30 14:29:54,"Seperti flu biasa, infeksi Omicron memicu gejala hidung mampet, meler, dan batuk. Batuk seperti apa yang menandakan infeksi Omicron? Ini penjelasan dokter paru:  https://t.co/wUUv2FpURq",41,3,21,4,2022-01-30,14,Sunday,7,62,7
1487793809530388483,2022-01-30 14:24:20,"Polisi mengungkap, pelaku modus 'tabrak lari' di Jakarta Timur tengah menjalani terapi metadon. Apa sih itu terapi metadon? Ini fakta-faktanya:  https://t.co/UDGWY4VLUl",14,1,2,0,2022-01-30,14,Sunday,7,16,1
1487791366231015429,2022-01-30 14:14:38,"Timnas Indonesia mampu menumbangkan Timor Leste 3-0 dalam laga uji coba. Tiga gol Garuda lahir dari Terens Puhiri, Ramai Rumakiek, dan Ricky Kambuaya. https://t.co/8aiUJubcMB",41,2,4,0,2022-01-30,14,Sunday,7,45,2
1487790228395933697,2022-01-30 14:10:06,"Nggak cuma untuk membaca peruntungan, romansa, dan sifat seseorang, tapi zodiak juga bisa mengetahui jurusan kuliah apa yang cocok. Ini tipe yang cocok untuk kamu: (part 2) https://t.co/fJT3Bf0n3R",6,0,2,1,2022-01-30,14,Sunday,7,8,1
1487789233217720323,2022-01-30 14:06:09,"Langit selepas petang memberi pesan. Hari selesai, bersiap menuju malam. Transisi ini beri keajaiban visual yang sedap diilihat. Cocok buat para pencari senja. https://t.co/RdCAq2Qb4d",13,1,5,1,2022-01-30,14,Sunday,7,18,2
1487788358764052482,2022-01-30 14:02:41,"Ramai diperbincangkan soal husband stitch, jahitan tambahan yang disebut-sebut dapat memuaskan suami saat berhubungan seks setelah persalinan normal. #detiknetwork  https://t.co/2lqPE4SbLy",14,2,4,0,2022-01-30,14,Sunday,7,18,2
1487788353076477957,2022-01-30 14:02:39,"Program vaksinasi dosis ketiga #Covid19 sudah bisa diperoleh masyarakat umum, dengan prioritas lansia dan yang memiliki penyakit komorbid. Bagi Anda yang ingin melakukan booster, #Intip hal yang perlu dan tidak dibolehkan setelah booster di #detiknetwork  https://t.co/se3pkD2238",3,1,2,0,2022-01-30,14,Sunday,7,5,1
1487786648242991106,2022-01-30 13:55:53,"Polisi menangkap sekelompok pemuda terlibat tawuran di Pos Pengumben, Kebon Jeruk, Jakarta Barat. Kelompok pemuda itu dikenal dengan nama gengster 'Joglo 92'. https://t.co/AzkMp4dlpt",6,3,2,3,2022-01-30,13,Sunday,7,8,6
1487785795423551491,2022-01-30 13:52:30,"Beberapa orang mengeluh tidak enak badan usai menerima vaksin booster. Tidak perlu panik, ada beberapa tips untuk membantu meredakannya. https://t.co/R9CbcPZiNT",5,0,6,2,2022-01-30,13,Sunday,7,11,2
1487785504858902530,2022-01-30 13:51:20,Ibu dan anak ini jadi viral di TikTok karena kemiripan keduanya. Sang ibu bahkan kerap disebut sebagai saudara kembar dengan anaknya. https://t.co/B8Nbzh2Sl3,5,0,2,0,2022-01-30,13,Sunday,7,7,0
1487782364868661253,2022-01-30 13:38:52,"Belum beres urusan Omicron, dunia kini geger soal temuan virus NeoCov. Bukan varian Corona, peneliti minta masyarakat tidak panik soal NeoCov. Ini alasannya:  https://t.co/CO5b8dHsix",12,3,7,5,2022-01-30,13,Sunday,7,19,8
1487782343016435712,2022-01-30 13:38:46,Gubernur Jawa Barat Ridwan Kamil meresmikan Kuningan Command Center dalam kunjungan kerjanya ke Kabupaten Kuningan pada Minggu (30/1/2022). https://t.co/CtvfyUy4zf,3,0,2,0,2022-01-30,13,Sunday,7,5,0
1487781449344368640,2022-01-30 13:35:13,Apa saja isi seserahan pernikahan untuk pria agar tampak pantas saat diberikan kepada keluarga calon pasangan? Berikut daftarnya:  https://t.co/kgP5BHFPcF,16,1,6,3,2022-01-30,13,Sunday,7,22,4
1487780088611545091,2022-01-30 13:29:49,Olivier Giroud mengawali kariernya di AC Milan dengan tidak mulus. Giroud kini sudah bebas masalah dan siap bersinar di tahun yang baru. https://t.co/seVtlQqZwq,8,0,1,0,2022-01-30,13,Sunday,7,9,0
1487779168947519488,2022-01-30 13:26:10,Bruno Fernandes mengungkap tiga momen yang paling dikenangnya selama dua tahun bermain untuk Manchester United.  https://t.co/DRTOtI1rIs,13,2,1,0,2022-01-30,13,Sunday,7,14,2
1487778397245915140,2022-01-30 13:23:06,Viral unggahan suami yang mengatakan jangan bantu istri mendapatkan reaksi dari warganet.  https://t.co/SbU4nSiSje,10,1,2,0,2022-01-30,13,Sunday,7,12,1
1487776959652417539,2022-01-30 13:17:23,"Ening (61), warga Kecamatan Sukaresik, Kabupaten Tasikmalaya tewas tersambar kereta api saat sedang berjalan di atas jembatan rel. https://t.co/iXXHGlgZdT",8,0,0,0,2022-01-30,13,Sunday,7,8,0
1487776027703230468,2022-01-30 13:13:41,Pedagang oleh-oleh di Jalur Cileunyi-Sumedang terdampak beroperasinya Tol Cisumdawu seksi 1. Mereka mengalami penurunan penjualan usai ruas tol itu beroperasi. https://t.co/sp1lEHrbO4,13,0,2,1,2022-01-30,13,Sunday,7,15,1
1487774112114221056,2022-01-30 13:06:04,Selesai sudah proses transfer Luis Diaz. Liverpool baru saja mengumumkan Diaz sebagai pemain barunya. https://t.co/71qrpw1HRX,8,0,1,1,2022-01-30,13,Sunday,7,9,1
1487772660520177664,2022-01-30 13:00:18,Video voral di media sosial soal masa lalu Karina Nadila. Rupanya ia tidak pernah mengenal sosok ayah kandungnya. Ini kata Karina Nadila:  https://t.co/U1y80eIG2A,8,2,1,0,2022-01-30,13,Sunday,7,9,2
1487771861723320321,2022-01-30 12:57:07,K-Talk kali ini bahas Our Beloved Summer. Ini kisah CLBK dengan closure memuaskan. #KTalk  https://t.co/v0p4SDWeTi,16,1,3,1,2022-01-30,12,Sunday,7,19,2
1487770761364492288,2022-01-30 12:52:45,"Setelah mengumumkan bercerai dari Lisa Bonet, Jason Momoa tertangkap kamera tinggal di sebuah van kemping seharga Rp 10 miliar. https://t.co/AaihzELevS",12,0,3,1,2022-01-30,12,Sunday,7,15,1
1487769835786416136,2022-01-30 12:49:04,Polisi berikan sejumlah tips bagi masyarakat jika mendapati kejadian serupa pemerasan modus 'tabrak lari'. Ini tips dari polisi:  https://t.co/NoMjw6a8c4,20,2,5,1,2022-01-30,12,Sunday,7,25,3
1487768777034977282,2022-01-30 12:44:52,Sejarawan UGM tidak setuju jika Nusantara dijadikan nama IKN. Ada hal-hal yang hilang bila nama ibu kota memakai nama baru. https://t.co/KPjOLlwkv2,28,10,5,1,2022-01-30,12,Sunday,7,33,11
1487766998255906823,2022-01-30 12:37:48,"Beberapa lalu Casio merilis G-Shock edisi khusus Timnas Indonesia, kini bagi para Cules bisa mengkoleksi G-Shock edisi Barcelona hadir secara terbatas. https://t.co/PgsK5UJXGA",12,3,3,3,2022-01-30,12,Sunday,7,15,6
1487766452103000067,2022-01-30 12:35:38,Musisi bisa memiliki keuntungan lebih jika mampu menjual karya musiknya lewat Non-Fungible Tokens (NFT). Keuntungannya bukan cuma cuan. https://t.co/oYOJMhgVSP,11,0,6,1,2022-01-30,12,Sunday,7,17,1
1487765688152375302,2022-01-30 12:32:36,"Timnas Inggris didesak bicara soal dugaan pelanggaran HAM yang dilakukan Qatar, jelang tampil di Piala Dunia 2022. Bertabur bintang jadi alasannya. https://t.co/YnNiNcbHVe",9,0,3,0,2022-01-30,12,Sunday,7,12,0
1487763918646820865,2022-01-30 12:25:34,"Setelah viral kerumunan pengunjung, PT Tangerang Nusantara Global (TNG) selaku pengelola Pasar Lama Tangerang akan menutup sementara kawasan tersebut. https://t.co/pDvUIJELOY",66,27,32,41,2022-01-30,12,Sunday,7,98,68
1487763690585825294,2022-01-30 12:24:39,Liburan ke objek wisata Pangandaran tidak hanya menjajal keindahan alamnya saja. Wisatawan wajib tahu pusat seafood dan hiburan malam ada di Kampung Turis. https://t.co/HNlfkgbFPh,11,1,5,0,2022-01-30,12,Sunday,7,16,1
1487762918699683846,2022-01-30 12:21:35,"Infeksi Omicron memicu gejala yang relatif ringan seperti batuk-pilek, badan lemas, sakit kepala, hingga masalah pencernaan. Waduh, kok mirip masuk angin? Ini pesan dokter:   https://t.co/GUPbZmGEgI",24,11,28,6,2022-01-30,12,Sunday,7,52,17
1487761886544338946,2022-01-30 12:17:29,Fisikawan telah menemukan partikel misterius dari awal waktu. Partikel X ini disebut berasal dari detik-detik pertama pembentukan semesta. https://t.co/32kmdq9Ah7,18,0,4,0,2022-01-30,12,Sunday,7,22,0
1487761025629892608,2022-01-30 12:14:04,"1,35 miliar unit ponsel dikapalkan sepanjang tahun 2021. Samsung mencatatkan pengapalan terbesar, yaitu 271 juta unit, dan diikuti oleh Apple di posisi kedua. https://t.co/w8eHWGgMQY",18,3,2,1,2022-01-30,12,Sunday,7,20,4
1487759977624256526,2022-01-30 12:09:54,"Mengusung konsep toko dengan ekosistem perangkat cerdas, OPPO eXperience Store kini hadir untuk mempertemukan berbagai konsumen, komunitas, dan merek OPPO. https://t.co/k1V1ctxWXi",8,1,1,0,2022-01-30,12,Sunday,7,9,1
1487759462358208512,2022-01-30 12:07:51,"Telkom bekerjasama dengan Gabungan Kelompok Tani (Gapokan) Tani Mulus Indrayamayu, Jawa Barat, berbagi pendapatan hasil panen sampai Rp 1 miliar. https://t.co/qEBlbi9WAs",4,1,1,0,2022-01-30,12,Sunday,7,5,1
1487758608154640386,2022-01-30 12:04:28,"Beredar video viral menunjukkan puluhan satpam telah mengenakan seragam baru, ragam komentar netizen pun banyak yang bilang mirip polisi di India. https://t.co/x73hSLwJvG",516,211,115,59,2022-01-30,12,Sunday,7,631,270
1487757736758718468,2022-01-30 12:01:00,Sutradara Jon Watts mengungkapkan kisah ketika menyatukan tiga Spider-Man dalam No Way Home. Ia mengaku sempat khawatir karena mengumpulkan ketiga Spider-Man termasuk para penjahat lintas semesta yang telah familier di hati penggemar. #CNNIndonesia  #de... https://t.co/sdzdFStpVS,10,1,2,0,2022-01-30,12,Sunday,7,12,1
1487756941241851907,2022-01-30 11:57:50,Artis Prilly Latuconsina resmi masuk jajaran pemilik Persikota Tangerang. Pihak klub juga sudah mengonfirmasinya membeli saham Persikota. https://t.co/N4r5igNuPh,20,1,0,2,2022-01-30,11,Sunday,7,20,3
1487756164389560320,2022-01-30 11:54:45,"Ronaldo Kwateh dan Marselino Ferdinan tak lekas berpuas diri usai debut di Timnas Indonesia. Jika dapat kesempatan berikutnya, mereka bertekad main lebih baik. https://t.co/cR6BdM7Xeb",8,0,1,0,2022-01-30,11,Sunday,7,9,0
1487755629334781953,2022-01-30 11:52:37,"Sembilan pemain Persib Bandung absen dalam pertandingan melawan Persikabo 1973 dalam lanjutan BRI Liga 1, Sabtu (29/1) karena sedang jalani karantina setelah dinyatakan terpapar COVID-19. https://t.co/hYUg278Q2r",5,0,2,1,2022-01-30,11,Sunday,7,7,1
1487754981029691401,2022-01-30 11:50:03,Juventus rupanya belum puas dengan kedatangan Dusan Vlahovic. Bianconeri masih ingin menggaet gelandang Borussia Moenchengladbach Denis Zakaria. https://t.co/wUFNq9xuQ1,6,0,0,0,2022-01-30,11,Sunday,7,6,0
1487754434222374912,2022-01-30 11:47:52,Teknologi seluler generasi ketiga alias 3G tengah dihadapi akhir hayatnya di Indonesia. Masyarakat sudah siap-siap merasakan internet cepat? https://t.co/AYmMxhNFAv,6,0,1,0,2022-01-30,11,Sunday,7,7,0
1487753316780187651,2022-01-30 11:43:26,"Seorang karyawan baru Tencent, raksasa internet China, bikin heboh media sosial setempat. Ia dengan berani memprotes sistem kerja di Tencent. https://t.co/JamSb8si2Z",12,0,3,2,2022-01-30,11,Sunday,7,15,2
1487753298383974410,2022-01-30 11:43:22,Ini beberapa hal yang bisa dijual musisi lewat NFT. Tak cuma musik lho...  https://t.co/R4gEWt2paW,4,1,0,0,2022-01-30,11,Sunday,7,4,1
1487752743112613889,2022-01-30 11:41:09,"Hari ini Indonesia mencatat 12.422 kasus baru virus Corona dalam sehari. Selama sepekan terakhir, kasus Corona terus mengalami lonjakan.  https://t.co/oMMr5s5HXk",27,9,8,9,2022-01-30,11,Sunday,7,35,18
1487750890266054657,2022-01-30 11:33:47,"""Dunia kita nggak bakal berakhir cuma karena cerai doang. Aku sendiri udah ngerasain."" https://t.co/9Zl5kwd15s",21,3,5,1,2022-01-30,11,Sunday,7,26,4
1487750646644228097,2022-01-30 11:32:49,Badai salju menerjang sejumlah wilayah di Amerika Serikat. Salju yang menutupi jalanan kota New York bahkan dimanfaatkan warga untuk bermain ski. Ini potretnya:  https://t.co/2xCq29iI6R,6,0,1,0,2022-01-30,11,Sunday,7,7,0
1487749994710982661,2022-01-30 11:30:14,"Lonjakan COVID-19 RI berlanjut, jumlah kasus aktif terus bertambah. Tercatat 61.718 kasus aktif, Minggu (30/1/2022), DKI menyumbang sebanyak 28.702 kasus. https://t.co/RgbCZuuOX7",6,1,5,0,2022-01-30,11,Sunday,7,11,1
1487749979615678466,2022-01-30 11:30:10,Seorang pria melakukan eksperimen gila makan daging mentah setiap hari. Apa sih alasannya melakukan percobaan nekat tersebut? Ini ceritanya:   https://t.co/3lSLY7fsH1,5,3,2,0,2022-01-30,11,Sunday,7,7,3
1487749437673852929,2022-01-30 11:28:01,"PBNU menggelar istighosah di Penajam Paser Utara, Kalimantan Timur. Ketua Umum PBNU berharap kantor PBNU telah siap berdiri di Ibu Kota baru Nusantara. https://t.co/HM6mkpv8lW",13,1,3,4,2022-01-30,11,Sunday,7,16,5
1487748968490668033,2022-01-30 11:26:09,Logitech G memulai 2022 dengan memboyong keyboard mekanikal yang dijual dengan harga terjangkau tersedia dalam versi full size dan TKL. https://t.co/p7YLX836dU,3,0,1,0,2022-01-30,11,Sunday,7,4,0
1487748946378301440,2022-01-30 11:26:04,"Laga uji coba Indonesia Vs Timor Leste akan dimainkan nanti malam, Minggu (30/1). Link live streaming laga tersebut bisa disimak di sini:  https://t.co/z4Cw2sPN73",2,1,1,0,2022-01-30,11,Sunday,7,3,1
1487748445091807234,2022-01-30 11:24:04,"Angka positif harian Covid-19 DKI Jakarta kembali mengalami lonjakan. Hal itu membuat keterisian tempat tidur, atau BOR 140 RS Rujukan COVID-19 DKI Jakarta meningkat jadi 56%.  https://t.co/UYYh4zAw1z",6,0,4,2,2022-01-30,11,Sunday,7,10,2
1487747946452033539,2022-01-30 11:22:06,Gejala Omicron yang amat mirip dengan flu biasa bikin khawatir banyak warga RI. Ini gejala paling khas pada Omicron menurut dokter paru:  https://t.co/d2FuYNJbeA,5,2,3,2,2022-01-30,11,Sunday,7,8,4
1487747377926746115,2022-01-30 11:19:50,"Seorang ibu nekat melempar putrinya yang masih berusia 3 tahun ke dalam kandang beruang di kebun binatang Tashkent, Uzbekistan.  https://t.co/OPb2dYY7a3",4,1,3,1,2022-01-30,11,Sunday,7,7,2
1487745846485659651,2022-01-30 11:13:45,"Saat imajinasi dibiarkan menjadi liar, mungkin nasibnya akan menjadi seperti deretan foto-foto ini:  https://t.co/wnagoJg9Fj",5,0,1,0,2022-01-30,11,Sunday,7,6,0
1487745835869868032,2022-01-30 11:13:42,"Indonesia mencatat sebanyak 12.422 kasus baru COVID-19, Minggu (30/1/2022). DKI menyumbang kasus terbanyak dengan jumlah 6.613. https://t.co/sAM0Zm8Y0U",6,7,6,5,2022-01-30,11,Sunday,7,12,12
1487744853979062272,2022-01-30 11:09:48,"Satu unit motor matik yang empat hari parkir di Desa Kurung, Kecamatan Ceper, Klaten, sempat ramai dibahas di medsos. Pemilik motor ternyata lupa.  https://t.co/eNXudN1Jbq",4,0,3,1,2022-01-30,11,Sunday,7,7,1
1487743785924796420,2022-01-30 11:05:34,Ramalan zodiak cinta Aries jalani hidup ini dengan sesantai mungkin agar pikiran dan hati bisa damai. Simak ramalan zodiak cinta hari ini: https://t.co/La20yOEjyq,2,0,0,0,2022-01-30,11,Sunday,7,2,0
1487743542747357184,2022-01-30 11:04:36,Kepadatan pengunjung di kawasan kuliner Pasar Lama Tangerang jadi sorotan. Pengelola tak menampik hal tersebut. https://t.co/y8kksDiBWs,10,2,2,1,2022-01-30,11,Sunday,7,12,3
1487743249150316546,2022-01-30 11:03:26,"Vihara Dharma Bhakti di Jalan Petak Sembilan, Glodok, Jakarta Barat mulai didatangi warga menjelang Tahun Baru Imlek 2573 Kongzili. Begini suasananya:  https://t.co/MB8gflvVcN",3,1,0,0,2022-01-30,11,Sunday,7,3,1
1487742479839420424,2022-01-30 11:00:22,"Nama Lia Thomas, seorang atlet renang transgender, sedang jadi buah bibir. Seorang rekan satu timnya curhat, risih dengan kehadirannya di ruang ganti. https://t.co/c430928JX5",3,1,0,1,2022-01-30,11,Sunday,7,3,2
1487742234833342465,2022-01-30 10:59:24,Satu lagi artis yang mengumumkan terpapar virus COVID-19 ialah Giorgino Abraham. Ia ingin segera kembali kuat...  https://t.co/0P2hhULr95,9,1,1,1,2022-01-30,10,Sunday,7,10,2
1487741480181678087,2022-01-30 10:56:24,"Tak cuma telaten menjaga diri, Ronaldo rupanya juga peduli pada tumbuh-kembang anak. Itu mengapa Ronaldo belum memberi izin anaknya punya HP sendiri. https://t.co/NpCHVSRJo1",54,6,3,1,2022-01-30,10,Sunday,7,57,7
1487740694940856321,2022-01-30 10:53:17,"Indonesia mencatatkan 12.422 kasus baru virus Corona COVID-19, Minggu (30/1/2022). Jumlah pasien sembuh bertambah 3.241 kasus, meninggal dunia 18 kasus. https://t.co/loMDYKxyKL",7,2,9,2,2022-01-30,10,Sunday,7,16,4
1487739725326823424,2022-01-30 10:49:26,"Salah satu akademisi bidang jurnalistik Camelia Pasandaran, menyatakan karakter konten Edy Mulyadi bukan merupakan produk jurnalistik. https://t.co/Oqw5MqfmL4",15,7,1,1,2022-01-30,10,Sunday,7,16,8
1487739208328527873,2022-01-30 10:47:22,Artis Prilly Latuconsina resmi masuk jajaran pemilik Persikota Tangerang. Pihak klub juga sudah mengonfirmasinya membeli saham Persikota. https://t.co/QSHREqUS6D,18,0,0,0,2022-01-30,10,Sunday,7,18,0
1487737908035522560,2022-01-30 10:42:12,"AD (37), perampok bengis yang menewaskan mahasiswi di Lampung Timur tewas di tangan polisi saat ditangkap. Perlawanan AD berakhir didor petugas. https://t.co/2Q8Q7tvilK",8,2,1,1,2022-01-30,10,Sunday,7,9,3
1487736850898993155,2022-01-30 10:38:00,Seorang tukang cukur rambut di Bogor nyari dibacok pelanggan. Pelanggan itu marah diduga karena cukuran tidak sesuai. https://t.co/hNhcnXtfqB,165,84,65,40,2022-01-30,10,Sunday,7,230,124
1487736368298139649,2022-01-30 10:36:05,Seorang turis jadi korban saat sedang bersafari di Taman Nasional Uganda. Ini yang terjadi kalau tidak mengikuti peraturan:  https://t.co/NjKcrNoq6K,6,0,1,0,2022-01-30,10,Sunday,7,7,0
1487735799076511744,2022-01-30 10:33:49,Bripka Bayu Tamtomo meminta maaf ke mahasiswi DV karena telah memperkosa korban. https://t.co/j1Z1IvHuDj,10,7,6,1,2022-01-30,10,Sunday,7,16,8
1487735373862215680,2022-01-30 10:32:08,Gubernur DKI Jakarta Anies Baswedan menyebut kata terpenting dalam 'Bhinneka Tunggal Ika' adalah 'Tunggal'. Ini penjelasannya:  https://t.co/n4M9gp9ZV6,6,4,5,0,2022-01-30,10,Sunday,7,11,4
1487734739914080259,2022-01-30 10:29:37,Gubernur DKI Jakarta Anies Baswedan dan Gubernur Jawa Barat Ridwan Kamil kembali tampil bersama. Momen 'mesra' keduanya ini bukan kali pertama terjadi. https://t.co/EHakYoYGze,43,25,3,2,2022-01-30,10,Sunday,7,46,27
1487733676234481672,2022-01-30 10:25:23,"Liverpool kabarnya melarang Sadio Mane untuk tampil di Perempatfinal Piala Afrika 2021. Tapi, permintaan The Reds itu sulit terwujud. Kenapa ya? https://t.co/CLA4z8TTrs",3,0,1,0,2022-01-30,10,Sunday,7,4,0
1487732804586778630,2022-01-30 10:21:56,Mola TV mengumumkan platform streaming miliknya akan dikenaka biaya sejak 8 Februari 2022 dan tidak memperpanjang penayangan siaran Liga Inggris musim depan. https://t.co/rC7IBGXGYG,6,5,2,2,2022-01-30,10,Sunday,7,8,7
1487732304436944899,2022-01-30 10:19:56,Sebanyak 200 lapak di Pasar Sedayu Gresik terbakar. Kebakaran yang diduga akibat korsleting listrik itu mengakibatkan kerugian mencapai 2 miliar rupiah. Ini potretnya:  https://t.co/e59ctlumFw,4,0,0,1,2022-01-30,10,Sunday,7,4,1
1487731205873283073,2022-01-30 10:15:34,Kemenprekraf menyebut kasus turis yang diduga jadi korban jebakan karantina itu terjadi karena ada misskomunikasi antara hotel dengan turis. https://t.co/O3O9TmGxjo,3,1,2,1,2022-01-30,10,Sunday,7,5,2
1487730215770071040,2022-01-30 10:11:38,Kemenparekraf mengungkapkan kronologi dugaan 'jebakan karantina' di hotel yang dilaporkan oleh turis Ukraina. Ini penjelasannya:  https://t.co/anj0UMiMf4,10,1,6,1,2022-01-30,10,Sunday,7,16,2
1487729706959003652,2022-01-30 10:09:37,Anies Baswedan dan Ridwan Kamil terlihat tampil bareng dua kali dalam sehari. Gerindra menilai keduanya punya masalah yang sama jelang 2024. https://t.co/FBg7UyMBVm,8,7,0,0,2022-01-30,10,Sunday,7,8,7
1487729431913414663,2022-01-30 10:08:31,Madelene Wright awalnya meniti karier di dunia sepakbola. Tapi dalam setahun terakhir ia banting setir jualan foto-foto seksi usai dipecat klubnya. https://t.co/JNd14Uqd33,4,0,0,0,2022-01-30,10,Sunday,7,4,0
1487729430433009665,2022-01-30 10:08:31,"Tetangga AF pun menceritakan suasana ketika AF ditangkap di rumahnya di Depok, Jawa Barat. https://t.co/VB8npzsljK",9,7,5,2,2022-01-30,10,Sunday,7,14,9
1487728434025480194,2022-01-30 10:04:33,"Sejumlah wajah tokoh yang dinilai berjasa bisa diabadikan dalam prangko. Salah satunya Jenderal Sudirman di prangko Ukraina, kok bisa? https://t.co/zQ1uKjYQjO",22,0,7,1,2022-01-30,10,Sunday,7,29,1
1487727537048465408,2022-01-30 10:01:00,"Ali Mochtar Ngabalin mengatakan pemindahan ibu kota negara ke Penajam Paser Utara, Kalimantan Timur adalah bukti Indonesia tak lagi Jawa-Sentris. https://t.co/6FYcaDRZK0",36,20,4,1,2022-01-30,10,Sunday,7,40,21
1487727232772624387,2022-01-30 09:59:47,Satu lagi artis Tanah Air terjun ke dunia sepakbola Indonesia. Prillly Latuconsina resmi mengakuisis klub Liga 3 Persikota Tangerang. https://t.co/7ZWxXqqib5,61,2,11,2,2022-01-30,9,Sunday,7,72,4
1487726986982301697,2022-01-30 09:58:48,Mantan istri Kiwil kehilangan Rommi Halley. Rommy dinilai orang baik dan tak malu dengan dirinya. https://t.co/UWbzImBoTM,2,0,0,0,2022-01-30,9,Sunday,7,2,0
1487726445627645952,2022-01-30 09:56:39,"Kim Jung Hyun jalani 10 bulan hiatus setelah terlibat kontroversi beberapa waktu lalu. Kini, ia kembali siap menghibur dengan aktingnya. #KimJungHyun  https://t.co/3ejop24Tey",6,0,0,0,2022-01-30,9,Sunday,7,6,0
1487725899684454404,2022-01-30 09:54:29,"Polres Mesuji melakukan penangkapan terhadap tiga pengedar sabu jaringan internasional. Penangkapan dilakukan di Gerbang Tol Simpang Pematang, Mesuji, Lampung. https://t.co/ObsbOLS8qv",20,1,1,0,2022-01-30,9,Sunday,7,21,1
1487725369973161987,2022-01-30 09:52:23,Youtuber Indra Kenz belakangan ini diketahui sebagai afiliator dari binary option. Dia juga sering memberikan tips dan edukasi trading dengan Binomo. https://t.co/8rRwJqAS5Z,8,2,0,1,2022-01-30,9,Sunday,7,8,3
1487724498656894976,2022-01-30 09:48:55,Polisi menyebut AF tersangka modus 'tabrak lari' di Jakarta Timur melakukan aksi pemerasan karena membutuhkan uang. AF membutuhkan uang untuk membeli obat terapi. https://t.co/WvtyihQy8P,20,9,3,2,2022-01-30,9,Sunday,7,23,11
1487724009747800066,2022-01-30 09:46:59,"Papan reklame di Jalan Raya Bogor, Cisalak Pasar, Cimanggis, Depok dikeluhkan pengendara sekitar. Pasalnya beberapa bagian seng di papan mulai berjatuhan. https://t.co/jFeoCEFboK",7,0,2,1,2022-01-30,9,Sunday,7,9,1
1487722988313137152,2022-01-30 09:42:55,Partai Golkar menepis ramalan ekonom senior Faisal Basri yang menyebut pemerintahan Joko Widodo-Ma'ruf Amin akan ambruk secara moral sebelum 2024. https://t.co/SazjZGbk8V,11,1,3,0,2022-01-30,9,Sunday,7,14,1
1487722226644406276,2022-01-30 09:39:54,"Pengacara Jerinx SID, Sugeng Teguh Santoso hingga saat ini belum dipanggil polisi terkait laporan Adam Deni atas dugaan pencemaran nama baik.  https://t.co/28hEYAYyKl",4,0,0,0,2022-01-30,9,Sunday,7,4,0
1487721720173768704,2022-01-30 09:37:53,"Manajemen VIVIZ mengumumkan dua member grup trio itu positif COVID-19, yakni Eunha dan Umji. https://t.co/l6oxLG0Bwn",15,0,2,0,2022-01-30,9,Sunday,7,17,0
1487720956428791810,2022-01-30 09:34:51,Selama tahun 2021 scammer berhasil mencuri uang sebanyak USD 770 juta atau sekitar Rp 11 trilun di media sosial. https://t.co/QPwUWFS1D2,6,0,2,0,2022-01-30,9,Sunday,7,8,0
1487720939492200451,2022-01-30 09:34:47,Sebuah bus rute Kota Medan menuju Jambi menabrak flyover di wilayah Padang Panjang. Akibatnya atap bus sampai terlepas dan melukai 17 penumpang. https://t.co/t9NqleukHh,7,0,1,1,2022-01-30,9,Sunday,7,8,1
1487720079735377920,2022-01-30 09:31:22,"Arsenal menyatakan ketertarikannya mendatangkan Dusan Vlahovic. Namun apa daya, pemain yang tengah bersinar itu memilih Juventus sebagai labuhan berikutnya. https://t.co/eOjbzK0D87",4,0,0,0,2022-01-30,9,Sunday,7,4,0
1487719049211568128,2022-01-30 09:27:16,"Ketua Umum Forum Komunikasi Solidaritas Bangsa indonesia, Djafar Badjeber mendukung Polri memproses pelaporan masyarakat terhadap Edy Mulyadi. https://t.co/RVu2FkIaVG",9,0,1,0,2022-01-30,9,Sunday,7,10,0
1487719032010727426,2022-01-30 09:27:12,"Tersangka pemeras modus 'tabrak lari' di Pasar Rebo, Jakarta Timur, AF (46) mengaku menjalani terapi mandiri.  https://t.co/bC7XDGgGgy",3,0,0,0,2022-01-30,9,Sunday,7,3,0
1487718261143789571,2022-01-30 09:24:08,"Polisi masih mendalami keterangan, AF (46), tersangka pemeras modus 'tabrak lari' di Jakarta Timur. Pelaku mengaku baru sekali melakukan aksi modus tersebut.  https://t.co/iShSWOxgtC",10,1,1,0,2022-01-30,9,Sunday,7,11,1
1487717694770196485,2022-01-30 09:21:53,AF tersangka modus 'tabrak lari' di Jakarta Timur terancam hukuman paling lama 4 tahun penjara. https://t.co/2tfxM0V72X,10,0,0,0,2022-01-30,9,Sunday,7,10,0
1487717205194203138,2022-01-30 09:19:56,"Situs trading Binary Option lagi banyak dibicarakan belakangan ini. Konon, milenial kaya raya seperti Doni Salmanan dan Indra Kenz dapat banyak duit dari situ. https://t.co/O9o744bdsU",4,3,0,1,2022-01-30,9,Sunday,7,4,4
1487716687730380800,2022-01-30 09:17:53,Mario Balotelli comeback ke Timnas Italia setelah hampir empat tahun absen. Perubahan dalam diri Super Mario membuat pangling beberapa staf Gli Azzurri. https://t.co/E0mqLKhsg0,3,3,1,0,2022-01-30,9,Sunday,7,4,3
1487714729481093125,2022-01-30 09:10:06,Satu lagi artis Tanah Air terjun ke dunia sepakbola Indonesia. Prillly Latuconsina resmi mengakuisis klub Liga 3 Persikota Tangerang. https://t.co/ohwOimWK2i,72,10,22,10,2022-01-30,9,Sunday,7,94,20
1487714250667790336,2022-01-30 09:08:12,Profesor UI Hikmahanto Juwana menilai Singapura cerdik sehingga bisa mengecoh Indonesia terkait perjanjian FIR atau kendali ruang udara. Begini analisisnya:  https://t.co/mi6mskNKHj,26,3,22,4,2022-01-30,9,Sunday,7,48,7
1487713199084474368,2022-01-30 09:04:01,"Soal-soal berikut membutuhkan daya pikir sekaligus kesabaran. Kalau dirasa susah, tidak perlu marah-marah. Cek komentar, barangkali sudah ada yang mewakili...  https://t.co/moIARZWT4d",7,4,0,1,2022-01-30,9,Sunday,7,7,5
1487712545112838149,2022-01-30 09:01:25,"Jenis investasi saham ternyata diprediksi akan mengalami penurunan di semester kedua tahun 2022, Bunda. Kira-kira apa penyebabnya, ya? Simak di sini, yuk! #detiknetwork  https://t.co/YgphM4n29A",4,0,0,0,2022-01-30,9,Sunday,7,4,0
1487711833591099392,2022-01-30 08:58:36,Wakil Gubernur DKI Jakarta Ahmad Riza Patria mengatakan pihaknya bakal memperketat pengawasan di sejumlah sektor karena kasus omicron semakin banyak.  https://t.co/rWzSFWR0iT,5,3,0,0,2022-01-30,8,Sunday,7,5,3
1487711339892158466,2022-01-30 08:56:38,Polda Sumut mengusut dugaan adanya penghuni yang tewas di kerangkeng rumah Bupati Langkat nonaktif Terbit Rencana Perangin Angin. https://t.co/jOxsHu4yCs,3,0,0,0,2022-01-30,8,Sunday,7,3,0
1487711079945940994,2022-01-30 08:55:36,"Pelaku 'tabrak lari' di Pasar Rebo, Jakarta Timur, ternyata memiliki bekas luka di kaki. Hal ini dimanfaatkan pelaku untuk memeras calon korban. https://t.co/rG4mVEGMw2",20,8,5,0,2022-01-30,8,Sunday,7,25,8
1487710321154396160,2022-01-30 08:52:35,Eggi Sudjana mengklaim dirinya sebagai warga korps Baret Merah. Namun klaim Eggi ini langsung ditepis Danjen Kopassus Mayjen TNI Teguh Muji Angkasa. https://t.co/TD9Q8RXOiu,6,3,1,1,2022-01-30,8,Sunday,7,7,4
1487709295345115139,2022-01-30 08:48:30,Pilihan rumah di Bogor dalam d'House Hunter edisi pekan ini cukup beragam dengan harga mulai dari Rp 500 jutaan. Ini pilihannya:  https://t.co/btPZ598NmM,12,0,1,0,2022-01-30,8,Sunday,7,13,0
1487708719962071049,2022-01-30 08:46:13,River Plate mengonfirmasi Julian Alvarez akan gabung ke Manchester City. Tapi tidak saat ini juga. https://t.co/8QrcyFmFma,2,0,0,0,2022-01-30,8,Sunday,7,2,0
1487707919307190276,2022-01-30 08:43:02,Para ilmuwan China menemukan virus baru NeoCov di tengah badai Omicron. Kepala Bioteknologi Gamaleya Center angkat bicara soal ancaman dari virus ini. https://t.co/EzVwLQ4icz,14,8,3,3,2022-01-30,8,Sunday,7,17,11
1487707161551683587,2022-01-30 08:40:02,Empat drakor baru tayang di Netflix pada Februari 2022. Dari Business Proposal sampai Thirty-Nine. https://t.co/mRZzu2t2yr,2,0,0,0,2022-01-30,8,Sunday,7,2,0
1487706563267674113,2022-01-30 08:37:39,"Angka positif Covid-19 varian Omicron DKI Jakarta kembali mengalami kenaikan. Kini, angka positif omicron di DKI Jakarta telah mencapai 2526 kasus. https://t.co/egzAZ2Kcz7",7,0,4,0,2022-01-30,8,Sunday,7,11,0
1487705952333836297,2022-01-30 08:35:13,Gubernur Sumut Edy Rahmayadi ditegur oleh Presiden Joko Widodo usai warga Karo mengirim jeruk ke Istana. https://t.co/PmgL2NKUPb,22,10,1,1,2022-01-30,8,Sunday,7,23,11
1487705380843139072,2022-01-30 08:32:57,Tersangka pemeras yang berkedok korban tabrak lari berasalan butuh uang beli obat dan terapi saat melancarkan aksi di Jaktim. https://t.co/WLu673JqGh,23,6,5,4,2022-01-30,8,Sunday,7,28,10
1487704468946931714,2022-01-30 08:29:20,"Marvel Comics menyatukan cerita Avengers, X-Men, dan Eternals dalam sebuah kisah crossover tahun ini dalam Judgement Day. https://t.co/ZP4fgbmdrZ",17,0,3,0,2022-01-30,8,Sunday,7,20,0
1487703724961239040,2022-01-30 08:26:22,"Polisi menangkap pelaku modus tabrak lari di Pasar Rebo, Jakarta Timur, berinisial AF (46). Begini detik-detik polisi menelusuri jejak AF:  https://t.co/y5FjOVTCDK",11,0,1,1,2022-01-30,8,Sunday,7,12,1
1487702963976081408,2022-01-30 08:23:21,"Api yang melalap belasan kapal di Pelabuhan Kota Tegal, Jawa Tengah, akhirnya berhasil dipadamkan siang ini. Terlihat masih ada asap dari puing bangkai kapal. https://t.co/tcd7z0yitv",6,0,0,0,2022-01-30,8,Sunday,7,6,0
1487702952194330624,2022-01-30 08:23:18,15 kilogram sabu disita dari tiga pengedar jaringan Internasional. Sabu tersebut dikemas dalam belasan plastik teh China 'Qing Shan'. https://t.co/dtGxXCSMwF,11,0,3,0,2022-01-30,8,Sunday,7,14,0
1487702355839795200,2022-01-30 08:20:56,Sergio Ramos dikabarkan mengalami cedera lagi. Bek Paris Saint-German itu mengalami masalah pada ototnya. https://t.co/MbmOfrvIUH,7,0,0,0,2022-01-30,8,Sunday,7,7,0
1487701341204099073,2022-01-30 08:16:54,Baru-baru ini viral di media sosial aksi pemerasan berkedok pura-pura tertabrak lari. Pemilik mobil disarankan memasang dashcam sebagai bukti. https://t.co/IHi7pcnScC,16,2,7,4,2022-01-30,8,Sunday,7,23,6
1487700842165805058,2022-01-30 08:14:55,Beredar di media sosial pembuatan Surat Izin Mengemudi yang menelan biaya cukup mahal. Bahkan disebut pembuatan SIM itu mencapai Rp 600.000. https://t.co/29117E318Q,121,194,25,52,2022-01-30,8,Sunday,7,146,246
1487699354496425984,2022-01-30 08:09:00,Jendela transfer musim dingin sebentar lagi ditutup. Sejumlah nama-nama familiar sudah hijrah ke klub baru. https://t.co/f0cP2f0rnT,3,0,0,0,2022-01-30,8,Sunday,7,3,0
1487698296961392641,2022-01-30 08:04:48,"Sejumlah mahasiswa menentang pemerkosaan yang dilakukan sejumlah orang terhadap wanita di India. Tak hanya diperkosa, korban juga dipukul dan diarak di jalan. https://t.co/lRFhK0fxde",37,11,5,5,2022-01-30,8,Sunday,7,42,16
1487697216768778247,2022-01-30 08:00:31,Ratusan juta warga China tetap mudik jelang Imlek. Mereka diminta melakukan test Covid-19 terlebih dahulu sebelum bepergian ke kampung halaman. https://t.co/DJ3BKjiSO7,6,4,1,1,2022-01-30,8,Sunday,7,7,5
1487696346538815489,2022-01-30 07:57:03,Uang kripto semakin hari semakin tenar. Barang digital yang di Indonesia diakuinya sebagai aset bukan mata uang juga makin tenar di Indonesia. https://t.co/tvPyyhQUKr,4,2,2,0,2022-01-30,7,Sunday,7,6,2
1487695207776854016,2022-01-30 07:52:32,Polres Mesuji meringkus tiga pengedar sabu jaringan Internasional. Proses penangkapan pelaku tersebut menyedot perhatian pengguna lalu lintas. https://t.co/qbG7ZuLcJD,17,3,6,1,2022-01-30,7,Sunday,7,23,4
1487694853383327746,2022-01-30 07:51:07,"Kabar duka datang dari keluarga Arzeti Bilbina. Ayahnya, Mayjend TNI Purn. H. Bachrul Ulum, meninggal dunia hari ini, Minggu (30/1). Turut berduka cita...  https://t.co/olBOGgFOe5",5,0,1,0,2022-01-30,7,Sunday,7,6,0
1487694839584022535,2022-01-30 07:51:04,"Akhir tahun lalu, kisah Rurouni Kenshin itu dikabarkan bakal diadaptasi ke panggung musikal. Pertunjukannya bakal dihidupkan dari cerita Arc Kyoto.  https://t.co/vxasc9LYC5",9,0,3,1,2022-01-30,7,Sunday,7,12,1
1487693768048484355,2022-01-30 07:46:48,Omicron yang lebih mudah menular memicu naiknya jumlah kasus COVID-19 di RI. Meski begitu masih ada warga Sumedang yang beraktivitas di luar rumah tanpa masker. https://t.co/Nbfv0ymXa8,18,4,2,1,2022-01-30,7,Sunday,7,20,5
1487692719279546373,2022-01-30 07:42:38,Tengah ramai diperbincangkan dugaan aksi kejahatan di jalan modus pura-pura jadi korban tabrak lari. Ini yang harus dilakukan jika berada dalam situasi itu:  https://t.co/ljahxKFyf2,17,1,10,1,2022-01-30,7,Sunday,7,27,2
1487691909522939904,2022-01-30 07:39:25,"Minyak goreng sudah murah harganya, saat ini ditetapkan Rp 14.000 per liter untuk minyak goreng kemasan. Tapi, barangnya gaib... https://t.co/CcbdibbaLK",48,28,4,4,2022-01-30,7,Sunday,7,52,32
1487690919671435264,2022-01-30 07:35:29,"Sepanjang 2021, Toyota Global berhasil menjual lebih dari 10 juta kendaraan. Hal ini membuatnya menjadi pabrikan mobil dengan penjualan mobil terbesar di dunia. https://t.co/DgupgzJsAW",3,2,0,0,2022-01-30,7,Sunday,7,3,2
1487690125354098688,2022-01-30 07:32:20,Pemprov DKI Jakarta mengatakan pihaknya siap menambah fasilitas kesehatan di rumah sakit rujukan. Termasuk menambah tempat tidur pasien. https://t.co/AR9rsf9sIW,10,0,3,1,2022-01-30,7,Sunday,7,13,1
1487689769698086913,2022-01-30 07:30:55,"Polis menetapka status tersangka kepada AF, seorang pelaku pemerasan dengan modus pura-pura pincang di Jaktim.  https://t.co/yLRuAp0wsZ",33,5,3,0,2022-01-30,7,Sunday,7,36,5
1487689012940877826,2022-01-30 07:27:55,Kemenag mengeluarkan surat edaran jelang Tahun Baru Imlek 2573 Kongzili. Kemenag mengimbau agar tidak mudik dan melakukan kumpul bersama keluarga besar. https://t.co/7tg1I7C0bN,8,0,2,0,2022-01-30,7,Sunday,7,10,0
1487688272998539264,2022-01-30 07:24:58,"Tabrakan beruntun sering kali terjadi di jalan tol. Pemicunya banyak, salah satunya karena pengendara yang tidak mau jaga jarak yang cukup. https://t.co/hCjjsLF6k8",10,1,5,0,2022-01-30,7,Sunday,7,15,1
1487687184312414208,2022-01-30 07:20:39,PWI Kalteng meminta Edy tak melibatkan profesi wartawan dalam masalahnya. PWI Kalteng menyebut Edy Mulyadi sebagai provokator. https://t.co/XTf48jSxFq,41,8,7,3,2022-01-30,7,Sunday,7,48,11
1487686486363357187,2022-01-30 07:17:52,Tiga pengedar sabu jaringan Internasional dibekuk petugas gabungan Polres Mesuji. Sabu 15 kilogram disita dari para pelaku. https://t.co/fvbEi28HMb,13,3,3,2,2022-01-30,7,Sunday,7,16,5
1487685141279514626,2022-01-30 07:12:32,Pelaku penusuk tukang parkir hingga tewas di Jakbar ditangkap polisi. Pelaku ditangkap empat jam usai kejadian. https://t.co/c7UGFSZLWr,4,0,2,0,2022-01-30,7,Sunday,7,6,0
1487684529749995526,2022-01-30 07:10:06,Apple akan mengeluarkan fitur pengenalan Face ID saat memakai masker lewat iOS 15.4 beta pertama untuk developer. Fitur ini akan mengenali bagian unik disekitar mata untuk proses autentifikasi Face ID. https://t.co/xXQEvFZ32u,11,3,4,1,2022-01-30,7,Sunday,7,15,4
1487683390102978560,2022-01-30 07:05:34,"Ketua Umum PBNU Yahya Cholil Staquf mengatakan Nusantara adalah singkatan dari NU, Santri, Pemerintah dan Rakyat. https://t.co/U1TceeiKVJ",1142,362,144,87,2022-01-30,7,Sunday,7,1286,449
1487683380883959810,2022-01-30 07:05:32,"Sukses bekerja sebagai asisten artis Indonesia, begini penampakan rumah para asisten artis. Ada yang berada di kawasan elite dan harganya mencapai Rp 5 miliar! https://t.co/OMT2hyN10u",7,0,3,2,2022-01-30,7,Sunday,7,10,2
1487682196114653184,2022-01-30 07:00:50,Pertikaian antara Lee Zii Jia dan Asosiasi Badminton Malaysia mengejutkan dunia badminton. Hal tersebut sudah pernah dialami Pelatnas Cipayung. Indonesia telah melalui jalan panjang untuk mengatasi hubungan pemain independen dengan PBSI. #detiknetwork  https://t.co/S2dt8kmEYv,6,0,1,1,2022-01-30,7,Sunday,7,7,1
1487680937236303872,2022-01-30 06:55:49,"Ada-ada saja kelakuan pemain Brentford, Ivan Toney. Dia terekam kamera menghina klubnya sendiri saat asyik liburan. Duh! https://t.co/vrTyNgayIt",2,1,1,0,2022-01-30,6,Sunday,7,3,1
1487679683810447361,2022-01-30 06:50:51,Adama Traore resmi kembali ke Barcelona. Winger asal Spanyol itu bahagia betul kembali ke klub masa kecilnya. https://t.co/EZcfuvpNh6,6,0,0,0,2022-01-30,6,Sunday,7,6,0
1487678438207012864,2022-01-30 06:45:54,Seorang pelayanan restoran bernama Ali diangggaap tidak bersyukur karena meremehkan pemberian seorang pelanggan. https://t.co/DbdrXUn9Og,6,0,3,0,2022-01-30,6,Sunday,7,9,0
1487677169933459457,2022-01-30 06:40:51,"TPU Tanah Kusir dulunya terkenal menyeramkan, tapi kini untuk sebagian orang area tersebut tak lagi menyeramkan. Diramaikan dengan munculnya jajanan kaki lima ini:  https://t.co/WCQ7F5VoJl",9,1,3,0,2022-01-30,6,Sunday,7,12,1
1487674863921811462,2022-01-30 06:31:41,Newcastle United diwanti-wanti agar tidak terlalu berharap kepada Dele Alli. Pemain Tottenham Hotspur itu diklaim hanya ingin gabung klub besar. https://t.co/ZOLe42ZDKo,10,1,1,1,2022-01-30,6,Sunday,7,11,2
1487672601552068617,2022-01-30 06:22:42,Pedangdut Nabilla Gomes siap menyambut kelahiran anak pertama. Dia ngaku deg-degan sampai nangis tiap malam. https://t.co/LTrn66dbDf,10,1,2,0,2022-01-30,6,Sunday,7,12,1
1487671731426934785,2022-01-30 06:19:15,Kemenkes menyediakan layanan telemedicine dan paket obat gratis bagi pasien isoman Omicron di wilayah Jabodetabek. Ini cara mendapatkannya:  https://t.co/VFHTuxORsx,25,0,15,2,2022-01-30,6,Sunday,7,40,2
1487670708138393600,2022-01-30 06:15:11,Aksi pemerasan bermoduskan pura-pura picang sebagai korban tabrak lari di Jaktim bikin heboh. Pelaku sempat emosi karena aksinya itu malah gagal. https://t.co/KSxA8rj7xe,11,1,2,1,2022-01-30,6,Sunday,7,13,2
1487669962068180994,2022-01-30 06:12:13,Chanel menampilkan busana gaya era 1920-an dan 1980-an yang berpadu dengan makeup smokey eyes. Ini koleksi busana Chanel Haute Couture Spring 2022:  https://t.co/Tv31wgfl0n,2,0,0,0,2022-01-30,6,Sunday,7,2,0
1487668710366191617,2022-01-30 06:07:14,Pindang bandeng jadi salah satu sajian khas imlek. Umumnya dibuat pindang dengan kuah kecap atau bening asam segar. Ini resepnya:  https://t.co/8vryrM7gHz,16,1,5,0,2022-01-30,6,Sunday,7,21,1
1487667387344297984,2022-01-30 06:01:59,Minyak goreng di pasaran makin langka. Sejumlah minimarket di kawasan Jakarta bahkan tidak memiliki stok sedikit pun. https://t.co/DSZgigpSpY,12,22,3,1,2022-01-30,6,Sunday,7,15,23
1487666287249702916,2022-01-30 05:57:37,"Newcastle United tertarik mendatangkan Jesse Lingard pada bursa musim dingin ini. Di satu sisi, The Toons dapat saran untuk tidak ngotot mendatangkan Lingard. https://t.co/s6mwilQhyu",4,1,0,0,2022-01-30,5,Sunday,7,4,1
1487665298312515588,2022-01-30 05:53:41,Kabar terbaru memunculkan soal sosok berinisial AD yang berpose mengacungkan jari tengah ke foto Presiden Joko Widodo.  https://t.co/QOSLH4Xna8,7,2,1,0,2022-01-30,5,Sunday,7,8,2
1487664034614853633,2022-01-30 05:48:39,"Para ilmuwan China mengungkap ancaman NeoCov, virus baru yang bikin gempar di tengah badai Omicron. Ini kata WHO:  https://t.co/7wexIRjS4q",114,88,46,37,2022-01-30,5,Sunday,7,160,125
1487662975091712000,2022-01-30 05:44:27,"Varian Omicron diperkirakan mulai mendominasi kasus COVID-19. Kemenkes RI juga sudah menemukan kasus pada anak-anak, terutama terjadi di klaster keluarga. https://t.co/uE3BtgouYC",7,2,4,0,2022-01-30,5,Sunday,7,11,2
1487661906672377858,2022-01-30 05:40:12,"Wanita ini bekerja sebagai TKW di Hongkong, anak majikannya memberikan predikat sebagai pengasuh terbaik. Ini kisahnya:  https://t.co/AljlONSfnl",15,0,2,0,2022-01-30,5,Sunday,7,17,0
1487660401785458690,2022-01-30 05:34:13,Rizal Rama jadi satu-satunya model asal Indonesia yang tampil di catwalk Fendi saat Milan Fashion Week. Ini perjuangan Rizal untuk bisa sampai di sana:  https://t.co/G12hzAmrQX,9,1,3,0,2022-01-30,5,Sunday,7,12,1
1487659616167202822,2022-01-30 05:31:06,Hampir seminggu terakhir penambahan kasus Covid-19 di Jakarta terus bertambah. Sebelumnya Luhut mengatakan bahwa teater pandemi kian terjadi di DKI dan kemungkinan berubahnya status level PPKM. https://t.co/QcEeWvtssC,10,11,3,1,2022-01-30,5,Sunday,7,13,12
1487658315194814465,2022-01-30 05:25:56,Kantor PT DNA Pro Akademik disegel kembali oleh pemerintah. DNA Pro merupakan perusahaan yang melakukan penjualan robot trading dengan sistem MLM.  https://t.co/voGFpI5wjv,11,0,6,4,2022-01-30,5,Sunday,7,17,4
1487657567807590402,2022-01-30 05:22:58,Yannick Carrasco disanksi UEFA. Gelandang Atletico Madrid itu dihukum larangan bermain sebanyak tiga pertandingan. https://t.co/SwYUlyhUjm,2,0,2,0,2022-01-30,5,Sunday,7,4,0
1487657073907314691,2022-01-30 05:21:00,"Striker AC Milan, Olivier Giroud, melemparkan pujian kepada rekan setimnya, Zlatan Ibrahimovic. Dia mengakui Ibracadabra sebagai motivator di skuad Rossoneri. https://t.co/yvDT2eVVUC",6,0,2,0,2022-01-30,5,Sunday,7,8,0
1487655804614455298,2022-01-30 05:15:57,"Polisi meringkus pelaku pemerasan dengan bermoduskan pura-purang pincang. Diketahui, pelaku berprofesi sebagai tukang parkir. https://t.co/ZPFSqWgZFv",65,22,20,13,2022-01-30,5,Sunday,7,85,35
1487654777081282560,2022-01-30 05:11:52,Enzy Storia mengumumkan terpapar COVID-19. Begini kondisi terkini Enzy:  https://t.co/pquTQyabss,6,0,4,2,2022-01-30,5,Sunday,7,10,2
1487653783106732032,2022-01-30 05:07:55,"Keju umumnya terbuat dari susu sapi, tapi ada beberapa keju unik dan aneh di dunia. Ada keju tradisional yang dibuat menggunakan belatung dan tungau. Hii! https://t.co/ZFYzLlI4hQ",8,0,2,0,2022-01-30,5,Sunday,7,10,0
1487652664246738944,2022-01-30 05:03:29,"Viral video seorang pria diduga pura-pura jadi korban tabrak lari di Pasar Rebo, Jakarta Timur. Kini, pelaku itu sudah diamankan oleh Polres Jaktim. https://t.co/yJ44wUc0jk",27,11,3,2,2022-01-30,5,Sunday,7,30,13
1487652109118062592,2022-01-30 05:01:16,Deretan sosok hebat pencari nafkah yang tak gentar mencari rejeki demi bertahan hidup. https://t.co/J9tnSlhMDn,32,1,9,0,2022-01-30,5,Sunday,7,41,1
1487650852122808323,2022-01-30 04:56:17,Para astronom di Australia menemukan objek misterius di galaksi Bimasakti yang tak pernah disaksikan sebelumnya. Objek itu melepaskan ledakan besar energi radio selama satu menit penuh setiap 18 menit. https://t.co/yOi3kXeIBi,2,2,2,0,2022-01-30,4,Sunday,7,4,2
1487650833953177602,2022-01-30 04:56:12,"Rommi Halley, pacar berondong mantan istri Kiwil meninggal dunia. Rohimah turut sedih...   https://t.co/RjeC9UQ6uu",8,3,1,0,2022-01-30,4,Sunday,7,9,3
1487650097198505986,2022-01-30 04:53:17,"Selain menghindari makanan berlemak, ada makanan yang secara alami ampuh menurunkan kolesterol. Termasuk apel dan alpukat yang terbukti turunkan kolesterol. https://t.co/6VxXkiajGv",16,0,6,0,2022-01-30,4,Sunday,7,22,0
1487649067551318017,2022-01-30 04:49:11,Badai COVID-19 menghantam klub-klub peserta BRI Liga 1. Persib Bandung dan Persebaya Surabaya menjadi korbannya. https://t.co/I8vAddoGM6,5,0,1,0,2022-01-30,4,Sunday,7,6,0
1487648284793524224,2022-01-30 04:46:04,"Aparat kepolisian menangkap seorang pengemudi ojek onlineyang viral di media sosial karena mencuri hp di kota Makassar, Sulsel, KA (39). Pelaku mencuri HP di laci motor yang terparkir di halaman masjid di Makassar. https://t.co/zzKThIdvtG",4,0,1,0,2022-01-30,4,Sunday,7,5,0
1487647307621359620,2022-01-30 04:42:11,Terduga pelaku pemerasan di Jaktim ditangkap Polisi. Polisi akan merilis penangkapan terduga pelaku siang ini. https://t.co/hS8KESXIF3,45,6,8,1,2022-01-30,4,Sunday,7,53,7
1487646743189671937,2022-01-30 04:39:57,"Kawasan Bundaran HI, Jakarta Pusat ramai aktivitas warga pada Minggu (30/1) pagi. Banyak dari mereka melakukan olahraga dan berswafoto bersama. https://t.co/HcfLdO79HY",5,2,3,0,2022-01-30,4,Sunday,7,8,2
1487645492431499264,2022-01-30 04:34:59,Ekonom senior Faisal Basri berikan kritik pedas pemerintahan Presiden Joko Widodo. Ia berpendapat pemerintah Jokowi akan ambruk secara moral sebelum 2024. https://t.co/rpqQTH9uT4,382,184,69,30,2022-01-30,4,Sunday,7,451,214
1487644758063431683,2022-01-30 04:32:04,Ramalan zodiak Pisces perlu kesabaran dan ketelitian untuk bisa meraih kesuksesan. Simak ramalan zodiak hari ini: https://t.co/bgah6XvvTa,6,0,1,0,2022-01-30,4,Sunday,7,7,0
1487644009308766208,2022-01-30 04:29:05,Pesinetron Asty Ananta membuat netizen pangling dengan penampilannya. Ini potret terbaru Asty Ananta:  https://t.co/4OjRtPNUKv,10,0,1,0,2022-01-30,4,Sunday,7,11,0
1487642495383130117,2022-01-30 04:23:04,Dejan Kulusevski segera meninggalkan Juventus. Juventus kabarnya sudah sepakat dengan Tottenham Hotspur untuk transfer winger asal Swedia itu. https://t.co/EgOYqsA0YX,6,0,1,0,2022-01-30,4,Sunday,7,7,0
1487642002619572228,2022-01-30 04:21:07,Jenazah Indah Sukmadani atau DJ Indah Cleo diterbangkan ke kampung halamannya di Sumatera Barat.  https://t.co/hNVsUAqpWm,8,0,0,0,2022-01-30,4,Sunday,7,8,0
1487640995357413381,2022-01-30 04:17:06,"Kekasih Cristiano Ronaldo, Georgina Rodriguez, merayakan ulang tahun ke-28 di Dubai. Ini potret kemewahan pesta tersebut:  https://t.co/3nw61hWPWZ",5,1,2,1,2022-01-30,4,Sunday,7,7,2
1487640255897427969,2022-01-30 04:14:10,Meriam Bellina sindir mantan kekasih yang tak benar. Ia tegaskan bukan untuk Hotman Paris. #MeriamBellina  https://t.co/msO4vjHynZ,8,0,2,0,2022-01-30,4,Sunday,7,10,0
1487639270873518081,2022-01-30 04:10:15,"Bintang Timnas, Pratama Arhan jadi idola usai tampil di Piala AFF 2020. Arhan sudah punya gandengan, ini sosok Marshella Aprilia:  https://t.co/pLKOfY04vr",12,0,2,0,2022-01-30,4,Sunday,7,14,0
1487637941077819395,2022-01-30 04:04:58,"Salju turun menyelimuti kompleks Al Aqsa, Yerusalem. Fenomena yang jarang terjadi ini membuat transportasi umum dihentikan sementara. https://t.co/BX7IzBBH6M",14,0,2,2,2022-01-30,4,Sunday,7,16,2
1487636692588806152,2022-01-30 04:00:01,Empat masjid di Klaten belum dirobohkan meskipun proyek jalan Tol Jogja-Solo mulai dikerjakan. Masjid-masjid tersebut tetap dipakai oleh warga. https://t.co/fw5eUd15hP,11,1,1,0,2022-01-30,4,Sunday,7,12,1
1487635688887623680,2022-01-30 03:56:01,Pelaku pemerasan dengan modus pura-pura pincang di Jaktim viral di media sosial. Pelaku kini berhasil diamankan polisi. https://t.co/6sCiwcLfPV,279,50,60,16,2022-01-30,3,Sunday,7,339,66
1487635207129899010,2022-01-30 03:54:06,Kasus mobil Mercy dirusak di Bantul masih diusut polisi. Polisi mengungkap kasus ini berawal dari cekcok lalu pemobil menyerempet pemotor dan diteriaki maling. https://t.co/bv4T9gspP9,7,3,2,1,2022-01-30,3,Sunday,7,9,4
1487632384770166784,2022-01-30 03:42:54,"Gempa bermagnitudo 1,4 terjadi di Kabupaten Bantul, Daerah Istimewa Yogyakarta pagi ini. Pusat gempa berada di 14 kilometer tenggara Bantul. https://t.co/FLgQoa1rk6",21,0,4,2,2022-01-30,3,Sunday,7,25,2
1487632110060032002,2022-01-30 03:41:48,20Detik merangkum kejadian heboh dan menarik dalam sepekan ini. Simak dalam video berikut ini:  https://t.co/b63J6lVSrQ,8,1,1,0,2022-01-30,3,Sunday,7,9,1
1487630624034799616,2022-01-30 03:35:54,"#FOTO Orang terkaya nomor dua di dunia, Jeff Bezos, baru saja menghabiskan banyak uang untuk membeli properti mewah di dekat pantai Hawaii. Ini potretnya:  https://t.co/66180ZmI4Y",4,0,1,1,2022-01-30,3,Sunday,7,5,1
1487629238203084805,2022-01-30 03:30:23,Dokter paru mengungkap ternyata demam bukanlah gejala awal dari Omicron. Ini gejala awal pasien terinfeksi Omicron:  https://t.co/rby7pmgcV6,22,1,7,0,2022-01-30,3,Sunday,7,29,1
1487627629901619203,2022-01-30 03:24:00,"Terkuak pernah ada penghuni yang tewas di kerangkeng di rumah Bupati Langkat Terbit Rencana Perangin Angin. Ternyata, korban tewas lebih dari satu orang. https://t.co/aC5eQjXxFk",111,18,22,9,2022-01-30,3,Sunday,7,133,27
1487626271421046785,2022-01-30 03:18:36,#FOTO Kantor Google ataupun beberapa perusahaan teknologi lain memang menyenangkan karena fasilitasnya berlimpah ruah. https://t.co/NXVKTMPWvK,7,0,4,0,2022-01-30,3,Sunday,7,11,0
1487624483385090048,2022-01-30 03:11:30,"Berlian hitam yang luar biasa, siap dilelang dan akan menjadi milik penawar tertinggi. Ini keistimewaannya:  https://t.co/jLpUig7y3L",12,2,1,2,2022-01-30,3,Sunday,7,13,4
1487623013956829188,2022-01-30 03:05:39,Ririe Fairus tak bisa membendung air mata ketika mengingat momen bersama Ayus Sabyan selama 15 tahun. Semua berakhir karena perselingkuhan... https://t.co/h5grVurH5s,29,13,4,6,2022-01-30,3,Sunday,7,33,19
1487621456427163651,2022-01-30 02:59:28,"Di tengah ancaman Omicron, ilmuwan China melaporkan temuan virus NeoCoV yang diklaim lebih mematikan. Virus ini bersifat zoonosis alias ditularkan dari hewan. https://t.co/QC0VX8hK5A",623,344,236,330,2022-01-30,2,Sunday,7,859,674
1487620202003144709,2022-01-30 02:54:29,Rey Mbayang ngaku lebih bucin kepada Dinda Hauw setelah mereka menikah. Dia pun memberikan penjelasan ini:  https://t.co/l826DKNv55,19,4,1,0,2022-01-30,2,Sunday,7,20,4
1487618815953362944,2022-01-30 02:48:59,Aliando ngaku idap OCD yang cukup ekstrem dan berjuang untuk sembuh dari gangguan mental tersebut. Sang ibunda sampaikan pujian dan rasa cinta. https://t.co/GreGU02jyr,16,2,2,0,2022-01-30,2,Sunday,7,18,2
1487617487155912707,2022-01-30 02:43:42,Laga Timnas Indonesia Vs Timor Leste akan kembali hadir di laga uji coba. Duel 'leg' kedua itu dimainkan Minggu (30/1) malam WIB. https://t.co/oo8sn2ILTV,10,1,4,1,2022-01-30,2,Sunday,7,14,2
1487616242265563138,2022-01-30 02:38:45,Sejumlah aparat keamanan dan lembaga pemerintah melakukan investigasi soal kerangkeng manusia yang ditemukan di rumah Bupati Langkat. Ini hasilnya:  https://t.co/XtxZRao67n,18,4,13,1,2022-01-30,2,Sunday,7,31,5
1487614857604173828,2022-01-30 02:33:15,"Koalisi Ulama, Habaib, dan Pengacara Anti Penodaan Agama melaporkan KSAD Jenderal Dudung Abdurachman terkait pernyataan Tuhan kita bukan orang Arab. https://t.co/StOWxuHrI1",1876,471,408,76,2022-01-30,2,Sunday,7,2284,547
1487613681873661959,2022-01-30 02:28:34,Tebak-tebakan ini belum tentu bisa dijawab oleh orang cerdas sekalipun. Coba pecahkan teka-teki receh ini sambil melatih otak. https://t.co/8WuM9zxiJO,78,107,8,8,2022-01-30,2,Sunday,7,86,115
1487611083473002499,2022-01-30 02:18:15,"Setahun berselang sejak heboh dugaan perselingkuhan, kini Ayus dan Nissa Sabyan sudah kembali lagi aktif bermusik. https://t.co/2xXVcrYFSj",7,4,1,2,2022-01-30,2,Sunday,7,8,6
1487609520566284295,2022-01-30 02:12:02,"Mikaila Patritz bersama suaminya, Fardhan Khan, bicara soal nikah muda dari pengalaman pribadi mereka. Mereka berikan tips ini:  https://t.co/wbTfz5YJU6",8,0,1,1,2022-01-30,2,Sunday,7,9,1
1487608225059033088,2022-01-30 02:06:53,"Pasien Omicron bergejala ringan dan tak bergejala kini boleh isoman di rumah. Jika tinggal di Jabodetabek, ada layanan telemedicine dan paket obat gratis. https://t.co/3UtkUM3gvE",22,0,9,1,2022-01-30,2,Sunday,7,31,1
1487606642489372673,2022-01-30 02:00:36,"Di tengah melonjaknya Omicron COVID-19 di sejumlah negara, WHO harus menghadapi skandal rasisme. Tudingan ini dialamatkan pada direktur regional Pasifik Barat. https://t.co/0etJkCrm5B",10,0,3,0,2022-01-30,2,Sunday,7,13,0
1487604833133764611,2022-01-30 01:53:25,"Lagu Bento milik musisi legendaris, Iwan Fals sangat ikonik di telinga masyarakat. Iwan Fals jelaskan makna sebenarnya dibalik lagu Bento:  https://t.co/ec8UKA79T0",9,3,0,1,2022-01-30,1,Sunday,7,9,4
1487603330322997249,2022-01-30 01:47:26,Rancangan UU IKN telah disahkan oleh DPR RI. Berapa lama tahapan pemindahan Ibu Kota Negara dari Jakarta ke Kalimantan Timur? Segini biayanya:  https://t.co/1imbhf4SNC,5,2,1,0,2022-01-30,1,Sunday,7,6,2
1487601925650530307,2022-01-30 01:41:52,Perayaan Tahun Baru Imlek tak bisa lepas dari kehadiran Barongsai dan Liang Liong. Ini makna sebenernya Barongsai dan Liang Liong:  https://t.co/0YWLW5nflZ,2,1,1,0,2022-01-30,1,Sunday,7,3,1
1487600192178339848,2022-01-30 01:34:58,Enzy Storia ngaku terpapar virus COVID-19 untuk yang pertama kali. Ia merasa terkena karena tengah apes. https://t.co/3EzCNnLAcW,23,6,2,1,2022-01-30,1,Sunday,7,25,7
1487598757503983617,2022-01-30 01:29:16,Rompi beban atau weighted body vest ala militer yang dipakai AHY viral gara-gara disangka rompi antipeluru. Ini manfaat pakai rompi seperti AHY:  https://t.co/5dSVCJ9EqZ,21,11,5,3,2022-01-30,1,Sunday,7,26,14
1487597271726403586,2022-01-30 01:23:22,"Sekeluarga di Dusun Ngentak, Desa Kranggan, Polanharjo, Klaten kini jadi satu-satunya yang tersisa di RT 14 RW 5 kawasan tersebut karena dampak proyek tol. https://t.co/iMxS1KTaMA",13,4,7,0,2022-01-30,1,Sunday,7,20,4
1487595981726175236,2022-01-30 01:18:14,"Lonjakan COVID-19 RI berlanjut, termasuk di DKI Jakarta. Dari 52.555 kasus aktif yang tercatat pada Sabtu (29/1/2022), hampir setengahnya berasal dari ibukota. https://t.co/jcfV451qZS",8,1,2,3,2022-01-30,1,Sunday,7,10,4
1487594672784560129,2022-01-30 01:13:02,DJ Indah Cleo jadi satu dari 18 korban tewas bentrokan di tempat hiburan malam di Sorong. Permintaan terakhir Sang DJ telah dipahami keluarganya.  https://t.co/vjfAltKmuQ,10,1,2,0,2022-01-30,1,Sunday,7,12,1
1487593130987823106,2022-01-30 01:06:55,"Thailand jadi negara pertama di ASEAN yang melegalkan ganja untuk keperluan medis. Tetapi tetap ada aturannya, dan tentunya sanksi tegas bagi yang melanggar. https://t.co/OTy0GYaN0h",59,7,27,8,2022-01-30,1,Sunday,7,86,15
1487591434614185984,2022-01-30 01:00:10,Edy Mulyadi ingin berlindung dengan UU Pers terkait polemik 'jin buang anak'. Keinginan Edy Mulyadi tersebut mendapat sorotan tajam. https://t.co/QT9XZcUAJ6,42,61,8,6,2022-01-30,1,Sunday,7,50,67
1487589181958369282,2022-01-30 00:51:13,Cara komunikasi yang baik perlu dipahami agar lawan bicara suka dan merasa nyaman. Berikut ini tips komunikasi yang baik. https://t.co/xqsNxjdr5g,15,0,3,0,2022-01-30,0,Sunday,7,18,0
1487588404988624898,2022-01-30 00:48:08,Granit Xhaka menyiratkan tak akan mengubah pendekatan permainannya yang keras. Legenda Arsenal Martin Keown menyebutnya sebagai sumber masalah tim. https://t.co/W7qv6I9Vkw,8,1,1,0,2022-01-30,0,Sunday,7,9,1
1487587884613963778,2022-01-30 00:46:04,"Ketum PKB, Cak Imin sowan ke beberapa ulama di Maluku Utara. Di sana Cak Imin mendapatkan saran untuk maju bareng Anies Baswedan di Pilpres 2024. https://t.co/4KQ1dmCojJ",21,24,4,6,2022-01-30,0,Sunday,7,25,30
1487587398913564674,2022-01-30 00:44:08,"Alvaro Morata tampaknya masih harus bertahan di Juventus. Klub pemilik Morata, Atletico Madrid, enggan membiarkan striker Spanyol itu untuk gabung Barcelona. https://t.co/cAfpt0wbjr",8,0,0,0,2022-01-30,0,Sunday,7,8,0
1487586894191992832,2022-01-30 00:42:08,Kasus kecelakaan kerja di wilayah Jabar mengalami penurunan pada 2021 atau tahun kedua pandemi COVID-19. https://t.co/1aArUxOxCc,8,2,2,0,2022-01-30,0,Sunday,7,10,2
1487586147379392513,2022-01-30 00:39:10,Menag Yaqut Cholil Qoumas meminta umat Konghucu mematuhi protokol kesehatan (prokes) dalam merayakan Tahun Baru Imlek 2573 Kongzili. https://t.co/sHcm5viNtm,24,15,2,2,2022-01-30,0,Sunday,7,26,17
1487585397412712448,2022-01-30 00:36:11,"Apabila seseorang mengalami gejala atau kejadian ikutan pasca imunisasi (KIPI) usai mendapatkan vaksin booster, tak perlu panik. Ini 5 cara menghadapinya. https://t.co/gfONKhdF93",9,2,4,0,2022-01-30,0,Sunday,7,13,2
1487584554982551556,2022-01-30 00:32:50,Menpora Zainudin Amali tahu bahwa atlet-atlet muda bakal jadi tulang punggung Indonesia di masa depan. Maka pelatihan sejak dini harus terus digalakkan. https://t.co/DAHOBOEEZj,8,1,0,0,2022-01-30,0,Sunday,7,8,1
1487584056267182082,2022-01-30 00:30:51,"Tawuran antarwarga di kawasan Karuwisi, Makassar, Sulsel, menyebabkan satu orang warga meninggal dunia. Korban terkena anak panah busur dari pelaku tawuran. https://t.co/T6X2duag8f",5,3,2,1,2022-01-30,0,Sunday,7,7,4
1487583080609193984,2022-01-30 00:26:59,Kecelakaan tunggal mobil sedan di KM 166 menjadi kecelakaan pertama di tol Cisumdawu. Tol ini diketahui mulai dioperasikan pada Selasa kemarin. https://t.co/S9My7yrGnm,10,4,1,1,2022-01-30,0,Sunday,7,11,5
1487582520564756480,2022-01-30 00:24:45,"Aksi teror di Masjid Jarafa, Sudan merupakan salah satu yang paling miris. Aksi teror ini dilakukan oleh seorang pria sendirian dan menewaskan 20 orang. https://t.co/creH37RlI1",16,3,3,1,2022-01-30,0,Sunday,7,19,4
1487581684950347778,2022-01-30 00:21:26,"Seorang pria sempat marah ke warga lantaran aksi modus tabrak larinya gagal. Aksi yang terjadi di Pasar Rebo, Jakarta Timur, itu cukup menyita perhatian publik. https://t.co/HRToEDbMs7",31,8,6,6,2022-01-30,0,Sunday,7,37,14
1487581139816562690,2022-01-30 00:19:16,"Polisi mengungkap peran masing-masing 11 tersangka bentrokan maut di Sorong, Papua Barat. https://t.co/10qm06yiav",6,1,2,0,2022-01-30,0,Sunday,7,8,1
1487580375723425794,2022-01-30 00:16:14,Sandiaga Uno murka gegara turis Ukraina diduga menjadi korban jebakan karantina. Menparekraf itu mengaku akan menindak oknum jika terbukti berbuat curang. https://t.co/NYio9vt8Kj,15,5,2,1,2022-01-30,0,Sunday,7,17,6
1487579230426828812,2022-01-30 00:11:41,Badai COVID-19 menghantam klub-klub peserta BRI Liga 1. Persib Bandung dan Persebaya Surabaya menjadi korbannya. https://t.co/6uLlAH4Pry,11,2,1,0,2022-01-30,0,Sunday,7,12,2
1487578730952335369,2022-01-30 00:09:41,KSP menekannya pentingnya komunikasi publik presidensi G20 agar masyarakat domestik dan internasional mendukung hasil-hasil pertemuan dalam G20. https://t.co/uNEJhwFspe,7,0,0,0,2022-01-30,0,Sunday,7,7,0
1487577594165874692,2022-01-30 00:05:10,"Sebuah mobil sedan mengalami kecelakaan tunggal hingga terbalik di Tol Cisumdawu KM 166-200, Sumedang. Tidak ada korban tewas dalam kejadian. https://t.co/6oS97Mat9l",4,0,3,0,2022-01-30,0,Sunday,7,7,0
1487576813597605889,2022-01-30 00:02:04,Sering alami gatal-gatal di area kemaluan? Awas jangan digaruk! Cobalah atasi dengan 6 obat gatal kemaluan tradisional ini. https://t.co/lcXv12fyad,13,1,4,2,2022-01-30,0,Sunday,7,17,3
1487575948694335489,2022-01-29 23:58:38,Anggota DPR RI Dedi Mulyadi mendapatkan dukungan untuk melenggang ke bursa Pilpres 2024. https://t.co/ccERUsXSl8,87,52,9,14,2022-01-29,23,Saturday,6,96,66
1487575197767147521,2022-01-29 23:55:39,"Lonjakan COVID-19 RI berlanjut, termasuk di DKI Jakarta. Dari 52.555 kasus aktif yang tercatat pada Sabtu (29/1/2022), hampir setengahnya berasal dari ibukota. https://t.co/gQHyrKj8ev",9,2,3,1,2022-01-29,23,Saturday,6,12,3
1487574668982763527,2022-01-29 23:53:33,"Polres Serang Kota menangkap pelaku pencabulan, inisial A. Penjual mainan keliling kampung ini mencabuli anak di bawah umur. https://t.co/0slYthOdWF",9,2,2,0,2022-01-29,23,Saturday,6,11,2
1487574127808417792,2022-01-29 23:51:24,Ada beberapa hewan yang dianggap suci karena menyimbolkan hal-hal baik hingga penjelmaan dewa. Hewan apa saja itu? Ini penjelasannya. https://t.co/6bi1b8t5CC,6,1,1,1,2022-01-29,23,Saturday,6,7,2
1487573371831336965,2022-01-29 23:48:24,"Tiga orang pelaku pencurian sepeda motor (curanmor) tewas dihajar warga di Deli Serdang, Sumatera Utara. Ketiga orang ini tewas dengan sejumlah luka di tubuh. https://t.co/JOA2Y2zi5R",24,13,0,4,2022-01-29,23,Saturday,6,24,17
1487572482013941771,2022-01-29 23:44:52,"Olahraga tidak hanya memberikan dampak yang baik bagi kesehatan tubuh, melainkan juga untuk kesehatan seksual karena dapat meningkatkan libido pada pria. https://t.co/hLH5VWdJ2Z",9,1,3,0,2022-01-29,23,Saturday,6,12,1
1487571989443366913,2022-01-29 23:42:54,"Tren kasus COVID-19 di RI akhir-akhir ini tengah naik lagi. Kemenkes pun mengungkap beberapa wilayah yang menyumbang kasus terbanyak, apa saja? https://t.co/G9N7u9pVZD",7,3,3,0,2022-01-29,23,Saturday,6,10,3
1487570320575942657,2022-01-29 23:36:16,"Rompi beban atau weighted body vest ala militer yang dipakai AHY viral gara-gara disangka rompi antipeluru. Sebenarnya, apa sih manfaat pakai rompi seperti ini? https://t.co/LCIwSi7uHJ",15,0,6,0,2022-01-29,23,Saturday,6,21,0
1487568856281452544,2022-01-29 23:30:27,"Aplikasi BOT1 hadir sebagai platform digital yang mampu memantau kondisi penderita diabetes, sekaligus pendamping cerdas dalam proses penyembuhan. https://t.co/aEkDkuTyc0",6,0,4,0,2022-01-29,23,Saturday,6,10,0
1487567549382512640,2022-01-29 23:25:16,Dua tersangka pencuri rel kereta api sepanjang 7 meter berhasil diringkus personel Polres Serang Kota. https://t.co/Ksne53g2hT,18,2,3,1,2022-01-29,23,Saturday,6,21,3
1487566261286580230,2022-01-29 23:20:08,"Tak hanya itu, warna merah yang timbul pada kulitnya terdiri dari kandungan antosianin yang sangat baik untuk tubuh. https://t.co/ACqUN0O8mC",11,3,4,0,2022-01-29,23,Saturday,6,15,3
1487565215474540544,2022-01-29 23:15:59,Saat bercinta perempuan cenderung sulit untuk dipahami apakah sudah merasa terpuaskan atau belum. Tak perlu khawatir karena tanda-tandanya bisa dilihat. https://t.co/mJQ0idzX7U,2,0,2,0,2022-01-29,23,Saturday,6,4,0
1487564136603136004,2022-01-29 23:11:42,Tentara Niger mengumumkan bahwa mereka telah menembak mati 10 gerilyawan Islam. Peristiwa itu dipicu karena jihadis menyerang pos militer. https://t.co/LY5uxdKxJ8,14,2,2,0,2022-01-29,23,Saturday,6,16,2
1487562849253826563,2022-01-29 23:06:35,Persib Bandung dihantam badai COVID-19 jelang lawan Persikabo 1973 dalam laga lanjutan BRI Liga 1 2021/2022. 9 pemain Maung Bandung dinyatakan positif Corona. https://t.co/j1U9k0VczI,5,0,1,0,2022-01-29,23,Saturday,6,6,0
1487561772290691073,2022-01-29 23:02:18,"Bakamla berhasil mengevakuasi Wakil Kali Kota Tual yang terjebak di speedboat mati mesin di perairan Pulau Dua, Tual, Maluku. https://t.co/dYhd909iOc",11,4,3,1,2022-01-29,23,Saturday,6,14,5
1487560569314070538,2022-01-29 22:57:31,Penjaga Pantai Amerika Serikat (AS) mengatakan bahwa pihaknya telah memulangkan 40 orang ke Kuba setelah mencegat 2 kapal di dekat Florida. https://t.co/jJqwb0aSCI,6,1,0,0,2022-01-29,22,Saturday,6,6,1
1487558713602985985,2022-01-29 22:50:09,Perampok sadis yang menewaskan mahasiswi di Lampung Timur tewas di tangan polisi. Pelaku berinisial AD ditembak mati polisi lantaran melawan saat ditangkap. https://t.co/QxcnHkdpWX,28,10,2,0,2022-01-29,22,Saturday,6,30,10
1487557888306515973,2022-01-29 22:46:52,"Ketua Umum PAN, Zulkifli Hasan menyampaikan pidato kebudayaan saat acara Zulhas Award. Dia berpidato di depan 3 kandidat potensial capres 2024. https://t.co/Q41asLbA9Q",3,2,1,0,2022-01-29,22,Saturday,6,4,2
1487556318248505344,2022-01-29 22:40:38,"Polisi menangkap pengemudi ojol inisial KA (39), yang viral di media sosial mencuri HP di Makassar. Pelaku mencuri HP di laci motor yang terparkir di Masjid. https://t.co/XGAnjWvsz2",6,2,0,0,2022-01-29,22,Saturday,6,6,2
1487554829400653827,2022-01-29 22:34:43,Sebanyak 74 persen Perguruan Tinggi Kementerian Lain (PTKL) dari 179 institusi ternyata tidak terakreditasi. Dari yang sudah terakreditasi pun mayoritas B. https://t.co/m7NDYDBdfZ,9,0,2,0,2022-01-29,22,Saturday,6,11,0
1487552868194435075,2022-01-29 22:26:55,Wakil Ketua Umum PKB Jazilul mendorong polisi mengusut kasus Edy Mulyadi terkait 'jin buang anak'. Jazilul mengatakan pentingnya kasus ini untuk diproses. https://t.co/PxrIQlKPmD,18,3,3,1,2022-01-29,22,Saturday,6,21,4
1487552396062511105,2022-01-29 22:25:03,Ia mengatakan Indonesia masih beruntung bisa mengejar capaian vaksinasi COVID-19 sehingga pandemi masih bisa terkendali. https://t.co/vcVTa2K6TT,13,13,2,0,2022-01-29,22,Saturday,6,15,13
1487550468528214022,2022-01-29 22:17:23,BMKG mengeluarkan peringatan dini cuaca untuk DKI Jakarta. BMKG memprediksi terjadi hujan disertai petir dan angin kencang di Jaktim dan Jaksel sore ini. https://t.co/OWHgQKwcNd,7,1,0,1,2022-01-29,22,Saturday,6,7,2
1487548706211737600,2022-01-29 22:10:23,"Gempa magnitudo (M) 4,2 terjadi di barat laut Kabupaten Jayapura, Papua. Pusat gempa berada di darat. https://t.co/9Sj2Lbj5CJ",7,0,0,0,2022-01-29,22,Saturday,6,7,0
1487548229235392519,2022-01-29 22:08:29,"Komnas HAM dan Polda Sumut terus mendalami kerangkeng manusia di rumah Bupati Langkat Terbit Rencana. Untuk menelusuri kasus ini, Terbit juga akan diperiksa. https://t.co/0xYsXN3ZxN",9,2,1,2,2022-01-29,22,Saturday,6,10,4
1487544741432492032,2022-01-29 21:54:38,Polres Lampung Timur berhasil menangkap perampok sadis yang menewaskan seorang mahasiswi. Pelarian pelaku berinisial AD berakhir setelah sepekan buron. https://t.co/4Wyizhe890,6,1,2,0,2022-01-29,21,Saturday,6,8,1
1487544024139505673,2022-01-29 21:51:47,"Aplikasi BOT1 hadir sebagai platform digital yang mampu memantau kondisi penderita diabetes, sekaligus pendamping cerdas dalam proses penyembuhan. https://t.co/k6ZYO7rBw2",5,1,1,1,2022-01-29,21,Saturday,6,6,2
1487542187831222274,2022-01-29 21:44:29,"Lalu lintas di Jalan Kisamaun menuju Pasar Lama Kota Tangerang, Banten malam ini macet. Polisi melakukan sistem buka tutup untuk mengurai kemacetan. https://t.co/KR74NFhbpf",2,1,0,0,2022-01-29,21,Saturday,6,2,1
1487539932591759360,2022-01-29 21:35:31,"#Terpopuler Salah satu astronaut memotret pemandangan awan di sekitar Pulau Sumatera. Terlihat juga Pulau Bangka dan Belitung, Laut Jawa, dan pantai barat Kalimantan. https://t.co/3E7OvHCOtA",37,0,6,1,2022-01-29,21,Saturday,6,43,1
1487538653006077953,2022-01-29 21:30:26,"Nama pulau ini mungkin masih terdengar asing, tapi keindahannya tak perlu diragukan. Ditambah lagi, pulau jadi taman nasional terkecil dunia! https://t.co/sAoXoMZKxK",18,0,1,0,2022-01-29,21,Saturday,6,19,0
1487537376784232452,2022-01-29 21:25:22,Pemerintah melaporkan kasus harian positif Corona hari ini sebanyak 11.588 kasus. Provinsi kasus tertinggi dalam 24 jam terakhir adalah Provinsi DKI Jakarta. https://t.co/22JVi8uXjG,7,0,4,1,2022-01-29,21,Saturday,6,11,1
1487535324670664716,2022-01-29 21:17:13,"Dokter paru mengungkap ternyata demam bukanlah gejala awal dari Omicron. Lalu, seperti apa gejala awal yang dikeluhkan pasien saat terinfeksi varian itu? https://t.co/DM9gnyJpoQ",32,6,5,1,2022-01-29,21,Saturday,6,37,7
1487533972146077702,2022-01-29 21:11:50,Tisu magic sering digunakan oleh pria saat melakukan hubungan seksual. Benda ini biasa digunakan untuk menunda ejakulasi dini. Bagaimana efek sampingnya ya? https://t.co/1YghpzzWml,2,0,1,0,2022-01-29,21,Saturday,6,3,0
1487532697350250502,2022-01-29 21:06:46,Menparekraf Sandiaga Uno membongkar dugaan 'permainan' karantina terhadap wisatawan. Sandi mengaku tak segan menindak oknum yang mencoreng nama Indonesia. https://t.co/qyT8nhXqAq,4,0,2,1,2022-01-29,21,Saturday,6,6,1
1487528915727958028,2022-01-29 20:51:45,"Ular sanca 1 meter membuat geger warga di Makassar, Sulawesi Selatan. Ular ini muncul di rak piring di rumah warga. https://t.co/CRDChZuLQl",5,2,2,0,2022-01-29,20,Saturday,6,7,2
1487526664565309442,2022-01-29 20:42:48,Pengamat sepakbola Mohamad Kusnaeni menyebut Liga 1 harusnya tidak terlalu lama menerapkan sistem bubble. Potensi kebocoran mungkin terjadi. https://t.co/SSkLkLE4yj,4,0,0,0,2022-01-29,20,Saturday,6,4,0
1487524248109432844,2022-01-29 20:33:12,"Eks Ketua Komnas HAM, Ifdal Kasim berkomentar soal kasus 'jin buang anak' yang menjerat Edy Mulyadi. Menurutnya, laporan soal Edy Mulyadi layak diproses polisi. https://t.co/aJdF4UAxbe",4,0,0,1,2022-01-29,20,Saturday,6,4,1
1487523045162070022,2022-01-29 20:28:25,Seorang bocah laki-laki berusia 12 tahun mengalami priapisme yang membuat penisnya ereksi 24 jam. Tim medis menduga hal ini disebabkan infeksi COVID-19. https://t.co/RxTYwoLVay,70,65,21,28,2022-01-29,20,Saturday,6,91,93
1487520508887326724,2022-01-29 20:18:20,Viktor &amp; Rolf mempersembahkan koleksi yang sumber inspirasinya datang dari drakula dan kisah horor film Hollywood klasik lainnya. Seperti ini penampakannya: https://t.co/haYyxQ5JsJ,5,0,0,1,2022-01-29,20,Saturday,6,5,1
1487518088652279814,2022-01-29 20:08:43,"Seperti halnya pisau, otak juga perlu diasah agar selalu tajam. Otak juga butuh diolahragakan agar lebih berstamina untuk menyambut awal pekan. Yuk dicoba! https://t.co/c8KFMvKwu4",47,23,6,3,2022-01-29,20,Saturday,6,53,26
1487515862785564675,2022-01-29 19:59:53,"Jelang perayaan Tahun Baru China banyak rutinitas atau tradisi yang perlu dilakukan. Mulai dari membersihkan peralatan makan, sampai ngemil bareng keluarga. https://t.co/avLCSIMHAC",6,0,0,0,2022-01-29,19,Saturday,6,6,0
1487513995867209738,2022-01-29 19:52:27,"Seorang programmer terpaksa lengser dari posisi dan digantikan anak baru. Dia juga dipaksa menghapus data. Ternyata, keputusan itu disesali enam bulan kemudian. https://t.co/HrWAgwuZ78",10,0,2,2,2022-01-29,19,Saturday,6,12,2
1487512220938424328,2022-01-29 19:45:24,Sebelum mendaftar beasiswa LPDP perlu adanya persiapan matang yang harus dilakukan. Berikut ini tips dari dosen UGM. https://t.co/Ci5jDTrhGD,12,0,1,0,2022-01-29,19,Saturday,6,13,0
1487508543955685376,2022-01-29 19:30:48,"Wagub DKI, Riza Patria memastikan pembelajaran tatap muka 100% tetap dilaksanakan di tengah meningkatnya kasus Covid-19. Menurutnya DKI telah memenuhi persyaratan. https://t.co/getlDPVIbU",6,0,0,1,2022-01-29,19,Saturday,6,6,1
1487507305654628355,2022-01-29 19:25:52,Wamen LHK memastikan tindakan Bupati Langkat memelihara satwa dilindungi dapat diproses hukum. Satwa dilindungi tidak boleh dipelihara. https://t.co/nCMHadISPN,11,3,4,0,2022-01-29,19,Saturday,6,15,3
1487505816089415685,2022-01-29 19:19:57,Malware Android ini bisa menghapus data di ponsel setelah membobol rekening korban untuk menutupi jejaknya. Malware ini sudah menyerang di beberapa negara. https://t.co/T0A8xSHmRS,18,4,11,0,2022-01-29,19,Saturday,6,29,4
1487504484624482307,2022-01-29 19:14:40,Barcelona resmi memulangkan Adama Traore ke Camp Nou. Winger asal Spanyol itu dipinjam sampai akhir musim dari Wolverhampton Wanderers. https://t.co/jDiDoMeWi2,2,0,1,0,2022-01-29,19,Saturday,6,3,0
1487503230842114059,2022-01-29 19:09:41,Rafael Tan sudah mantap menikah dengan kekasihnya Sabina Paz yang berasal dari Australia. Saat ini dia sudah mulai menyiapkan rencana usai menikah. https://t.co/LZT4m4Inzc,7,2,0,0,2022-01-29,19,Saturday,6,7,2
1487501805256912903,2022-01-29 19:04:01,Dua orang pemilik warung di London bercerita tentang kerja keras dan tantangan yang mereka hadapi untuk tetap bertahan di tengah pandemi Corona. https://t.co/BQ6JFOEKrP,11,0,1,0,2022-01-29,19,Saturday,6,12,0
1487500156849295363,2022-01-29 18:57:28,"Peristiwa percobaan penipuan bermodus tabrak lari di Pasar Rebo, Jakarta Timur, viral. Apa yang harus kita lakukan bila menjadi sasaran modus tabrak lari? https://t.co/17gI6YT4DZ",71,15,31,2,2022-01-29,18,Saturday,6,102,17
1487497201437884416,2022-01-29 18:45:43,Gubernur Ridwan Kamil akan melakukan evaluasi pelaksanaan pembelajaran tatap muka (PTM) di Jawa Barat. Hal itu lantaran kasus Corona yang melonjak di Jabar. https://t.co/iiZFPkm0eo,6,0,1,1,2022-01-29,18,Saturday,6,7,1
1487495561959952384,2022-01-29 18:39:12,"Salah satu tradisi warga keturunan Tionghoa jelang Imlek yakni sembahyang leluhur. Nah, foto-foto berikut memvisualisasikan tradisi tersebut dalam bingkai foto. https://t.co/PR1TXggK0J",5,0,1,0,2022-01-29,18,Saturday,6,6,0
1487494213021356034,2022-01-29 18:33:51,Ada-ada saja tingkah menggemaskan seekor anjing. Salah satunya anjing husky ini yang baru mau makan setelah pemiliknya pura-pura jadi Salt Bae. https://t.co/keWkLP4tYI,6,0,1,0,2022-01-29,18,Saturday,6,7,0
1487492201596825609,2022-01-29 18:25:51,"Hujan deras disertai angin kencang di Kabupaten Kepahyang, membuat tiga pohon besar tumbang disertai tanah longsor. Akibatnya jalan tak bisa dilewati kendaraan. https://t.co/e0fFoaLCdB",6,0,0,0,2022-01-29,18,Saturday,6,6,0
1487490338482761729,2022-01-29 18:18:27,"Achmad Megantara baru saja menikahi kekasihnya, Asri Faradila, pada 22 Januari 2022. Bagaimana dengan harapan karier Megantara usai menikah? https://t.co/YwTrmerm7g",2,0,0,0,2022-01-29,18,Saturday,6,2,0
1487488737789554689,2022-01-29 18:12:05,"Indah Cleo Disc jockey atau Dj asal Bukit Tinggi, Sumatera Barat, merupakan salah satu dari 17 korban tewas dalam pembakaran karaoke Doubel 0 di Sorong. https://t.co/7m1gdOfYHo",7,0,3,1,2022-01-29,18,Saturday,6,10,1
1487486630831300612,2022-01-29 18:03:43,"Lama tak terlihat usai kontroversinya dengan Seo Ye Ji, Kim Jung Hyun akan membintangi film terbaru. Berikut sinopsisnya: https://t.co/RfH5qluDT7",4,0,0,0,2022-01-29,18,Saturday,6,4,0
1487484930770755591,2022-01-29 17:56:58,Lembaga Perlindungan Saksi dan Korban menemukan dugaan adanya penghuni yang tewas di kerangkeng rumah Bupati Langkat nonaktif Terbit Rencana Perangin Angin. https://t.co/LPmkqpA6if,10,0,1,2,2022-01-29,17,Saturday,6,11,2
1487481519119687680,2022-01-29 17:43:24,"Jika saat ini kamu sedang merencanakan pernikahan dan masih bingung memilih souvenir pernikahan, maka kamu perlu membaca artikel yang satu ini. https://t.co/CaP02MQTFU",5,0,3,0,2022-01-29,17,Saturday,6,8,0
1487479534794551300,2022-01-29 17:35:31,Rafael Tan sudah yakin akan menikah dengan Sabina Paz tahun depan. Ada satu alasan yang membuatnya sangat yakin buat meminang kekasih bulenya itu. https://t.co/qVMHy3hCsu,6,0,0,0,2022-01-29,17,Saturday,6,6,0
1487477926971035650,2022-01-29 17:29:08,Sekjen PDIP Hasto Kristianto membandingkan kepemimpinan Jokowi-Ahok hingga Anies saat memimpin Jakarta. Hsto lantas menyindir pemimpin santay. https://t.co/nk7XNge8HM,32,30,5,6,2022-01-29,17,Saturday,6,37,36
1487476010782240769,2022-01-29 17:21:31,"Gegara parkir sembarangan, pria ini dibuat bingung lantaran motornya dirantai ke tiang listrik. https://t.co/LTgHzprZXC",11,0,0,0,2022-01-29,17,Saturday,6,11,0
1487473803638759435,2022-01-29 17:12:45,"Tisu magic banyak dijadikan opsi oleh pasangan agar sesi bercinta jadi lebih tahan lama. Tapi, bagaimana cara pakai tisu magic yang benar? Begini caranya: https://t.co/YOqX6Q7CuN",6,0,0,3,2022-01-29,17,Saturday,6,6,3
1487472241499586566,2022-01-29 17:06:32,"Tiggo 4 Pro digadang-gadang bakal jadi SUV termurah Chery yang bakal segera dijual di RI dalam waktu dekat. Penasaran seperti apa kelebihannya? Yuk, lihat. https://t.co/zNO0VWiTlr",7,0,0,1,2022-01-29,17,Saturday,6,7,1
1487470219559903234,2022-01-29 16:58:30,Kadang hal yang tampak sederhana bisa jadi jebakan yang mengecoh logika. Buktikan kecerdasan kamu dengan menjawab teka-teki ini. https://t.co/AGtQVgIpVO,156,195,28,5,2022-01-29,16,Saturday,6,184,200
1487468902506536962,2022-01-29 16:53:16,Kumpul keluarga pada malam perayaan Imlek jadi agenda rutin yang ditunggu-tunggu. Lima restoran keluarga ini cocok untuk menjadi tempat santap bersama. https://t.co/knOucg9Ybe,1,0,0,1,2022-01-29,16,Saturday,6,1,1
1487467618315472900,2022-01-29 16:48:10,Ridwan Kamil dan Anies Baswedan saling berkomunikasi untuk menggelar pelaksanaan KTT Youth 20 yang akan berlangsung di Jakarta dan Bandung tahun ini. https://t.co/9tW2Szcnlx,16,0,1,0,2022-01-29,16,Saturday,6,17,0
1487467370994094080,2022-01-29 16:47:11,Ramai video Gala Sky merindukan Vanessa Angel dan Bibi Ardiansyah. Dalam video itu tampak Gala sendiri di kamar dan kepergok memandangi foto orang tuanya. https://t.co/pAP3Gxbr3J,16,1,0,0,2022-01-29,16,Saturday,6,16,1
1487466043014529026,2022-01-29 16:41:55,Netizen Indonesia tengah heboh olahan mie instan dengan tambahan es krim. Ternyata hal serupa juga ada di Jepang dimana ramen disajikan dengan topping es krim. https://t.co/qSvsuLKhM9,4,0,1,2,2022-01-29,16,Saturday,6,5,2
1487464083687460875,2022-01-29 16:34:07,"Lagu Bento milik musisi legendaris, Iwan Fals sangat ikonik di telinga masyarakat. Iwan Fals jelaskan makna sebenarnya dibalik lagu Bento:  https://t.co/j2aLf1BkRx",47,14,9,2,2022-01-29,16,Saturday,6,56,16
1487462883403444227,2022-01-29 16:29:21,"Rian Ekky Pradipta membuktikan kepada publik soal pertanyaan bahwa Rian dMasiv dan Momo Geisha adalah satu orang yang sama. Melalui lagu Cinta Ini Membunuhku milik dMasiv, Rian mencoba menjawab pertanyaan publik. https://t.co/mmzrC3cN6x",10,5,2,4,2022-01-29,16,Saturday,6,12,9
1487461209448370179,2022-01-29 16:22:42,Kapolda Metro Jaya Irjen Fadil Imran angkat bicara soal praktik pinjol ilegal. Dia menyebut praktik pinjol ilegal bak terjebak dalam lingkaran setan. https://t.co/dgVvX2BtZ3,25,3,5,0,2022-01-29,16,Saturday,6,30,3
1487459906152194051,2022-01-29 16:17:31,"Kelompok Koalisi Ulama, Habib &amp; Pengacara Anti Penodaan Agama (KUHAP APA) menyatakan sikap soal dugaan adanya perbuatan pelanggaran hukum yang dilakukan KSAD Jenderal Dudung Abdurachman. Perbuatan yang dimaksud yakni omongan Jenderal Dudung di sebuah ch... https://t.co/7o7MoxcBLa",44,35,5,5,2022-01-29,16,Saturday,6,49,40
1487458472006463489,2022-01-29 16:11:50,Aksi Brigjen Junior Tumilaar marah-marah terkait polemik lahan Sentul City dengan warga viral. Tumilaar mengungkap alasan dirinya marah-marah. https://t.co/p1YZxyNFCm,8,2,2,0,2022-01-29,16,Saturday,6,10,2
1487457354958446595,2022-01-29 16:07:23,"Fasilitas proving ground yang ada di Bekasi ini akan dibuat sesuai standar internasional, dengan beberapa fasilitas pengujian. https://t.co/ojamJc1ZdC",7,0,1,0,2022-01-29,16,Saturday,6,8,0
1487456171221045254,2022-01-29 16:02:41,"Broken heart syndrome atau kardiomiopati adalah penyakit jantung yang dipicu stres. Gelajanya mirip serangan jantung, yakni sakit dada dan sesak napas. https://t.co/TeSKe8Ce7Y",20,2,11,1,2022-01-29,16,Saturday,6,31,3
1487453887095349253,2022-01-29 15:53:36,"Inilah deretan rekor pemecatan manajer di Liga Inggris. Terselip satu nama, Jose Mourinho! https://t.co/JKGuGgTy2O",4,0,1,0,2022-01-29,15,Saturday,6,5,0
1487453865234550789,2022-01-29 15:53:31,"Agus Harimurti Yudhoyono (AHY) didukung kader Demokrat menjadi calon presiden 2024. Menanggapi hal tersebut, Agus mengatakan adalah hal yang wajar. https://t.co/PGghTwJpao",36,43,0,7,2022-01-29,15,Saturday,6,36,50
1487452775751593993,2022-01-29 15:49:11,Tiga pemain Persebaya Surabaya dinyatakan positif COVID-19. Itu diketahui usai menjalani tes swab rutin. https://t.co/LNP8zqNgvc,16,0,2,2,2022-01-29,15,Saturday,6,18,2
1487451671009628160,2022-01-29 15:44:48,Kapolda Sumut mengatakan ada 656 orang yang menjadi penghuni kerangkeng manusia di rumah Bupati Langkat nonaktif Terbit Rencana Perangin Angin. https://t.co/jXOARIviup,46,18,22,13,2022-01-29,15,Saturday,6,68,31
1487451110898114566,2022-01-29 15:42:35,"Untuk membuat varian sushi pedas, biasanya diberi tambahan bubuk cabai. Tapi sushi ini justru dilengkapi dengan irisan cabai rawit yang membuatnya terlihat aneh. https://t.co/n2n9DJiFmO",8,0,4,2,2022-01-29,15,Saturday,6,12,2
1487450013928149006,2022-01-29 15:38:13,"Ada beberapa rute alternatif menuju Lembang, Kabupaten Bandung Barat. Mau liburan ke sejumlah objek wisata di kawasan Lembang? Catat rute alternatif ini! https://t.co/Pedh5ZlMM3",13,3,4,3,2022-01-29,15,Saturday,6,17,6
1487449283934789638,2022-01-29 15:35:19,Ridwan Kamil buka suara soal niat maju ke pencapresan lewat Pemilu 2024. Dia tidak menolak jika kesempatan itu datang. https://t.co/542nf20MhQ,24,38,7,29,2022-01-29,15,Saturday,6,31,67
1487448124067045377,2022-01-29 15:30:42,"Kawasan kuliner Pasar Lama Kota Tengerang, Banten dipadati pengunjung. Satpol PP meminta warga untuk menjaga jarak dan menaati protokol kesehatan. https://t.co/GJqD7u3kqM",26,6,6,3,2022-01-29,15,Saturday,6,32,9
1487447515804934145,2022-01-29 15:28:17,Bukan Elon Musk namanya kalau tidak menciptakan kehebohan. Kali ini dia menawarkan McDonald's menerima pembelian dengan Dogecoin. https://t.co/6DDlbEFFAt,12,1,3,1,2022-01-29,15,Saturday,6,15,2
1487445097058910215,2022-01-29 15:18:41,"Polisi membantah tudingan playing victim kepada sopir taksi online yang menabrak dua pemotor jambret hingga tewas di Tebet, Jakarta Selatan, pada Oktober 2021. https://t.co/lyMwp5pfJO",6,0,3,0,2022-01-29,15,Saturday,6,9,0
1487444256583213060,2022-01-29 15:15:20,"Park Shin Hye dan Choi Tae Joon tengah menantikan kelahiran anak pertama. Kini, muncul dugaan bahwa Park Shin Hye mengandung anak laki-laki. https://t.co/x5OkY2621q",7,1,1,2,2022-01-29,15,Saturday,6,8,3
1487443216366505992,2022-01-29 15:11:12,Frank Lampard menjadi kandidat terkuat manajer baru Everton. Manajemen The Toffees akan segera meresmikannya dalam waktu dekat. https://t.co/wxvlHu9yP7,9,0,2,0,2022-01-29,15,Saturday,6,11,0
1487442242012954625,2022-01-29 15:07:20,#Terpopuler Pencarian terhadap makhluk hidup atau alien di luar Bumi makin diintensifkan. Lembaga antariksa NASA dan SETI Institute berharap akan ada titik terang. https://t.co/X0DtNGaILk,7,1,2,1,2022-01-29,15,Saturday,6,9,2
1487441323158388737,2022-01-29 15:03:41,Beberapa artis tanah air ini memilih untuk memberikan asisten kesayangannya kado berupa barang-barang mewah. Penasaran apa saja? Berikut foto-fotonya: https://t.co/pzU9bxf6eC,10,1,2,0,2022-01-29,15,Saturday,6,12,1
1487440386142441472,2022-01-29 14:59:58,Pria ini membuat para cat lover geregetan gemas. Ia membuat acara selapanan untuk anak kucing yang baru lahir dan memberikan nama https://t.co/Xmximbitle,31,2,4,0,2022-01-29,14,Saturday,6,35,2
1487439241554579458,2022-01-29 14:55:25,"#Terpopuler 2 tahun Aliando Syarief menghilang dari dunia hiburan. Kini, Aliando muncul dan mengumumkan dirinya tengah mengidap OCD.  https://t.co/9ct6geUZyk",14,1,2,0,2022-01-29,14,Saturday,6,16,1
1487438402651889669,2022-01-29 14:52:05,Indonesia masuk dalam tiga besar wisatawan terbanyak yang datang ke Singapura. Kegiatan favorit mereka adalah berbelanja dan mencicipi kuliner. https://t.co/9y176cZF7g,28,4,4,3,2022-01-29,14,Saturday,6,32,7
1487437226409705478,2022-01-29 14:47:24,"Magelang meraih penghargaan sebagai Kota Ramah Sepeda kategori kota kecil/sedang dengan predikat emas dalam Bike to Work (B2W) Award 2021, Sabtu (29/1/2022). https://t.co/foZ8b2Y6BA",59,5,13,0,2022-01-29,14,Saturday,6,72,5
1487435973055197191,2022-01-29 14:42:25,Suka bingung menulis caption Instagram? Sesekali keluarkan sisi humorismu dengan caption Instagram lucu yang bisa bikin banyak orang tekan tombol like. https://t.co/7IsHNqO6gV,25,1,9,0,2022-01-29,14,Saturday,6,34,1
1487434808351416328,2022-01-29 14:37:48,"Dikenal sebagai penemu makanan, makam orang-orang ini ramai dikunjungi dan diberi penghormatan. Beberapa makam bahkan juga dipenuhi makanan! https://t.co/Mxyt3CXx4r",4,0,3,0,2022-01-29,14,Saturday,6,7,0
1487433823101014018,2022-01-29 14:33:53,"Stefan Chen bercerai dengan Keanna Taiyh, saat istrinya hamil. Stefan Chen juga kala itu mengancam untuk merilis rekaman seks mereka. https://t.co/XlcNgwCRJo",10,0,1,0,2022-01-29,14,Saturday,6,11,0
1487432816988246016,2022-01-29 14:29:53,"Kontrak Paul Pogba dengan Manchester United habis akhir musim ini. Bisa direkrut cuma-cuma, Pogba dinilai jadi opsi sangat bagus buat Chelsea. https://t.co/mRt584uUxt",13,0,1,0,2022-01-29,14,Saturday,6,14,0
1487431653446369281,2022-01-29 14:25:15,Ashleigh Barty tampil gemilang untuk menjuarai Australian Open 2022. Ia bangkit dari ketertinggalan di set kedua untuk menang 2-0 atas Danielle Collins. https://t.co/w2XjMlmSiq,7,0,2,0,2022-01-29,14,Saturday,6,9,0
1487430914787446784,2022-01-29 14:22:19,"Gubernur Jawa Barat Ridwan Kamil, yang juga seorang arsitek, menyebut Jakarta International Stadium (JIS) keren. RK pun memberi dua jempolnya untuk Anies. https://t.co/ZqupRWlle3",229,28,30,7,2022-01-29,14,Saturday,6,259,35
1487429715493363721,2022-01-29 14:17:33,Gubernur Jawa Barat Ridwan Kamil mengaku lebih realistis mencalonkan diri menjadi Gubernur Jawa Barat 2 periode ketimbang maju sebagai calon presiden (capres). https://t.co/0uJDMcBRqA,38,36,4,25,2022-01-29,14,Saturday,6,42,61
1487429069495021570,2022-01-29 14:14:59,"Ridwan Kamil hadir dalam acara Zulhas Award. Dalam sambutannya, dia menyebut saat ini bangsa Indonesia menghadapi permasalahan utama, yakni pertengkaran. https://t.co/Cai9AzYY2I",5,9,2,3,2022-01-29,14,Saturday,6,7,12
1487428373500547074,2022-01-29 14:12:13,Cuaca Bandung Raya cenderung lebih panas dalam beberapa hari terakhir ini yang menyentuh 30 °C. https://t.co/E6BY1C6lYi,15,1,2,1,2022-01-29,14,Saturday,6,17,2
1487428125780762624,2022-01-29 14:11:14,Video seorang guru pukul siswa SMP di Surabaya viral di grup whatsapp. Aksi guru itu dilaporkan ke polisi orang orangtua siswa. https://t.co/0myLkqlSoL,180,122,29,36,2022-01-29,14,Saturday,6,209,158
1487427558874529796,2022-01-29 14:08:59,"Kebakaran rumah terjadi di Kebon Baru, Tebet, Jakarta Selatan, pagi tadi. Tiga orang dinyatakan tewas akibat peristiwa ini. https://t.co/0Klt80Shbh",7,1,2,0,2022-01-29,14,Saturday,6,9,1
1487426425699323912,2022-01-29 14:04:29,"Tottenham Hotspur ditikung Liverpool dalam transfer Luis Diaz. Bukan yang pertama, bukan pula paling pedih buat Spurs karena sebelumnya ada kisah Willian. https://t.co/YYRExi2kue",3,1,0,0,2022-01-29,14,Saturday,6,3,1
1487425770096107523,2022-01-29 14:01:53,"WNI asal Bandung ini menceritakan suka dukanya kerja di Swiss selama lebih dari 10 tahun. Kini, dia sukses menjadi mekanik dengan gaji Rp77 juta per bulan. #detiknetwork  https://t.co/mvSghsWlwU",23,0,3,1,2022-01-29,14,Saturday,6,26,1
1487424353633456129,2022-01-29 13:56:15,"Pasar mobil di Indonesia memang didominasi oleh tipe MPV, wajar jika dapur produksi di pabrik dipenuhi dengan mobil MPV demi memenuhi kebutuhan pasar domestik. https://t.co/ZN7qcJsxxA",5,0,3,0,2022-01-29,13,Saturday,6,8,0
1487423484087185414,2022-01-29 13:52:48,Timnas Indonesia harus berbenah jelang laga kontra Timor Leste kali kedua. Pasukan Shin Tae-yong harus selesaikan lima masalah ini. https://t.co/lk1zRQR479,9,0,1,0,2022-01-29,13,Saturday,6,10,0
1487422550628085764,2022-01-29 13:49:05,Pengguna iPhone tidak lama lagi akan bisa membuka kunci dengan Face ID saat mengenakan masker. Fitur ini akan hadir di iOS 15.4 yang masih dalam tahap beta. https://t.co/4j9aFGGXwJ,17,5,11,17,2022-01-29,13,Saturday,6,28,22
1487421436067209216,2022-01-29 13:44:39,Imlek menjadi momen mudik warga China seperti lebaran di Indonesia. Tetapi pemerintah China malah bikin kebijakan lockdown yang bikin bingung warganya. https://t.co/JvmZs2DL3r,10,1,2,0,2022-01-29,13,Saturday,6,12,1
1487420357220999177,2022-01-29 13:40:22,Megantara merasa bahagia usai menikah karena akhirnya dia bisa pacaran. Begini penuturannya: https://t.co/xDYkoXwtZi,26,1,1,5,2022-01-29,13,Saturday,6,27,6
1487419793921695753,2022-01-29 13:38:08,"Lionel Messi belum terlihat gemilang bersama PSG di Lgiue 1. Setidaknya sampai pertengahan musim ini, Messi masih memble bikin gol. https://t.co/n05omh3w2i",5,3,0,0,2022-01-29,13,Saturday,6,5,3
1487417522894868482,2022-01-29 13:29:06,Viral video petugas menurunkan barang melalui pintu belakang pesawat melalui tangga pesawat Lion Air. Manajemen Lion Air tengah menyelidiki video viral itu. https://t.co/kPyemtQkfS,73,7,25,4,2022-01-29,13,Saturday,6,98,11
1487416347164389377,2022-01-29 13:24:26,Tiga pemain Persebaya Surabaya positif COVID-19. Itu diketahui usai menjalani tes swab rutin. Meski begitu belum ada statemen resmi dari klub Persebaya. https://t.co/hDWy9VVoWy,6,1,1,0,2022-01-29,13,Saturday,6,7,1
1487415199309176832,2022-01-29 13:19:53,"Januari ini Arsenal begitu suram nan 'horor'. The Gunners kalah melulu dan sulit cetak gol, hingga terdepak dari dua kompetisi. https://t.co/wlktlQusvP",8,0,0,1,2022-01-29,13,Saturday,6,8,1
1487414326923350021,2022-01-29 13:16:25,LPSK mengungkap sejumlah fakta terkait kerangkeng manusia di rumah Bupati Langkat. LPSK mengatakan para penghuni itu dibatasi beribadah. https://t.co/tQlknToogJ,12,0,6,1,2022-01-29,13,Saturday,6,18,1
1487413123132936195,2022-01-29 13:11:38,"Ada 10 musisi yang lagunya dilarang diputar di radio-radio di China. Hal itu disebabkan kebijakan pemerintah setempat, apa saja? https://t.co/JS5tAJJPco",9,0,4,0,2022-01-29,13,Saturday,6,13,0
1487412373262675971,2022-01-29 13:08:39,Kelompok kesenian barongsai di Asahan Sumatera Utara (Sumut) tahun ini sangat antusias menyambut Hari Raya Imlek. Mereka mengaku sudah setahun tak menampilkan atraksi tarian barongsai setelah satu tahun tidak pernah bermain. https://t.co/Esk9JZWqOC,8,0,1,0,2022-01-29,13,Saturday,6,9,0
1487411458937966596,2022-01-29 13:05:01,Kawula muda Surabaya mana yang tidak suka nongkrong di kafe? Apalagi saat weekend. Berikut 10 rekomendasi tempat nongkrong cozy di Surabaya. https://t.co/iPfXw4Loo7,14,2,1,2,2022-01-29,13,Saturday,6,15,4
1487410645339447299,2022-01-29 13:01:47,Polisi masih memproses kasus dugaan suntikan vaksin kosong ke siswa SD di Medan. Polisi kini tapkan dokter G yang menyuntikkan vaksin kosong sebagai tersangka. https://t.co/dt7YJUXQ6L,15,1,2,0,2022-01-29,13,Saturday,6,17,1
1487409801625800706,2022-01-29 12:58:26,"Satu jenazah korban erupsi Gunung Semeru kembali ditemukan. Korban tersebut ditemukan di Kampung Rentang, Desa Sumberwuluh, Kecamatan Candipuro. https://t.co/m0efsvaPDY",9,0,3,0,2022-01-29,12,Saturday,6,12,0
1487408835132284935,2022-01-29 12:54:35,"#Terpopuker Rizky Billar punya rencana mengikuti jejak Raffi Ahmad, Gading Marten dan Atta Halilintar membeli klub sepakbola. Ini alasan Rizky Billar batal beli PSMS Medan:  https://t.co/4C7CoGF61e",16,4,2,4,2022-01-29,12,Saturday,6,18,8
1487407527998468100,2022-01-29 12:49:24,"Berusaha menyajikan menu vegan untuk tamu di acara pernikahannya, pengantin ini menuai kritik pedas. Pasalnya menu yang disajikannya tampak seperti rumput. https://t.co/Rep43xu4iR",5,0,0,3,2022-01-29,12,Saturday,6,5,3
1487406686776213506,2022-01-29 12:46:03,Kasus Covid-19 di Indonesia mengalami kenaikan. Ketua Satgas Covid-19 IDI Prof Zubairi Djoerban dan epidemiolog UI Pandu Riono punya pendapat berbeda. https://t.co/ZdwYFvg68o,15,3,0,0,2022-01-29,12,Saturday,6,15,3
1487405297085952000,2022-01-29 12:40:32,"Wahana bermain dan berpetualang yang seru untuk anak-anak. Amber Immersive Land, sebuah digital playground audio visual yang dapat dinikmati secara interaktif dengan sensor gerak dan suara. https://t.co/n7cTOTduyV",6,1,1,1,2022-01-29,12,Saturday,6,7,2
1487404101105295370,2022-01-29 12:35:46,Dicky Budiman memprediksi lonjakan kasus Covid-19 varian Omicron jatuh di bulan Februari. Kasus di level global dalam 7 hari terakhir ini mencapai 21 juta. https://t.co/GYI99hDV4e,19,1,6,1,2022-01-29,12,Saturday,6,25,2
1487401603367899141,2022-01-29 12:25:51,"Kasus aktif Corona di Indonesia melonjak, menembus angka 50 ribu orang. Hampir setengahnya disumbang DKI Jakarta, ini sebaran kasus aktif Corona terbaru. https://t.co/MgpAZ0kEwK",12,2,6,6,2022-01-29,12,Saturday,6,18,8
1487401475425071110,2022-01-29 12:25:20,"Ridwan Kamil diisukan bergabung ke Partai Amanat Nasional (PAN). Saat diminta konfirmasi, Gubernur Jawa Barat itu masih mempertimbangkan. https://t.co/AAqDZTCnvB",8,0,0,0,2022-01-29,12,Saturday,6,8,0
1487400655300014085,2022-01-29 12:22:05,#VIDEO Ramai video di sosial media yang menyiratkan bahwa Gala Sky tengah merindukan Vanessa Angel dan Bibi Ardiansyah. Dalam video itu tampak Gala sendiri di kamar dan kepergok tengah memandangi foto orang tuanya dalam sampul majalah. https://t.co/rpqhgsyYzY,9,0,0,0,2022-01-29,12,Saturday,6,9,0
1487399476360847364,2022-01-29 12:17:24,Nissan kabarnya akan melahirkan city car Nissan March yang berubah total. Nissan March itu disebut akan mengusung tenaga listrik. https://t.co/tN66WOsPeO,11,0,1,1,2022-01-29,12,Saturday,6,12,1
1487398446898294785,2022-01-29 12:13:18,"Setelah wawancara Ririe Fairus bersama Maia Estianty viral, cuplikan video pendek dari Nissa Sabyan saat ditanya soal poligami jadi sorotan. https://t.co/AhFeKqkc37",8,0,1,2,2022-01-29,12,Saturday,6,9,2
1487397630330163204,2022-01-29 12:10:04,"Gejala COVID-19 Omicron yang ringan cenderung muncul dalam bentuk batuk dan sakit tenggorokan. Namun, kadang bisa juga muncul gejala pada mata dan telinga. https://t.co/tizwbl0qrA",6,0,2,1,2022-01-29,12,Saturday,6,8,1
1487396376958971906,2022-01-29 12:05:05,Sikap keluarga kepada Aliando Syarief yang idap OCD ekstrem. Seperti apa? https://t.co/T8FaTlR7Jh,6,1,1,0,2022-01-29,12,Saturday,6,7,1
1487395441813729280,2022-01-29 12:01:22,Valentino Rossi mengungkapkan momen paling menakutkan selama mengaspal di MotoGP. Apa yang membuat The Doctor masih merasa takut? Baca selengkapnya di #CNNIndonesia #detiknetwork  https://t.co/LDcdHyO3VR,7,0,3,0,2022-01-29,12,Saturday,6,10,0
1487394105525252100,2022-01-29 11:56:03,"Ananda Omesh mengaku terkejut saat melihat posting-an terbaru Instagram dari istrinya, Dian Ayu Lestari, lantaran sang istri naik moge saat hamil. https://t.co/MRTN5jmNDr",7,0,1,0,2022-01-29,11,Saturday,6,8,0
1487393023235440643,2022-01-29 11:51:45,"Juventus gemar betul membeli striker. Dalam satu dekade terakhir, Si Nyonya Tua sudah keluarkan kocek sebanyak Rp 7 triliun buat belanja penyerang baru! https://t.co/49ir3N15bf",10,2,3,0,2022-01-29,11,Saturday,6,13,2
1487391635696762883,2022-01-29 11:46:15,Temuan-temuan baru muncul setelah penyelidikan terhadap kecelakaan maut truk tronton di Balikpapan dilakukan. Salah satunya soal alasan sopir tak banting setir. https://t.co/8XD5MrUjPG,24,0,3,2,2022-01-29,11,Saturday,6,27,2
1487390884161277953,2022-01-29 11:43:15,Penyanyi Widi 'Vierratale' baru saja bercerita panjang di akun media sosial Instagram miliknya. Widi curhat soal pacarnya yang meminta unfollow laki-laki lain. https://t.co/f2EO2rH4Lz,28,10,4,6,2022-01-29,11,Saturday,6,32,16
1487390617026150400,2022-01-29 11:42:12,"PDIP kembali menyindir Gubernur DKI Jakarta Anies Baswedan. Setidaknya, ada tiga kali PDIP menyindir Anies dalam sepekan terakhir. https://t.co/lpG8e7ZFtu",19,27,1,2,2022-01-29,11,Saturday,6,20,29
1487388671040970752,2022-01-29 11:34:28,"Fitria, TKW asal Karawang, kini berada di Jakarta. Sebelumnya, video perempuan tersebut viral karena meminta tolong untuk dipulangkan dari Bahrain ke Indonesia. https://t.co/zdR9MVvbuI",31,1,5,1,2022-01-29,11,Saturday,6,36,2
1487387776882511873,2022-01-29 11:30:54,"Banyak foto yang dikaburkan di Google Maps karena alasan privasi pengguna. Namun foto-foto berikut ini, dikaburkan diduga karena alasan yang dirahasiakan. https://t.co/8vGqG6EzR8",5,0,1,0,2022-01-29,11,Saturday,6,6,0
1487387237692153856,2022-01-29 11:28:46,Keluarga DJ Indah Cleo segera menerbangkan jenazah untuk dimakamkan di tanah kelahirannya di Bukit Tinggi setelah diserahkan pihak Kepolisian. https://t.co/1cARynPqrv,4,2,0,0,2022-01-29,11,Saturday,6,4,2
1487386617660772352,2022-01-29 11:26:18,Kebakaran terjadi di Pasar Induk Bondowoso di Jalan Teuku Umar. Obyek yang terbakar adalah sejumlah toko yang ada berada di pasar. https://t.co/89bbMxKFbD,7,0,1,1,2022-01-29,11,Saturday,6,8,1
1487386134929985539,2022-01-29 11:24:23,Panti asuhan yang juga ponpes ini kondisinya penuh keterbatasan. Atap bocor dan dinding bolong-bolong. Ini penampakannya: https://t.co/tMrNsHSCmX,20,1,2,1,2022-01-29,11,Saturday,6,22,2
1487385279723941889,2022-01-29 11:20:59,Widi bimbang antara menikah dan Vierratale. Ia curhat di media sosial. https://t.co/Fvd2leETiW,10,0,0,1,2022-01-29,11,Saturday,6,10,1
1487385262883840002,2022-01-29 11:20:55,"Gempa bumi kembali mengguncang Pacitan. Setelah gempa M 3.0 terjadi pukul 15.09 WIB, kali ini gempa Pacitan berkekuatan M 3.4 terjadi pukul 15.41.34 WIB. https://t.co/hzBp1ut7VD",12,0,0,0,2022-01-29,11,Saturday,6,12,0
1487384519112015874,2022-01-29 11:17:58,"Kemenkes RI melaporkan kondisi kasus COVID-19 di Indonesia. Ternyata, dibandingkan negara Asia lainnya kondisi COVID-19 RI jauh lebih baik. Berikut rinciannya: https://t.co/YvXTFDlAzI",11,1,1,0,2022-01-29,11,Saturday,6,12,1
1487383742603747331,2022-01-29 11:14:53,"Hujan deras menyebabkan 3 kecamatan di Jember diterjang banjir luapan aliran sungai. Dari data sementara TRC BPBD Jember, tiga kecamatan terdampak banjir https://t.co/WP4jvN9qr6",3,0,0,0,2022-01-29,11,Saturday,6,3,0
1487383230424756226,2022-01-29 11:12:51,"Ada sesuatu yang salah pada deretan gambar ini. Kamu harus cari dan menebaknya. Namun, perlu fokus yang tinggi, semoga berhasil. https://t.co/1eBCQXTaRS",12,2,2,0,2022-01-29,11,Saturday,6,14,2
1487382964568838149,2022-01-29 11:11:47,Donny van de Beek sudah cukup frustrasi. Dirinya dikabarkan sampai memohon kepada Manchester United untuk melepasnya di bursa transfer musim dingin ini. https://t.co/qvWkbvziBN,6,1,1,1,2022-01-29,11,Saturday,6,7,2
1487381841153826819,2022-01-29 11:07:19,Ada beberapa sekolah kedinasan yang cocok untuk jurusan IPA dan SMK. Berikut adalah daftarnya: https://t.co/2TLDFGzPG2,9,0,1,0,2022-01-29,11,Saturday,6,10,0
1487381195407175680,2022-01-29 11:04:45,"Indonesia mencatat sebanyak 11.588 kasus baru COVID-19, Sabtu (29/1/2022). DKI menyumbang kasus terbanyak dengan jumlah 5.765 kasus. https://t.co/awkDFHjmXO",14,2,5,1,2022-01-29,11,Saturday,6,19,3
1487381087676420099,2022-01-29 11:04:20,Akhir Januari 2022 akan ada fenomena astronomi menarik. Langit bakal dikunjungi fenomena Bulan Hitam. Apa itu Bulan Hitam? https://t.co/qpqZgxutbH,11,1,4,1,2022-01-29,11,Saturday,6,15,2
1487380217165406208,2022-01-29 11:00:52,Msncuat nama Ahok higga Tri Risma Harini menjadi calon kepala (IKN). PDIP selaku parpol yang menaungi keduanya mengatakan keputusan ditangan Presiden Jokowi. https://t.co/QfYoDjTqpa,17,16,1,2,2022-01-29,11,Saturday,6,18,18
1487379436471296001,2022-01-29 10:57:46,"Wakil Gubernur DKI Jakarta, Riza Patria mengimbau masyarakat DKI tidak menimbulkan kerumunan saat merayakan tahun baru Imlek. Hal itu untuk mencegah penularan Covid-19. https://t.co/Dt2TZRUoS4",4,2,0,0,2022-01-29,10,Saturday,6,4,2
1487378624579842057,2022-01-29 10:54:32,Balada minyak goreng langka di minimarket masih terus berlangsung. Hari ini stok di sejumlah minimarket juga kosong melompong. https://t.co/AOOd9hOkf8,50,22,12,8,2022-01-29,10,Saturday,6,62,30
1487377823895543810,2022-01-29 10:51:22,"Wakil Gubernur DKI Jakarta, Riza Patria, menyebut BOR di DKI Jakarta meningkat 54%. Pihaknya meminta warga menunda bepergian. https://t.co/8nH5IJLJsH",8,0,1,2,2022-01-29,10,Saturday,6,9,2
1487376575779725315,2022-01-29 10:46:24,"Kumpulan hasil gambar sketsa dari para netizen ini nyeleneh abis, bikin ketawa ngakak sampai bengkek. Benar-benar di luar ekspetasi. Penasaran seperti apa? https://t.co/CZZjOuiLRp",9,0,3,0,2022-01-29,10,Saturday,6,12,0
1487375556576432131,2022-01-29 10:42:21,"Bicara soal restoran legendaris, Wong Fu Kie salah satu yang tertua di Jakarta. Restoran Hakka ini berdiri sejak tahun 1925 dan sudah melegenda. https://t.co/Y8zqRjT37e",19,2,2,0,2022-01-29,10,Saturday,6,21,2
1487373493612208132,2022-01-29 10:34:09,"Jumlah kasus COVID-19 bertambah 11.588 kasus pada Sabtu (29/1/2022), sehingga total menjadi 4.330.763. Pasien sembuh bertambah 2.590, meninggal 17. https://t.co/BoQxUfhpr6",10,1,3,12,2022-01-29,10,Saturday,6,13,13
1487372427570999300,2022-01-29 10:29:55,Ekonom senior Faisal Basri memprediksi pemerintahan Presiden Joko Widodo (Jokowi) akan ambruk secara moral sebelum 2024. https://t.co/k64JpROdRG,1620,560,340,112,2022-01-29,10,Saturday,6,1960,672
1487371623032311809,2022-01-29 10:26:43,"Jangan Lupa! Malam ini ada Fun Match dBattle Arena Bareng Komika! Siapa jagoan kamu?
-
Tonton live streamingnya dan tebak skornya yuk. Ada hadiah saldo e-wallet total senilai 1 Juta. Selengkapnya: https://t.co/T2HzMHgIqU https://t.co/No1zSz5zXv",2,0,2,0,2022-01-29,10,Saturday,6,4,0
1487371098413060098,2022-01-29 10:24:38,Presiden Jokowi meminta dukungan ICMI dalam program pembangunan IKN di Kalimantan Timur. Menurutnya program IKN bukan sekedar pindah gedung pemerintahan. https://t.co/NfrL0SZzfE,19,0,2,1,2022-01-29,10,Saturday,6,21,1
1487370377219215363,2022-01-29 10:21:46,"Tetangga negara Indonesia, Myanmar dan Malaysia memiliki kisah unik soal ibu kota negara barunya. Simak kisahnya di sini: https://t.co/kI4wcy6Rot",5,0,5,1,2022-01-29,10,Saturday,6,10,1
1487368354415452166,2022-01-29 10:13:44,Ketua Komisi VIII DPR RI Yandri Susanto angkat bicara terkait data BNPT yang mengungkap adanya 119 Ponpes terindikasi terorisme. https://t.co/m1POv5sD51,7,2,2,1,2022-01-29,10,Saturday,6,9,3
1487367838755078144,2022-01-29 10:11:41,"Bali United menghadapi Borneo FC di lanjutan Liga 1. Bali United menang dramatis dengan gol di menit akhir laga, yang membuatnya menang 2-1. https://t.co/uqATwh6XY0",3,0,0,0,2022-01-29,10,Saturday,6,3,0
1487367515168722946,2022-01-29 10:10:24,Apakah foto tersebut diambil ketika Thariq Halilintar akhirnya melamar Fuji? Fuji bilang 'Yes'. https://t.co/wp873hzd24,9,3,0,0,2022-01-29,10,Saturday,6,9,3
1487366437970886660,2022-01-29 10:06:07,"LPSK melakukan investigasi dan memeriksa sejumlah saksi terkait kasus tersebut, hasilnya LPSK menemukan 7 temuan dalam polemik kerangkeng manusia itu. https://t.co/y3PkQ87xXL",10,3,5,0,2022-01-29,10,Saturday,6,15,3
1487365926626508805,2022-01-29 10:04:05,Puding buatan ibu rumah tangga di Jombang banyak digemari untuk buah tangan perayaan Imlek. Ramainya pesanan membuat omzet penjualan puding capai Rp 2 juta/hari https://t.co/6KY5iYfQnz,8,0,0,0,2022-01-29,10,Saturday,6,8,0
1487364749100736516,2022-01-29 09:59:24,Boiyen ngaku banyak pria mendekati. Ia jadi ingin segera menikah. https://t.co/U6RXxLCq3q,6,0,0,1,2022-01-29,9,Saturday,6,6,1
1487363823417929729,2022-01-29 09:55:44,"Juventus sudah mendatangkan Dusan Vlahovic dari Fiorentina dengan harga yang sangat tinggi. Selain Vlahovic, ada 2 transfer mahal lainnya di bulan Januari. https://t.co/CCXsROJCIA",6,0,0,0,2022-01-29,9,Saturday,6,6,0
1487363029050302464,2022-01-29 09:52:34,Polisi meminta warga tidak menyebar isu viral soal penabrak yang 'playing victim' itu. Di sinilah lokasi yang penabrak menewaskan dua orang itu. https://t.co/jbAm3BGItu,8,1,0,0,2022-01-29,9,Saturday,6,8,1
1487362250407133186,2022-01-29 09:49:29,Pria diduga penipu bermodus tabrak lari lalu pura-pura pincang di Jakarta Timur gagal beraksi. Pria itu disebut sempat marah ke warga usai aksinya gagal. https://t.co/b9aZATfLa1,106,20,36,8,2022-01-29,9,Saturday,6,142,28
1487361261956390912,2022-01-29 09:45:33,Poached egg menjadi salah satu menu sarapan ala Barat yang populer. Kalau ingin membuat poached egg sempurna dan praktis bisa memakai cara ini. https://t.co/xLHPQ8v2jY,2,0,1,0,2022-01-29,9,Saturday,6,3,0
1487360505723469825,2022-01-29 09:42:33,Aplikasi diet ini jadi kontroversi setelah menyarankan penggunanya untuk mengonsumsi kalori jauh lebih sedikit dari kebutuhan per hari. https://t.co/BXhR92aIR2,6,0,0,1,2022-01-29,9,Saturday,6,6,1
1487359189819211776,2022-01-29 09:37:19,"Bentrokan Sorong menewaskan 18 orang. Bentrokan di tempat Karaoke Double O dipicu 2 kelompok anak muda yang terlibat keributan. Kini, 2 kelompok itu berdamai. https://t.co/dbPJl9aoMG",14,2,0,1,2022-01-29,9,Saturday,6,14,3
1487358228564426752,2022-01-29 09:33:30,"Nggak cuma untuk membaca peruntungan, romansa, dan sifat seseorang, tapi zodiak juga bisa mengetahui jurusan kuliah apa yang cocok. Ini tipe yang cocok untuk kamu: https://t.co/JD1aO3ufGM",3,4,1,1,2022-01-29,9,Saturday,6,4,5
1487356876090191879,2022-01-29 09:28:07,Presiden Jokowi menghadiri pengukuhan Majelis Pengurus Pusat ICMI secara virtual. Jokowi berharap ICMI dapat ikut dalam melakukan transformasi Indonesia. https://t.co/xk3sraQpEL,9,0,1,2,2022-01-29,9,Saturday,6,10,2
1487355983244533762,2022-01-29 09:24:34,PAN menggelar Zulhas Award. Gubernur DKI Jakarta Anies Baswedan dan Gubernur Jawa Barat Ridwan Kamil terlihat duduk bersebelahan di acara ini. https://t.co/BvmzT2rxq3,17,10,4,1,2022-01-29,9,Saturday,6,21,11
1487353903868006401,2022-01-29 09:16:19,Satpol PP bersama BPOM dan Dinkes Kabupaten Tangerang menggrebek toko kosmetik di wilayah Solear. Toko kosmetik itu diduga menjual obat-obat terlarang. https://t.co/ockUwSOabk,5,0,2,0,2022-01-29,9,Saturday,6,7,0
1487353636342710272,2022-01-29 09:15:15,Pihak Edy Mulyadi mengatakan akan mengirim surat ke Dewan Pers terkait polemik kasus dugaan ujaran kebencian soal pernyataan 'tempat jin buang anak'. https://t.co/Q2oCudmq6H,15,20,5,4,2022-01-29,9,Saturday,6,20,24
1487352399505338368,2022-01-29 09:10:20,Aktris Cina Angelababy mengumumkan perceraiannya dengan Huang Xiaoming. Berikut fakta-fakta Angelababy yang menggelar pesta pernikahan Rp 417 miliar. https://t.co/5p3zX8YjGC,4,1,1,1,2022-01-29,9,Saturday,6,5,2
1487351521813671937,2022-01-29 09:06:51,Bagi orangtua mungkin menginginkan nama bayi perempuan terbaik. Ada beberapa pilihan nama bayi perempuan lengkap dari A hingga Z. https://t.co/a4m3spcpXh,12,0,1,0,2022-01-29,9,Saturday,6,13,0
1487350170698268672,2022-01-29 09:01:28,Apakah Bunda merasa perut cepat buncit padahal sudah mengurangi makanan? Salah satu penyebabnya adalah karena sering melewatkan sarapan. Simak alasannya yuk! #detiknetwork  https://t.co/GPplGY6pYA,10,2,4,1,2022-01-29,9,Saturday,6,14,3
1487348755384909824,2022-01-29 08:55:51,"Menurut Senior Investigator KNKT, Achmad Wildan, salah satu penyebab kecelakaan truk maut di Balikpapan karena menggunakan klakson telolet. https://t.co/Mhpiy4pl9I",93,21,25,6,2022-01-29,8,Saturday,6,118,27
1487346243747598341,2022-01-29 08:45:52,"Angkringan di Pacitan diberi nama unik, 'Sempak Suwek'. Selama ini kata 'Sempak' identik pakaian dalam. Sedangkan 'Suwek' dalam Bahasa Jawa berarti robek. https://t.co/D7158E4vVY",2,0,1,0,2022-01-29,8,Saturday,6,3,0
1487345133137891330,2022-01-29 08:41:27,Moderna melakukan uji klinis khusus untuk menangkal Omicron. Uji coba akan dilakukan pada 600 orang dewasa yang telah mendapat vaksinasi Covid-19. https://t.co/I12P401AIk,11,0,3,0,2022-01-29,8,Saturday,6,14,0
1487344002559062023,2022-01-29 08:36:58,Video memperlihatkan Brigadir Jenderal Junior Tumilaar membela warga desa yang berkonflik dengan PT Sentul City viral di media sosial. https://t.co/KInED0Wyjp,27,3,7,0,2022-01-29,8,Saturday,6,34,3
1487343491864743940,2022-01-29 08:34:56,"Jeff Bezos kabarnya akan jadi pemilik baru kapal pesiar mewah senilai Rp 7,1 triliun. Seperti ini wujud kapal pesiar mewah yang diduga pesanannya:  https://t.co/UmR2rZWHh0",9,0,2,1,2022-01-29,8,Saturday,6,11,1
1487342997268307975,2022-01-29 08:32:58,"Seorang wanita di India diculik, diperkosa bergiliran dan diarak di jalanan New Delhi. Sebanyak 11 orang, termasuk beberapa wanita, telah ditangkap polisi. https://t.co/EwqUB3K1Pa",10,7,4,0,2022-01-29,8,Saturday,6,14,7
1487342088433946630,2022-01-29 08:29:22,"Pantas Polda Jabar bergerak cepat memburu penunggang patung Maung Lodaya, ternyata ikon kepolisian di Tanah Pasundan itu memiliki filosofi yang dalam. https://t.co/h2fTJizdff",9,4,1,1,2022-01-29,8,Saturday,6,10,5
1487340837751119873,2022-01-29 08:24:23,"Aksi pemerasan berkedok pura-pura terlindas di depan PP Plaza, Pasar Rebo, Jakarta berujung gagal. Saat kejadian, pria diduga penipu sempat diteriaki modus https://t.co/i1hqbqXYHM",21,3,6,2,2022-01-29,8,Saturday,6,27,5
1487339470449954816,2022-01-29 08:18:57,"#Terpopuler Salah satu astronaut memotret pemandangan awan di sekitar Pulau Sumatera. Terlihat juga Pulau Bangka dan Belitung, Laut Jawa, dan pantai barat Kalimantan. https://t.co/0zojJeBwLi",49,0,11,2,2022-01-29,8,Saturday,6,60,2
1487337404407201796,2022-01-29 08:10:45,"Dear Scorpio, hilangkan perasaan was-was yang terkadang muncul. Bagaimana dengan ramalan zodiak lainnya? Simak di sini: https://t.co/xVJI5CRwuE",6,1,0,0,2022-01-29,8,Saturday,6,6,1
1487337235192193031,2022-01-29 08:10:04,Valve resmi mengungkap tanggal perilisan Steam Deck yaitu 25 Februari 2022. Pengiriman pertama akan dilakukan pada 28 Februari. https://t.co/LMatj4EYNA,5,2,1,1,2022-01-29,8,Saturday,6,6,3
1487335938359504896,2022-01-29 08:04:55,"Direktur Keuangan JakPro Yuliantina Wangsawiguna mundur dari jabatannya. Wakil Gubernur DKI Jakarta Pusat, Ahmad Riza Patria menilai hal tersebut tidak beruhubungan dengan formula E. https://t.co/ORL09PkUB6",7,6,1,0,2022-01-29,8,Saturday,6,8,6
1487334520944799745,2022-01-29 07:59:17,Edy Mulyadi mengaku akan memenuhi panggilan polisi pekan depan terkait kasus dugaan ujaran kebencian soal pernyataan 'tempat jin buang anak'. https://t.co/bKH7wzaSQF,7,3,0,0,2022-01-29,7,Saturday,6,7,3
1487333261844041729,2022-01-29 07:54:17,Atta Halilintar kabarnya akan menyewa satu rumah sakit. Ashanty memang membenarkan. Tapi... https://t.co/ajkNJS6TTc,259,267,24,58,2022-01-29,7,Saturday,6,283,325
1487331985907494917,2022-01-29 07:49:13,Juventus tampaknya belum selesai berburu striker di bursa transfer musim dingin. Kali ini ada Pierre-Emerick Aubameyang yang diisukan akan merapat ke Turin. https://t.co/WeAoiQMSoB,5,5,1,0,2022-01-29,7,Saturday,6,6,5
1487330780825141249,2022-01-29 07:44:26,"Seorang programmer terpaksa lengser dari posisi dan digantikan anak baru. Dia juga dipaksa menghapus data. Ternyata, keputusan itu disesali enam bulan kemudian. https://t.co/mtHJW5wEkd",20,2,11,2,2022-01-29,7,Saturday,6,31,4
1487329426060857344,2022-01-29 07:39:03,Video pria mengaku korban tabrak lari berpura-pura kakinya terlindas mobil di Jaktim viral. Salah satu warga menceritakan detik-detik peristiwa itu. https://t.co/20ybyeJuJN,14,1,4,2,2022-01-29,7,Saturday,6,18,3
1487328931674042371,2022-01-29 07:37:05,Jawaban Rizky Febian tentang status hubungan dengan Mahalini. Seperti apa? https://t.co/eOOWTqlHtf,5,0,0,1,2022-01-29,7,Saturday,6,5,1
1487327639132119041,2022-01-29 07:31:57,Sukri kini sukses bahkan bisa menghasilkan omzet Rp 60 juta per bulan. Pria yang masih berusia 19 tahun pun membagi perjuangannya kepada sesama anak muda. https://t.co/wlHL9UHC5d,96,5,18,8,2022-01-29,7,Saturday,6,114,13
1487326051151847424,2022-01-29 07:25:38,"Warga Surabaya yang belum menerima vaksin COVID-19, jangan khawatir masih ada jadwal vaksin COVID-19 untuk weekend. Berikut jadwal vaksin dosis 1,2 dan booster: https://t.co/JADFfh7egr",4,3,1,1,2022-01-29,7,Saturday,6,5,4
1487324866420391936,2022-01-29 07:20:55,"Pengacara kondang, Hotman Paris, punya asisten baru lagi. Wanita cantik itu bernama Loli Auristela. https://t.co/yNPNQZvhvg",20,2,7,1,2022-01-29,7,Saturday,6,27,3
1487323603683131394,2022-01-29 07:15:54,Al Ghazali mengungkapkan sedikit soal pernikahan impian. Seperti apa? https://t.co/5xzNJNfqpK,24,1,0,2,2022-01-29,7,Saturday,6,24,3
1487322325804535811,2022-01-29 07:10:50,Infeksi COVID-19 varian Omicron bisa mirip dengan influenza. Tapi ada gejala kunci tertentu yang bisa jadi pembedanya. https://t.co/3IzM1WmoI9,6,1,1,2,2022-01-29,7,Saturday,6,7,3
1487320958633402369,2022-01-29 07:05:24,"Presiden AS, Joe Biden, mengatakan akan segera mengirimkan sejumlah kecil tentara AS untuk meningkatkan kehadiran NATO di kawasan Eropa Timur. https://t.co/3ZwLAsXBQU",19,6,3,4,2022-01-29,7,Saturday,6,22,10
1487320027233726464,2022-01-29 07:01:42,KPU telah membuat rencana jadwal pelaksanan Pemilu 2024. Pendaftaran partai politik peserta pemilu akan dimulai pada awal Agustus 2022 mendatang. Puncak pesta demokrasi saat pemungutan suara dilakukan pada 14 Februari 2024. #CNNIndonesia  #detiknetwork  https://t.co/wjKsfVHIzM,10,1,3,5,2022-01-29,7,Saturday,6,13,6
1487318609781305345,2022-01-29 06:56:04,PT Bank Pembangunan Daerah Jawa Tengah (Bank Jateng) menggandeng KPK dalam penagihan kredit macet. Setidaknya sudah ada Rp 40 miliar yang dikembalikan oleh 35 debitur yang sempat bermasalah. https://t.co/JqsS6CFrml,8,2,0,0,2022-01-29,6,Saturday,6,8,2
1487317473938522113,2022-01-29 06:51:33,"Di tengah kota Bangkok yang terik dan ramai, detikers bisa berkunjung ke sebuah kafe dengan tema rustic dan klasik. Seraya menyesap secangkir kopi dan kembang gula. https://t.co/Hxi4U1x2do",2,0,0,1,2022-01-29,6,Saturday,6,2,1
1487316059090792450,2022-01-29 06:45:56,"AirPods 3 yang diluncurkan Oktober 2021 kini resmi dijual di Indonesia. Earphone TWS teranyar Apple ini bawa peningkatan dari generasi sebelumnya, harganya? https://t.co/pOWQhcBH6w",5,5,2,1,2022-01-29,6,Saturday,6,7,6
1487315327587397634,2022-01-29 06:43:01,"#FOTO Orang terkaya nomor dua di dunia, Jeff Bezos, baru saja menghabiskan banyak uang untuk membeli properti mewah di dekat pantai Hawaii. Ini potretnya:  https://t.co/wzaCjAIoAi",7,1,0,0,2022-01-29,6,Saturday,6,7,1
1487313973145972741,2022-01-29 06:37:38,Video memperlihatkan Brigadir Jenderal Junior Tumilaar membela warga desa yang berkonflik dengan PT Sentul City viral di media sosial. Brigjen Tumilaar mengaku marah karena PT Sentul City masih melakukan penggusuran meski sudah dilarang. https://t.co/70HIdT5mpA,49,5,2,2,2022-01-29,6,Saturday,6,51,7
1487313605330673666,2022-01-29 06:36:11,"Tak hanya dengan obat, menurunkan berat badan juga bisa dilakukan dengan bahan alami. Salah satunya jintan, rempah alami yang diakui bagus menurunkan bb. https://t.co/5TvmlRYu6t",10,0,2,0,2022-01-29,6,Saturday,6,12,0
1487312307881394177,2022-01-29 06:31:01,Malware Android ini bisa menghapus data di ponsel setelah membobol rekening korban untuk menutupi jejaknya. Malware ini sudah menyerang di beberapa negara. https://t.co/dfpY0idUtP,12,1,4,0,2022-01-29,6,Saturday,6,16,1
1487311307183476736,2022-01-29 06:27:03,"Dalam laga Liga 1 2021 pekan ke-21, Persebaya Surabaya akan melawan PSS Sleman. Pelatih Persebaya Aji Santoso akan menurunkan Arsenio Valpoort sejak menit awal. https://t.co/CeWOanyQ9G",5,0,0,0,2022-01-29,6,Saturday,6,5,0
1487310060606963716,2022-01-29 06:22:05,"Berlian hitam yang luar biasa, siap dilelang dan akan menjadi milik penawar tertinggi. Ini keistimewaannya:  https://t.co/OIcCGOaemC",8,0,0,1,2022-01-29,6,Saturday,6,8,1
1487308979252469761,2022-01-29 06:17:48,"Umat Muslim memiliki pantangan makan daging babi. Supaya tak salah beli atau makan, sebaiknya kenali dulu 25 istilah babi dalam komposisi makanan. https://t.co/40792gsn20",25,0,9,3,2022-01-29,6,Saturday,6,34,3
1487307655433658372,2022-01-29 06:12:32,Sebuah konsep hotel budaya Baduy dan Peranakan bisa kamu temukan di Gading Sepong. Setiap bagian hotel memiliki kedua unsur budaya Baduy dan Peranakan. https://t.co/cA7sHPoIFr,18,8,0,6,2022-01-29,6,Saturday,6,18,14
1487306886521266179,2022-01-29 06:09:29,#FOTO Segala aspek di kehidupan kita telah berubah secara dramatis antara masa lalu dan kini. Semua itu terlihat pada foto perbandingan yang cukup mencengangkan ini: https://t.co/vrdXnqJV2q,11,0,5,1,2022-01-29,6,Saturday,6,16,1
1487305886079062016,2022-01-29 06:05:30,Aksi marah-marah Brigjen Junior Tumilaar terhadap PT Sentul City viral. PT Sentul City pun menanggapi aksi marah-marah yang dilakukan Brigjen Tumilaar itu. https://t.co/ow0cR4FNbw,2,0,0,0,2022-01-29,6,Saturday,6,2,0
1487305111684722692,2022-01-29 06:02:26,Angelababy dan Huang Xiaoming bercerai setelah enam tahun berumahtangga. Ini perjalanan cinta mereka dari pacaran hingga menikah dan dikaruniai satu putra. https://t.co/VHfhS5ZZrw,6,1,0,2,2022-01-29,6,Saturday,6,6,3
1487304471399047175,2022-01-29 05:59:53,Ririe Fairus tak bisa membendung air mata ketika mengingat momen bersama Ayus Sabyan selama 15 tahun. Semua berakhir karena perselingkuhan... https://t.co/kMUzyyP3qT,47,14,14,6,2022-01-29,5,Saturday,6,61,20
1487303135081152512,2022-01-29 05:54:34,Kantor Google ataupun beberapa perusahaan teknologi lain memang menyenangkan karena fasilitasnya berlimpah ruah. Ini potretnya:  https://t.co/pm30BsLmMX,13,0,5,1,2022-01-29,5,Saturday,6,18,1
1487299845001990144,2022-01-29 05:41:30,"Ganjil genap masih berlaku pada akhir pekan di tiga lokasi wisata. Catat, nih, lokasi dan jadwal berlakunya. https://t.co/xKoFsPk8ZX",2,0,1,0,2022-01-29,5,Saturday,6,3,0
1487298354157654016,2022-01-29 05:35:34,Kawasan Pantjoran PIK di Jakarta Utara kian memerah jelang Hari Raya Imlek. Ini potretnya di malam hari: https://t.co/kfmvGgznUy,5,0,3,1,2022-01-29,5,Saturday,6,8,1
1487297353551917058,2022-01-29 05:31:36,Apa hal teraneh yang pernah kamu lihat dan berapa lama waktu yang kamu butuhkan untuk memahaminya? Deretan foto ini akan menipu kalau lihatnya nggak fokus. https://t.co/iFum3fFnQd,13,0,4,2,2022-01-29,5,Saturday,6,17,2
1487296322713669637,2022-01-29 05:27:30,Xiaomi memperkenalkan MIUI 13 ke pasar global pada 26 Januari lalu bersamaan dengan peluncuran Redmi Note 11 Series. Lantas smartphone Xiaomi tipe apa saja nih yang kebagian MIUI 13? Berikut daftarnya: https://t.co/qjydJk9m3X,4,0,0,0,2022-01-29,5,Saturday,6,4,0
1487294915361087488,2022-01-29 05:21:55,"DJ Khaled kembali menambah koleksi jam tangannya. Kali ini, bukan jam biasa mengingat harganya yang mencapai puluhan miliar rupiah. https://t.co/FJO5JJAyzk",12,1,2,0,2022-01-29,5,Saturday,6,14,1
1487294046942945280,2022-01-29 05:18:28,"Aksi heroik Khaerun (52), sopir PPD menyelamatkan wanita yang hendak bunuh diri mendapatkan apresiasi hingga penghargaan. https://t.co/C3ZECcvswZ",39,2,5,2,2022-01-29,5,Saturday,6,44,4
1487293053547294722,2022-01-29 05:14:31,Direktur Keuangan JakPro mengundurkan diri dari jabatannya. Hal ini menambah daftar jajaran JakPro yang mengundurkan diri saat Jakpro memegang proyek Formula E. https://t.co/JaPt7hOX2Z,28,23,9,6,2022-01-29,5,Saturday,6,37,29
1487292060529012740,2022-01-29 05:10:34,COVID-19 varian Omicron bisa menimbulkan berbagai macam gejala. Para ahli melihat ada gejala khas yang bisa muncul saat bangun tidur dan buang air besar. https://t.co/ccle2LuSFu,9,0,3,0,2022-01-29,5,Saturday,6,12,0
1487290169531142147,2022-01-29 05:03:03,"Isak tangis mengiringi pemakaman Sertu Anumerta Muhammad Rizal Maulana Arifin di Taman Makam Pahlawan (TMP), Cikutra, Kota Bandung. https://t.co/Ik9EGosf6M",10,1,2,1,2022-01-29,5,Saturday,6,12,2
1487289543229378561,2022-01-29 05:00:34,Meriam Bellina sempat bikin heboh gegara membuat TikTok yang berisi ungkapan kekesalan pada mantannya. Dia pun memberikan klarifikasi. https://t.co/dEmiWTNjGp,7,0,1,0,2022-01-29,5,Saturday,6,8,0
1487289172280942592,2022-01-29 04:59:05,Aktor Morgan Stevens yang dikenal dalam Fame dan Melrose Place ditemukan meninggal dunia di rumahnya Los Angeles hari Rabu (26/1). Polisi pun menemukannya meninggal secara natural di dapur rumahnya. https://t.co/rN6E7YjURe,8,0,2,0,2022-01-29,4,Saturday,6,10,0
1487288466270527491,2022-01-29 04:56:17,Kabar buruk menimpa Persib Bandung dalam lanjutan BRI Liga 1 2021/2022. Ada 9 pemain Maung Bandung yang dikarantina karena positif COVID-19. https://t.co/19hr4mUsnw,10,0,2,2,2022-01-29,4,Saturday,6,12,2
1487287062797639680,2022-01-29 04:50:42,Pernyataan Ayus soal poligami beberapa tahun lalu menjadi sorotan. Katanya boleh jika mampu. https://t.co/mGtV7sQJLH,7,12,1,3,2022-01-29,4,Saturday,6,8,15
1487285908340711425,2022-01-29 04:46:07,Hewan darat apa yang usianya paling tua dan saat ini masih hidup? Jawabannya adalah Jonathan si kura-kura. https://t.co/3QTa43aApa,24,1,3,1,2022-01-29,4,Saturday,6,27,2
1487284732614295555,2022-01-29 04:41:27,Kabar buruk menimpa Persib Bandung dalam lanjutan BRI Liga 1 2021/2022. Ada 9 pemain Maung Bandung yang dikarantina karena positif COVID-19. https://t.co/WtRrb79lA7,21,3,8,1,2022-01-29,4,Saturday,6,29,4
1487284058245763072,2022-01-29 04:38:46,"Dear zodiak Leo, kondisi keuanganmu masih belum begitu memungkinkan maka jangan paksakan. Bagaimana dengan ramalan zodiak lainnya? Simak di sini: https://t.co/6nd4RTvLF8",7,2,0,0,2022-01-29,4,Saturday,6,7,2
1487283986070130688,2022-01-29 04:38:29,Sejumlah stasiun kereta api di Jakarta telah didandani dan makin hijau. Berikut potret terbarunya: https://t.co/FcQU2MCt8v,13,0,1,0,2022-01-29,4,Saturday,6,14,0
1487282555032322051,2022-01-29 04:32:48,Kamp Konsentrasi Auschwitz jadi saksi bisu kekejaman era Nazi. Lokasi genosida itu kini jadi lokasi wisata. https://t.co/lbN2qtQ1S7,8,0,0,0,2022-01-29,4,Saturday,6,8,0
1487281414273912832,2022-01-29 04:28:16,Kementerian PUPR menggenjot pembangunan Jalan Tol Semarang-Demak. Begini progres jalan tol yang terintegrasi dengan Tanggul Laut Kota Semarang tersebut.  https://t.co/ZmxhACBagP,27,4,1,2,2022-01-29,4,Saturday,6,28,6
1487280168091754497,2022-01-29 04:23:19,"Pasar Lama Tangerang identik dengan pusatnya jajanan enak. Di sini, siapa saja bisa menemukan aneka jenis kudapan. Beberapa sudah melegenda sejak dulu  https://t.co/cb1NQPHadp",7,0,5,2,2022-01-29,4,Saturday,6,12,2
1487279186876186626,2022-01-29 04:19:25,"Sebagian besar kasus Omicron yang bergejala ringan diminta melakukan isolasi mandiri di rumah. Ada obat gratis yang sudah disiapkan, begini cara mendapatkannya: https://t.co/VhqFXvlP3i",47,3,24,0,2022-01-29,4,Saturday,6,71,3
1487278196638859266,2022-01-29 04:15:29,Seorang bule cantik memberi 'tutorial' untuk para traveler mengenai hal yang dilarang di Indonesia. Benar nggak ya ini hal yang disebutkan bule ini dilarang? https://t.co/al96NBgkiu,13,0,5,0,2022-01-29,4,Saturday,6,18,0
1487276982547136513,2022-01-29 04:10:39,"Nama DJ Indah Cleo disorot lantaran jadi salah satu korban bentrok di kelab Double O, Sorong, Papua. Kejadian tragis itu merenggut nyawanya. https://t.co/JSItVqUOtC",6,0,0,0,2022-01-29,4,Saturday,6,6,0
1487275742295699456,2022-01-29 04:05:43,"Kabar gembira untuk kalian para gamer Indonesia. Karena detikcom kembali menghadirkan dBattle Arena, dengan membawa game olahraga sepak bola, yakni eFootball. https://t.co/x4wyntZl80",3,1,0,0,2022-01-29,4,Saturday,6,3,1
1487274747452960770,2022-01-29 04:01:46,"Hubungan Venna Melinda dan Ferry Irawan semakin serius. Menjelang hari pernikahan, pasangan yang terpaut usia 5 tahun ini melakukan sesi prewedding di Bali. #detiknetwork  https://t.co/6zRXQ2wXfa",9,0,1,0,2022-01-29,4,Saturday,6,10,0
1487274729438384128,2022-01-29 04:01:42,"Jejak digital Bupati Langkat terus diburu warganet. Vlog yang berisi rekaman perayaan ultahnya bertema BTS yang diunggah tahun lalu, kini tuai hujatan. #detiknetwork  https://t.co/pkDZ1aiJi1",9,0,1,3,2022-01-29,4,Saturday,6,10,3
1487273602990886914,2022-01-29 03:57:13,"Jenazah mahasiswi asal Minahasa Utara (Minut) Sulawesi Utara (Sulut), Grace Karundeng yang meninggal misterius di Kanada telah tiba di rumah duka. https://t.co/NCwa2LtnOl",14,0,5,0,2022-01-29,3,Saturday,6,19,0
1487272677857538049,2022-01-29 03:53:33,Qatar memasukkan Indonesia ke daftar negara hijau. Sehingga pelaku perjalanan asal Indonesia yang telah divaksinasi COVID-19 bisa leluasa mengunjungi Qatar. https://t.co/warh3sQnnG,16,0,2,1,2022-01-29,3,Saturday,6,18,1
1487268518496194560,2022-01-29 03:37:01,"Kebakaran rumah warga di Jl Masjid 2, Kebon Baru, Tebet, Jakarta Selatan, menewaskan tiga orang. Penyebab kebakaran diduga korsleting listrik. https://t.co/UZ5nFFFYfV",4,1,4,0,2022-01-29,3,Saturday,6,8,1
1487268278393348097,2022-01-29 03:36:04,"#Terpopuler  Kecelakaan truk tronton yang mengalami rem blong dan menabrak pengendara di lampu merah terjadi di Simpang Rapak, Balikpapan. Kenapa sopir tidak banting setir? https://t.co/OZDifl54uw",9,0,2,1,2022-01-29,3,Saturday,6,11,1
1487267987321204740,2022-01-29 03:34:54,"Munir Alamsyah (53), eks guru yang membakar sekolah di Garut gegara upahnya tak dibayar, dibebaskan polisi. Munir sempat diamankan akibat aksi tersebut. https://t.co/qPIZ3TWsZn",91,17,20,3,2022-01-29,3,Saturday,6,111,20
1487267194438393860,2022-01-29 03:31:45,"Dusan Vlahovic sudah tiba di Juventus, untuk menyelesaikan kepindahannya dari Fiorentina. Striker muda Serbia itu disambut hangat fans Bianconeri. https://t.co/Kk9J5ZYvMS",2,2,1,0,2022-01-29,3,Saturday,6,3,2
1487265532529233926,2022-01-29 03:25:09,"Pantas Polda Jabar bergerak cepat memburu penunggang patung Maung Lodaya, ternyata ikon kepolisian di Tanah Pasundan itu memiliki filosofi yang dalam https://t.co/tVcip9IERh",10,0,2,2,2022-01-29,3,Saturday,6,12,2
1487264836295737346,2022-01-29 03:22:23,Kasus pemerasan video seks yang dilakukan Karim Benzema kepada Mathieu Valbuena belum berakhir. Pengadilan menyita uang denda dari rekening Benzema. https://t.co/z4lFM4KBwA,5,0,0,0,2022-01-29,3,Saturday,6,5,0
1487264201651503105,2022-01-29 03:19:52,"Menurut data yang dikumpulkan oleh Zoe COVID Study, lima gejala yang dikonfirmasi atau dicurigai merupakan varian Omicron adalah sebagai berikut. https://t.co/2JDvVES1MH",5,1,0,1,2022-01-29,3,Saturday,6,5,2
1487262907138256896,2022-01-29 03:14:43,"Kebakaran rumah terjadi di Kebon Baru, Tebet, Jakarta Selatan pagi tadi. Ada tiga orang yang tewas akibat peristiwa ini. https://t.co/gCPiYUS6xa",3,0,0,0,2022-01-29,3,Saturday,6,3,0
1487262678817067013,2022-01-29 03:13:49,"Virgil van Dijk percaya tim-tim lawan tak pernah senang bertemu dengan Liverpool. Dalam kondisi ideal, Liverpool punya senjata yang komplet untuk semua situasi. https://t.co/XYfTgwBtvY",8,2,0,1,2022-01-29,3,Saturday,6,8,3
1487262389359853571,2022-01-29 03:12:40,Erling Haaland bosan mendengar rumor transfernya. Striker Borussia Dortmund itu meminta orang-orang berhenti membicarakan dan fokus pada performanya saja. https://t.co/I0IFC2ZtSq,6,0,0,0,2022-01-29,3,Saturday,6,6,0
1487262141275123712,2022-01-29 03:11:41,Pergaulan adalah proses interaksi sosial yang dilakukan oleh individu dengan individu lainnya yang saling memberikan pengaruh satu sama lain. https://t.co/CHhFtKWqnn,5,1,2,0,2022-01-29,3,Saturday,6,7,1
1487260610576498690,2022-01-29 03:05:36,Salah seorang muslim di Islandia harus menjalankan ibadah puasa selama 22 jam dalam sehari. Ia mengaku hanya mengonsumsi yoghurt dan buah saat sahur. https://t.co/XCkrb2iXFJ,12,0,4,1,2022-01-29,3,Saturday,6,16,1
1487260285492731906,2022-01-29 03:04:18,"PBSI mempercayakan anak-anak muda di sektor ganda campuran. Ada tanggung jawab berat, tapi mereka diyakini punya daya juang tinggi! https://t.co/ZnwDGMX71c",10,1,0,0,2022-01-29,3,Saturday,6,10,1
1487260145151365121,2022-01-29 03:03:45,Inter Milan pernah identik dengan Timnas Jerman. Kini aroma Die Manschaft kembali muncul seiring kehadiran Robin Gosens. https://t.co/NxUbN7VXIn,6,0,0,0,2022-01-29,3,Saturday,6,6,0
1487258009252335619,2022-01-29 02:55:15,Penunggang patung Maung Lodaya ditetapkan sebagai tersangka demo anarkis. Pria anggota GMBI itu ditahan di sel Mapolda Jabar. https://t.co/CwnJzVKt9K,6,3,1,3,2022-01-29,2,Saturday,6,7,6
1487257508221702144,2022-01-29 02:53:16,"Pemakaman jenazah prajurit TNI yang tewas dalam kontak tembak dengan KKB di Papua, Sertu Anumerta Rizal Maulana Arifin, rencananya akan dilaksanakan di TMP Cikutra, Kota Bandung hari ini. KSAD Jenderal Dudung Abdurachman dijadwalkan memimpin upacara. https://t.co/lajdnsgNzz",14,9,2,0,2022-01-29,2,Saturday,6,16,9
1487256767272824834,2022-01-29 02:50:19,Subvarian Omicron BA.2 disebut lebih sulit terdeteksi oleh tes PCR SGTF. Pakar menjelaskan dampaknya tehadap upaya testing di Indonesia. https://t.co/GwaoPLXqPZ,4,0,1,1,2022-01-29,2,Saturday,6,5,1
1487254123649114112,2022-01-29 02:39:49,"Sekitar 100.000 tentara Rusia bersiaga di perbatasan Ukriana, yang memicu ketegangan kawasan. Bagaimana warga Ukraina merespons tindakan Rusia? https://t.co/Ge4X9ybOh3",6,1,0,0,2022-01-29,2,Saturday,6,6,1
1487253884045303808,2022-01-29 02:38:52,Delapan sekolah di Jakarta Pusat sempat ditutup akibat ada pihak yang positif COVID-19. Kini delapan sekolah tersebut diperbolehkan gelar PTM lagi. https://t.co/v6lpAabxoz,2,0,0,0,2022-01-29,2,Saturday,6,2,0
1487253161538633731,2022-01-29 02:36:00,Sebagian orang mungkin masih bertanya-tanya dimana titik G-spot wanita karena titik tersebut tidak tampak seperti struktur kemaluan lainnya. Simak petunjuknya. https://t.co/4M1uX36bJX,8,1,3,0,2022-01-29,2,Saturday,6,11,1
1487253136938975235,2022-01-29 02:35:54,Kasus harian Covid-19 di Korea Selatan terus pecah rekor hingga menembus angka 16.096 pada Jumat (28/1). Puluhan idol K-Pop pun dinyatakan positif Covid-19 dalam beberapa hari terakhir. Berikut daftarnya: https://t.co/NR6nstlVZT,2,1,1,0,2022-01-29,2,Saturday,6,3,1
1487252055886647297,2022-01-29 02:31:36,"Lapis legit jadi kue yang kerap hadir pada perayaan Imlek. Kalau kamu sedang cari lapis legit enak, lima tempat ini bisa jadi pilihan.  https://t.co/0oyMUx7bQ6",6,0,1,1,2022-01-29,2,Saturday,6,7,1
1487250458959880196,2022-01-29 02:25:15,Baru-baru ini Menteri Pertahanan Prabowo Subianto mengunggah foto objek wisata di Bintan. Banyak yang salah mengira. https://t.co/udDCScWiav,15,1,2,0,2022-01-29,2,Saturday,6,17,1
1487249631662813193,2022-01-29 02:21:58,Nusron Wahid memuji langkah pemerintah melalui Kementerian Perdagangan yang memberlakukan DMO dan DPO untuk mengendalikan harga minyak goreng. https://t.co/cL0y7P6H6h,8,17,0,2,2022-01-29,2,Saturday,6,8,19
1487249104405155845,2022-01-29 02:19:52,Tebak-tebakan ini belum tentu bisa dijawab oleh orang cerdas sekalipun. Coba pecahkan teka-teki receh ini sambil melatih otak. https://t.co/SXM8sw9n62,82,121,6,1,2022-01-29,2,Saturday,6,88,122
1487247347021135876,2022-01-29 02:12:53,#FOTO Atta Halilinta makin percaya diri dengan penampilan barunya. Ia mulai meninggalkan bandana yang selama ini jadi ciri khasnya. Ini potret Atta:  https://t.co/tvf8kvtQN5,7,0,1,1,2022-01-29,2,Saturday,6,8,1
1487245505818157056,2022-01-29 02:05:34,Brigjen Junior Tumilaar kembali mencuri perhatian lantaran ngamuk kepada PT Sentul City. Dia juga sempat menyinggung seorang Brigjen bernama Rio. https://t.co/pSSEUWQUKS,43,10,13,4,2022-01-29,2,Saturday,6,56,14
1487245227190591488,2022-01-29 02:04:28,"Sejak tahun 2018, Dikti mendapat teguran dari KPK karena dianggap sebagai tumpang tindih kewenangan. Begini tanggapan Dirjen Dikti. https://t.co/EUfrZTbpmj",4,0,0,0,2022-01-29,2,Saturday,6,4,0
1487245225831579653,2022-01-29 02:04:28,"Api melalap 10 kios yang berada dalam satu lokasi di kawasan Bendung Manganti, Kabupaten Ciamis, Jawa Barat. https://t.co/XANXjDZiJV",5,0,0,0,2022-01-29,2,Saturday,6,5,0
1487244488284295169,2022-01-29 02:01:32,"Ketua Umum PAN, Zulkifli Hasan bakal menyampaikan pidato kebudayaan saat acara Zulhas Award. Dia akan berpidato di depan 3 kandidat potensial capres 2024. https://t.co/edU7RKUZjB",2,0,0,0,2022-01-29,2,Saturday,6,2,0
1487244467367256066,2022-01-29 02:01:27,Menkes mengungkap tiga pasien Omicron yang meninggal dunia karena memiliki komorbid. Berikut komorbid pasien meninggal Omicron yang perlu diwaspadai. #CNNIndonesia  #detiknetwork  https://t.co/X2YEBzi6d0,3,1,0,0,2022-01-29,2,Saturday,6,3,1
1487244244850982914,2022-01-29 02:00:34,Kantor Google dengan segudang fasilitas dan rancangan tata ruang yang menarik sangat menggiurkan untuk menjadi karyawan di perusahaan teknologi tersebut. Tapi arsiteknya nyesel merancang fasilitas menyenangkan itu. Kok bisa? https://t.co/jbwCzsOltY,4,1,3,0,2022-01-29,2,Saturday,6,7,1
1487244200013971462,2022-01-29 02:00:23,DPRD Jabar mendorong agar perpanjangan izin ormas GMBI dikaji ulang usai demo berujung ricuh di Jabar. Apa kata Kemendagri soal permintaan itu? https://t.co/w3q8FfWOcN,2,2,1,0,2022-01-29,2,Saturday,6,3,2
1487243941183475712,2022-01-29 01:59:21,PDIP DKI Jakarta menyindir Gubernur Anies Baswedan tak ada terobosan mengatasi persoalan kemacetan dan banjir di Jakarta. https://t.co/2o2tHRRKFQ,31,38,3,4,2022-01-29,1,Saturday,6,34,42
1487243688078102530,2022-01-29 01:58:21,Tipe gaya belajar ini penting dipahami oleh siswa dan guru agar bisa maksimal dalam pembelajaran. Lantas apa saja tipe belajar itu? https://t.co/1K1VjglSuB,4,1,3,0,2022-01-29,1,Saturday,6,7,1
1487243420393521152,2022-01-29 01:57:17,Anggota Komisi II DPR Guspardi Gaus meminta Kemendagri segera bertindak atas ormas GMBI yang demo berujung ricuh di Polda Jabar. https://t.co/7oxlAs1A3M,6,2,0,1,2022-01-29,1,Saturday,6,6,3
1487243175966167042,2022-01-29 01:56:19,Satgas COVID-19 IDI mengingatkan pemerintah atas risiko lonjakan kasus COVID-19 di tengah aktivitas Pembelajaran Tatap Muka (PTM) hingga 100 persen. https://t.co/2CRP8pqjSU,1,1,0,1,2022-01-29,1,Saturday,6,1,2
1487242618841059329,2022-01-29 01:54:06,Kasus sopir taksi online menabrak dua pemotor diduga penjambret hingga tewas di Jaksel pada Oktober 2021 mencuat. Polisi memastikan dua pemotor itu penjambret. https://t.co/Aq4szinROw,11,6,3,1,2022-01-29,1,Saturday,6,14,7
1487242373944029185,2022-01-29 01:53:08,Pendaftaran beasiswa kuliah dibuka Unnes untuk mahasiswa semester genap 2021/2022. Apa saja persyaratannya? https://t.co/Ti6BXvEZfW,4,1,2,0,2022-01-29,1,Saturday,6,6,1
1487241865497882629,2022-01-29 01:51:07,"PM Inggris, Boris Johnson akan berbicara dengan Presiden Rusia, Vladimir Putin. Johnson bakal mendesak Putin menarik pasukan demi meredam ketegangan di Ukraina. https://t.co/sSNBoRm7Wb",3,3,0,0,2022-01-29,1,Saturday,6,3,3
1487241363267764227,2022-01-29 01:49:07,ITDC terus mengebut persiapan sirkuit Mandalika menatap MotoGP 2022. Sarana-prasana sirkuit dipastikan maksimal menjelang race pada Maret mendatang. https://t.co/HIncujVQQu,7,1,0,0,2022-01-29,1,Saturday,6,7,1
1487241119905857538,2022-01-29 01:48:09,Satgas Kota Bogor kembali memberlakukan sistem ganjil genap pada Sabtu dan Minggu pekan ini. https://t.co/AiydcBHPhm,1,1,1,0,2022-01-29,1,Saturday,6,2,1
1487240824207425547,2022-01-29 01:46:58,DPD Partai Demokrat (PD) Aceh melakukann kosolidasi di 5 wilayah di Aceh. Para pimpinan DPD meminta agar akar rumput di Aceh berkoalisi dengan rakyat. https://t.co/E2gBmNi4Iy,1,0,0,0,2022-01-29,1,Saturday,6,1,0
1487240445067468802,2022-01-29 01:45:28,"Lapak semi permanen milik pedagang sepatu di Jalan Mataram, Kota Yogyakarta, dibongkar. Lokasinya tak jauh dari Malioboro. Untuk memperkuat kawasan itu. https://t.co/cgvD3PekwW",16,1,4,1,2022-01-29,1,Saturday,6,20,2
1487240156918726659,2022-01-29 01:44:19,Surah Yasin ayat 1-20 beserta dengan Arab dan latinnya lengkap. Berikut juga lafal doanya agar bacaan menjadi lebih sempurna. https://t.co/rbP43tWcfk,11,1,3,0,2022-01-29,1,Saturday,6,14,1
1487239854299754498,2022-01-29 01:43:07,Syarat isolasi mandiri bagi pasien terkonfirmasi perlu diperhatikan. Berikut serba-serbi informasinya. https://t.co/VR53vE690E,5,3,3,0,2022-01-29,1,Saturday,6,8,3
1487239613441839104,2022-01-29 01:42:10,"Butuh konsentrasi tinggi agar otak bisa bekerja optimal. Kondisi mental yang labil membuat otak susah fokus, teka-teki mudah ini jadi terasa lebih sulit. https://t.co/dgicY9sCxJ",3,6,1,1,2022-01-29,1,Saturday,6,4,7
1487239307861577731,2022-01-29 01:40:57,"Sejumlah stasiun di China ramai penumpang menjelang tahun baru Imlek. Imlek identik dengan mudik besar-besaran, semua orang ingin berkumpul dengan keluarga. https://t.co/9BFhgA7CJW",12,4,3,1,2022-01-29,1,Saturday,6,15,5
1487238828578455552,2022-01-29 01:39:02,"Wakil Ketua Fraksi PKS, Mulyanto menekankan pihaknya sampai saat ini masih tidak setuju terkait pemindahan IKN ke Penajam Paser Utara, Kalimantan Timur. https://t.co/nr9n63JMyy",8,3,0,0,2022-01-29,1,Saturday,6,8,3
1487238811235098626,2022-01-29 01:38:58,#terpopuler Seorang kakek di Iran bikin peneliti bingung karena tetap sehat dan fit meski sehari-hari mengonsumsi bangkai hewan dan air yang kotor. Begini ceritanya.  https://t.co/ghSlPNlv20,4,0,3,0,2022-01-29,1,Saturday,6,7,0
1487237490511683587,2022-01-29 01:33:43,Dusan Vlahovic resmi menjadi penggawa anyar Juventus. Striker Serbia itu amat bahagia bisa berseragam Si Nyonya Tua. https://t.co/itym7o0ZBY,7,0,0,1,2022-01-29,1,Saturday,6,7,1
1487236982170341380,2022-01-29 01:31:42,Praveen Jordan/Melati Daeva Oktavianti tak lagi jadi penghuni pelatnas PBSI mulai tahun ini. Prestasi dan regenerasi menjadi pertimbangan untuk melepas mereka. https://t.co/JJldGunYQh,4,0,1,1,2022-01-29,1,Saturday,6,5,1
1487236698958450693,2022-01-29 01:30:35,"Seorang pasien yang seharusnya menjalani transplantasi jantung ditolak RS. Diketahui, alasannya karena si pasien belum divaksinasi COVID-19. https://t.co/47q3wMWF8d",28,20,7,5,2022-01-29,1,Saturday,6,35,25
1487236164360806404,2022-01-29 01:28:27,Asal-usul Imlek atau Chinese New Year penuh dengan legenda. Imlek merupakan salah satu perayaan paling penting dalam budaya Tiongkok. https://t.co/gxGsVmKhWI,2,2,2,0,2022-01-29,1,Saturday,6,4,2
1487235917085646851,2022-01-29 01:27:28,Pemprov DKI Jakarta melaporkan penambahan kasus positif Corona atau COVID-19 varian Omicron. Total kasus Omicron di Jakarta mencapai 2.525 orang. https://t.co/AqNQF1AipK,5,2,2,0,2022-01-29,1,Saturday,6,7,2
1487234358465470468,2022-01-29 01:21:17,"PKB mengutuk demo berujung ricuh GMBI di Polda Jabar. PKB menyebut ormas harusnya membina masyarakat, bukan malah melanggar hukum. https://t.co/7npgd3WBd7",8,4,0,0,2022-01-29,1,Saturday,6,8,4
1487233861016854531,2022-01-29 01:19:18,Edy Mulyadi yang dilaporkan karena pernyataan 'tempat jin buang anak' tak penuhi panggilan Bareskrim Polri hari ini. Panggilan kedua dilayangkan ke Edy Mulyadi. https://t.co/bkDs786EW9,18,16,3,3,2022-01-29,1,Saturday,6,21,19
1487233264779771904,2022-01-29 01:16:56,"Meloxicam merupakan obat untuk mengurangi rasa nyeri, bengkak, dan kaku pada sendi. Kenali dosis, efek samping dan interaksi obat lainnya di sini. https://t.co/3Y9YHnnblo",17,0,2,0,2022-01-29,1,Saturday,6,19,0
1487233246010163202,2022-01-29 01:16:51,Hari Kusta sedunia atau World Leprosy Day (WLD) diperingati setiap minggu terakhir bulan Januari. Bagaimana sejarah hingga perayaan tahun ini? https://t.co/u4vmA0WG29,0,0,1,0,2022-01-29,1,Saturday,6,1,0
1487232954225070086,2022-01-29 01:15:42,"Pemain Amartha Hangtuah, Sevly Rondonuwu, mendapat peran baru di awal musim IBL 2022 sebagai point guard. Hal itu disambut antusias olehnya. https://t.co/pCwJ0LuWc8",1,1,0,0,2022-01-29,1,Saturday,6,1,1
1487232395074064386,2022-01-29 01:13:29,"Pencurian 8 tabung oksigen di RSUD Depok, Jawa Barat terungkap. Ironisnya, pelaku, CAN (23) merupakan relawan ambulans. https://t.co/g5GAKdYVYg",4,0,3,0,2022-01-29,1,Saturday,6,7,0
1487232152936886274,2022-01-29 01:12:31,"Aksi pemerasan dengan modus 'korban tabrak lari' di Pasar Rebo, Jaktim sempat membuat heboh. Pelaku, yang berpura-pura pincang, kini diburu polisi. https://t.co/5WaL6aa88F",652,104,232,51,2022-01-29,1,Saturday,6,884,155
1487231624978833409,2022-01-29 01:10:25,"Sorotan tertuju kepada Ketua Umum Partai Demokrat Agus Harimurti Yudhoyono (AHY). Bukan karena aksi politik, tapi ini tentang gaya berolahraga. https://t.co/opisxTJMno",10,3,1,4,2022-01-29,1,Saturday,6,11,7
1487230235611471878,2022-01-29 01:04:54,"Kapolres Bogor, AKBP Iman Imanuddin bersama jajarannya melakukan razia ormas GMBI di wilayah hukumnya. Hasilnya 15 orang dan sejumlah sajam diamankan. https://t.co/N4YXMNW2nL",20,6,3,1,2022-01-29,1,Saturday,6,23,7
1487230234449563649,2022-01-29 01:04:53,Presiden Joko Widodo (Jokowi) menyampaikan arahan terbaru di tengah lonjakan kasus COVID-19 varian Omicron di Indonesia. https://t.co/aXYqIM6wZ6,8,2,2,1,2022-01-29,1,Saturday,6,10,3
1487229757649477640,2022-01-29 01:03:00,"Pos Indonesia songsong 2022 dengan semangat baru, seiring dengan bangkitnya ekonomi pascapandemi, serta potensi pasar yang terbuka luas https://t.co/DlrDPlKPeY",12,1,0,1,2022-01-29,1,Saturday,6,12,2
1487228307812888582,2022-01-29 00:57:14,"Munir Alamsyah (53), eks guru yang membakar sekolah di Garut gegara upahnya tak dibayar, dibebaskan polisi. Munir sempat diamankan akibat aksi tersebut. https://t.co/mJvzgEs3Lx",11,0,3,2,2022-01-29,0,Saturday,6,14,2
1487227046619238401,2022-01-29 00:52:13,Bento biasanya dikemas menggunakan tempat makan biasa yang berbahan plastik maupun kayu. Ada inovasi wadah boks bento unik berbentuk rumah tingkat yang unik.  https://t.co/2fWWngvZWu,9,0,3,0,2022-01-29,0,Saturday,6,12,0
1487225992238272521,2022-01-29 00:48:02,"Seorang penari asal Pangandaran menjadi korban bentrokan di tempat hiburan malam Double O, Sorong, Papua. https://t.co/iHUfYVRZyb",4,0,2,0,2022-01-29,0,Saturday,6,6,0
1487224644931407872,2022-01-29 00:42:41,"Setelah Thailand, Vietnam dan Malaysia, sekarang Filipina mengumumkan akan mengizinkan lagi kedatangan turis yang sudah divaksin penuh. https://t.co/ugK8p5VUgU",12,0,1,2,2022-01-29,0,Saturday,6,13,2
1487223116283748354,2022-01-29 00:36:36,Video Brigadir Jenderal Junior Tumilaar membela warga desa yang berkonflik dengan PT Sentul City viral di media sosial. https://t.co/s9gVeh0OG1,114,26,19,5,2022-01-29,0,Saturday,6,133,31
1487222116248395779,2022-01-29 00:32:38,Kode rahasia yang dituliskan oleh pembunuh berantai Zodiac Killer diklaim berhasil dipecahkan oleh FBI. Ini isi pesannya:  https://t.co/2UHk2D24t2,24,3,4,0,2022-01-29,0,Saturday,6,28,3
1487220728244146176,2022-01-29 00:27:07,"Meski dikecam Barat, Rusia tetap menggelar latihan militer di perbatasan Ukraina. Sejumlah pihak khawatir Rusia bakal mencaplok negara kaya energi tersebut. https://t.co/wMzb16zh7k",10,0,0,2,2022-01-29,0,Saturday,6,10,2
1487219671619280901,2022-01-29 00:22:55,"Dirjen Dikti menyebut Perguruan Tinggi Kementerian Lain menghabiskan dana 13,8 kali lipat dibandingkan perguruan tinggi di bawah Kemendikbudristek. https://t.co/FsISIIgXLC",5,0,1,0,2022-01-29,0,Saturday,6,6,0
1487218903679967235,2022-01-29 00:19:52,"Universitas Airlangga mempunyai tiket ekstra di samping SNMPTN 2022. Selain berprestasi, siswa perlu menyerahkan syarat ini. https://t.co/wa7hZnJ7mp",10,2,0,0,2022-01-29,0,Saturday,6,10,2
1487217425322057735,2022-01-29 00:14:00,Video perusakan mobil Mercy di Bantul viral di media sosial. Perusakan itu disebut dipicu pengendara mobil yang kabur usai menabrak pemotor. https://t.co/Gk0G1kHXGw,6,1,1,2,2022-01-29,0,Saturday,6,7,3
1487216936903663616,2022-01-29 00:12:03,Kantor Google ataupun beberapa perusahaan teknologi lain memang menyenangkan karena fasilitasnya berlimpah ruah. Ini potretnya:  https://t.co/ulRTACwYWp,6,0,0,0,2022-01-29,0,Saturday,6,6,0
1487215834552360962,2022-01-29 00:07:40,Rektor Unair Mohammad Nasih membeberkan rahasia bagaimana kampusnya menyeleksi calon mahasiswa di SNMPTN 2022. Apa saja faktor kelulusannya? https://t.co/1KDjvczQ1h,5,0,0,0,2022-01-29,0,Saturday,6,5,0
1487214405691531267,2022-01-29 00:02:00,Pemain sinetron Ganteng-Ganteng Serigala Aliando Syarief dikabarkan mengidap obsessive-compulsive disorder (OCD). Ini ciri-ciri seseorang yang mengidap OCD. https://t.co/J7y7IGTUVH,4,1,3,0,2022-01-29,0,Saturday,6,7,1
1487213127678803980,2022-01-28 23:56:55,Panglima TNI Jenderal Andika Perkasa berjanji bahwa pihaknya akan memburu pelaku penembak yang menewaskan tiga prajuritnya di Papua. https://t.co/jLWGZjJu9I,56,14,8,5,2022-01-28,23,Friday,5,64,19
1487211817705345025,2022-01-28 23:51:43,Pangdam XVIII/Kasuari Mayjen TNI I Nyoman Cantiasa membeberkan capaian para prajuritnya selama menjabat sebagai pimpinan di Kodam XVIII/Kasuari. https://t.co/8DOLoOXjzD,4,0,0,0,2022-01-28,23,Friday,5,4,0
1487210451549229062,2022-01-28 23:46:17,Jaringan Rakyat Miskin batal menggelar demo di Balai Kota setelah bertemu dengan Anies. JRMK mengancam bakal menggelar demo jika Anies tak menepati janjinya. https://t.co/BExxCPBqWs,19,10,4,0,2022-01-28,23,Friday,5,23,10
1487209449206992903,2022-01-28 23:42:18,Gubernur Sumatera Utara (Gubsu) Edy Rahmayadi mengaku tak suka marah. Edy mengatakan dirinya akan mengambil pistol jika marah. https://t.co/oBwfih6fif,295,207,62,139,2022-01-28,23,Friday,5,357,346
1487208072732885001,2022-01-28 23:36:50,"JakPro dan IMI melaksanakan studi banding ke Diriyah, Arab Saudi, untuk mempelajari Formula E. Keputusan itu menuai pro dan kontra. https://t.co/MbLzB0v5hD",5,2,0,1,2022-01-28,23,Friday,5,5,3
1487207038312751104,2022-01-28 23:32:43,"Jenazah Rizal Maulana Arifin tiba di rumah duka, Kecamatan Dayeuhkolot, Kabupaten Bandung. Rizal salah satu prajurit TNI yang gugur ditembak KKB di Papua. https://t.co/luisBTJC6g",22,1,4,1,2022-01-28,23,Friday,5,26,2
1487205916621651971,2022-01-28 23:28:16,Lionel Messi sudah meninggalkan Barcelona di awal musim ini. Los Cules disebut sedang membangun tim hebat tanpa diperkuat oleh La Pulga. https://t.co/Zu9KU6ctC6,16,0,0,0,2022-01-28,23,Friday,5,16,0
1487205027856977922,2022-01-28 23:24:44,Ketua DPP PKS Mardani Ali Sera mengkritik keras aksi anarkis ormas GMBI saat demo berujung ricuh di depan Mapolda Jabar. PKS menilai ormas harus patuh hukum. https://t.co/rupEk06n1o,10,4,3,3,2022-01-28,23,Friday,5,13,7
1487204250266611718,2022-01-28 23:21:38,Kejati Sultra resmi menahan tiga tersangka kasus mafia tanah Universitas Halu Oleo. https://t.co/9HVrWnWhKf,6,0,0,0,2022-01-28,23,Friday,5,6,0
1487203498307592198,2022-01-28 23:18:39,"Pendiri PAN, Abdillah Toha, digeruduk netizen setelah mempertanyakan rompi 'militer' AHY. Jubir Demokrat, Herzaky Mahendra, menyinggung etika bermedsos. https://t.co/l6iPulsO0F",11,0,1,0,2022-01-28,23,Friday,5,12,0
1487201824067276806,2022-01-28 23:12:00,"Ritual sedekah laut digelar nelayan di Tarumajaya, Kabupaten Bekasi, Jawa Barat. Begini prosesnya. https://t.co/xXvYw8snVj",6,1,3,0,2022-01-28,23,Friday,5,9,1
1487200240012832768,2022-01-28 23:05:42,"Kisah Kaum Tsamud yang diazab akibat mengabaikan Nabi Shaleh terjadi di Lembah Hijr, yang berada dekat Al Ula, Madinah. Saat ini Al Ula menjadi lokasi wisata. https://t.co/B713aYutBn",19,0,5,0,2022-01-28,23,Friday,5,24,0
1487199731814182913,2022-01-28 23:03:41,Paraf Bupati Morowali diduga dipasulkan oleh lima perusahaan tambang untuk IUP dan OP. Kelima perusahaan itu telah dilaporkan ke polisi. https://t.co/sl2x9KLJSM,20,5,9,2,2022-01-28,23,Friday,5,29,7
1487199509612568581,2022-01-28 23:02:48,"Kehadiran Egy Maulana Vikri dan Witan Sulaeman berdampak besar bagi FK Senica, setidaknya terlihat jumlah followers Instagram mereka yang meningkat drastis. https://t.co/lB9FhQryxx",23,3,2,0,2022-01-28,23,Friday,5,25,3
1487198589176750081,2022-01-28 22:59:09,Buktikan keahliannya membuat kue. Bocah berusia 12 tahun ini memukau orang-orang dengan kue bentuk sate dan bumbu kacang di televisi Inggris.  https://t.co/3TiHOy6Da4,19,1,3,1,2022-01-28,22,Friday,5,22,2
1487197521802043392,2022-01-28 22:54:54,Marvel Comics mengumumkan segera merilis seri terbaru setelah klimaks dari acara Devil's Reign. https://t.co/qJR6uiiFoa,5,1,3,0,2022-01-28,22,Friday,5,8,1
1487196465764175880,2022-01-28 22:50:42,Elon Musk menawari Rp 71 juta kepada mahasiswa stalker untuk menghapus akun Twitter stalker yang melacak pergerakan pesawat jet pribadinya. https://t.co/KeIPIPFmMT,15,1,4,1,2022-01-28,22,Friday,5,19,2
1487195621459124230,2022-01-28 22:47:21,"Ar Raqib artinya Allah Maha Mengawasi sebagai salah satu nama Asmaul Husna, nama-nama Allah yang paling mulia. https://t.co/SczYQeG6nD",33,0,5,0,2022-01-28,22,Friday,5,38,0
1487194072376922119,2022-01-28 22:41:12,"Polisi New York menangkap seorang pria, Morgan Mank (31) lantaran menabrak bangunan milik Taylor Swift. Pelaku juga disebut memaksa masuk bangunan tersebut. https://t.co/yCKz2p5PmK",7,0,3,0,2022-01-28,22,Friday,5,10,0
1487193595748704256,2022-01-28 22:39:18,"Kasus Omicron di DKI Jakarta menembus 2 ribu kasus, total kasus transmisi lokal mulai setara dengan pelaku perjalanan luar negeri. Cek laporan terbarunya. https://t.co/hfdwK0yFtg",8,2,4,3,2022-01-28,22,Friday,5,12,5
1487192569805160449,2022-01-28 22:35:14,Kejagung menjelaskan tentang pernyataan Jaksa Agung ST Burhanuddin yang menyebut pelaku tipikor dengan kerugian negara di bawah Rp 50 juta. Simak penjelasannya. https://t.co/barOpF4Y0R,10,10,4,4,2022-01-28,22,Friday,5,14,14
1487190497458364417,2022-01-28 22:26:59,"Ketua Umum DPP Partai Demokrat, AHY meminta agar para kader Partai Demokrat bersiap untuk Pemilu 2024. Dia berkeyakinan hasil tidak akan khianati ikhtiar. https://t.co/cf66JVQBua",6,13,2,0,2022-01-28,22,Friday,5,8,13
1487189179473793029,2022-01-28 22:21:45,"Suara dentuman yang sangat keras dilaporkan terdengar banyak warga di wilayah New Orleans, Amerika Serikat. https://t.co/br9LgHAqAX",4,1,2,1,2022-01-28,22,Friday,5,6,2
1487188397542236163,2022-01-28 22:18:39,Teknologi pengenalan wajah dan objek ini bisa terhubung ke platform PeduliLindungi untuk menyajikan informasi status vaksinasi dengan cepat. https://t.co/rHe77o0bN9,6,1,3,0,2022-01-28,22,Friday,5,9,1
1487187070456107010,2022-01-28 22:13:22,"BMKG mengeluarkan prakiraan cuaca untuk wilayah DKI Jakarta. Hari ini, wilayah Jakarta Selatan diprediksi akan diguyur hujan deras. https://t.co/jw97ITgqg5",9,0,4,1,2022-01-28,22,Friday,5,13,1
1487186059440050185,2022-01-28 22:09:21,Pertengkaran antara kepala desa dan kepala dusun di Lumajang berujung keduanya dilarikan ke rumah sakit karena luka bacok. Pertikaian itu dipicu dendam lama. https://t.co/ZOZwsmruaG,4,5,2,4,2022-01-28,22,Friday,5,6,9
1487184604817670145,2022-01-28 22:03:34,"Timnas Indonesia memang mampu menang besar dari Timor Leste. Namun, secara permainan justru skuad Garuda sangat mengecewakan. https://t.co/4gEiQFISJ7",4,0,1,0,2022-01-28,22,Friday,5,5,0
1487184119343820801,2022-01-28 22:01:39,"#terpopuler Memiliki penasaran yang tinggi, seorang bocah memasukkan petai ke penampung air dispenser. Hasilnya satu rumah geger karena bau petai yang tak kunjung hilang!  https://t.co/bhK5DdfmGt",5,1,7,1,2022-01-28,22,Friday,5,12,2
1487182609335607303,2022-01-28 21:55:39,Miliarder Jeff Bezos memberikan suntikan dana untuk startup yang dibangun milenial Indonesia. Ini alasannya:  https://t.co/9saOUHFKk5,4,0,1,0,2022-01-28,21,Friday,5,5,0
1487180988765593600,2022-01-28 21:49:12,"Tiga prajurit TNI yang gugur ditembak teroris KKB di Papua dipulangkan ke kampung halaman masing-masing. Sebelumnya, digelar upacara pelepasan. https://t.co/O8kRWcSAzS",9,3,5,3,2022-01-28,21,Friday,5,14,6
1487179669711593472,2022-01-28 21:43:58,Apple sedang mengembangkan fitur baru agar pengguna iPhone dapat menerima pembayaran kartu kredit melalui teknologi nirsentuh. #iPhone  https://t.co/A437gbwSCT,5,0,1,0,2022-01-28,21,Friday,5,6,0
1487177765174583303,2022-01-28 21:36:24,"Bermain tanpa gawai, membetulkan letak topi atau berbincang di atas kuda. Hal kecil yang bisa dilakukan sebagai manusia namun sering terlewatkan di era digital. https://t.co/JirIK7kOJQ",24,1,3,0,2022-01-28,21,Friday,5,27,1
1487176587825061892,2022-01-28 21:31:43,Perpindahan ibu kota Indonesia ke Kalimantan Timur (Kaltim) akan melalui berbagai tahapan. Berikut sejumlah tahapannya. https://t.co/0f2vBoQnjg,10,3,1,0,2022-01-28,21,Friday,5,11,3
1487174476357906435,2022-01-28 21:23:20,"Keterisian tempat tidur, atau BOR 140 RS Rujukan COVID-19 DKI Jakarta melonjak jadi 54 persen. Begitu pula BOR ICU naik jadi 18 persen. https://t.co/jqFLCCitoK",20,3,12,3,2022-01-28,21,Friday,5,32,6
1487173119756414976,2022-01-28 21:17:56,"Seorang pria di Medan berinisial YB (35) ditangkap pihak kepolisian. YB dibekuk lantaran mencuri kotak infak di sejumlah masjid di Medan, Sumatera Utara. https://t.co/O9Rs4VG47Y",13,2,2,0,2022-01-28,21,Friday,5,15,2
1487171954331332612,2022-01-28 21:13:18,Pentagon mengingatkan dampak dari rencana serangan Rusia ke Ukraina akan mengerikan. Konflik itu akan berakibat kehancuran dan korban manusia sangat besar. https://t.co/a5ykwIXyiF,29,10,5,1,2022-01-28,21,Friday,5,34,11
1487170512711303171,2022-01-28 21:07:35,Wayne Rooney mengambil sikap atas tawaran melatih Everton. Pria 36 tahun itu menolak membesut The Toffees. https://t.co/Cf1I33mL7q,6,0,1,1,2022-01-28,21,Friday,5,7,1
1487169433965670402,2022-01-28 21:03:17,Jack Ma makin diincar musuhnya. Salah sedikit bisa jadi ancaman bagi keberlangsungan bisnis Alibaba Group. #JackMa  https://t.co/kIr9dzOUm4,0,0,0,0,2022-01-28,21,Friday,5,0,0
1487168178207744011,2022-01-28 20:58:18,Yuk latih otak kamu agar bisa lancar memecahkan masalah. Teka-teki ini bisa membuktikan apakah kamu jenius. https://t.co/y2LsTshcgA,30,17,3,3,2022-01-28,20,Friday,5,33,20
1487166540743118850,2022-01-28 20:51:48,"Desainer Dior, Maria Grazia merilis koleksi busana Haute Couture Spring/Summer 2022 di Paris Fashion Week. Berikut ini Koleksinya. https://t.co/vO2YQRfQpa",3,0,0,0,2022-01-28,20,Friday,5,3,0
1487164183724675073,2022-01-28 20:42:26,Kasus sopir taksi online menabrak dua pemotor diduga jambret hingga tewas di Tebet pada Oktober 2021 mencuat kembali. Beredar rekaman CCTV penjambretan itu. https://t.co/RhvJz1A82Q,88,25,35,11,2022-01-28,20,Friday,5,123,36
1487161963041935362,2022-01-28 20:33:36,Bank Mandiri sedang membuka lowongan kerja untuk berbagai posisi. Lowongan ini terbuka bagi lulusan S1 jurusan IT hingga Akuntansi. https://t.co/HNz2CYByCh,10,0,4,0,2022-01-28,20,Friday,5,14,0
1487160644134752259,2022-01-28 20:28:22,"Orgasme memberikan dampak yang baik bagi kesehatan tubuh wanita. Tak hanya kepuasan saat berhubungan seks, simak 7 manfaat orgasme. https://t.co/mrkveGOZWx",8,0,3,0,2022-01-28,20,Friday,5,11,0
1487158938026090500,2022-01-28 20:21:35,"Polda Jabar mengamankan total 731 perusuh aksi demo massa GMBI yang berujung ricuh di Mapolda Jabar, Kota Bandung. Anggota DPR Eva Yuliana memberi apresiasi. https://t.co/4U1aXV5gLG",4,2,1,0,2022-01-28,20,Friday,5,5,2
1487157967728398344,2022-01-28 20:17:44,"Para bintang TikTok semakin kaya raya, bahkan pendapatan sebagian dari mereka disebut telah menyamai bahkan melebihi penghasilan CEO di perusahaan top. https://t.co/n94DKCG6qe",10,1,3,0,2022-01-28,20,Friday,5,13,1
1487155343671103494,2022-01-28 20:07:18,"Pelanggan Smartfren berpeluang mendapatkan hak khusus mengakses berbagai konten premium, serta menyaksikan lebih dari 70 saluran TV lokal dan internasional. https://t.co/24IxZAEvgN",4,0,1,0,2022-01-28,20,Friday,5,5,0
1487154117294317569,2022-01-28 20:02:26,Tips cuap-cuap menghasilkan cuan. Ini kata Diana Wardhani:  https://t.co/b76iIiqcRM,3,0,1,0,2022-01-28,20,Friday,5,4,0
1487152525493125124,2022-01-28 19:56:06,Kemungkinan ada ratusan ribu batu angkasa meteorit berada di padang es Antartika. Bahkan jumlahnya diperkirakan bisa mencapai 300 ribu buah.  https://t.co/SRIInGoq05,11,3,2,0,2022-01-28,19,Friday,5,13,3
1487151174323249154,2022-01-28 19:50:44,Harus ada pemain yang dikorbankan apabila Luis Diaz jadi gabung ke Liverpool. Adalah Divock Origi dan Takumi Minamino yang bakal dijual The Reds. https://t.co/hfhkigAzYR,5,0,1,0,2022-01-28,19,Friday,5,6,0
1487149880363687942,2022-01-28 19:45:36,Seorang pria berinisial MAG ditangkap pihak kepolisian. MAG diciduk lantaran menembak warga inisial RS pakai senapan angin gegara sengketa lahan sawit. https://t.co/Hb9evhR4z8,2,0,0,0,2022-01-28,19,Friday,5,2,0
1487148577424031749,2022-01-28 19:40:25,"Restoran Chinese food banyak tersebar di Jakarta. Salah satunya Tio Ciu 78 yang menawarkan hidangan Tio Ciu. Ada gurame tahu tausi, mie goreng dan capcay.  https://t.co/TxUUC7eyW0",3,0,0,0,2022-01-28,19,Friday,5,3,0
1487147072600129543,2022-01-28 19:34:26,Seorang YouTuber asal Korea Selatan dapat menghabiskan ratusan porsi makanan. Kala itu ia menghabiskan 200 tiram kukus sendirian di sebuah restoran.  https://t.co/iQqkdvq6GK,11,1,0,0,2022-01-28,19,Friday,5,11,1
1487145724756303875,2022-01-28 19:29:05,"Intel mencoba melawan dominasi performa Apple M1 (dan berbagai variannya) lewat Alder Lake. Memang lebih kencang sih, tapi... https://t.co/7rAWslvVJa",7,1,0,0,2022-01-28,19,Friday,5,7,1
1487144461780013056,2022-01-28 19:24:04,"Oknum guru MW di Kabupaten Buton, Sulawesi Tenggara (Sultra), resmi dinonaktifkan setelah viral menghukum 16 murid mengunyah sampah. https://t.co/bukWt7yQW2",3,1,1,0,2022-01-28,19,Friday,5,4,1
1487143219376832515,2022-01-28 19:19:07,"Berawal kangen masakan khas Bali, Ira Rahmawati mencoba membuat menu makanan khas Bali yakni Ayam Betutu dan Sate Plecing. Ternyata disukai para tetangga.  https://t.co/kRp8bFurt0",12,0,1,0,2022-01-28,19,Friday,5,13,0
1487141606100803588,2022-01-28 19:12:43,Juventus resmi memperkenalkan Dusan Vlahovic sebagai pemain anyar mereka. Si Nyonya Tua merekrut striker Serbia itu dengan kontrak berdurasi empat tahun. https://t.co/SVoMq2y2vl,6,1,1,0,2022-01-28,19,Friday,5,7,1
1487140848395595782,2022-01-28 19:09:42,Rompi 'militer' yang dipakai AHY ternyata bisa juga digunakan sebagai terapi penyakit. Namun penggunaannya tak boleh asal ya. Simak penjelasan dokter: https://t.co/cUOiQg84NZ,5,3,1,0,2022-01-28,19,Friday,5,6,3
1487139337263321088,2022-01-28 19:03:42,Epidemiolog Dicky Budiman menyarankan untuk mempertimbangkan peniadaan Pembelajaran Tatap Muka (PTM) dan memperbanyak Work From Home. Berikut pemaparannya! https://t.co/1UR0XrkQVa,10,0,1,1,2022-01-28,19,Friday,5,11,1
1487137966556430342,2022-01-28 18:58:15,"Pasien COVID-19 bergejala ringan tidak bisa lagi masuk RS, disarankan isolasi mandiri atau terpadu. Jika ingin isoman di rumah, ini 8 tips dari Dekan FKUI. https://t.co/8HBKszb5uu",14,0,1,1,2022-01-28,18,Friday,5,15,1
1487135738651103233,2022-01-28 18:49:24,Smartfren baru merilis paket Unlimited Harian yang dijanjikan punya keunggulan menarik. Apa saja? https://t.co/dIrFyPDaYn,7,0,3,0,2022-01-28,18,Friday,5,10,0
1487134404908617728,2022-01-28 18:44:06,"#FOTO Seorang seniman yang juga menyukai sejarah, mencoba membuat logo-logo populer di dunia dengan tema di abad pertengahan. Ini hasilnya:   https://t.co/vdy1UJ4eXQ",6,0,1,0,2022-01-28,18,Friday,5,7,0
1487133108059217920,2022-01-28 18:38:57,"Apple memulai 2022 dengan manis lewat laporan keuangan fiskal Q1 2022-nya, yaitu pemasukan antara Oktober - Desember 2021 yang melesat. https://t.co/xbsKUx7zgI",5,0,0,0,2022-01-28,18,Friday,5,5,0
1487131622679928833,2022-01-28 18:33:03,"Kementerian Perdagangan kembali penertiban terhadap pelaku investasi ilegal dengan skema expert advisor atau robot trading, yakni PT DNA Pro Akademi.  https://t.co/O0DB3ZSDM9",5,5,4,2,2022-01-28,18,Friday,5,9,7
1487130388917100552,2022-01-28 18:28:08,Kejaksaan Negeri Bungo Jambi menetapkan seorang kepala desa dan tiga perangkatnya sebagai tersangka atas dugaan korupsi pembangunan turap senilai Rp 500 juta. https://t.co/oAIvv5k6Md,5,0,3,0,2022-01-28,18,Friday,5,8,0
1487128897133195269,2022-01-28 18:22:13,"Sejak bikin heboh karena foto selfie-nya laris sampai miliaran rupiah sebagai NFT, nama Ghozali Everyday makin menanjak. https://t.co/K8HQJXIpqJ",8,0,2,0,2022-01-28,18,Friday,5,10,0
1487127509049257984,2022-01-28 18:16:42,Ulah hacker yang menyusup di sesi video conference atau Zoombombing terjadi lagi. Kali ini saat webinar Riset Pengembangan Vaksin COVID-19 yang digelar BRIN.  https://t.co/UpjmxyzcEq,46,12,12,6,2022-01-28,18,Friday,5,58,18
1487125954208186372,2022-01-28 18:10:31,Bambang Drias biasa garap horor. Drias cerita pengalaman buat film drama Mengejar Surga:  https://t.co/QlHSa32swJ,3,0,1,0,2022-01-28,18,Friday,5,4,0
1487124829891436545,2022-01-28 18:06:03,AirTag asesoris buatan Apple telah dipuji kemampuannya sebagai alat pelacak yang dinilai sangat efektif dan terjangkau. Namun ada juga bahayanya. https://t.co/n4go2rl6XD,6,1,1,0,2022-01-28,18,Friday,5,7,1
1487123452372959232,2022-01-28 18:00:35,Wagub DKI Riza Patria menganggap wajar jika JakPro studi banding ke Diriyah demi mempelajari Formula E. JakPro dinilai perlu belajar dari Arab Saudi. https://t.co/0GSjUA1eL0,5,3,1,0,2022-01-28,18,Friday,5,6,3
1487121848378789892,2022-01-28 17:54:12,"Warga yang berdagang di Kawasan Pasar Lama, Kota Tangerang resah akan adanya pungli. Para pedagang mengaku pungli dimintai dengan kedok uang keamanan. https://t.co/v1hdMIyrzJ",7,0,3,0,2022-01-28,17,Friday,5,10,0
1487120721188990985,2022-01-28 17:49:43,Kominfo membuka kesempatan bagi multi stakeholders terlibat memperjuangkan isu digital di Digital Economy Working Group Presidensi G20 Indonesia 2022. https://t.co/b5se9oMX1K,3,1,2,0,2022-01-28,17,Friday,5,5,1
1487120202332528643,2022-01-28 17:47:40,"Aneka peristiwa terjadi di Jabar hari ini. Ketua Umum GMBI menjadi tersangka imbas demo ricuh. Lalu, di Cianjur, heboh bocah kecanduan makan kertas. https://t.co/LmssZLVsrl",1,1,1,2,2022-01-28,17,Friday,5,2,3
1487117461048766470,2022-01-28 17:36:46,"Deretan pemberitahuan nyeleneh ini endingnya di luar dugaan, bisa bikin jomblo gigit jari. Ini potretnya:  https://t.co/sxOR9DmS5a",8,0,5,1,2022-01-28,17,Friday,5,13,1
1487116127998296070,2022-01-28 17:31:28,"Pandemi COVID-19 berdampak pada perekonomian warga di berbagai negara dunia. Di Sao Paulo Brasil, populasi gelandangan meningkat hingga 30% selama pandemi. https://t.co/DDObKfwSt0",2,1,3,0,2022-01-28,17,Friday,5,5,1
1487114388620423175,2022-01-28 17:24:34,"Di setiap kesempatan, Paris Hilton selalu memperlihatkan gaya fashion terkini. Baru-baru ini, Paris Hilton viral karena pakai dua sepatu yang berbeda. https://t.co/ubNZk3FDvh",8,1,2,1,2022-01-28,17,Friday,5,10,2
1487113465437298691,2022-01-28 17:20:54,"Artis cilik pemain film 'Danur', Matthew White, meninggal dunia akibat penyakit diabetes. Berikut beberapa faktor risiko diabetes anak yang wajib diketahui. https://t.co/XU2rf1qcgi",13,0,10,1,2022-01-28,17,Friday,5,23,1
1487112242831183875,2022-01-28 17:16:02,Viral trik tidur dalam dua menit ala tentara yang diklaim bikin tidur pulas. Penasaran caranya bagaimana? Sini merapat: https://t.co/hRFWHZavX0,102,6,40,7,2022-01-28,17,Friday,5,142,13
1487111483846705155,2022-01-28 17:13:01,"Menurut laporan media setempat, China sepakat untuk memberikan akses kunjungan bagi PBB ke Xinjiang pada tahun 2022. https://t.co/xH3axIc1UD",1,0,1,1,2022-01-28,17,Friday,5,2,1
1487110945759506439,2022-01-28 17:10:53,Kadang hal yang tampak sederhana bisa jadi jebakan yang mengecoh logika. Buktikan kecerdasan kamu dengan menjawab teka-teki ini. https://t.co/oYFllrxPV2,135,153,18,6,2022-01-28,17,Friday,5,153,159
1487109866367954949,2022-01-28 17:06:35,Pameran seni 'Para Sekutu yang Tidak Bisa Berkata Tidak' dibuka di Galeri Nasional Indonesia mulai 28 Januari sampai 27 Februari 2022. https://t.co/cvgpWZ4gss,3,0,3,0,2022-01-28,17,Friday,5,6,0
1487109601170493450,2022-01-28 17:05:32,Sebuah jembatan di Pittsburgh runtuh dan memberi latar belakang simbolis untuk perjalanan Presiden Amerika Serikat (AS) Joe Biden ke kota itu. https://t.co/0VlXDT3b8h,3,0,1,0,2022-01-28,17,Friday,5,4,0
1487108865481129989,2022-01-28 17:02:37,Tebak-tebakan ini belum tentu bisa dijawab oleh orang cerdas sekalipun. Coba pecahkan teka-teki receh ini sambil melatih otak. https://t.co/PYHFi3h8c4,41,52,5,2,2022-01-28,17,Friday,5,46,54
1487107481092374538,2022-01-28 16:57:07,Tisu magic sering digunakan oleh pria saat melakukan hubungan seksual. Benda ini biasa digunakan untuk menunda ejakulasi dini. Bagaimana efek sampingnya ya? https://t.co/9ml06fEeec,4,1,1,1,2022-01-28,16,Friday,5,5,2
1487106633306193926,2022-01-28 16:53:45,Yuk latih otak kamu agar bisa lancar memecahkan masalah. Teka-teki ini bisa membuktikan apakah kamu jenius. https://t.co/qLSDvUmy2F,49,49,8,2,2022-01-28,16,Friday,5,57,51
1487106043217862660,2022-01-28 16:51:24,"Berlian hitam yang luar biasa, siap dilelang dan akan menjadi milik penawar tertinggi. Apa keistimewaannya? Berlian ini berasal dari luar angkasa. https://t.co/SR3zj6jzq8",12,0,3,0,2022-01-28,16,Friday,5,15,0
1487106041938653185,2022-01-28 16:51:24,"Fenomena langka terjadi di Gurun Sahara. Di gurun pasir terbesar dunia yang biasanya tandus dan diliputi pasir tersebut, turun salju. Ini potretnya:  https://t.co/XSb4NWgtRc",17,4,4,1,2022-01-28,16,Friday,5,21,5
1487105668444217348,2022-01-28 16:49:55,"Nian Gao selalu jadi hidangan utama saat Imlek. Selain bisa dibeli langsung di toko, kue keranjang juga bisa dipesan online buat kamu yang tak mau repot.  https://t.co/f9QbwzquTp",4,0,0,0,2022-01-28,16,Friday,5,4,0
1487104408294932480,2022-01-28 16:44:54,"Ular sanca sepanjang 3 meter dievakuasi dari salah satu rumah warga di Kecamatan Panakukan, Kota Makassar, Sulawesi Selatan. Penangkapan ular ini sempat menyulitkan petugas damkar. https://t.co/SxvGX0SeY0",6,1,0,0,2022-01-28,16,Friday,5,6,1
1487103245243854853,2022-01-28 16:40:17,"Tisu magic banyak dijadikan opsi oleh pasangan agar sesi bercinta jadi lebih tahan lama. Tapi, bagaimana cara pakai tisu magic yang benar? Begini caranya: https://t.co/HN3LeMo4Tk",8,1,4,0,2022-01-28,16,Friday,5,12,1
1487102656778805255,2022-01-28 16:37:57,"Walaupun serial Layangan Putus telah tamat, namun beberapa adegan ikonik dalam serial itu masih terngiang di benak para penonton setianya. https://t.co/Mspf5wDp76",14,0,2,0,2022-01-28,16,Friday,5,16,0
1487101199795032068,2022-01-28 16:32:09,"Suasana pilu menyelimuti rumah mendiang Grace Karundeng mahasiswi asal Minut, Sulut, yang meninggal misterius di Kanada. Para pelayat tampak terus berdatangan. https://t.co/AzFtKENPfB",4,1,0,0,2022-01-28,16,Friday,5,4,1
1487100858416484356,2022-01-28 16:30:48,Di dalam gambar berikut ada beberapa hal yang tidak masuk akal. Bila kamu bisa menemukannya berarti logika kamu jalan. https://t.co/Qd1PbLm4bg,7,12,0,0,2022-01-28,16,Friday,5,7,12
1487099803926466563,2022-01-28 16:26:36,"Menkes meyakini turunan varian Omicron BA.2 sudah masuk RI. Diduga menular lebih cepat dari Omicron BA.1 dan sulit dideteksi dengan SGTF, begini catatan pakar: https://t.co/euCfaP1Tej",7,1,1,4,2022-01-28,16,Friday,5,8,5
1487098922724175872,2022-01-28 16:23:06,"Antusiasme masyarakat mendukung pegiat usaha di Indonesia, khususnya UMKM lokal melalui platform Tokopedia semakin meningkat. https://t.co/o4TxoStelo",8,1,2,0,2022-01-28,16,Friday,5,10,1
1487097849846415364,2022-01-28 16:18:51,Aksi Putri Monako Charlotte Casiraghi berkuda membuka peragaan adibusana Chanel di Paris Fashion Week. Ini potret penampilannya yang kontroversi:  https://t.co/ZvyCAcb7C5,6,1,1,0,2022-01-28,16,Friday,5,7,1
1487096997974888451,2022-01-28 16:15:27,Jisoo BLACKPINK disandingkan dengan Suzy karena memiliki banyak kesamaan. #Jisoo #Suzy  https://t.co/deKV6SMh3s,21,5,3,1,2022-01-28,16,Friday,5,24,6
1487095217341751303,2022-01-28 16:08:23,Rizal Maulana Arifin salah satu prajurit TNI yang gugur ditembak teroris Kelompok Kriminal Bersenjata (KKB) di Papua. Jenazahnya akan dimakamkan di TMP Cikutra. https://t.co/bZIEmXM5vT,16,0,3,0,2022-01-28,16,Friday,5,19,0
1487094927989387273,2022-01-28 16:07:14,"Kenalan dengan Kim De Klop, pilot pembawa pesawat kargo berparas cantik yang viral di media sosial. Ini potretnya:  https://t.co/Sist1Xj7Qo",14,0,1,0,2022-01-28,16,Friday,5,15,0
1487093728665812995,2022-01-28 16:02:28,Seorang wanita dicap tidak profesional ketika menampilkan pakaiannya yang seksi saat menemui calon manager. https://t.co/MTLEc8zaur,5,1,0,1,2022-01-28,16,Friday,5,5,2
1487092729171648512,2022-01-28 15:58:30,Partisipasi atlet transpuan jadi polemik di antara rekan-rekan satu tim. Beberapa mengatakan tidak nyaman ganti baju di ruangan yang sama. https://t.co/bUMFxXgokC,6,1,1,0,2022-01-28,15,Friday,5,7,1
1487091604011859975,2022-01-28 15:54:01,Inisiatif yang telah diluncurkan pada pertengahan 2020 ini telah menghasilkan berbagai dampak positif bagi para UMKM Bali hingga masyarakat secara umum. https://t.co/DHixo8muAc,2,0,0,0,2022-01-28,15,Friday,5,2,0
1487090567603445765,2022-01-28 15:49:54,"Unggahan Tissa Biani mencuri perhatian warganet, ia tampil pangling saat mengenakan hijab. Ini penampilannya:  https://t.co/nf8UjNEVqQ",6,0,0,1,2022-01-28,15,Friday,5,6,1
1487089627051737094,2022-01-28 15:46:10,Bagaimana ramalan cinta shio naga hingga shio ayam di tahun 2022? Ini prediksinya:  https://t.co/VoNCZRThqU,5,1,0,0,2022-01-28,15,Friday,5,5,1
1487088582745632768,2022-01-28 15:42:01,"Seperti halnya pisau, otak juga perlu diasah agar selalu tajam. Otak juga butuh diolahragakan agar lebih berstamina untuk menyambut awal pekan. Yuk dicoba! https://t.co/9AzAz3qGA3",26,20,1,1,2022-01-28,15,Friday,5,27,21
1487087263137861633,2022-01-28 15:36:46,"Sandiaga Uno mengunggah video NCT lagi nge-dance dengan lagu Mendung Tanpo Udan versi Ndarboy Genk. Dalam keterangannya, Sandi mengapresiasi keberhasilan sektor ekonomi kreatif Indonesia. https://t.co/q1Iuch9ebs",13,1,3,0,2022-01-28,15,Friday,5,16,1
1487086121410613248,2022-01-28 15:32:14,"Para musisi terlibat di sebuah acara futsal yang digelar di GOR Ciracas, Jakarta Timur. Mereka unjuk kebolehan, termasuk Danilla yang tampak mengenakan sarung. Ini potretnya:  https://t.co/4UXeUeK2qK",18,0,3,0,2022-01-28,15,Friday,5,21,0
1487084805271474178,2022-01-28 15:27:00,Pengakuan Rafael Tan soal rencana pernikahan tahun depan dengan Sabina Paz:   https://t.co/FqRWWKygtT,3,0,1,0,2022-01-28,15,Friday,5,4,0
1487083626160394240,2022-01-28 15:22:19,"Kenalan dengan Alisha Lehmann, pesepak bola wanita yang disebut-sebut tercantik di dunia. Inilah gaya glamour Alisha yang mirip Barbie:  https://t.co/1CGnMg2F1P",7,0,5,1,2022-01-28,15,Friday,5,12,1
1487082261866590211,2022-01-28 15:16:54,Teknologi militer termasuk yang paling pesat perkembangannya. Ini contoh teknologi militer masa depan yang mengerikan dan menakjubkan:  https://t.co/ii6lFcTfyv,4,0,4,1,2022-01-28,15,Friday,5,8,1
1487081229153406979,2022-01-28 15:12:48,Jakarta Aquarium &amp; Safari mengangkat kisah cinta legendaris dari negeri China ke dalam parade Sea of Love. Gelaran ini diadakan mulai 28 Januari-28 Februari 2022 untuk merayakan Imlek sekaligus Hari Valentine. https://t.co/xDVYFSRX43,6,0,3,1,2022-01-28,15,Friday,5,9,1
1487079917250437131,2022-01-28 15:07:35,"Seorang pasien di Boston, Amerika Serikat (AS) yang ingin transplantasi jantung mengaku ditolak oleh rumah sakit. Penolakan itu didasari karena pasien belum divaksinasi Covid-19. https://t.co/ikWEpnQLZN",4,3,2,0,2022-01-28,15,Friday,5,6,3
1487079366303571980,2022-01-28 15:05:24,PSM Makassar meraih tiga poin saat melawan Barito Putera di lanjutan kompetisi BRI Liga 1 2021. Juku Eja menang 2-1 atas Laskar Antasari. https://t.co/F9e5ISN1WP,0,0,1,0,2022-01-28,15,Friday,5,1,0
1487078809425874947,2022-01-28 15:03:11,Girlband XG sudah nggak sabar untuk debut! Sebelumnya kamu bisa menyaksikan video penampilan mereka dulu nih:  https://t.co/hkCFJzx74l,5,0,1,0,2022-01-28,15,Friday,5,6,0
1487077744882163718,2022-01-28 14:58:57,"Co-founder Microsoft, Bill Gates sudah meramal pandemi sejak beberapa tahun lalu. Kini, ia menyebut ancaman bioterorisme memakai virus yang direkayasa. https://t.co/6hFp3WvNeV",32,6,14,2,2022-01-28,14,Friday,5,46,8
1487076960920604674,2022-01-28 14:55:50,"Axiata Group Berhad (Axiata) dan PT XL Axiata Tbk (XL Axiata) melakukan pengambilalihan terhadap sejumlah 66,03% saham PT Link Net Tbk (Link Net).  https://t.co/mXtvhfnwOC",8,0,4,0,2022-01-28,14,Friday,5,12,0
1487075944300961797,2022-01-28 14:51:48,"Kristina Ozturk, wanita berusia 24 tahun yang memiliki 22 anak. Ini sosok Kristina yang kisahnya punya 22 anak di usia muda membuat penasaran. https://t.co/jFil7tU6GG",21,2,7,2,2022-01-28,14,Friday,5,28,4
1487074817492889610,2022-01-28 14:47:19,Museum patung lilin di Jerman ini jadi kontroversi setelah memperlihatkan foto di balik layar saat renovasi. Ada konten Ratu Elizabeth II dengan rambut botak. https://t.co/J8YKtEgvSw,16,0,8,1,2022-01-28,14,Friday,5,24,1
1487073942942715908,2022-01-28 14:43:51,"#Terpopuler Awal tahun 2022 ini rupanya kurang menggembirakan terhadap Bitcoin dan mata uang kripto lainnya, di mana harganya anjlok. https://t.co/dlTL1ukuBK",7,0,2,0,2022-01-28,14,Friday,5,9,0
1487072943947624452,2022-01-28 14:39:52,"Nama Eunice Tjoa jadi sorotan netizen, ia jadi salah satu TikTokers yang naik daun saat ini. Kenalin nih Eunice Tjoa, TikTokers berpenghasilan Rp 300 juta sebulan:  https://t.co/iLr853aOnx",19,0,2,3,2022-01-28,14,Friday,5,21,3
1487072310683131919,2022-01-28 14:37:21,Acara pernikahan Putri Fadzilah dari Brunei jadi perhatian dunia. Acara tersebut digelar secara mewah selama 10 hari berturut-turut. Ini fakta-faktanya:  https://t.co/MHSyGGVB9H,13,3,4,1,2022-01-28,14,Friday,5,17,4
1487070549926985735,2022-01-28 14:30:22,"Aliando Syarief ngaku menderita penyakit gangguan mental OCD. Ia tidak sendirian, beberapa artis ini juga ngaku OCD:  https://t.co/jSUdsLPvxq",6,0,1,0,2022-01-28,14,Friday,5,7,0
1487070304102928390,2022-01-28 14:29:23,Ulah hacker yang menyusup di sesi video conference atau Zoombombing terjadi lagi. Kali ini saat webinar Riset Pengembangan Vaksin COVID-19 yang digelar BRIN.  https://t.co/sinCLd5RPz,39,7,16,14,2022-01-28,14,Friday,5,55,21
1487069562105253892,2022-01-28 14:26:26,"Rumah tangga aktor Gunawan Sudrajat dan istrinya, Lala Gunawan, sudah berumur 18 Tahun. Ini rahasia rumah tangga awet Gunawan Sudrajat:  https://t.co/SXzdyvki8k",7,0,0,0,2022-01-28,14,Friday,5,7,0
1487068544177160193,2022-01-28 14:22:23,Brad Pitt kini dikabarkan tengah berkencan dengan penyanyi Lykke Li. Keduanya tinggal berdekatan dan kerap kepergok makan bareng.  https://t.co/lndmH7UbX7,4,3,0,0,2022-01-28,14,Friday,5,4,3
1487068274353479681,2022-01-28 14:21:19,Aktor tampan Aliando Syarif bukan hanya jago akting di depan kamera tapi juga jago kulineran. Momen makannya banyak dibagikan lewat Instagram pribadinya.  https://t.co/F6OUgvCC8m,5,0,0,1,2022-01-28,14,Friday,5,5,1
1487068272952590336,2022-01-28 14:21:19,"NCT Dream belum lama ini bikin heboh karena aksinya joget dengan lagu yang dibawakan Ndar Boy. Tak hanya itu, NCT Dream juga dijadikan brand ambassador mi instan asal Indonesia. #NCT  https://t.co/n2czJZA2nY",13,0,3,0,2022-01-28,14,Friday,5,16,0
1487066839708573697,2022-01-28 14:15:37,"Saya selama ini sabar dengan uang seadanya untuk makan anak, tapi ternyata jumlah gaji suami lumayan banget dan sering dia berikan kepada keluarganya di kampung. #detiknetwork  https://t.co/sS09j8NpQ2",14,2,5,1,2022-01-28,14,Friday,5,19,3
1487065695909203973,2022-01-28 14:11:04,Tak sengaja makan burger yang di dalamnya berisi daging babi berbentuk bacon. Pria Muslim ini langsung mual-mual dan sakit selama beberapa hari!  https://t.co/5jRk3CWTrh,21,12,4,2,2022-01-28,14,Friday,5,25,14
1487065555941175301,2022-01-28 14:10:31,"Salah sebut nama restoran Chipotle jadi Chicotle, Jungkook 'BTS' langsung dapat perlakuan istimewa. Karena Chipotle langsung berikan diskon untuk penggemar BTS!  https://t.co/0DIyGRkjuk",310,5,87,3,2022-01-28,14,Friday,5,397,8
1487065259340963840,2022-01-28 14:09:20,Seorang pria berinisial IHMS ditangkap pihak kepolisian. Dia dibekuk lantaran menembak warga pakai air gun gegara sakit hati. https://t.co/ekvhPqPjSC,6,0,0,0,2022-01-28,14,Friday,5,6,0
1487065062355386373,2022-01-28 14:08:33,"Kementerian Kominfo mengungkap alasan sulitnya melakukan penanganan terhadap pelanggaran perlindungan data pribadi. Plt Direktur Tata Kelola Ditjen Aptika, Teguh Arifiyadi menyebut proses investigasi kejahatan siber lebih rumit dibanding kejahatan biasa... https://t.co/bC4fGc9B7S",8,1,1,1,2022-01-28,14,Friday,5,9,2
1487064730577645572,2022-01-28 14:07:14,"Suasana pilu menyelimuti rumah mendiang Grace Karundeng, mahasiswi asal Minahasa Utara, Sulut yang meninggal misterius di Kanada. Jenazah Grace tiba hari ini. https://t.co/RyvhsZkVRp",12,0,0,0,2022-01-28,14,Friday,5,12,0
1487064436292694024,2022-01-28 14:06:04,Sering disebut sebagai makanan populer yang disukai banyak orang. Ternyata beberapa makanan ini justru dianggap tidak enak oleh netizen!  https://t.co/lUUk6ulxZd,18,3,4,5,2022-01-28,14,Friday,5,22,8
1487064153332330502,2022-01-28 14:04:57,"Bintang Timnas, Pratama Arhan jadi idola usai tampil di Piala AFF 2020. Arhan sudah punya gandengan, ini sosok Marshella Aprilia:  https://t.co/9ryhhknTYH",12,1,0,0,2022-01-28,14,Friday,5,12,1
1487063668890161155,2022-01-28 14:03:01,Google dikabarkan akan segera mengenalkan ponsel layar lipatnya yang diberi nama Google Pixel Notepad. Apakah ponsel ini akan menjadi pesaing Samsung Galaxy Z Fold dan Oppo Find N? https://t.co/SFeecnrCHQ,9,0,3,0,2022-01-28,14,Friday,5,12,0
1487063333186551813,2022-01-28 14:01:41,Satuan tugas atau task force dan action council dalam B20 Indonesia telah dibentuk. Satgas dan action council ini dipimpin oleh para pengusaha Indonesia.  https://t.co/25DBlA6IR0,7,0,0,0,2022-01-28,14,Friday,5,7,0
1487063326035226624,2022-01-28 14:01:39,Produk investasi dari perusahaan asuransi yakni unit link sempat bikin heboh. Otoritas Jasa Keuangan (OJK) pun mengambil jalan untuk merombak aturan.  https://t.co/K8zvlDr8nu,6,0,1,0,2022-01-28,14,Friday,5,7,0
1487062718553247744,2022-01-28 13:59:15,Aktris China Angelababy mengumumkan perceraiannya dengan aktor Huang Xiaoming. Ini penyebab cerai pasangan yang pesta nikahnya berbiaya Rp 417 miliar:  https://t.co/rOLOcseoAS,21,2,0,3,2022-01-28,13,Friday,5,21,5
1487061972612956160,2022-01-28 13:56:17,"Drama Korea garapan Netflix, All of Us Are Dead mengikuti pertarungan siswa SMA melawan zombie. Ini fakta-fakta menariknya: https://t.co/Rx3RX5IgH8",6,0,1,0,2022-01-28,13,Friday,5,7,0
1487061952874561552,2022-01-28 13:56:12,Empat Masjid di Klaten terkena proyek jalan tol Yogya-Solo. Masjid-masjid tersebut masih berdiri dan belum dirobohkan.  https://t.co/KSmWKZ5d4K,6,0,1,0,2022-01-28,13,Friday,5,7,0
1487061937254977544,2022-01-28 13:56:08,Sebanyak 18 orang pegawai KPK dinyatakan positif virus Corona. Plt Juru Bicara KPK Ali Fikri menyebut para pegawai itu mengalami gejala ringan. https://t.co/kqv5Poo2Uv,3,0,0,0,2022-01-28,13,Friday,5,3,0
1487061446919962627,2022-01-28 13:54:11,Presiden Joko Widodo menyampaikan Indonesia memiliki kekayaan sumber daya mineral yang dibutuhkan untuk mendorong transisi ekonomi hijau yang berkelanjutan. Jokowi tegaskan Indonesia tak akan mengekspor sumber daya itu dalam bentuk mentah. https://t.co/ecLV6qUoxa,11,2,2,1,2022-01-28,13,Friday,5,13,3
1487061431497506817,2022-01-28 13:54:08,"Sosok orang paling mulia di hari kiamat dalam pandangan Allah SWT telah dijelaskan dalam beberapa hadits. Tiap muslim berpeluang menjadi yang paling mulia.

via: detikedu  https://t.co/QSjOCTv5Up",14,0,1,0,2022-01-28,13,Friday,5,15,0
1487061263381405707,2022-01-28 13:53:28,"Minyak goreng harganya turun lagi jadi Rp 11.500/liter, 3 hari lagi.  https://t.co/L3Pv8ZorLH",67,55,26,21,2022-01-28,13,Friday,5,93,76
1487060625134133249,2022-01-28 13:50:55,Singapore Airlines akan membuka kembali penerbangan komersial harian dari Singapura ke Bali. Penerbangan perdana mulai tanggal 16 Februari 2022.  https://t.co/SMc1qbyQA9,5,1,1,2,2022-01-28,13,Friday,5,6,3
1487059729868333056,2022-01-28 13:47:22,Beberapa waktu terakhir nama Binomo kembali mencuat. Hal ini karena aplikasi ini mengendorse banyak artis supaya banyak orang yang tertarik menggunakan.  https://t.co/kK4GsEBzXK,4,0,2,0,2022-01-28,13,Friday,5,6,0
1487059706040438787,2022-01-28 13:47:16,"Sebuah video TikTok viral, terkait Manchester United. Dalam video itu, Ralf Rangnick memastikan Jesse Lingard akan pergi di akhir musim. https://t.co/kBpEtafbtf",1,0,0,0,2022-01-28,13,Friday,5,1,0
1487059376514940934,2022-01-28 13:45:58,Emas merupakan salah satu instrumen investasi yang paling aman dibandingkan yang lain.  https://t.co/RXAfTpb3n6,14,3,1,0,2022-01-28,13,Friday,5,15,3
1487059363672072195,2022-01-28 13:45:55,Sudah beberapa hari para nelayan di kawasan Pantai Santolo Garut tidak melaut. Hal itu terjadi dikarenakan angin kencang yang melanda kawasan laut selatan.  https://t.co/tPrAOF2yyq,6,1,2,0,2022-01-28,13,Friday,5,8,1
1487059001464471560,2022-01-28 13:44:28,"Sering digunakan untuk mengusir makhluk halus, ternyata daun kelor punya manfaat lebih. Tiga diantaranya bermanfaat untuk vitalitas pria.  https://t.co/LLaNW09bkE",10,0,2,0,2022-01-28,13,Friday,5,12,0
1487058352018501636,2022-01-28 13:41:53,Hendra/Ahsan masih masuk dalam daftar Pelatnas PBSI 2022 dan diharapkan bisa jadi inspirasi dan berbagi pengalaman untuk para pemain muda. https://t.co/JzBbKrLgd4,18,0,2,1,2022-01-28,13,Friday,5,20,1
1487057726249259014,2022-01-28 13:39:24,"BRI Liga 1 bergulir di tengah pandemi COVID-19. Selain menggulirkan kompetisi kasta tertinggi, BRI juga mempunyai misi untuk membangkitkan UMKM. https://t.co/QtAY6Ehosl",4,0,1,0,2022-01-28,13,Friday,5,5,0
1487056749433606153,2022-01-28 13:35:31,OJK akan mengeluarkan ketentuan di Industri Keuangan NonBank. Di antaranya peraturan mengenai Produk Asuransi Yang Dikaitkan dengan Investasi atau unit link.  https://t.co/UUH7jJpS3T,9,0,2,0,2022-01-28,13,Friday,5,11,0
1487056736846553090,2022-01-28 13:35:28,"Dari 16 PTN-BH, UI menempati urutan pertama sebagai perguruan tinggi yang paling 'kaya' lewat BMN yang digunakan!  https://t.co/8rPOCM5IYk",24,1,4,4,2022-01-28,13,Friday,5,28,5
1487056212944424966,2022-01-28 13:33:23,"Aksi numpang makan di pesta pernikahan orang tak dikenal banyak dilakukan orang. Tapi kali ini, aksi numpang makan ini justru ketahuan oleh keluarga pengantin!  https://t.co/XSLTqlnJ6X",3,2,1,1,2022-01-28,13,Friday,5,4,3
1487056193717735425,2022-01-28 13:33:19,Husband stitch merupakan jahitan tambahan pada vagina usai persalinan normal. Prosedur ini diklaim membuat vagina lebih rapat sehingga seks lebih memuaskan. https://t.co/FgI1sc0HOx,7,1,2,1,2022-01-28,13,Friday,5,9,2
1487055590954258441,2022-01-28 13:30:55,"Kejadian getok harga di tempat makan sangat menyebalkan. Tak heran kalau kisahnya selalu viral di media sosial, termasuk 5 kisah getok harga ini.  https://t.co/jZ431yiEMV",6,2,1,0,2022-01-28,13,Friday,5,7,2
1487055397311627265,2022-01-28 13:30:09,"Gianluigi Buffon senang Dusan Vlahovic bisa didatangkan Juventus, dan ingin melihat juga  berduet bareng Paulo Dybala. https://t.co/2XxOTdXKIg",9,0,1,1,2022-01-28,13,Friday,5,10,1
1487055369155264515,2022-01-28 13:30:02,Bakti sosial dan pengobatan gratis yang dilakukan oleh partai Golkar ini membuat masyarakat merasa diperhatikan. https://t.co/fA1I6mpKEw,9,1,0,1,2022-01-28,13,Friday,5,9,2
1487054209426022400,2022-01-28 13:25:26,Madura United meraih poin penuh saat melawan PSIS Semarang pada pekan ke-21 BRI Liga 1 2021. Laskar Sape Kerab menang 2-1. https://t.co/a5VOGbGpsY,5,0,0,0,2022-01-28,13,Friday,5,5,0
1487053716486299656,2022-01-28 13:23:28,"Kasus aktif Corona di Indonesia melonjak, menembus hampir 45 ribu orang. Hampir setengahnya disumbang DKI Jakarta, ini sebaran kasus aktif Corona terbaru. https://t.co/aCT4ViS7Z6",29,6,8,3,2022-01-28,13,Friday,5,37,9
1487053706604466179,2022-01-28 13:23:26,"Grup barongsai di Asahan, Sumatera Utara, sudah setahun lebih tak beraksi karena pandemi Corona. Kini, order untuk tampil mulai berdatangan jelang Imlek. https://t.co/3PsVjb3FSa",11,1,0,0,2022-01-28,13,Friday,5,11,1
1487053126754521092,2022-01-28 13:21:08,"Nur Asia Uno termasuk perempuan yang suka dengan perhiasan. Istri Sandiaga Uno itu, ikut mempromosikan 5 destinasi Indonesia lewat perhiasan.  https://t.co/DC8Q0Wn2U5",6,0,0,0,2022-01-28,13,Friday,5,6,0
1487052623320600576,2022-01-28 13:19:08,"Anies Baswedan menyebut kemacetan di Jakarta tidak akan berefek meski status ibu kota pindah ke Kalimantan Timur (Kaltim). Menurut Anies, kontribusi sektor pemerintahan dalam kemacetan di DKI selama ini kurang dari 7%. https://t.co/lPUiHjOIL2",37,37,4,10,2022-01-28,13,Friday,5,41,47
1487051762099970053,2022-01-28 13:15:42,"Inilah daya tampung dan tingkat keketatan prodi soshum di Unair tahun 2022. Informasinya berlaku untuk penerimaan jalur SNMPTN, SBMPTN, dan Mandiri.

via: detikedu  https://t.co/osNj3EAJuh",3,0,1,0,2022-01-28,13,Friday,5,4,0
1487051251275730951,2022-01-28 13:13:41,"Setelah kehilangan pekerjaan karena pandemi, ia malah menemukan bisnis baru yang tak hanya 'cuan' tapi hanya perlu kerja dua jam sehari. Ini profesinya:  https://t.co/ebfuD7BIUY",4,0,0,0,2022-01-28,13,Friday,5,4,0
1487049934138396682,2022-01-28 13:08:27,Rapat Dewan Komisioner LPS menetapkan untuk mempertahankan tingkat bunga penjaminan untuk simpanan rupiah di bank umum dan BPR.  https://t.co/HiQvDhW7oI,4,1,1,0,2022-01-28,13,Friday,5,5,1
1487048580556898308,2022-01-28 13:03:04,"Polisi menangkap muncikari prostitusi online yang mempekerjakan dua anak di bawah umur. Sejoli, inisial SI dan BR, diringkus di salah satu tempat penginapan. https://t.co/AK0UphaAO1",9,0,0,1,2022-01-28,13,Friday,5,9,1
1487047379572473862,2022-01-28 12:58:17,"Daniil Medvedev melangkah ke final Australian Open 2022 untuk menantang Rafael Nadal, setelah mengalahkan Stefanos Tsitsipas dalam duel empat set! https://t.co/o55kKMSCR2",3,0,0,0,2022-01-28,12,Friday,5,3,0
1487046485913047047,2022-01-28 12:54:44,LPSK mendapatkan kesimpulan sementara soal kerangkeng manusia di rumah Bupati Langkat. LPSK menyimpulkan penahanan yang dilakukan adalah ilegal. https://t.co/yI0aUzHYTz,9,1,0,0,2022-01-28,12,Friday,5,9,1
1487046004453040129,2022-01-28 12:52:50,"UICI sebagai Kampus Startup Digital Pertama di Indonesia membuka pendaftaran mahasiswa baru 2022 tanpa tes. Apa saja syaratnya?

via: detikedu  https://t.co/Jk9mBa6emr",12,0,2,3,2022-01-28,12,Friday,5,14,3
1487045012445618176,2022-01-28 12:48:53,"Untuk tampil cantik dan menarik di momen Imlek, kamu perlu mempersiapkan outfit yang kece serta tampilan makeup Imlek yang on point tentunya! Simak di sini:  https://t.co/IB4ASW7TU0",2,0,0,0,2022-01-28,12,Friday,5,2,0
1487044048074551299,2022-01-28 12:45:03,Balitbangkes Kemenkes RI memperbarui sebaran varian baru Corona termasuk Omicron di Indonesia. Kasus Omicron naik lebih banyak ketimbang varian Delta. https://t.co/EDMzvFDb4c,8,0,3,0,2022-01-28,12,Friday,5,11,0
1487043389426176001,2022-01-28 12:42:26,WHO kini tengah terlibat skandal rasisme yang melibatkan beberapa negara tetangga Indonesia. Seperti apa kasusnya? Berikut penjelasannya: https://t.co/Sy52MPyjIg,4,0,1,0,2022-01-28,12,Friday,5,5,0
1487042822603747331,2022-01-28 12:40:11,Paris Hilton menawan memakai tiara elegan bertabur batu zirkonia dalam poster Paris in Love. Tiara itu ternyata karya Rinaldy Yunardi. https://t.co/xnxnebXFnv,4,0,0,0,2022-01-28,12,Friday,5,4,0
1487042223443226624,2022-01-28 12:37:48,#Terpopuler Dunia maya dihebohkan dengan video aktor Steven Seagal ke Indonesia. Ia disebut mendatangi Kalimantan.  https://t.co/boIXS0BAoU,19,4,3,1,2022-01-28,12,Friday,5,22,5
1487041911668056065,2022-01-28 12:36:34,Video seorang pria dibonceng motor mengejar mobil viral. Pria itu berpura-pura kakinya terlindas mobil dan menuntut pertanggungjawaban. Waspada! https://t.co/bOr5QQKwBE,191,33,110,20,2022-01-28,12,Friday,5,301,53
1487041408422879233,2022-01-28 12:34:34,Fans Naruto dan Boruto kesal karena komikus Masashi Kishimoto belum mengungkapkan lebih jauh tentang karakter Amado.  https://t.co/Miepppzm68,10,0,1,0,2022-01-28,12,Friday,5,11,0
1487040667150868483,2022-01-28 12:31:37,"Kemenkes menyediakan layanan telemedisin dan obat gratis bagi pasien isoman COVID-19, termasuk varian Omicron. Begini cara akses dan alur pelayanannya: https://t.co/NDucimriyi",9,0,7,1,2022-01-28,12,Friday,5,16,1
1487040645369839626,2022-01-28 12:31:32,Gempa tektonik merupakan salah satu jenis gempa bumi yang sering terjadi. Berikut serba-serbinya. https://t.co/1UDwjsosOV,3,1,0,0,2022-01-28,12,Friday,5,3,1
1487040106548674573,2022-01-28 12:29:23,"Polisi menyelidiki kasus modus pemerasan dengan berpura-pura kaki terlindas mobil di Pasar Rebo, Jakarta Timur. Pelaku kini masuk radar perburuan polisi. https://t.co/evvOdg8XRl",121,22,40,7,2022-01-28,12,Friday,5,161,29
1487039586199027712,2022-01-28 12:27:19,"Anak mengikuti jejak orang tuanya jadi politikus tak asing di Indonesia. Namun, ada sejumlah anak yang memilih jalan berbeda dari bapaknya. Ini kisahnya.  https://t.co/QUBLfzobmo",2,1,0,0,2022-01-28,12,Friday,5,2,1
1487038831698362370,2022-01-28 12:24:19,"Menjelang Olimpiade Beijing, animo warga menyukai olahraga musim dingin semakin meningkat. Hoki dan ski menjadi cabor yang paling diminati anak-anak di China. https://t.co/xw1yA6I7sq",3,0,0,0,2022-01-28,12,Friday,5,3,0
1487037241927081987,2022-01-28 12:18:00,Luna Maya dipasangkan dengan Tora Sudiro dalam serial terbaru Turut Berduka Cita. Begini kesan keduanya saat dijadikan suami-istri:   https://t.co/QZASBPuSlz,8,1,1,0,2022-01-28,12,Friday,5,9,1
1487036666384633861,2022-01-28 12:15:43,"Berdasarkan data IUCN, 361 spesies hewan Indonesia terancam punah. Dari jumlah tersebut, 192 di antaranya sangat terancam punah.

via: detikedu  https://t.co/xJUZPH47gD",7,1,6,2,2022-01-28,12,Friday,5,13,3
1487035632501276675,2022-01-28 12:11:37,Anya Geraldine dan Kiky Saputri curi perhatian usai dikabarkan membentuk kelompok dua pelakor. Ini adu gaya Anya Geraldine dan Kiky Saputri:  https://t.co/1cWaNfqmZO,6,1,0,0,2022-01-28,12,Friday,5,6,1
1487034874112483330,2022-01-28 12:08:36,"Sejak beberapa minggu terakhir, Sheila Dara Aisha terus jadi sorotan. Kali ini Sheila Dara jadi trending topic karena foto ini:  https://t.co/yzABDOnF2a",34,1,3,1,2022-01-28,12,Friday,5,37,2
1487034507651866624,2022-01-28 12:07:09,Rusia mencatatkan rekor kasus harian Covid-19 yang mencapai 88 ribu. Setengah dari total kasus tersebut merupakan pasien anak di bawah 18 tahun. https://t.co/lTBt1m8ZOX,0,0,1,0,2022-01-28,12,Friday,5,1,0
1487033050647220225,2022-01-28 12:01:21,"Rusia dan Ukraina semakin memanas. Ukraina, Amerika Serikat, serta beberapa negara Barat kerap menuduh Moskow berencana melakukan invasi pada Kiev. Ada hal apa dengan Rusia, termasuk AS dan NATO terkait situasi panas kawasan Laut Hitam? #Analisis #CNNIn... https://t.co/3gsGvQ9QmL",4,0,1,0,2022-01-28,12,Friday,5,5,0
1487032472651063306,2022-01-28 11:59:03,Binary Option lagi-lagi ramai diperbincangkan karena bisa mendapat uang dengan cepat dan mudah!  https://t.co/IsFEoqeC0G,6,0,3,2,2022-01-28,11,Friday,5,9,2
1487032452719820805,2022-01-28 11:58:59,"Band yang beranggotakan 6 orang ini juga tewas dan diduga karena terbakar di dalam kelab Double O Sorong, Papua Barat. https://t.co/z3T3PTztU0",6,0,2,2,2022-01-28,11,Friday,5,8,2
1487032175660867591,2022-01-28 11:57:53,"Pemerintah mengimbau masyarakat agar tetap tenang dalam menyikapi varian Omicron. Jika memiliki 3 gejala ini, wajib simak baik-baik pesan dari Jokowi. https://t.co/rTTXCGphKb",9,0,1,0,2022-01-28,11,Friday,5,10,0
1487031425043996676,2022-01-28 11:54:54,Pemerintah akan mengeluarkan anggaran untuk revitalisasi Bandara Halim Perdanakusuma di Jakarta. Hal itu tertuang dalam Peraturan Presiden Nomor 9 Tahun 2022  https://t.co/vcqSdpyXag,6,1,1,0,2022-01-28,11,Friday,5,7,1
1487030851821002752,2022-01-28 11:52:37,"Nama Mendikbudristek, Nadiem Anwar Makarim, dijadikan sebagai nama gedung baru di sebuah politeknik yang terletak di Kalimantan Selatan.

via; detikedu  https://t.co/dQZ54MVFmK",11,1,2,1,2022-01-28,11,Friday,5,13,2
1487030494999031812,2022-01-28 11:51:12,"Praveen/Melati sebenarnya masih jadi ganda campuran terbaik bulutangkis Indonesia. Sayangnya, keduanya harus terdepak di Pelatnas PBSI tahun 2022! https://t.co/seyKrYFLRy",7,0,1,0,2022-01-28,11,Friday,5,8,0
1487029830289969154,2022-01-28 11:48:33,Beginilah sejarah Kawah Ijen hingga membentuk api biru atau blue flame. Ternyata memang Banyuwangilah satu-satunya yang memilikinya!  https://t.co/R8plw4Wz6T,22,2,6,1,2022-01-28,11,Friday,5,28,3
1487028208553938953,2022-01-28 11:42:07,"Angelina Petrova, model Ukraina ini pernah berpose bugil di lapangan. Itu demi menyelamatkan keuangan tim sepakbola kesayangannya! https://t.co/2vrcUqxjdX",10,2,1,0,2022-01-28,11,Friday,5,11,2
1487027698690105344,2022-01-28 11:40:05,"Wah, Kota Surabaya ternyata menyimpan sejumlah jembatan yang ikonik. Tertarik mampir? https://t.co/8dhLhhdn9f",19,0,2,0,2022-01-28,11,Friday,5,21,0
1487027066948268037,2022-01-28 11:37:35,"Muncul kabar, bahwa Manchester United tak mau melihat Jesse Lingard sukses bersama klub lain dan enggan membiarkan Lingard pergi! https://t.co/HVYkrZUAm4",10,1,1,1,2022-01-28,11,Friday,5,11,2
1487026238485151747,2022-01-28 11:34:17,All of Us Are Dead siap ditayangkan di Netflix. Drama bertemakan zombie ini akan ditayangkan sebanyak 12 episode.  https://t.co/ZQ4d2ihI6m,19,1,1,0,2022-01-28,11,Friday,5,20,1
1487025734082347009,2022-01-28 11:32:17,"Delapan unit ruko di Jalan Condet Raya hangus terbakar. Salah satu warga, Andhi Nomash (37) mengaku kehilangan empat unit ruko miliknya akibat kebakaran ini. https://t.co/yZ21poPYp1",8,0,1,0,2022-01-28,11,Friday,5,9,0
1487025376517890048,2022-01-28 11:30:52,Brad Pitt dikabarkan tengah berkencan dengan penyanyi Lykke Li yang merupakan fans dari Angelina Jolie. #BradPitt  https://t.co/UZtOO3dMaq,3,1,2,1,2022-01-28,11,Friday,5,5,2
1487024785792110594,2022-01-28 11:28:31,Luhut Pandjaitan mengatakan Indonesia akan konsisten memerangi perubahan iklim dan deforestasi alias penggundulan hutan.  https://t.co/QI9nXojSWx,15,5,2,2,2022-01-28,11,Friday,5,17,7
1487024155530829827,2022-01-28 11:26:00,"Satuan Tugas Penanganan Hak Tagih Negara Dana Bantuan Likuiditas Bank Indonesia (Satgas BLBI) menyita aset obligor BLBI, Santoso Sumali.  https://t.co/cKxiB5e68q",8,0,2,0,2022-01-28,11,Friday,5,10,0
1487024134529990660,2022-01-28 11:25:55,KPK menerima banyak dokumen dari Pengadilan Negeri Surabaya (PN) terkait berkas perkara yang diadili oleh Itong Isnaeni. https://t.co/Djt8NdOMxq,2,1,1,0,2022-01-28,11,Friday,5,3,1
1487023859450658816,2022-01-28 11:24:50,Indonesia mulai memberi perhatian terhadap pajak berbasis gender. Tujuan pajak gender ini adalah untuk memberikan insentif terhadap wanita.  https://t.co/zOGsl7Bo45,6,0,3,1,2022-01-28,11,Friday,5,9,1
1487023846905585665,2022-01-28 11:24:47,Para pembuat dan penerbit game semakin berkembang seiring bertambahnya para pemain game itu sendiri.  https://t.co/O7IrHKtRtj,5,1,1,0,2022-01-28,11,Friday,5,6,1
1487023578977603587,2022-01-28 11:23:43,Aksi heroik sopir TransJakarta yang menggagalkan upaya bunuh diri seorang wanita dari flyover Jakarta Barat viral di media sosial. Sopir bernama Khaerun itu akan mendapat apresiasi atas aksinya. https://t.co/lDBKHkBafR,13,0,3,0,2022-01-28,11,Friday,5,16,0
1487023278879166464,2022-01-28 11:22:31,Kementerian Pekerjaan Umum dan Perumahan Rakyat (PUPR) terus mendorong penyelesaian pembangunan Jalan Tol Semarang-Demak.  https://t.co/N0qwJiArJL,4,0,2,0,2022-01-28,11,Friday,5,6,0
1487022975756943363,2022-01-28 11:21:19,"Masyarakat adat Dayak menuntut Edy Mulyadi untuk datang ke Kalimantan dan membayar denda sesuai ketentuan adat. Kuasa hukum menyatakan Edy siap datang, namun ia khawatir terkait masalah keamanan. https://t.co/GGfF3Vf7zE",6,6,4,2,2022-01-28,11,Friday,5,10,8
1487022958812012544,2022-01-28 11:21:15,Bagaimana ramalan shio tikus di tahun 2022 yang merupakan tahun macan air? Apakah shio tikus akan beruntung? Berikut prediksi nasib shio tikus di 2022:  https://t.co/mGLPtmTqVc,1,0,1,0,2022-01-28,11,Friday,5,2,0
1487022379998097410,2022-01-28 11:18:57,"Nama Basuki Tjahaja Purnama alias Ahok diusung PDIP sebagai Kepala Otorita Ibu Kota Negara (IKN). Menanggapi hal tersebut, Partai Keadilan Sejahtera (PKS) berharap pemilihan pemimpin IKN tidak sampai membuat kegaduhan politik. https://t.co/YSS21vcE4S",8,11,1,0,2022-01-28,11,Friday,5,9,11
1487021716039770115,2022-01-28 11:16:19,"Sudah divaksin booster, masih berisiko terpapar? Memang masih bisa, tapi bukan berarti vaksin tak bermanfaat. Begini penjelasan pakar: https://t.co/mxyqU1kvTK",7,0,4,0,2022-01-28,11,Friday,5,11,0
1487021698528559106,2022-01-28 11:16:15,Satuan Tugas Bantuan Likuiditas Bank Indonesia (Satgas BLBI) meminta anggaran operasional kepada Menteri Keuangan Sri Mulyani Indrawati. Buat apa ya?  https://t.co/O4XxzKGXWB,3,0,1,0,2022-01-28,11,Friday,5,4,0
1487021293199409164,2022-01-28 11:14:38,"Di kelas medium SUV, Almaz dan CR-V tengah mendominasi pasar Indonesia. Tak mau kalah, Chery Motor Indonesia mencoba mengganggu dengan membawa Tiggo 7 Pro! https://t.co/vKFgxUS3Tm",2,0,0,0,2022-01-28,11,Friday,5,2,0
1487021017625247748,2022-01-28 11:13:32,Selis mengajak Sahabat Selis untuk #MainSepedaLagi dengan menggunakan sepeda listrik! https://t.co/mtPFPyRegJ,4,0,1,1,2022-01-28,11,Friday,5,5,1
1487020712153997313,2022-01-28 11:12:19,"Shin Tae-yong sangat kecewa dengan penampilan Timnas saat melawan Timor Leste. Menurutnya, Garuda akan kesulitan menjadi tim kuat di level Asia Tenggara! https://t.co/wS3tUrKIBk",7,0,1,0,2022-01-28,11,Friday,5,8,0
1487020690729541634,2022-01-28 11:12:14,Kementerian Pekerjaan Umum dan Perumahan Rakyat (PUPR) terus mendorong penyelesaian pembangunan Jalan Tol Semarang-Demak.  https://t.co/N0qwJiS38l,3,0,1,1,2022-01-28,11,Friday,5,4,1
1487020355302608899,2022-01-28 11:10:54,Pedagang pasar mengaku mengalami kerugian imbas dari adanya kebijakan harga minyak goreng satu harga Rp 14 ribu per liter.  https://t.co/sizvp6t44M,2,0,1,1,2022-01-28,11,Friday,5,3,1
1487020348658884612,2022-01-28 11:10:53,Australia mengalami hari paling mematikan karena COVID-19 Omicron. Vaksinasi booster diperluas untuk usia 16 dan 17 tahun. Begini kondisi terkini di sana: https://t.co/nwZ7J6S9fA,5,0,2,0,2022-01-28,11,Friday,5,7,0
1487020011533344775,2022-01-28 11:09:32,Danilla Riyadi berencana merilis album terbarunya. Album itu akan berkisah soal keluarga. https://t.co/3sdISJ8jHi,5,0,2,0,2022-01-28,11,Friday,5,7,0
1487019697908461568,2022-01-28 11:08:18,Stasiun Pasar Senen ramai jelang libur Imlek. Tanggal 31 Januari yang merupakan 'Hari Kejepit Nasional' dimanfaatkan warga untuk cuti agar liburan lebih lama!  https://t.co/22483aljs9,3,1,1,0,2022-01-28,11,Friday,5,4,1
1487019680464265221,2022-01-28 11:08:13,Dekorasi pernikahan yang satu ini mencuri perhatian netizen karena menampilkan dekorasi keluarga Cendana yang terinspirasi dari suasana Taman Sari Yogyakarta. Area ballroom hotel pun berhasil disulap jadi Taman Sari. https://t.co/rSj8ZUf9ET,5,0,1,0,2022-01-28,11,Friday,5,6,0
1487019339333185546,2022-01-28 11:06:52,"Faktor psikis juga berhubungan erat dengan kesehatan jantung lho. Nah, e-Life malam ini bakal mengangkat judul ""Patah Hati Picu Penyakit Jantung?"" yang bisa kalian tonton pukul  19.00 WIB LIVE hanya di detikcom. Jangan ketinggalan ya! https://t.co/0ZGxAIkvFb",4,0,3,0,2022-01-28,11,Friday,5,7,0
1487019318546243591,2022-01-28 11:06:47,Nagita Slavina kembali jadi sorotan usai kedapatan mengenakan topi 'bolong' seharga motor. Ini penampilannya:  https://t.co/M0711MaSdi,7,0,1,0,2022-01-28,11,Friday,5,8,0
1487018427843817481,2022-01-28 11:03:15,#FOTO Hong Kong memangkas masa karantina bagi pelancong dari luar negeri. Awalnya masa karantina yang diwajibkan adalah 21 hari namun dipangkas menjadi 14 hari. https://t.co/j72FL5F0J6,3,0,3,0,2022-01-28,11,Friday,5,6,0
1487018411116961795,2022-01-28 11:03:11,Bandara Halim Perdanakusuma di Jakarta ditutup sementara untuk direvitalisasi. Pembangunan bandara tersebut akan memakai dana APBN.  https://t.co/yXWvi7hU7J,4,0,1,1,2022-01-28,11,Friday,5,5,1
1487018185887002629,2022-01-28 11:02:17,Vaksinasi COVID-19 di Afrika masih sangat rendah. Hal itu menjadi ancaman dunia. Akhirnya negara G20 pun turun tangan.   https://t.co/nGAEVnjat4,3,0,2,0,2022-01-28,11,Friday,5,5,0
1487017860937494535,2022-01-28 11:01:00,Praveen Jordan/Melati Daeva Oktavianti dicoret dari Pelatnas PBSI tahun 2022. Apa alasan pasangan ganda campuran itu dicoret? https://t.co/9Ed6N7hd3c,3,1,0,0,2022-01-28,11,Friday,5,3,1
1487017859284930560,2022-01-28 11:00:59,Kapal yang akan dilelang yaitu kapal eks KRI Teluk Mandar-514 dan kapal KRI Teluk Penyu-513 yang dibeli pada tahun 1979.  https://t.co/OwfznDDZq6,3,1,1,1,2022-01-28,11,Friday,5,4,2
1487017806440845315,2022-01-28 11:00:47,Video seorang pria dibonceng motor mengejar mobil di Pasar Rebo viral. Pria itu berpura-pura kakinya terlindas mobil dan menuntut pertanggungjawaban. https://t.co/34JDDZqIys,23,3,18,5,2022-01-28,11,Friday,5,41,8
1487017491159293957,2022-01-28 10:59:31,"Peran kaca spion tengah sangat penting, tetapi keberadaan spion tengah ini sering diabaikan oleh pengendara mobil! https://t.co/iy3hcW5GMm",5,0,1,0,2022-01-28,10,Friday,5,6,0
1487017236078411777,2022-01-28 10:58:31,"Bank Indonesia (BI) mencatat pada data transaksi 24-27 Januari 2022 nonresiden di pasar keuangan domestik jual neto Rp 5,34 triliun.  https://t.co/og4Kk3k9Tn",1,1,4,0,2022-01-28,10,Friday,5,5,1
1487017227090022401,2022-01-28 10:58:29,Kemenkes Malaysia akan melarang penjualan rokok untuk warga yang lahir tahun 2005 ke atas. Ini dilakukan sebagai langkah pengendalian tembakau. https://t.co/ysMadpwsPf,7,0,4,1,2022-01-28,10,Friday,5,11,1
1487016907836383232,2022-01-28 10:57:12,"Anggota Komisi III DPR, Habiburokhman, mengutuk tindakan oknum polisi yang memperkosa mahasiswi Universitas Lambung Mangkurat (ULM) di Banjarmasin, Kalimantan Selatan (Kalsel). Dirinya meminta agar pelaku dihukum berat. https://t.co/h5Q3ZAgiWb",6,0,1,0,2022-01-28,10,Friday,5,7,0
1487016891029893122,2022-01-28 10:57:08,Negara G20 belum kompak dalam menyikapi transisi energi. Bagaimana sikap Jokowi?  https://t.co/1iXayd1gCN,4,0,1,0,2022-01-28,10,Friday,5,5,0
1487015866306908163,2022-01-28 10:53:04,Aliando Syarief menceritakan bagaimana efek karena penyakit OCD yang dia idap. Aliando mengatakan kerap mendengar bisikan dan ilusi aneh. https://t.co/DSOG72mx9x,13,1,1,1,2022-01-28,10,Friday,5,14,2
1487015851031244802,2022-01-28 10:53:00,Fakta di lapangan sebetulnya minyak goreng dengan harga murah belum tersedia secara merata. Kok bisa?  https://t.co/T4eIllZrm7,14,9,8,7,2022-01-28,10,Friday,5,22,16
1487015513582669828,2022-01-28 10:51:40,"Industri esports tidak bercokol pada pembuat game dan pemainnya saja. Dengan modifikasi dan kreatifitas, seseorang dapat memperoleh keuntungan di sektor ini.  https://t.co/GWWPbctDjv",4,0,1,0,2022-01-28,10,Friday,5,5,0
1487015498508349443,2022-01-28 10:51:36,Penyidik KPK menggeledah kantor Bupati Langkat nonaktif Terbit Rencana Perangin Angin. Apa saja yang didapat dari lokasi itu? https://t.co/iPx6VY8nbX,4,1,1,0,2022-01-28,10,Friday,5,5,1
1487015199425155078,2022-01-28 10:50:25,"Berikut ini jumlah kursi tersedia dan tingkat keketatan program studi rumpun soshum di Unair untuk tahun 2022, mulai jalur SNMPTN sampai Mandiri.

via: detikedu  https://t.co/E3945fOiZY",5,0,0,0,2022-01-28,10,Friday,5,5,0
1487015170354331652,2022-01-28 10:50:18,"Tidak banyak memiliki kesempatan bermain, Georginio Wijnaldum dirumorkan mau direkrut Arsenal. https://t.co/RWbFtIuyiS",4,0,0,0,2022-01-28,10,Friday,5,4,0
1487014679067168774,2022-01-28 10:48:21,Khaerun seorang sopir TransJakarta berhasil menyelamatkan percobaan bunuh diri yang hendak dilakukan oleh seorang wanita di flyover Jakarta Barat. Berapa ya kira-kira penghasilan dari supir TransJakarta?  https://t.co/J00L2MXaIS,33,26,9,11,2022-01-28,10,Friday,5,42,37
1487014615942934528,2022-01-28 10:48:06,"Petani milenial membudidayakan tanaman hias di Green House, Kabupaten Ciamis. Tanaman hias itu diekspor hingga negeri K-Pop dengan omset Rp 15 juta per bulan.  https://t.co/YgY068gY0j",13,1,3,0,2022-01-28,10,Friday,5,16,1
1487014272391688194,2022-01-28 10:46:44,Akurnya hubungan Menteri Pertahanan Prabowo Subianto dan Menteri Keuangan Sri Mulyani Indrawati terungkap saat menghadiri rapat kerja di Komisi I DPR.  https://t.co/iuhkmzXOJg,2,1,2,1,2022-01-28,10,Friday,5,4,2
1487013456507289603,2022-01-28 10:43:30,Jokowi memaparkan perkembangan lonjakan kasus Covid varian Omicron di Tanah Air. Simak pernyataan lengkapnya berikut ini: https://t.co/fKMd5T47yd,1,2,0,0,2022-01-28,10,Friday,5,1,2
1487013196745646082,2022-01-28 10:42:28,Harga emas pada 2021 tercatat naik turun. Sempat menyentuh ke level terendah namun akhirnya kembali ke level di atas Rp 900 ribuan.  https://t.co/ZWKC0jlHkv,7,0,5,0,2022-01-28,10,Friday,5,12,0
1487013179414695941,2022-01-28 10:42:23,"Investor aset kripto ketar-ketir. Sejak memasuki 2022, Bitcoin cs masuk fase bearish alias jatuh berdarah-darah!  https://t.co/p5XikV5VU7",6,1,3,0,2022-01-28,10,Friday,5,9,1
1487013164612997128,2022-01-28 10:42:20,Presiden RI Joko Widodo (Jokowi) menyampaikan agar pasien Omicron yang bergejala ringan isolasi mandiri. Tujuannya agar fasilitas kesehatan tidak terbebani. https://t.co/s3Et2ZNZSh,25,5,6,0,2022-01-28,10,Friday,5,31,5
1487012231623712781,2022-01-28 10:38:38,Utang PT Lapindo Minarak Jaya (LMJ) per 31 Desember 2020 mencapai Rp 2 triliun lebih atau tepatnya Rp 2.233.941.033.474!  https://t.co/4I5uSlMUP7,29,9,6,2,2022-01-28,10,Friday,5,35,11
1487012216499023875,2022-01-28 10:38:34,"Sebanyak 8 ruko di Jalan Condet Raya, Kramat Jati, Jakarta Timur (Jaktim) terbakar. Kebakaran diduga akibat terjadinya gas bocor. https://t.co/a616SSp8Ob",3,0,2,0,2022-01-28,10,Friday,5,5,0
1487011597746847748,2022-01-28 10:36:06,Plt Wali Kota Bandung Yana Mulyana menyayangkan aksi anarkis yang dilakukan ormas GMBI saat melakukan aksi unjuk rasa di Mapolda Jabar. https://t.co/D0mJFA73zx,3,5,0,1,2022-01-28,10,Friday,5,3,6
1487011213347368965,2022-01-28 10:34:35,Mahasiswa semester 4-6 bisa siap-siap syarat dan dokumen untuk ikut IISMA 2022 dari sekarang. Berikut jadwal dan syarat pendaftaran IISMA 2022 selengkapnya. https://t.co/0Levj3mPtW,16,2,3,1,2022-01-28,10,Friday,5,19,3
1487010964247650308,2022-01-28 10:33:35,"Liverpool bakal mendapatkan pemain baru di bursa transfer Januari ini, setelah menyalip Tottenham Hotspur untuk menggaet Luis Diaz dari FC Porto! https://t.co/HtRIhj5twq",2,0,0,0,2022-01-28,10,Friday,5,2,0
1487010941925478408,2022-01-28 10:33:30,Presiden Joko Widodo (Jokowi) memprediksi kasus COVID-19 bakal terus meningkat dalam beberapa pekan ke depan. https://t.co/9cKabus74F,7,4,4,0,2022-01-28,10,Friday,5,11,4
1487010940247842816,2022-01-28 10:33:30,Partai Golkar telah memutuskan Airlangga Hartarto sebagai calon presiden pada Pilpres 2024 sebagaimana hasil Munas yang disepakati. https://t.co/5YFDE55P1j,4,3,0,1,2022-01-28,10,Friday,5,4,4
1487010898183180290,2022-01-28 10:33:20,"Industri aset kripto semakin lama semakin tumbuh di Indonesia. Akibatnya, banyak pelaku penipuan yang mulai menggunakan kedok kripto dalam menjalankan aksinya.  https://t.co/6bIHZ0aBjj",3,0,1,0,2022-01-28,10,Friday,5,4,0
1487010528568520715,2022-01-28 10:31:51,Persik Kediri secara mengejutkan mengalahkan Bhayangkara FC pada lanjutan BRI Liga 1 2021 dengan skor 1-0 lewat gol Youssef Ezzejjari. https://t.co/octBSRT4h2,2,0,1,0,2022-01-28,10,Friday,5,3,0
1487009648272187398,2022-01-28 10:28:22,Persik Kediri secara mengejutkan mengalahkan Bhayangkara FC pada lanjutan BRI Liga 1 2021. Tim asuhan Javier Rocha menang 1-0 lewat gol Youssef Ezzejjari. https://t.co/kLguZq6Pa4,5,0,1,0,2022-01-28,10,Friday,5,6,0
1487009646057562114,2022-01-28 10:28:21,Presiden Joko Widodo (Jokowi) menyatakan lonjakan kasus COVID-19 akan terus meningkat. Jokowi mengimbau masyarakat untuk tetap tenang dan tidak panik. https://t.co/ptzNJK7LqM,9,0,3,1,2022-01-28,10,Friday,5,12,1
1487009108385579011,2022-01-28 10:26:13,Kebijakan minyak goreng satu harga Rp 14 ribu per liter membuat para pedagang sembako pusing. Kenapa?  https://t.co/X279TLGgvW,9,0,3,0,2022-01-28,10,Friday,5,12,0
1487009089322430467,2022-01-28 10:26:08,Road show artefak Nabi Muhammad SAW digelar di Sumatera Utara (Sumut). Ada serban hingga rambut Nabi Muhammad SAW yang dipamerkan dalam acara itu. https://t.co/IOP979Ojui,24,0,8,1,2022-01-28,10,Friday,5,32,1
1487008095280812034,2022-01-28 10:22:11,Ketua Umum GMBI M Fauzan ditetapkan polisi sebagai tersangka berkaitan demo berujung anarkis di depan Mapolda Jabar. https://t.co/qAlSBR8sM8,13,4,4,2,2022-01-28,10,Friday,5,17,6
1487007719311687687,2022-01-28 10:20:42,Jokowi mengatakan penting jika pasien gejala ringan tidak dirawat di rumah sakit. Harapannya agar rumah sakit bisa fokus ke pasien dengan gejala berat. https://t.co/9Z3lDWYO87,12,0,5,3,2022-01-28,10,Friday,5,17,3
1487007716564680706,2022-01-28 10:20:41,Pemerintah melaporkan kasus harian positif Corona hari ini sebanyak 9.905 kasus. Provinsi melaporkan kasus tertinggi dalam 24 jam terakhir adalah Provinsi DKI https://t.co/IVZlRSD8Oh,8,1,1,0,2022-01-28,10,Friday,5,9,1
1487007169228722180,2022-01-28 10:18:31,Lowongan jadi Calon Pegawai Nagita Slavina (CPNS) di Badan Usaha Milih Nagita (BUMN) yang dibuka Raffi Ahmad masih tersedia!  https://t.co/RvHjiG2Ars,88,16,17,10,2022-01-28,10,Friday,5,105,26
1487006201904783364,2022-01-28 10:14:40,"Presiden Jokowi mengimbau pasien bergejala ringan untuk menjalani isolasi mandiri. Menurutnya, kasus Omicron bakal terus meningkat. https://t.co/yuhVi2RuFX",8,15,1,1,2022-01-28,10,Friday,5,9,16
1487005613058146304,2022-01-28 10:12:20,Jokowi mengatakan masyarakat yang terpapar Omicron tanpa gejala untuk melakukan isolasi mandiri selama 5 hari. https://t.co/LTDfC1IG2n,17,0,2,0,2022-01-28,10,Friday,5,19,0
1487005392529932290,2022-01-28 10:11:27,"Federasi Serikat Guru Indonesia (FSGI) mengkritisi sejumlah hal dalam penerapan kurikulum prototipe sebagai kurikulum opsional. Berikut sejumlah poinnya.

via: detikedu  https://t.co/uzwIyVllCb",4,0,0,0,2022-01-28,10,Friday,5,4,0
1487004511361187842,2022-01-28 10:07:57,Rem blong menjadi salah satu penyebab kecelakaan yang paling sering dialami kendaraan besar seperti truk dan bus. Seperti initeknik melewati jalanan menurun! https://t.co/p7CsoDomTO,12,0,0,0,2022-01-28,10,Friday,5,12,0
1487004169479278593,2022-01-28 10:06:35,"""...sampai Pak Edy itu ada dua nomor HP-nya dimatikan. Nggak berani, setiap hari yang telepon dia ada 1.000 orang Pak. Coba bayangkan saja,"" ujar pengacara Edy. https://t.co/W3pkWaJVBt",449,653,68,129,2022-01-28,10,Friday,5,517,782
1487003780856094722,2022-01-28 10:05:03,Badan regulator obat-obatan Inggris mengungkap vaksin AstraZeneca dikaitkan dengan efek samping mielitis transversa. Sudah ada di Indonesia? https://t.co/JDyxmSph2a,16,8,4,1,2022-01-28,10,Friday,5,20,9
1487002698763444224,2022-01-28 10:00:45,"Ketua Kuasa Hukum Edy Mulyadi, Herman Kadir, telah menyerahkan surat penundaan pemeriksaan kliennya ke penyidik Bareskrim. Ia memastikan Edy tak akan kabur dan siap hadapi jadwal pemanggilan kedua. https://t.co/lITESQfrVJ",4,11,1,0,2022-01-28,10,Friday,5,5,11
1487001427776004098,2022-01-28 09:55:42,Polisi jelaskan lagi fakta terkait tewasnya DJ Indah Cleo dan Rockvolution akibat bentrok di Sorong:  https://t.co/w9UFJp0JDI,4,0,2,0,2022-01-28,9,Friday,5,6,0
1487001257587974144,2022-01-28 09:55:01,"Indonesia mencatat sebanyak 9.905 kasus baru COVID-19, Jumat (28/1/2022). DKI menyumbang kasus terbanyak dengan jumlah 4.558 kasus. https://t.co/DJ1PThMSOY",4,1,3,3,2022-01-28,9,Friday,5,7,4
1487001169650143234,2022-01-28 09:54:40,"Indonesia menang atas Timor Leste dengan skor 4-1 pada leg 1 ajang FIFA Matchday di Stadion I Wayan Dipta, Gianyar Bali. Beginilah aksi dan selebrasi mereka! https://t.co/1cETFzrBt3",10,0,3,0,2022-01-28,9,Friday,5,13,0
1487000795472175104,2022-01-28 09:53:11,"Insiden truk mengalami rem blong, khususnya di jalanan menurun, melibatkan banyak faktor, salah satunya adalah modifikasi dengan memasang klakson telolet. https://t.co/QwgLB8bHQf",7,0,1,2,2022-01-28,9,Friday,5,8,2
1487000775318458373,2022-01-28 09:53:06,"Persegi panjang termasuk salah satu segi empat yang memiliki sifat-sifatnya tersendiri. Seperti apa sifatnya? Simak penjelasan berikut ini.

via: detikedu  https://t.co/EL968YeR69",0,0,0,0,2022-01-28,9,Friday,5,0,0
1487000100769574915,2022-01-28 09:50:25,"Sepeda motor TVS kurang dapat tempat di pasar roda dua dalam negeri. Berbeda dengan pangsa pasar ekspor, angkanya terbilang memuaskan! https://t.co/qc2tBRAmvB",8,0,2,0,2022-01-28,9,Friday,5,10,0
1486999551005319169,2022-01-28 09:48:14,All of Us Are Dead mengangkat isu-isu yang terjadi pada remaja. Ini alasan sutradara menggabungkannya dengan genre horor zombie:  https://t.co/GEV4p1fKZq,16,0,1,0,2022-01-28,9,Friday,5,17,0
1486999532852416518,2022-01-28 09:48:10,Wisata Pantai Surabaya akan dihidupkan kembali dengan konsep baru. Warga Surabaya menyambut baik hal ini. https://t.co/jqqwIxC50S,7,0,2,0,2022-01-28,9,Friday,5,9,0
1486999203532394497,2022-01-28 09:46:51,"Lembaga Penerbangan dan Antariksa Nasional (LAPAN) mengumumkan adanya fenomena matahari terbenam lebih lambat di Jawa, Bali, dan Nusa Tenggara. Ini jadwalnya.

via: detikedu  https://t.co/TYFUcilWBS",13,0,3,2,2022-01-28,9,Friday,5,16,2
1486997620048515080,2022-01-28 09:40:34,"Jumlah kasus COVID-19 bertambah 9.905 kasus pada Jumat (28/1/2022), sehingga total menjadi 4.319.175. Pasien sembuh bertambah 2.028, meninggal 7. https://t.co/BXTzwHQfk5",6,2,1,0,2022-01-28,9,Friday,5,7,2
1486997588700274688,2022-01-28 09:40:26,Gambia menjadi kejutan besar di gelaran Piala Afrika 2021. Sengatannya mengantar The Scorpions bisa maju sampai perempatfinal! https://t.co/mLroADXHrd,4,0,1,0,2022-01-28,9,Friday,5,5,0
1486997296256622602,2022-01-28 09:39:17,"Omicron memicu gejala lebih ringan dibanding varian Corona lain, bahkan mirip flu biasa. Omicron merebak, akankah COVID-19 jadi penyakit 'biasa' layaknya flu? https://t.co/MWH5SoKQ5A",20,8,8,7,2022-01-28,9,Friday,5,28,15
1486995990217330690,2022-01-28 09:34:05,"@duri_riko kalau ada fotonya, boleh banget kirim ke https://t.co/0Chp2xqlGK. jangan lupa sertakan deskripsi dan lokasinya yaa.",1,3,0,0,2022-01-28,9,Friday,5,1,3
1486995683181744133,2022-01-28 09:32:52,Menpolhukam Mahfud Md sebut tak ada unsur SARA di bentrokan Maluku dan Sorong. Ini ungkapannya. https://t.co/pHFyUNECdB,5,1,0,0,2022-01-28,9,Friday,5,5,1
1486994526309072899,2022-01-28 09:28:16,"Matahari akan terbenam lebih lambat mulai 26 Januari hingga 1 Februari 2022. Simak jadwalnya di Jatim, yuk! https://t.co/6FNxYMq4AF",8,2,5,0,2022-01-28,9,Friday,5,13,2
1486993911210024960,2022-01-28 09:25:50,"Awal 2022 Falcon Pictures mempersiapkan film terbaru. Falcon me-remake film box office Italia, Perfect Strangers dan merilis para pemainnya. https://t.co/fsDb9fir9D",8,1,3,1,2022-01-28,9,Friday,5,11,2
1486993564286529536,2022-01-28 09:24:27,DBS Group Holdings Ltd. sepakat untuk membeli aset untuk segmen consumer banking Citigroup Inc. di Taiwan.  https://t.co/dWjAMjLU0Y,5,0,1,1,2022-01-28,9,Friday,5,6,1
1486992622426243078,2022-01-28 09:20:42,"Pasangan beda negara ini menceritakan bagaimana keduanya bertemuda dan bisa saling jatuh cinta. Seperti apa kisahnya? Simak selengkapnya di sini, ya. #detiknstwork  https://t.co/EJrgJAVx4o",8,0,1,1,2022-01-28,9,Friday,5,9,1
1486992603975405572,2022-01-28 09:20:38,"Penjelasan polisi soal DJ Indah Cleo dan Rockvolution yang termasuk dalam 17 korban kebakaran di Sorong, Papua Barat. Ini penyebab korban terjebak:  https://t.co/bO3AWchR4i",1,0,0,0,2022-01-28,9,Friday,5,1,0
1486992040122535937,2022-01-28 09:18:23,Alvaro Morata rupanya belum menyerah untuk bergabung dengan Barcelona dan masih mengupayakan agar Atletico Madrid dan Juventus mengizinkannya! https://t.co/Nz5SnQUQak,4,1,0,0,2022-01-28,9,Friday,5,4,1
1486991689948532736,2022-01-28 09:17:00,Aksi demonstrasi ormas GMBI yang berakhir ricuh di Mapolda Jabar disesalkan Anton Charliyan. Begini responsnya. https://t.co/3ERTad7B3E,7,1,0,0,2022-01-28,9,Friday,5,7,1
1486991109565915137,2022-01-28 09:14:42,Mobil bekas masih menjadi pilihan masyarakat Indonesia. OLX Autos menggelar survei Review pasar Mobil Bekas 2021 dan Outlook 2022! https://t.co/IHRNIRT4PA,1,1,0,0,2022-01-28,9,Friday,5,1,1
1486990566797762560,2022-01-28 09:12:32,Polisi ungkap fakta terkait aksi demo ricuh ormas GMBI di depan Mapolda Jabar. Massa yang ikut dalam aksi tersebut menerima bayaran Rp 20-Rp 50 ribu. https://t.co/9DAvyZue26,23,10,2,5,2022-01-28,9,Friday,5,25,15
1486989949589200899,2022-01-28 09:10:05,"Meski menang 4-1, Pratama Arhan mengakui penampilan Timnas Indonesia mengecewakan saat jumpa Timor Leste. https://t.co/UetSfv0NLj",12,2,2,0,2022-01-28,9,Friday,5,14,2
1486989594885332993,2022-01-28 09:08:41,"Anggota Komisi IX DPR Fraksi PKS, Kurniasih Mufidayati, meminta Kementerian Kesehatan (Kemenkes) segera sediakan vaksin booster halal. Hal tersebut agar tak menjadi polemik berkepanjangan di masyarakat. https://t.co/VU9jmSWXWj",5,1,0,0,2022-01-28,9,Friday,5,5,1
1486989193108729858,2022-01-28 09:07:05,Pemprov DKI menyiapkan 341 tempat uji emisi di seluruh wilayah kota. Saat ini hanya 39 tempat di antaranya melayani uji emisi sepeda motor. https://t.co/HQic5L5U0q,1,0,1,0,2022-01-28,9,Friday,5,2,0
1486988412506750985,2022-01-28 09:03:59,Vicky Prasetyo ngaku tak bisa menghalangi takdir Tuhan soal nasib pernikahan. Vicky berseloroh tak mungkin setiap tahun ada berita pernikahannya. https://t.co/iSsHApxdJF,6,0,0,0,2022-01-28,9,Friday,5,6,0
1486987782534877187,2022-01-28 09:01:28,Kemenkes RI mengeluarkan sertifikat vaksin COVID-19 internasional sesuai standar WHO. Ini untuk mengantisipasi isu sertifikat RI yang tidak dikenal negara lain. https://t.co/7Noj0BJVG6,8,0,2,0,2022-01-28,9,Friday,5,10,0
1486986920257335297,2022-01-28 08:58:03,"Detikers sedang menimbang jurusan kuliah saintek yang santai? Nah, ada baiknya cek dulu daftar jurusan rendah stres dengan potensi karier menjanjikan berikut.

via: detikedu  https://t.co/k3oC0km1gz",3,0,0,0,2022-01-28,8,Friday,5,3,0
1486986604073869314,2022-01-28 08:56:47,Ghost Doctor drama Korea terbaru 2022 yang dibintangi oleh sederet bintang top. Penasaran tentang Ghost Doctor? Ini sinopsis dan pemain Ghost Doctor. https://t.co/N3jSXGQWGN,10,0,1,0,2022-01-28,8,Friday,5,11,0
1486986340633919488,2022-01-28 08:55:45,"Rektor Universitas Airlangga beberkan daya tampung dan keketatan di kampusnya untuk jalur SNMPTN, SBMPTN, dan jalur Mandiri 2022. Simak di sini ya.

via: detikedu  https://t.co/neGSsOYQY4",7,0,0,0,2022-01-28,8,Friday,5,7,0
1486986319410700289,2022-01-28 08:55:40,"WHO kembali membuat heboh. Kali ini bukan terkait laporan COVID-19 ataupun soal varian Omicron, melainkan adanya kasus rasisme. https://t.co/BoOkoBp1Je",5,0,0,0,2022-01-28,8,Friday,5,5,0
1486985169412239360,2022-01-28 08:51:05,"PP PBSI memanggil 88 atlet untuk mengikuti pelatihan nasional (pelatnas) bulutangkis 2022, terdapat atlet lama dan ditambah atlet baru yang lolos jalur seleksi. https://t.co/bK28Hj2RHT",5,0,1,0,2022-01-28,8,Friday,5,6,0
1486985002974085123,2022-01-28 08:50:26,"@antania_p Boleh banget nih ceritanya dishare ke https://t.co/0Chp2xIuUS. Informasi ter-update yang kamu miliki, berharga banget untuk para pembaca.

Jangan lupa sertakan foto atau video yaa jika ada.",0,0,0,0,2022-01-28,8,Friday,5,0,0
1486984631501086722,2022-01-28 08:48:57,"Matahari bakal terbenam lebih lambat di sejumlah wilayah di Indonesia, termasuk di Jawa Barat yang berlangsung dari tanggal 25-31 Januari. Ini titik pengamatannya.  https://t.co/JvixHVMQIP",7,1,2,1,2022-01-28,8,Friday,5,9,2
1486983192250826755,2022-01-28 08:43:14,Siap-siap! Menteri Kesehatan RI meminta masyarakat waspada kenaikan kasus di gelombang ketiga COVID-19. Ia membeberkan ciri-ciri varian Omicron. https://t.co/8ixnSx985N,6,3,3,2,2022-01-28,8,Friday,5,9,5
1486982588623466500,2022-01-28 08:40:50,"Anda pastinya tetap ingin menikmati lezatnya snack rumput laut tanpa perlu khawatir dengan kesehatan tubuh, bukan?  https://t.co/2QpT4AhpyU",4,0,1,0,2022-01-28,8,Friday,5,5,0
1486982059667111938,2022-01-28 08:38:44,Alasan komorbid memperparah COVID-19 karena orang dengan penyakit penyerta memiliki sistem kekebalan tubuh yang lebih lemah daripada mereka yang tidak. https://t.co/jfpi0TKlPi,5,1,1,3,2022-01-28,8,Friday,5,6,4
1486981283398008833,2022-01-28 08:35:39,Kabid Humas Polda Papua Barat Kombes Pol Adam Erwin menyebut hingga sekarang jenazah DJ Indah Cleo belum dibawa pulang keluarganya. https://t.co/cJcN9lYByD,4,0,0,0,2022-01-28,8,Friday,5,4,0
1486980730936827910,2022-01-28 08:33:27,"Dudung mengatakan tak memiliki wewenang soal pengejaran KKB. Lalu, apa saja wewenang KSAD? https://t.co/PQ32QcEDRD",45,85,5,7,2022-01-28,8,Friday,5,50,92
1486980350316322818,2022-01-28 08:31:56,"Storyboard jika diartikan ke dalam bahasa Indonesia yaitu papan cerita. Papan cerita ini dibuat untuk menggambarkan alur cerita dari ide yang dimiliki.

via: detikedu  https://t.co/hulS7JIvfu",3,0,2,1,2022-01-28,8,Friday,5,5,1
1486979627394506758,2022-01-28 08:29:04,"Jeff Bezos menawarkan bonus 'pay to quit' untuk pekerjanya di Amazon. Namun, ia berharap para pekerjanya tetap bersamanya untuk seterusnya. https://t.co/7UbCfRCjk0",5,0,0,1,2022-01-28,8,Friday,5,5,1
1486978821731631106,2022-01-28 08:25:52,Roket Falcon 9 milik SpaceX akan menabrak Bulan setelah menghabiskan tujuh tahun terombang-ambing di luar angkasa.  https://t.co/OpmJZlzQtb,4,1,1,0,2022-01-28,8,Friday,5,5,1
1486978213758881794,2022-01-28 08:23:27,"Kelangkaan chip yang terjadi selama pandemi tentu berdampak pada Intel. Namun, mereka malah mencatatkan rekor pemasukan pada Q4 2021. https://t.co/33Eqy2UWrq",4,0,0,0,2022-01-28,8,Friday,5,4,0
1486977689365983233,2022-01-28 08:21:22,"Franck Kessie lagi laris manis di bursa transfer, sekarang giliran Inter Milan yang coba membajak Kessie dari AC Milan! https://t.co/wKkKL825zs",5,0,1,0,2022-01-28,8,Friday,5,6,0
1486976912673103877,2022-01-28 08:18:17,Kesuksean TikTok akan format video pendek membuat YouTube ikutan mengadopsinya. Kurang dari dua tahun Short mencapai lebih dari 5 triliun penayangan. https://t.co/OQ6y7XE3um,5,0,1,0,2022-01-28,8,Friday,5,6,0
1486976657349136384,2022-01-28 08:17:16,Samsung mengenalkan perangkat smart home terbarunya yaitu kulkas Family Hub. Kulkas ini dilengkapi dengan layar pintar seukuran tablet di bagian depannya. https://t.co/es9hI2InAH,0,1,2,0,2022-01-28,8,Friday,5,2,1
1486975997270544390,2022-01-28 08:14:39,Kini kita dimudahkan untuk men-download MP3 secara legal dari Spotify hingga Joox. Berikut langkah-langkah mudahnya:  https://t.co/Dne9F1XCE6,5,0,1,0,2022-01-28,8,Friday,5,6,0
1486975699235880962,2022-01-28 08:13:28,"Dedik Setiawan nihil gol di laga Indonesia vs Timor Leste. Kapan buka puasa gol buat Timnas Indonesia, Dedik? https://t.co/9RdMncbqpo",3,4,0,0,2022-01-28,8,Friday,5,3,4
1486975677370966017,2022-01-28 08:13:22,"Sebanyak 90 sekolah di Jakarta setop PTM karena COVID-19. Gubernur DKI Jakarta, Anies Baswedan, didesak menghentikan skema PTM 100%. https://t.co/qdSOQu1NYf",7,1,0,0,2022-01-28,8,Friday,5,7,1
1486974908454346755,2022-01-28 08:10:19,Kimberly Ryder bercerita soal kegiatan selama pandemi. Ia ngaku jarang keluar rumah dan jualan ikan mas koki. https://t.co/MFrzLLPC0s,19,4,1,0,2022-01-28,8,Friday,5,20,4
1486974378806063110,2022-01-28 08:08:13,Proses pengusutan kasus dugaan kekerasan seksual yang dialami oleh mahasiswi UNY angkatan 2019 masih terus dilakukan. Berikut sederet fakta terbarunya. https://t.co/Zjx1w4rjFV,8,0,2,0,2022-01-28,8,Friday,5,10,0
1486974104859295747,2022-01-28 08:07:07,DJ Indah Cleo dan Rockvolution tak bisa terselamatkan dari kebakaran di Sorong karena hal ini:  https://t.co/YNFMvHAG0C,11,3,0,0,2022-01-28,8,Friday,5,11,3
1486973750134386690,2022-01-28 08:05:43,"Direktorat Jenderal Bea dan Cukai berikan penjelasan soal Kejati Banten sita Rp 1,16 miliar terkait kasus dugaan korupsi pemerasan atau pungli. https://t.co/94g7bZMTbV",7,0,0,0,2022-01-28,8,Friday,5,7,0
1486972378664079360,2022-01-28 08:00:16,Al Ghazali memberikan isyarat akan segera menikah di tahun ini. Al menyebut saat ini sedang mengupayakan pertemuan kedua keluarga untuk membahas rencana pernikahannya dengan Alyssa Daguise. https://t.co/PyoIMm78Pz,5,0,1,0,2022-01-28,8,Friday,5,6,0
1486972228201758721,2022-01-28 07:59:40,Prabowo Subianto membantu menggeser kursi yang akan diduduki Sri Mulyani Indrawati saat rapat di DPR RI kemarin.  https://t.co/uxfF9hnBJY,65,33,6,7,2022-01-28,7,Friday,5,71,40
1486971582216118273,2022-01-28 07:57:06,"Ronaldo Kwateh dan Marselino Ferdinand mencetak rekor setelah debut di Timnas Indonesia level senior, yaitu menjadi debutan termuda skuad Garuda! https://t.co/mkLvlNCJN7",10,1,1,0,2022-01-28,7,Friday,5,11,1
1486971028156858369,2022-01-28 07:54:54,Hwiyoung dan Chani SF9 dipanggil polisi setelah diduga melanggar peraturan pencegahan COVID-19 di Korea Selatan.  https://t.co/B86s0tkb1T,1,0,0,0,2022-01-28,7,Friday,5,1,0
1486970747226632192,2022-01-28 07:53:47,Pengacara menjamin Edy Mulyadi tidak melarikan diri dan mengikuti proses penyelidikan kasus 'jin buang anak'. https://t.co/pOkgPLEn5v,4,4,1,0,2022-01-28,7,Friday,5,5,4
1486970154663747587,2022-01-28 07:51:26,Gaon Chart Music Awards resmi digelar pada 27 Januari 2022. Berikut daftar lengkap pemenangnya:  https://t.co/XpUsEiXD6N,4,0,0,0,2022-01-28,7,Friday,5,4,0
1486969591255478274,2022-01-28 07:49:11,"Pekan ini komikus sekaligus pencipta Bleach, Tite Kubo pun menjadi perbincangan karena beberapa kicauan yang sekarang sudah dihapusnya. https://t.co/ijgMchzVDW",8,0,0,0,2022-01-28,7,Friday,5,8,0
1486968745943879681,2022-01-28 07:45:50,"Pemprov DKI menambah fasilitas mikrotrans. Kini mikrotrans memiliki AC, CCTV, dan juga pintu otomatis yang membuat penumpang lebih nyaman dengan tari Rp 0. Wah! https://t.co/0pP65amAgK",8,4,2,3,2022-01-28,7,Friday,5,10,7
1486968733662855171,2022-01-28 07:45:47,Resmi! Kemenkes RI menegaskan pasien COVID-19 tanpa gejala dan bergejala ringan termasuk yang terpapar Omicron tak bisa dirawat di rumah sakit. Cek aturannya: https://t.co/93wfJVygfz,4,0,3,1,2022-01-28,7,Friday,5,7,1
1486968064956588034,2022-01-28 07:43:07,Ucie Elfa's Singer orbitkan penyanyi cilik yang mirip Sherina dan Cinta Laura. Seperti ini ceritanya:  https://t.co/p2Wg9bjOda,0,0,0,0,2022-01-28,7,Friday,5,0,0
1486967463002660865,2022-01-28 07:40:44,Squid Game kembali dinominasikan dalam ajang internasional. Kali ini mereka dinominasikan dalam ajang Producers Guild of America Awards. #SquidGame  https://t.co/YkgNMesFWx,1,0,0,0,2022-01-28,7,Friday,5,1,0
1486967452797911042,2022-01-28 07:40:41,Tahukah kamu cara melacak lokasi handphone orang lain? Setidak ada empat cara mudah yang bisa detikers ikuti. Simak di sini:  https://t.co/Y7KuQ4tlMW,16,0,10,0,2022-01-28,7,Friday,5,26,0
1486966785278677005,2022-01-28 07:38:02,Uruguay memetik kemenangan penting atas Paraguay dengan skor 1-0 di Kualifikasi Piala Dunia 2022. Gol itu diciptakan oleh Luis Suarez. https://t.co/jVaOCk7w8P,3,0,0,0,2022-01-28,7,Friday,5,3,0
1486966120452141058,2022-01-28 07:35:24,Agensi DSP Media mengumumkan akhir dari girl group APRIL. APRIL resmi debut pada 24 Agustus 2015 dengan 8 member. Tapi hanya 6 member yang bertahan sampai akhir. https://t.co/Hs3xHvNZg1,3,0,0,0,2022-01-28,7,Friday,5,3,0
1486965582570442756,2022-01-28 07:33:16,"Dalam memeriahkan gelaran MotoGP, BRI telah menyediakan sejumlah promo pembelian tiket nonton di sirkuit! https://t.co/PcBsq7JZdr",2,0,0,0,2022-01-28,7,Friday,5,2,0
1486965233235206144,2022-01-28 07:31:52,"Wanita ini membuat video tutorial makeup 10 lapis mulai dari foundation, concealer hingga lipstik. Ini transformasinya:   https://t.co/hXzw8RNqLI",1,0,0,0,2022-01-28,7,Friday,5,1,0
1486964576717524994,2022-01-28 07:29:16,BTS dinominasikan dalam ajang iHeartRadio Music Awards. Mereka dinominasikan dalam 3 kategori. #BTS  https://t.co/yUZtNvKIQt,7,0,1,0,2022-01-28,7,Friday,5,8,0
1486964554693287943,2022-01-28 07:29:10,"Rafael Nadal menjejak final Australian Open 2022, setelah menang melawan Matteo Berrettini dalam pertarungan empat set! https://t.co/WFoXYXWgYh",4,0,0,0,2022-01-28,7,Friday,5,4,0
1486964029960724483,2022-01-28 07:27:05,"Hino mendirikan fasilitas pelatihan sopir truk di Purwakarta, Jawa Barat. Fasilitas pelatihan ini memiliki materi pengujian yang lengkap dan terstandar! https://t.co/m5SFjxBWV3",7,0,1,0,2022-01-28,7,Friday,5,8,0
1486963787932618760,2022-01-28 07:26:08,Indonesia vs Timor Leste jadi panggung buat para pemain debutan. Berikut kelima punggawa Garuda yang merasakan menit bermain di bawah komando Shin Tae-yong! https://t.co/0bnfddt4sl,2,0,0,0,2022-01-28,7,Friday,5,2,0
1486963772946362368,2022-01-28 07:26:04,"Sergio Ramos berpendapat, Paris St. Germain adalah kandidat terkuat di seluruh kompetisi, tetapi PSG butuh membuktikan anggapan itu! https://t.co/gHrVjRyeZq",0,0,0,0,2022-01-28,7,Friday,5,0,0
1486963001085378561,2022-01-28 07:23:00,"Jadwal Liga 1 hari ini . Terdapat 4 laga, ada Arema FC vs Persipura Jayapura. https://t.co/fiioSTiksI",2,0,0,0,2022-01-28,7,Friday,5,2,0
1486962717709721600,2022-01-28 07:21:52,Astra Honda Motor menjadwalkan peluncuran motor baru Honda pada pekan depan dan diprediksi motor yang akan meluncur dalam waktu dekat itu adalah Honda Vario 160. https://t.co/ZYvqkEsjog,3,1,1,1,2022-01-28,7,Friday,5,4,2
1486961444558049281,2022-01-28 07:16:49,"Juru Bicara Satgas Penanganan COVID-19 Kota Depok, Dadang Wihana menyebut mayoritas temuan 197 kasus berada di jenjang SMA. https://t.co/S7AH2aw0sy",2,1,1,1,2022-01-28,7,Friday,5,3,2
1486961311066071044,2022-01-28 07:16:17,"Jubir Menko Marves Luhut Binsar Pandjaitan, Jodi Mahardi menyebut ada kemungkinan PPKM di Jakarta akan naik menjadi level 3. Hal itu bisa terjadi jika kasus positif Covid-19 terus meningkat. #CNNIndonesia #detiknetwork  https://t.co/zpd1WdSALe",5,6,3,0,2022-01-28,7,Friday,5,8,6
1486961175996866560,2022-01-28 07:15:45,"Alhamdulillah! Rahma (14) warga asal Senen yang hilang sudah ditemukan, Rahma sebelumnya meninggalkan rumah sejak Sabtu, 22 Januari 2022. #detiktif https://t.co/iTaD2s3QZN",4,0,1,0,2022-01-28,7,Friday,5,5,0
1486960598923591682,2022-01-28 07:13:27,Bali United akan melawan Borneo FC pada lanjutan BRI Liga 1 2022. Bali United harus mewaspadai racikan strategi pelatih baru Fakhri Husaini. https://t.co/42aLMUxT8e,1,0,0,0,2022-01-28,7,Friday,5,1,0
1486960041085358080,2022-01-28 07:11:14,Seorang perwira polisi bernama Ipda Uji Mugni menghadang sebuah mobil yang hendak dibawa kabur. Video pengadangan itu beredar di media sosial. https://t.co/AA7ak6LgcX,2,0,0,0,2022-01-28,7,Friday,5,2,0
1486959509717270528,2022-01-28 07:09:08,"Ernesto Valverde buka suara soal kiprahnya di Barcelona, yang disebutnya cukup bagus dan mengalah pada tuntutan besar di Barca. https://t.co/mF4iqvSx8b",6,0,0,0,2022-01-28,7,Friday,5,6,0
1486959258142978049,2022-01-28 07:08:08,Penggemar roti perlu mengenali jenis roti yang sehat dan kurang sehat agar bisa bijak mengonsumsinya. Jenisnya ada roti gandum utuh hingga roti tawar putih.  https://t.co/knyKZPYl0O,13,1,2,0,2022-01-28,7,Friday,5,15,1
1486958092537536514,2022-01-28 07:03:30,"Terdapat bahan-bahan makanan rendah lemak yang dapat menjadi alternatif untuk hidup sehat, seperti ayam probiotik dan sapi grass-feed.  https://t.co/5Fh6dWO9dt",3,0,0,0,2022-01-28,7,Friday,5,3,0
1486957894520418307,2022-01-28 07:02:43,"@nova_fauziah Coba kirim cerita kamu ke https://t.co/0Chp2xIuUS yuk. Informasi ter-update yang kamu miliki, berharga untuk para pembaca lho.

Jangan lupa sertakan foto atau video yaa jika ada.",1,0,0,0,2022-01-28,7,Friday,5,1,0
1486957701049421826,2022-01-28 07:01:56,"@mautahungga Kirim cerita kamu ke https://t.co/0Chp2xqlGK yuk. Informasi ter-update yang kamu miliki, berharga untuk para pembaca lho.

Jangan lupa sertakan foto atau video yaa jika ada.",2,0,0,0,2022-01-28,7,Friday,5,2,0
1486957459336044547,2022-01-28 07:00:59,"Aktris Hong Kong, Christine Ng, ngamuk setelah diberitakan jalani terapi rahim demi bisa punya anak. Ini penjelasannya:  https://t.co/bUo39eETNt",4,0,1,0,2022-01-28,7,Friday,5,5,0
1486956902223429634,2022-01-28 06:58:46,Akhir Januari 2022 akan ada fenomena astronomi menarik. Langit bakal dikunjungi fenomena Bulan Hitam.  https://t.co/u5dPEcyRD4,10,0,0,0,2022-01-28,6,Friday,5,10,0
1486956872330530818,2022-01-28 06:58:39,Ronaldo Kwateh dan Marselino Ferdinan mencuri perhatian saat Indonesia vs Timor Leste dan pilihan nomor punggung mereka juga turut dibahas. https://t.co/3vugdXWlDv,7,0,0,0,2022-01-28,6,Friday,5,7,0
1486956199824310273,2022-01-28 06:55:59,Ronaldo Kwateh dan Marselino Ferdinan mencuri perhatian saat Indonesia vs Timor Leste dan pilihan nomor punggung mereka juga turut dibahas. https://t.co/8qcMvwdCje,2,0,0,0,2022-01-28,6,Friday,5,2,0
1486956183286132739,2022-01-28 06:55:55,"Polisi menyegel Duck Down Bar, Senopati, Jakarta selatan karena melanggar aturan PPKM level 2 DKI Jakarta. Kini, pihak manajemen Duck Down Bar diperiksa polisi. https://t.co/ljNw2EqVhX",5,3,2,5,2022-01-28,6,Friday,5,7,8
1486955645412823040,2022-01-28 06:53:46,"Di tengah ketegangan antar kedua negara ini, kira-kira siapa yang lebih kaya antara orang terkaya Rusia dengan orang terkaya Ukraina?  https://t.co/M0kpmk5EEB",1,0,0,0,2022-01-28,6,Friday,5,1,0
1486955625166868480,2022-01-28 06:53:41,Para tenaga honorer di Pandeglang merespons wacara pemerintah untuk menghapus honorer 2023. Mereka tak sepakat jika harus bersaing di tes PPPK/CPNS. https://t.co/Zhav9F3BfZ,2,0,1,0,2022-01-28,6,Friday,5,3,0
1486954954262786050,2022-01-28 06:51:02,"Jago masak dan selalu membuatkan aneka makanan untuk sang putri, Ayu Ting Ting, ada beberapa masakan Ayah Ojak yang jadi favorit Ayu sampai sekarang.  https://t.co/WtNVKpWKgh",5,6,1,1,2022-01-28,6,Friday,5,6,7
1486954942258683907,2022-01-28 06:50:59,"Umaru Takaeda sudah keluar dari grup band Drive. Kini, ia fokus untuk bersolo karier. https://t.co/ikxLhgQLU9",0,0,0,0,2022-01-28,6,Friday,5,0,0
1486954421498036224,2022-01-28 06:48:55,"Beberapa negara tengah dilanda musim dingin termasuk Jepang. Makan mie di luar ruangan bersuhu -15 derajat celsius, mie milik netizen ini auto beku!  https://t.co/7Wlf5dL3UG",4,2,0,1,2022-01-28,6,Friday,5,4,3
1486953633413484547,2022-01-28 06:45:47,"Menyambut Imlek, Sisca Kohl menunjukkan hampersnya yang begitu mewah. Dilengkapi dengan ukiran nama dan beragam kue, harganya mencapai Rp 6,5 juta!  https://t.co/sgb1EcHVui",5,3,1,0,2022-01-28,6,Friday,5,6,3
1486953574282235905,2022-01-28 06:45:33,Kemenko Marves yang dipimpin Luhut Pandjaitan berencana mengajukan tambahan anggaran Rp 178 miliar kepada Menteri Keuangan Sri Mulyani Indrawati.  https://t.co/QBEFfLw3ze,1,2,0,0,2022-01-28,6,Friday,5,1,2
1486953252419776513,2022-01-28 06:44:16,"Lama tak terlihat, Lee Min Ho akan membintangi serial Pachinko yang digarap Apple TV. Intip gayanya sebagai saudagar kaya yang berkuasa:  https://t.co/bRlN4C4o4h",145,3,35,6,2022-01-28,6,Friday,5,180,9
1486953240696696834,2022-01-28 06:44:13,#Terpopuler Polisi menjelasakan kondisi DJ Indah Cleo saat ditemukan tewas. DJ Indah Cleo jadi korban tewas dalam bentrokan maut di Sorong. https://t.co/oWf9wxLcNF,2,0,0,0,2022-01-28,6,Friday,5,2,0
1486953204168683520,2022-01-28 06:44:04,"Bagaimana menurut pantauan detikers soal harga dan stok minyak goreng di pasar-pasar?

Kirim kontribusi kamu lewat https://t.co/0Chp2xIuUS. Jangan lupa sertakan foto, lokasi, dan bagikan pandanganmu soal kebijakan harga minyak goreng satu harga ini.",2,1,2,0,2022-01-28,6,Friday,5,4,1
1486952713564962818,2022-01-28 06:42:07,"Wajah Kim Kardashian jadi salah satu yang paling ditiru menurut dokter bedah. Entah sengaja atau tidak, deretan wanita ini dijuluki kembarannya:  https://t.co/WdkRcco2lx",4,0,0,0,2022-01-28,6,Friday,5,4,0
1486952694069747714,2022-01-28 06:42:03,Syahrini hingga Anang Hermansyah menjual koleksi NFT. Punya siapa yang paling mahal?  https://t.co/aGBJNZ1K5G,4,3,2,0,2022-01-28,6,Friday,5,6,3
1486952397087907849,2022-01-28 06:40:52,"Dolly Parton selama ini digosipkan mengasuransikan dadanya senilai Rp 8,6 miliar. Kini Parton memberikan klarifikasinya:  https://t.co/QM5ulA9ezn",1,0,0,0,2022-01-28,6,Friday,5,1,0
1486951505152606212,2022-01-28 06:37:19,"Soal harga minyak yang turun lagi, detikcom menghubungi Wakil Ketua APPSI, Ngadiran, Kamis (27/01). Ia mengatakan jika pedagang pasar belum tahu sama sekali dengan informasi ini.

""Minyak goreng berapa? 11.000? Turun lagi? Saya belum tahu kalo turun lagi,"" kata Ngadiran.",3,1,2,0,2022-01-28,6,Friday,5,5,1
1486950987835265025,2022-01-28 06:35:16,Edy Mulyadi tak memenuhi panggilan Bareskrim Polri untuk diperiksa terkait pernyataan 'tempat jin buang anak'. Pemanggilan ke-2 dilayangkan. https://t.co/OuabY33SCl,19,7,0,1,2022-01-28,6,Friday,5,19,8
1486950839411372035,2022-01-28 06:34:40,"Menurutnya, persediaan minyak goreng ini tidak tersedia dalam waktu yang lama, karena langsung habis diserbu pembeli.",5,2,2,0,2022-01-28,6,Friday,5,7,2
1486950571705655297,2022-01-28 06:33:37,"Harga yang sebelumnya yaitu Rp 14.000/liter membuat rak minyak goreng kosong di mana-mana. Terbukti dari penuturan salah satu karyawan minimarket, yang mengaku mulai kesulitan mendapat pasokan minyak goreng.",2,1,3,1,2022-01-28,6,Friday,5,5,2
1486950410539581442,2022-01-28 06:32:58,"Hari ini, Kamis (27/01/2022) harga minyak goreng curah turun lagi dengan harga eceran tertinggi (HET) di Rp 11.500/liter. Hal ini dikemukakan oleh Menteri Perdagangan Muhammad Lutfi, saat konferensi pers hari ini.",7,3,2,2,2022-01-28,6,Friday,5,9,5
1486950401828081666,2022-01-28 06:32:56,Siapa yang menyangka jika rumah mungil cantik ini dulunya adalah tiang untuk tank air atau toren. Ini yang menginspirasi sang pemilik:  https://t.co/Xt2iPPmpe9,2,0,1,0,2022-01-28,6,Friday,5,3,0
1486950380206497807,2022-01-28 06:32:51,"Pesawat F35-C senilai Rp 1,4 triliun itu jatuh di Laut China Selatan setelah apa yang digambarkan Angkatan Laut AS sebagai ""kecelakaan"" ketika lepas landas. https://t.co/L35bzBPXJL",5,0,1,1,2022-01-28,6,Friday,5,6,1
1486949681850687491,2022-01-28 06:30:04,"Sopir Vanessa Angel, Tubagus Joddy, menjalani sidang perdana pada Kamis (27/1) terkait kasus kecelekaan yang menewaskan Vanessa dan Bibi. https://t.co/H31l59F3vz",5,0,1,1,2022-01-28,6,Friday,5,6,1
1486949665618763776,2022-01-28 06:30:01,"Penuh drama, Brasil ditahan imbang oleh Ekuador dalam lanjutan Kualifikasi Piala Dunia 2022. https://t.co/OUChxmoBUb",2,0,0,0,2022-01-28,6,Friday,5,2,0
1486949404401491968,2022-01-28 06:28:58,"Harga minyak goreng turun, Ok fine... Thank you.

Tapi kok langka?

#THREAD https://t.co/DTQEeBUQe4",181,68,44,22,2022-01-28,6,Friday,5,225,90
1486948808504356866,2022-01-28 06:26:36,Jenis vaksin booster ketiga ada berbagai macam. Apa saja ya jenis vaksin booster ketiga yang bisa didapatkan di DKI Jakarta? https://t.co/pjsumCMhTN,4,0,1,1,2022-01-28,6,Friday,5,5,1
1486948568061874178,2022-01-28 06:25:39,"Dengan printer 3D, banyak hal-hal kreatif dan mengagumkan yang muncul di internet. Salah satunya membuat helm mungil buat kucing. Hasilnya bikin gemas! https://t.co/YzFxJdOP7o",8,1,2,0,2022-01-28,6,Friday,5,10,1
1486948549015261187,2022-01-28 06:25:34,"Stefan Chen bercerai dengan Keanna Taiyh, saat istrinya hamil. Stefan Chen juga kala itu mengancam untuk merilis rekaman seks mereka. https://t.co/IFqFz3Ki7t",6,0,0,1,2022-01-28,6,Friday,5,6,1
1486948041395421186,2022-01-28 06:23:33,"Penuh drama, Brasil ditahan imbang oleh Ekuador dalam lanjutan Kualifikasi Piala Dunia 2022. https://t.co/T2Z5dhy1CN",3,0,0,0,2022-01-28,6,Friday,5,3,0
1486947922625404932,2022-01-28 06:23:05,"Harga minyak goreng sempat mahal sejak menjelang natal 2021 dan tahun baru 2022 (Nataru), baik yang curah ataupun kemasan. Kenapa ya?  https://t.co/D05gSmGd5B",8,1,0,0,2022-01-28,6,Friday,5,8,1
1486947329651482627,2022-01-28 06:20:44,"2 tahun Aliando Syarief menghilang dari dunia hiburan. Kini, Aliando muncul dan mengumumkan dirinya tengah mengidap OCD. #AliandoSyarief  https://t.co/p7e0mfuG3c",5,0,0,0,2022-01-28,6,Friday,5,5,0
1486946162892492800,2022-01-28 06:16:06,"Ketua Umum LSM GMBI M Fauzan ditangkap Poisi. Penangkapan merupakan imbas dari demo ricuh di depan Mapolda Jabar, Kamis (27/1/2022) kemarin. https://t.co/b6eivxJjF6",103,29,19,9,2022-01-28,6,Friday,5,122,38
1486946151572123649,2022-01-28 06:16:03,"Tak dipungkiri, ada keuntungan diraih pelaku industri kesehatan yang bergerak di bidang pengadaan vaksin selama pandemi. Siapa saja mereka?  https://t.co/XfuBoOzOT1",6,1,3,0,2022-01-28,6,Friday,5,9,1
1486945562951827458,2022-01-28 06:13:42,"Hari ini, AirAsia Group Berhad mengumumkan pergantian nama. Induk perusahaan grup ini berubah menjadi Capital A.  https://t.co/vvPAOeHvx3",3,0,4,0,2022-01-28,6,Friday,5,7,0
1486945341941460992,2022-01-28 06:12:50,Menteri Investasi/Kepala BKPM Bahlil Lahadalia menilai anak muda yang cuma jadi karyawan tidak akan bisa jadi kaya raya. Begini respons Ahmad Sahroni.  https://t.co/cw0BqZLfp9,17,17,3,2,2022-01-28,6,Friday,5,20,19
1486945335415123972,2022-01-28 06:12:48,Harga emas Antam hari ini tercatat Rp 930.000 per gram atau turun Rp 8.000 dibandingkan perdagangan hari sebelumnya.  https://t.co/2gd6XmJzu3,2,1,1,0,2022-01-28,6,Friday,5,3,1
1486945053528498180,2022-01-28 06:11:41,"Aksi getok harga masih jadi momok bagi pariwisata kita. Para pemilik homestay di Labuan Bajo, NTT pun diwanti-wanti tak melakukannya!  https://t.co/gjS7tQ0I99",5,1,2,0,2022-01-28,6,Friday,5,7,1
1486945045668315138,2022-01-28 06:11:39,Apa sih itu penyakit OCD atau obsessive-compulsive disorder seperti yang diidap Aliando Syarief? Berikut ini penjelasannya: https://t.co/PRgtc2Fq8J,20,5,3,0,2022-01-28,6,Friday,5,23,5
1486944172770799617,2022-01-28 06:08:11,Perdana menteri berikutnya yang memimpin pemerintahan koalisi harus memastikan pemulihan ekonomi terus berlanjut.  https://t.co/KooiyovYGm,6,0,2,0,2022-01-28,6,Friday,5,8,0
1486943665868136453,2022-01-28 06:06:10,"Vicky Prasetyo membantah dirinya hobi kawin cerai. Setiap kali menikah, dia selalu berharap langgeng, termasuk dengan Kalina Oktarani. https://t.co/R2TlfTZzgV",6,0,1,0,2022-01-28,6,Friday,5,7,0
1486942323770642434,2022-01-28 06:00:50,Ada yang tahu siapa nama gurunya? https://t.co/2VBTQpOfkB,882,977,100,119,2022-01-28,6,Friday,5,982,1096
1486942320260001793,2022-01-28 06:00:49,"JakPro bersama Ikatan Motor Indonesia (IMI) studi banding ke Diriyah, Arab Saudi untuk mempelajari rangkaian ajang Formula E. PDIP lempar kritik keras. https://t.co/f0PYRQGp7L",11,5,2,0,2022-01-28,6,Friday,5,13,5
1486941999743868928,2022-01-28 05:59:33,"Seorang programmer terpaksa lengser dari posisi dan digantikan anak baru. Dia juga dipaksa menghapus data. Ternyata, keputusan itu disesali enam bulan kemudian. https://t.co/4qQiGYuyNB",12,1,2,0,2022-01-28,5,Friday,5,14,1
1486941320866373632,2022-01-28 05:56:51,"Para bintang TikTok semakin kaya raya, bahkan pendapatan sebagian dari mereka disebut telah menyamai bahkan melebihi penghasilan CEO di perusahaan top. https://t.co/CIXPz0x7V0",4,0,3,0,2022-01-28,5,Friday,5,7,0
1486941006788534272,2022-01-28 05:55:36,"Dunia aviasi umumnya didominasi kaum pria. Maka ketika Kim De Klop muncul di media sosial sebagai pilot wanita muda, sosoknya jadi perhatian warganet. https://t.co/l3XttUYnSJ",5,1,3,0,2022-01-28,5,Friday,5,8,1
1486940177788456966,2022-01-28 05:52:19,"Sultan Ghozali sukses cuan Rp 1,5 miliar jualan NFT foto selfie. Kini ada lagi perempuan yang cuan Rp 1,7 miliar jualan NFT gambar bebek. https://t.co/8DWnK76v4z",6,1,5,0,2022-01-28,5,Friday,5,11,1
1486939617433636864,2022-01-28 05:50:05,"Rompi Agus Harimurti Yudhoyono saat berolahraga bikin salfok. Dikira rompi anti peluru, rompi ini bukan untuk keperluan bergaya melainkan latihan fisik. https://t.co/OzbGqtRKEf",4,0,1,2,2022-01-28,5,Friday,5,5,2
1486939079245713408,2022-01-28 05:47:57,"Ken Chu menyebut istrinya, Han Wenwen, kikuk saat melakukan pekerjaan rumah. Tak cuma memasak, ia juga menyebut sang istri tak bisa cuci piring. https://t.co/h05PxVrQt0",2,0,1,1,2022-01-28,5,Friday,5,3,1
1486938799187845121,2022-01-28 05:46:50,#Terpopuler Pria asal Indonesia ini menikah dan memiliki rumah di Jerman yang harganya hampir Rp7 Miliar. Ini kisahnya? https://t.co/Eok75OF25v,10,0,4,0,2022-01-28,5,Friday,5,14,0
1486938156482060291,2022-01-28 05:44:17,"Mantan bintang Real Madrid mengklaim, Kylian Mbappe akan bergabung di musim panas ini! https://t.co/xeyQXkLsxf",6,0,1,0,2022-01-28,5,Friday,5,7,0
1486937862201294856,2022-01-28 05:43:06,"Timnas Indonesia menang 4-1 atas Timor Leste di laga uji coba. Pelatih Shin Tae-yong tidak puas dengan hasilnya, minta Skuad Garuda main lebih ngotot! https://t.co/sBccmhlHIe",3,0,1,0,2022-01-28,5,Friday,5,4,0
1486936936606486529,2022-01-28 05:39:26,Venna Melinda dan Ferry Irawan melakukan sesi foto prewedding dengan adat Bali. Inilah potret prewedding Venna dan Ferry yang tuai cibiran:  https://t.co/s5HkRP5jk6,2,1,1,1,2022-01-28,5,Friday,5,3,2
1486936387890909184,2022-01-28 05:37:15,"Ketua Majelis Hakim memberi kesempatan kepada Joddy untuk merespons dakwaan tersebut. Namun, sopir Vanessa Angel itu menyatakan menerima dakwaan jaksa. https://t.co/SjEvi8touh",4,1,1,0,2022-01-28,5,Friday,5,5,1
1486935764445315073,2022-01-28 05:34:46,Rompi pemberat yang dipakai AHY umum digunakan untuk melatih kekuatan otot saat olahraga. Tapi ada syaratnya jika ingin ikut pakai. https://t.co/MBJ2DoBdjk,6,5,0,1,2022-01-28,5,Friday,5,6,6
1486934504547794944,2022-01-28 05:29:46,"Penampilan Ibu Ayu Ting Ting, Umi Kalsum mencuri atensi karena kedapatan mengenakan strap mask yang terbuat dari emas ali. Ini potretnya:  https://t.co/sTHt5YnUEH",5,3,1,0,2022-01-28,5,Friday,5,6,3
1486933462036717572,2022-01-28 05:25:37,"Ada sejumlah sunnah yang dilakukan khatib dalam pelaksanaan khutbah Jumat. Apa benar khatib harus selalu menghadap jamaah termasuk salah satunya?

via: detikedu  https://t.co/nVnyVDYKFE",5,0,4,0,2022-01-28,5,Friday,5,9,0
1486933448283545601,2022-01-28 05:25:34,Bermain tebak-tebakan gombal bisa jadi alternatif hiburan bersama pacar atau gebetan. Ini tebak-tebakan gombal yang bisa jadi referensi:  https://t.co/51fauNDV77,15,3,4,2,2022-01-28,5,Friday,5,19,5
1486932868001636352,2022-01-28 05:23:16,Ada sebagian makanan yang memang aman dikonsumsi dalam kondisi masih mentah. Namun ada juga makanan mentah yang membahayakan kalau dikonsumsi. Apa saja?  https://t.co/qgvmMZ4jf0,3,0,1,0,2022-01-28,5,Friday,5,4,0
1486932261870219264,2022-01-28 05:20:51,Apa saja perubahan yang bakal terjadi dengan adanya kenaikan suku bunga oleh bank sentral Amerika Serikat?  https://t.co/yXRpJrgSZV,10,0,2,1,2022-01-28,5,Friday,5,12,1
1486932008622297088,2022-01-28 05:19:51,"Margot Robbie menghadiri fashion show Chanel couture. Muncul head to toe dengan Chanel, tas mungilnya bikin salah fokus! https://t.co/6lhnBll7o6",9,0,1,0,2022-01-28,5,Friday,5,10,0
1486931686810079233,2022-01-28 05:18:34,"Pelayanan SIM keliling Depok buka setiap hari, kecuali Minggu. Jadwal SIM keliling hari ini, Jumat 28 Januari 2022 ada di dua lokasi. Cek ya: https://t.co/E7qtvqHPSG",5,0,1,0,2022-01-28,5,Friday,5,6,0
1486931149649764353,2022-01-28 05:16:26,"Hati dan ampela ayam bisa jadi lauk enak jika diolah dengan tepat. Dibumbui cabe dan rempah, diungkep dengan bumbu lengkap atau digoreng kering dengan tepung.  https://t.co/DjPXru6aaQ",4,0,2,0,2022-01-28,5,Friday,5,6,0
1486930594864979969,2022-01-28 05:14:14,Romelu Lukaku tengah melorot performanya bersama Chelsea. Hal ini diyakini bikin sebagian suporter The Blues mempertanyakan lagi keputusan membeli Lukaku. https://t.co/tNkWG1WFHb,7,0,1,0,2022-01-28,5,Friday,5,8,0
1486930578897256450,2022-01-28 05:14:10,"Berbeda dengan varian COVID-19 sebelumnya, Omicron memicu gejala yang lebih ringan. Dokter paru RS Persahabatan mengungkap gejala khas yang dialami pasien. https://t.co/LVyjyEtMz4",16,2,13,4,2022-01-28,5,Friday,5,29,6
1486930325330702336,2022-01-28 05:13:10,#FOTO Atta Halilinta makin percaya diri dengan penampilan barunya. Ia mulai meninggalkan bandana yang selama ini jadi ciri khasnya. Ini potret Atta:  https://t.co/ZTwTsW7nNV,3,0,2,0,2022-01-28,5,Friday,5,5,0
1486929792477839360,2022-01-28 05:11:03,Omicron BA.2 dipastikan Menkes Budi sudah terdeteksi di Indonesia. Kira-kira apa dampak dari subvarian yang dijuluki 'Omicron siluman' ini? https://t.co/UAdYuJ7GUr,12,0,3,5,2022-01-28,5,Friday,5,15,5
1486928975016439809,2022-01-28 05:07:48,"Sebuah pikap bermuatan buah menabrak bagian belakang sebuah truk di tol Cipularang, Jawa Barat pada Kamis (28/1) dini hari. Sopir pikap tewas akibat insiden ini. https://t.co/vCnPdYScfi",2,0,0,0,2022-01-28,5,Friday,5,2,0
1486928478977110018,2022-01-28 05:05:49,Sahabat akan menikah? Ini inspirasi kado pernikahan untuk sahabat yang unik dan jarang terpikirkan:  https://t.co/aUfe3zLD5Q,4,1,0,0,2022-01-28,5,Friday,5,4,1
1486927709775310852,2022-01-28 05:02:46,"#FOTO Seperti apa gaya Sonya Fatmala hingga Arumi Bachsin, artis yang kini jadi istri pejabat saat belanja ke pasar? Inilah gaya tujuh istri pejabat Indonesia:  https://t.co/G7T5cBnLjl",3,2,1,1,2022-01-28,5,Friday,5,4,3
1486926402859450375,2022-01-28 04:57:34,"Sidang perdana Tubagus Joddy, sopir Vanessa Angel mengungkap isi 'black box' mobil. Berdasarkan data, Joddy ngebut 135 km/jam sebelum kecelakaan. https://t.co/GVZtY2fPiT",63,22,10,6,2022-01-28,4,Friday,5,73,28
1486926082997735427,2022-01-28 04:56:18,Matt Reeves mengungkapkan alasan kenapa The Batman tidak akan menghadirkan origin story dari Bruce Wayne. Ini alasannya: https://t.co/bAjzXe3uwd,5,1,1,0,2022-01-28,4,Friday,5,6,1
1486925220606791681,2022-01-28 04:52:52,"Akomodasi di Lombok, Nusa Tenggara Barat, penuh pada tanggal pelaksanaan MotoGP Mandalika. Mandalika Grand Prix Association (MGPA) menyiapkan siasat untuk itu. https://t.co/YJRDNCQ7lQ",11,0,0,0,2022-01-28,4,Friday,5,11,0
1486924645781626880,2022-01-28 04:50:35,Forum B20 digelar dan diikuti oleh seluruh delegasi anggota G20 guna merumuskan dan menggenjot pertumbuhan ekonomi dunia dan Indonesia ke depannya. Seperti apa?  https://t.co/nWtiTT4k5n,5,0,0,0,2022-01-28,4,Friday,5,5,0
1486924132793081857,2022-01-28 04:48:33,"#Foto Duck Down Bar Senopati, Jakarta Selatan dirazia aparat Polda Metro Jaya, Jumat (28/1/2022) dini hari tadi. Bar tersebut kedapatan masih buka lewat tengah malam. Ini potretnya: https://t.co/RurpCgxNcl

Foto: Dok.Polda Metro Jaya https://t.co/pfOjHxNpnh",10,0,4,1,2022-01-28,4,Friday,5,14,1
1486923331047731201,2022-01-28 04:45:22,Curhat juga harus bisa melihat tempat. Ada 5 hal yang harus dihindari jadi tempat curhat. Ini kata ustaz:  https://t.co/nBfB9h5Isn,16,1,3,3,2022-01-28,4,Friday,5,19,4
1486923044706824193,2022-01-28 04:44:14,"Sekretaris Ditjen Kebudayaan Kemendikbudristek menyebut masih banyak Warisan Budaya Tak Benda belum ditetapkan. Baru sekitar sekitar 1.635 yang sudah ditetapkan

via: detikedu  https://t.co/qn5N8LLzT8",2,0,0,0,2022-01-28,4,Friday,5,2,0
1486922166323056643,2022-01-28 04:40:44,Satgas Covid-19 meminta perkantoran non-esensial mempertimbangkan penerapan work from home (WFH) atau bekerja dari rumah. Masyarakat diminta tetap waspada dan melakukan proteksi terhadap diri sendiri agar terhindar dari Covid-19. https://t.co/yWWMroOvIp,10,2,3,0,2022-01-28,4,Friday,5,13,2
1486921823648374784,2022-01-28 04:39:23,"Cerita bergambar legendaris Oki dan Nirmala diangkat jadi serial. Memerankan sosok Nirmala, Tissa Biani merasa senang dan tak menyangka. https://t.co/EAnEQYYXow",11,3,1,0,2022-01-28,4,Friday,5,12,3
1486921265738887169,2022-01-28 04:37:10,"Pabrikan mobil asal China, Chery pamerkan 3 SUV yang akan dihadirkan di Indonesia. Salah satunya Tiggo 8 Pro yang siap tantang Pajero Sport-Fortuner. Penasaran? https://t.co/3WZTC36nNh",9,0,0,0,2022-01-28,4,Friday,5,9,0
1486920465423777796,2022-01-28 04:33:59,Seorang pria di China melakukan percobaan bunuh diri. Pria tersebut nekat menghabisi nyawanya karena malu putranya belum juga menikah. https://t.co/1bFLedDnFu,5,1,0,6,2022-01-28,4,Friday,5,5,7
1486919951260831749,2022-01-28 04:31:56,Rusia mencatatkan rekor kasus harian COVID-19 mencapai 88 ribu kasus. Kondisi itu membuat nakes di rumah sakit Rusia pun sibuk merawat para pasien COVID-19. https://t.co/NrMczGabd6,8,0,0,0,2022-01-28,4,Friday,5,8,0
1486919424154165256,2022-01-28 04:29:51,Dekorasi pernikahan keluarga Cendana ini viral di TikTok. Pernikahan tersebut menghadirkan dekor seperti memindahkan Taman Sari Yogyakarta.  https://t.co/NEg3NTwLZT,5,0,1,1,2022-01-28,4,Friday,5,6,1
1486919406034853891,2022-01-28 04:29:46,"Sebanyak 90 sekolah di Jakarta tutup PTM imbas kasus COVID-19 siswa hingga guru. Ini respons guru, Wapres, Koordinator PPKM Jawa-Bali, dan Kemendikbudristek.

via: detikedu  https://t.co/S3LjQqtJR3",3,1,1,0,2022-01-28,4,Friday,5,4,1
1486919139369304075,2022-01-28 04:28:43,Menkes mengingatkan untuk tidak panik terkait peningkatan COVID-19 saat ini. Namun ia berpesan untuk membatasi mobilitas dan interaksi dengan banyak orang. https://t.co/Xv1YSFXOgw,14,8,6,4,2022-01-28,4,Friday,5,20,12
1486918627110662144,2022-01-28 04:26:40,Eggi Sudjana buka suara soal disebut bukan warga korps baret merah. Eggi menjelaskan soal dirinya bisa dilantik sebagai penasihat di FKKPBM. https://t.co/K53pomD7Yo,4,0,0,0,2022-01-28,4,Friday,5,4,0
1486918085407821824,2022-01-28 04:24:31,Vendor pernikahan ini mengungkapkan detail dekorasi pernikahan keluarga Cendana:  https://t.co/m1O3wOWR5F,5,0,0,0,2022-01-28,4,Friday,5,5,0
1486917610184876034,2022-01-28 04:22:38,"RI melaporkan 3 kasus kematian akibat Omicron. Seiring itu, Menkes yakin turunan varian Omicron BA.2 sudah masuk RI. Lebih menantang dibanding Omicron BA.1? https://t.co/DDO79eVN3y",7,1,2,0,2022-01-28,4,Friday,5,9,1
1486917587955027975,2022-01-28 04:22:33,"Polri terus menggebuk pinjol ilegal, terakhir yang berkantor di PIK, Jakarta. Lalu berapakah uang pinjol ilegal yang beredar di masyarakat? https://t.co/65hb0EcgKT",4,1,1,2,2022-01-28,4,Friday,5,5,3
1486917303023411200,2022-01-28 04:21:25,Aliando idap OCD ekstrem. Ia berpesan ke semua untuk jangan malu punya gangguan mental. #AliandoSyarief  https://t.co/BFfUsMCg3m,20,5,2,0,2022-01-28,4,Friday,5,22,5
1486916987049623556,2022-01-28 04:20:09,"Ekonomi Amerika Serikat (AS) di 2021 tercatat tumbuh 5,7%. Pertumbuhan ekonomi negara Paman Sam ini merupakan rekor tertinggi sejak 1984!  https://t.co/PLTy8EAge0",4,1,0,1,2022-01-28,4,Friday,5,4,2
1486915480937975810,2022-01-28 04:14:10,Sosok Ghozali Everyday kini kembali jadi perbincangan usai tampil membuat dessert box bersama pemilik Bittersweet by Najla. Semua karena ekspresinya!  https://t.co/5ZpISFr8tu,7,0,1,0,2022-01-28,4,Friday,5,8,0
1486914702345216011,2022-01-28 04:11:05,Instrumen kripto dan saham mulai mulai lesu awal tahun ini. Namun emas masih tetap kinclong meski tak seperti tahun-tahun sebelumnya.  https://t.co/O6AdaAktEx,3,0,0,0,2022-01-28,4,Friday,5,3,0
1486914557461372928,2022-01-28 04:10:30,"Minyak goreng saat ini harganya turun lagi, yang sebelumnya Rp 14.000/liter sekarang menjadi Rp 11.500/liter. Ini fakta-faktanya!  https://t.co/dKUuDsN9PW",5,6,2,3,2022-01-28,4,Friday,5,7,9
1486914127217975298,2022-01-28 04:08:48,Kematian Novia Widyasari Rahayu (23) masih meninggalkan pilu. Novia nekat mengakhiri hidupnya dengan menenggak racun di samping makam ayahnya. https://t.co/zSKXibyL0Z,11,0,0,0,2022-01-28,4,Friday,5,11,0
1486914106221338626,2022-01-28 04:08:43,"Kementerian Keuangan memblokir anggaran di seluruh kementerian dan lembaga (K/L) sebesar Rp 39,7 triliun. Gaji PNS aman?  https://t.co/rSFzlu7dS6",4,0,0,0,2022-01-28,4,Friday,5,4,0
1486913857499144194,2022-01-28 04:07:43,Robins Gosens berterima kasih kepada Atalanta usai memilih pindah ke Inter Milan. https://t.co/KjgoOcPeUC,1,0,0,0,2022-01-28,4,Friday,5,1,0
1486913532943818756,2022-01-28 04:06:26,"Vaksinasi COVID-19 di Surabaya digelar secara rutin. Catat ya, berikut info jadwal dan lokasinya: https://t.co/IycHvGND4s",1,0,0,0,2022-01-28,4,Friday,5,1,0
1486912836781711363,2022-01-28 04:03:40,Kepala Staf Angkatan Udara Marsekal TNI Fadjar Prasetyo meresmikan Komando Operasional Udara Nasional atau Koopsudnas. https://t.co/4isuu9UZkl,4,2,2,0,2022-01-28,4,Friday,5,6,2
1486912812781903872,2022-01-28 04:03:34,Momen menarik terjadi di laga Ekuador vs Brasil. Kiper timnas Brasil Alisson Becker dua kali diselamatkan Video Assistant Referee (VAR) dari kartu merah! https://t.co/Go5eEA8jWC,0,0,0,0,2022-01-28,4,Friday,5,0,0
1486912428646486018,2022-01-28 04:02:03,Menkes meyakini sebagian besar kasus COVID-19 di DKI adalah varian Omicron. Temuan di sejumlah RS dan laboratorium genome sequencing mendukung dugaan tersebut. https://t.co/MzWsuGOWZR,3,3,0,1,2022-01-28,4,Friday,5,3,4
1486911053950861312,2022-01-28 03:56:35,"Sebuah mobil jenis pikap menabrak bagian belakang truk tronton di ruas Jalan Tol Cipularang Km 87, wilayah Sukatani, Kabupaten Purwakarta. Satu orang tewas. https://t.co/GDyzZLiA1n",2,0,2,0,2022-01-28,3,Friday,5,4,0
1486911038608056330,2022-01-28 03:56:31,"Manajemen Kwon Eun Bi memberi kabar artisnya terinfeksi COVID-19. Di hari yang sama, manajemen Jaehee Weeekly juga mengumumkan hal yang sama. https://t.co/LmhjQUOz70",5,0,1,0,2022-01-28,3,Friday,5,6,0
1486910894567309313,2022-01-28 03:55:57,"Pasangan muda menghasilkan US$ 120.000 atau Rp 1,73 miliar (kurs Rp 14.385) dari menjual bebek kartun dalam bentuk non-fungible token (NFT)!  https://t.co/RZ3Twn4xqt",6,0,1,0,2022-01-28,3,Friday,5,7,0
1486910458695143427,2022-01-28 03:54:13,"Kecelakaan truk tronton yang mengalami rem blong dan menabrak pengendara di lampu merah terjadi di Simpang Rapak, Balikpapan. Kenapa sopir tidak banting setir? https://t.co/lg2fDIKKAT",2,0,0,0,2022-01-28,3,Friday,5,2,0
1486910436314394626,2022-01-28 03:54:08,"DJ Indah Cleo jadi korban tewas dalam pembakaran tempat hiburan malam Doubel O di Sorong, Papua Barat. Keluarga harap jenazah Indah cepat teridentifikasi. https://t.co/QbxAXtG21W",0,0,0,0,2022-01-28,3,Friday,5,0,0
1486910129438031873,2022-01-28 03:52:54,"Setelah wawancara Ririe Fairus bersama Maia Estianty viral, cuplikan video pendek dari Nissa Sabyan saat ditanya soal poligami jadi sorotan. https://t.co/b6lrFIMj0F",0,1,1,0,2022-01-28,3,Friday,5,1,1
1486909853473853442,2022-01-28 03:51:49,Anushka Sharma berikan ucapan selamat untuk Priyanka Chopra dan Nick Jonas. Ia berikan pesan untuk jadi orang tua:  https://t.co/qylof0Xdvt,5,0,1,1,2022-01-28,3,Friday,5,6,1
1486909361595293701,2022-01-28 03:49:51,"Della Dartyan menceritakan tentang film terbarunya, Arini by Love Inc. Ia mengaku merasa tertantang untuk main di sana.  https://t.co/sMPZnaOwID",7,0,1,0,2022-01-28,3,Friday,5,8,0
1486909344549638145,2022-01-28 03:49:47,Pep Guardiola menegaskan hasil bukan orientasi utamanya membesut Manchester City. Menurutnya hal yang terpenting timnya selalu ingin tampil lebih baik. https://t.co/8vCpax7nn5,7,1,1,0,2022-01-28,3,Friday,5,8,1
1486909067679473664,2022-01-28 03:48:41,"Saya mau beli rumah cash bertahap, tapi pengembang nggak mau PPJB ke notaris. Apakah aman? Ini penjelasannya. #detiksAdvocate https://t.co/Wq35imRAyH",13,0,2,0,2022-01-28,3,Friday,5,15,0
1486908171738398722,2022-01-28 03:45:08,"Donny van de Beek bisa meninggalkan Manchester United. Melalui Dennis Bergkamp yang merupakan kekasih dari anaknya, akan membujuk manajer Crystal Palace, Patrick Vieira. https://t.co/5dARC3ZIg8",4,8,1,0,2022-01-28,3,Friday,5,5,8
1486907632120209416,2022-01-28 03:42:59,Hati-hati! Muncul modus penipuan rekrutmen pegawai. PT KAI mengingatkan masyarakat untuk waspada penipuan bermodus rekrutmen KAI. https://t.co/Plb09PgYd1,7,1,1,0,2022-01-28,3,Friday,5,8,1
1486907621139439617,2022-01-28 03:42:56,"Menkes memastikan turunan Omicron BA.2 sudah masuk di RI, diperkirakan sebanyak 10 kasus. Diduga menular lebih cepat dari Omicron, picu gejala lebih berat? https://t.co/hdeBZOQQxw",15,32,13,13,2022-01-28,3,Friday,5,28,45
1486907250904023042,2022-01-28 03:41:28,"Dear Aquarius, berusaha tenang dan yang terpenting masih selalu berjalan di atas rel yang telah direncanakan. Berikut ramalan zodiak hari ini: https://t.co/EA0ejTPLrj",5,0,1,1,2022-01-28,3,Friday,5,6,1
1486906981273247744,2022-01-28 03:40:24,"Dear Cancer, bila ingin mencoba rencana baru sebaiknya dikondisikan dengan keuangan anda saat ini. Simak ramalan zodiak hari ini: https://t.co/u1OLUElj2v",5,0,0,0,2022-01-28,3,Friday,5,5,0
1486906448726609921,2022-01-28 03:38:17,"Presiden Joko Widodo mengundang peserta B20 yang terdiri dari pebisnis global, pejabat pemerintah dan pemangku kepentingan lain untuk berinvestasi kesehatan di Indonesia. Salah satu tujuannya agar bisa memperkuat sistem ketahanan kesehatan global. https://t.co/HZCYrHBLtE",3,2,1,1,2022-01-28,3,Friday,5,4,3
1486905877215031299,2022-01-28 03:36:01,"Parkir kendaraan memang gampang-gampang susah, tapi kalau melihat pria asal China ini memarkirkan kendaraannya, dijamin pasti detikers bakal tidak akan percaya! https://t.co/kBSOILU45w",1,2,0,0,2022-01-28,3,Friday,5,1,2
1486905181543489538,2022-01-28 03:33:15,Sopir TransJakarta ini melakukan aksi heroik saat menyelamatkan seorang wanita yang hendak bunuh diri dari flyover di Jakarta Barat. Begini kejadiannya. https://t.co/1xBT2cPdHE,7,0,2,0,2022-01-28,3,Friday,5,9,0
1486904410060038148,2022-01-28 03:30:11,PT Bali Bintang Sejahtera atau Bali United meluncurkan projek Non-Fungible Token (NFT). Projek NFT ini bertajuk Bali in Metavers atau Baliverse! https://t.co/MvyulTzVma,10,2,3,0,2022-01-28,3,Friday,5,13,2
1486903892889812994,2022-01-28 03:28:08,Pemotor ini jatuh di tengah jalan yang ramai. Aksi sigapnya setelah mencium aspal menghindarkan dia dari dihantam truk. https://t.co/Mwyne3XTAy,11,0,0,0,2022-01-28,3,Friday,5,11,0
1486903873461800961,2022-01-28 03:28:03,Viral di media sosial seorang sopir TransJakarta berhasil mengagalkan wanita yang hendak bunuh diri di flyover Jakarta Barat. Pihak TransJakarta pun mengapresiasi aksi heroik sang sopir.  https://t.co/uZzo1xXVc9,26,0,12,1,2022-01-28,3,Friday,5,38,1
1486903264566255618,2022-01-28 03:25:38,"Makanan yang dianggap membawa sial ketika disantap saat Imlek. Wanita yang turunkan BB setelah berhenti makan manis, dan viral penjual pani puri keju dikritik.  https://t.co/idF9cVd3Az",3,0,1,0,2022-01-28,3,Friday,5,4,0
1486903256945205255,2022-01-28 03:25:36,"Mulai bulan April 2022, pemerintah memberlakukan standar emisi Euro 4 untuk mesin diesel dan Isuzu mengklaim sudah menyiapkan diri sejak 10 tahun lalu! https://t.co/gZy6goJoI4",3,0,1,0,2022-01-28,3,Friday,5,4,0
1486902413441351685,2022-01-28 03:22:15,Raksasa teknologi Apple sekali lagi kembali menjadi merek smartphone terlaris di seluruh dunia!  https://t.co/bR3pMb9ySj,11,1,2,0,2022-01-28,3,Friday,5,13,1
1486902397154865159,2022-01-28 03:22:11,"Akan bertembu Paris St. Germain di babak 16 besar Liga Champions, Toni Kroos mengungkapkan, akan aneh bertarung dengan Sergio Ramos! https://t.co/cy1Xs0qBya",4,0,1,0,2022-01-28,3,Friday,5,5,0
1486901817481048065,2022-01-28 03:19:53,Rider KTM Miguel Oliveira mengaku memiliki gairah untuk menang sebesar Cristiano Ronaldo dan membidik performa yang lebih konsisten di MotoGP 2022! https://t.co/iOJpWbjICz,5,0,1,0,2022-01-28,3,Friday,5,6,0
1486901552401068032,2022-01-28 03:18:50,Kurs dolar Amerika Serikat (AS) terhadap rupiah pagi hari ini melemah tipis!  https://t.co/cSicg8fCy0,1,0,0,0,2022-01-28,3,Friday,5,1,0
1486900910538248193,2022-01-28 03:16:17,Andre Rosiade mengapresiasi langkah cepat kemendag yang mengeluarkan kebijakan DMO dan DPO untuk komoditas minyak goreng dengan harga terjangkau.  https://t.co/zVsKgUkfZ4,1,1,0,0,2022-01-28,3,Friday,5,1,1
1486900585374830595,2022-01-28 03:14:59,Harga emas Antam hari ini turun Rp 8.000 ke level Rp 930.000 per gram. Harga emas terus mengalami penurunan sejak kemarin.  https://t.co/lpj0KKun5y,6,0,0,0,2022-01-28,3,Friday,5,6,0
1486900243799097344,2022-01-28 03:13:38,Bagaimana tindak lanjut polisi di daerah usai demo ormas GMBI berujung kericuhan di Polda Jabar? Begini rangkumannya. https://t.co/WWResHheab,0,1,0,0,2022-01-28,3,Friday,5,0,1
1486900212392148992,2022-01-28 03:13:30,Daging buaya tengah jadi primadona imbas naiknya harga daging babi di Thailand. Lantas seperti apa sih peternakan buaya yang tengah naik daun ini? Lihat yuk.  https://t.co/jmMiUt1kZC,6,1,2,1,2022-01-28,3,Friday,5,8,2
1486899649915072515,2022-01-28 03:11:16,"Debut di dunia musik K-Pop pada 2015, DSP Media mengumumkan girlband APRIL resmi bubar. #APRIL  https://t.co/RkZJIqpDWy",2,0,0,1,2022-01-28,3,Friday,5,2,1
1486899067288494082,2022-01-28 03:08:57,"Kumis pada kucing memiliki manfaat tersendiri yang dapat melindungi tubuhnya dari bahaya. Lantas apa saja manfaat lainnya?

via: detikedu  https://t.co/dTDD17sIuE",6,1,0,0,2022-01-28,3,Friday,5,6,1
1486898518249906176,2022-01-28 03:06:46,"Polisi tidur banyak ditemui di wilayah perumahan. Banyak yang dibuat secara asal-asalan, padahal ada aturan mainnya! https://t.co/gdEklr4a7Y",26,11,8,4,2022-01-28,3,Friday,5,34,15
1486897958255796226,2022-01-28 03:04:33,Dedik Setiawan belum bertaji di lini depan Timnas Indonesia. Shin Tae-yong menegaskan tidak ada yang boleh menyalahkan striker Arema FC itu! https://t.co/6VrbB3l7cw,10,1,0,0,2022-01-28,3,Friday,5,10,1
1486897315336146948,2022-01-28 03:01:59,KSP meminta masyarakat menyikapi penutupan PTM 90 sekolah di Jakarta secara bijak. Masyarakat diminta tidak panik berlebihan. https://t.co/R6H4DATSyz,3,2,1,0,2022-01-28,3,Friday,5,4,2
1486896729236590596,2022-01-28 02:59:40,Robins Gosens resmi diperkenalkan sebagai pemain Inter Milan. Ia dipinjam dari Atalanta dengan Inter punya opsi untuk mempermanenkan Gosens. https://t.co/0lgXURkqdA,7,0,1,0,2022-01-28,2,Friday,5,8,0
1486896712631271426,2022-01-28 02:59:36,"Perwira polisi terpental saat menghadang pengemudi lansia yang membawa lari mobil rampasan di Jeneponto, Sulsel. Korban juga patah tulang. https://t.co/XE1RlAcZDu",5,0,0,1,2022-01-28,2,Friday,5,5,1
1486896193540177929,2022-01-28 02:57:32,"Wayne Lai sempat mengaku jika sering dibantu masalah finansial oleh sahabatnya, Michael Tao. Namun pernyataan itu malah dibantah oleh Michael. https://t.co/10jcC4Ot7f",5,0,0,0,2022-01-28,2,Friday,5,5,0
1486895528218660866,2022-01-28 02:54:53,"Uut Permatasari baru mengumumkan hamil anak kedua. Tetapi beberapa waktu lalu, Uut terbaring di rumah sakit. https://t.co/e68abprHez",6,0,0,0,2022-01-28,2,Friday,5,6,0
1486894860892311556,2022-01-28 02:52:14,"Selain Jepang, ternyata ada kota di luar benua Asia yang memiliki ratusan restoran sushi. Sampai disebut kota dengan sushi terbanyak di dunia selain Jepang.  https://t.co/sQQAyCacPP",4,0,1,0,2022-01-28,2,Friday,5,5,0
1486894290907414532,2022-01-28 02:49:58,"Kematian DJ Indah Cleo membawa duka yang mendalam. Tadi malam, warga kota Sorong menyalakan lilin dan doa bersama di lokasi kejadian. https://t.co/n5iEgO56Qr",8,1,0,1,2022-01-28,2,Friday,5,8,2
1486894273631039490,2022-01-28 02:49:54,Pilihan skutik retro entry level makin beragam di Indonesia setelah kehadiran Fazzio Hybrid Connected. Pabrikan Jepang hingga China ikut memasarkan motornya! https://t.co/gYv15AJuFI,4,0,1,0,2022-01-28,2,Friday,5,5,0
1486893292554014725,2022-01-28 02:46:00,"Dear Doddy Sudrajat, ini syarat dari keluarga Bibi Ardiansyah kalau ingin bertemu Gala Sky:  https://t.co/MbebBKKGOa",5,1,0,0,2022-01-28,2,Friday,5,5,1
1486893272412917760,2022-01-28 02:45:55,"Bintang Ertugrul Ghazi, Ayberk Pekcan meninggal dunia. Ia merupakan pemeran Artak Bay di serial paling tersohor itu. https://t.co/oXC1SoKhl3",9,1,1,1,2022-01-28,2,Friday,5,10,2
1486892711173099520,2022-01-28 02:43:42,PT Astra Honda Motor (AHM) menjadwalkan peluncuran motor baru Honda pada pekan depan. Apakah Honda Vario 160 yang akan meluncur? https://t.co/XEjLQem8TG,8,0,0,0,2022-01-28,2,Friday,5,8,0
1486892140567355399,2022-01-28 02:41:26,Ronaldo Kwateh dan Marselino Ferdinan telah membuat debut bersama Timnas Indonesia senior. Bagaimana aksinya menurut pelatih Shin Tae-yong? https://t.co/ChPw16JKU0,13,0,0,0,2022-01-28,2,Friday,5,13,0
1486891439611158531,2022-01-28 02:38:38,Produsen mobil listrik ternama Tesla memastikan pihaknya tidak akan merilis kendaraan listrik model terbaru di tahun ini. Imbasnya malah merembes ke mana-mana!  https://t.co/f0ZI85lsTo,4,0,0,0,2022-01-28,2,Friday,5,4,0
1486889797247504385,2022-01-28 02:32:07,"Argentina tetap meraih hasil positif di Kualifikasi Piala Dunia 2022 meski tanpa Lionel Messi. Menghadapi tuan rumah Chile, Argentina menang dengan skor 2-1. https://t.co/3emN1MjtNA",5,0,1,0,2022-01-28,2,Friday,5,6,0
1486889451976642561,2022-01-28 02:30:45,"Stasiun Pondok Cina jadi tempat jajan favorit warga Depok, Jawa Barat karena banyak sekali penjual makanan kaki lima. Mulai dari cilok hingga street food Korea!  https://t.co/wvz97OUALF",10,0,1,1,2022-01-28,2,Friday,5,11,1
1486888859485061122,2022-01-28 02:28:23,Makan terlalu banyak diungkapkan oleh dr. Zaidul Akbar dapat melemahkan iman seorang Muslim. Begini penjelasannya.  https://t.co/zoSZLz2WG5,6,1,1,1,2022-01-28,2,Friday,5,7,2
1486888290624155650,2022-01-28 02:26:08,"Indeks Harga Saham Gabungan (IHSG) hari ini dibuka naik 7 poin (0,11%) ke level 6.618. Bursa Asia apa kabar?  https://t.co/zkQXIYudyi",2,0,0,0,2022-01-28,2,Friday,5,2,0
1486888289319763976,2022-01-28 02:26:07,KNKT mendapati temuan mengejutkan terkait kecelakaan truk maut di Balikpapan. Kecelakaan tersebut salah satu penyebabnya adalah akibat klakson telolet. https://t.co/Alz4vDobJP,71,13,34,3,2022-01-28,2,Friday,5,105,16
1486887460881801218,2022-01-28 02:22:50,"Menyusul 3 member THE BOYZ, kali ini Ju Haknyeon juga dinyatakan positif COVID-19. Hal itu disampaikan langsung pihak manajemen. https://t.co/hfW56impda",2,0,0,0,2022-01-28,2,Friday,5,2,0
1486887442674298881,2022-01-28 02:22:46,Menyeduh kopi tidak semudah seperti yang terlihat. Ternyata ada kesalahan-kesalahan yang dapat merusak kenikmatan rasa kopi dan perlu dihindari.  https://t.co/18EGEewH0S,5,0,1,0,2022-01-28,2,Friday,5,6,0
1486886814917042181,2022-01-28 02:20:16,Kematian tragis DJ Indah Cleo yang jadi korban bentrokan di Sorong. Selamat jalan DJ Indah Cleo...  https://t.co/mqBgVSOphF,4,0,1,0,2022-01-28,2,Friday,5,5,0
1486886239915630593,2022-01-28 02:17:59,"Jika dahulu main game dimarahi orang tua karena dianggap buang-buang waktu, kini dari kegiatan tersebut bisa menghasilkan pendapatan menggiurkan!  https://t.co/Ni0Cbv2VDP",6,2,6,1,2022-01-28,2,Friday,5,12,3
1486885622824460291,2022-01-28 02:15:32,Banyak cara dicari masyarakat untuk cegah tertular virus Covid-19. Termasuk minum wine yang konon bisa cegah Covid-19. Penelitian terbaru mengungkap buktinya!  https://t.co/KTwUjUHXhp,11,2,2,3,2022-01-28,2,Friday,5,13,5
1486885612418478086,2022-01-28 02:15:29,Park Seo Joon dikabarkan akan membintangi drama Korea bersama Han So Hee. Aktor tampan ini kerap bergaya keren saat sedang menikmati es krim dan kopi hitam.  https://t.co/JtPudwnl4M,6,2,1,0,2022-01-28,2,Friday,5,7,2
1486885049022697475,2022-01-28 02:13:15,Erling Haaland mengungkap bek yang paling sulit dihadapi yaitu Virgil van Dijk! https://t.co/3Kt0OrGFNB,4,1,0,0,2022-01-28,2,Friday,5,4,1
1486884453821648902,2022-01-28 02:10:53,"Viral polisi diJeneponto, Sulsel nekat berpegangan pada kap depan mobil yang sedang dibawa kabur pengemudi lansia. Pengemudi lansia tersebut diamankan. https://t.co/43IJxkUIJu",11,0,2,0,2022-01-28,2,Friday,5,13,0
1486884436650209286,2022-01-28 02:10:49,"Emas sering dipandang sebagai komoditas yang tahan banting terhadap kenaikan suku bunga dan inflasi, apalagi saat sekarang dimana saham dan kripto mulai lesu!  https://t.co/jZcUMomezJ",5,1,2,1,2022-01-28,2,Friday,5,7,2
1486884133192278020,2022-01-28 02:09:36,Brasil berhadapan dengan Ekuador dalam lanjutan Kualifikasi Piala Dunia 2022. Laga penuh drama ini tuntas 1-1. https://t.co/WQnD87kldi,2,0,0,0,2022-01-28,2,Friday,5,2,0
1486883091792773127,2022-01-28 02:05:28,IHSG hari ini diprediksi menguat di kisaran 6.572-6.646. Simak rekomendasi saham hari ini.  https://t.co/tIlnVejAVX,4,0,0,0,2022-01-28,2,Friday,5,4,0
1486882765941485574,2022-01-28 02:04:11,16 dari 30 anggota Asosiasi Provinsi PSSI DKI Jakarta mendesak pelaksanaan Kongres. Sejauh ini belum anggota belum dapat pemberitahuan soal kongres. https://t.co/mNYIQae3ey,1,1,0,0,2022-01-28,2,Friday,5,1,1
1486882026246619149,2022-01-28 02:01:14,Presiden ke-2 Indonesia Soeharto disebut-sebut pernah masuk daftar orang terkaya dunia!  https://t.co/I7m20nYxtP,18,9,4,1,2022-01-28,2,Friday,5,22,10
1486882010710908930,2022-01-28 02:01:10,Mencintai diri sendiri atau self love dapat dilakukan dengan mudah. Simak empat langkah sederhana memulai self love di #CNNIndonesia #detiknetwork  https://t.co/q1w77NxZgf,6,0,2,1,2022-01-28,2,Friday,5,8,1
1486881353291517953,2022-01-28 01:58:34,"Seorang pegawai hotel mengungkap, seprai di kamar hotel jarang diganti. Ia memberikan tips agar tamu tidur di atas seprai bersih.  https://t.co/miSzTRAa3J",4,0,1,0,2022-01-28,1,Friday,5,5,0
1486881346530287616,2022-01-28 01:58:32,"Belakangan, Syahrini semakin jarang terlihat di layar kaca. Sekilas tak banyak perubahan yang terjadi kepadanya, tapi netizen memuji semakin langsing. Ini potretnya:  https://t.co/DmSiO5TVCb",2,0,0,0,2022-01-28,1,Friday,5,2,0
1486880944174862338,2022-01-28 01:56:56,Indonesia memiliki potensi sumberdaya hayati kelautan yang luar biasa. Tak banyak negara yang memiliki kondisi fisik laut yang begitu besar.  https://t.co/V9hhLVRPWF,5,0,1,1,2022-01-28,1,Friday,5,6,1
1486880325703774216,2022-01-28 01:54:29,Pemerintah mendorong investasi sektor kesehatan sebagai upaya untuk mengatasi impor.  https://t.co/LSmpYn1Pr8,2,2,0,1,2022-01-28,1,Friday,5,2,3
1486879629877170176,2022-01-28 01:51:43,"Guna mendukung hal ini, Jokowi meluncurkan Taksonomi Hijau Indonesia yang diprakarsai oleh Otoritas Jasa Keuangan (OJK).  https://t.co/vylyolWK1a",1,0,0,0,2022-01-28,1,Friday,5,1,0
1486879619861172229,2022-01-28 01:51:40,Ekonom Senior Faisal Basri menyampaikan kritikan pedas kepada pemerintah yang ingin buru-buru memindahkan Ibu Kota Negara (IKN) ke Kalimantan Timur.  https://t.co/XepX5zS25C,1,2,1,2,2022-01-28,1,Friday,5,2,4
1486879300506824719,2022-01-28 01:50:24,Ekonom Senior Faisal Basri buka-bukaan soal keganjilan pembangunan ibu kota negara (IKN) baru di Kalimantan Timur.  https://t.co/GdsEEFssfH,8,0,0,2,2022-01-28,1,Friday,5,8,2
1486879296278962176,2022-01-28 01:50:23,Bagaimana nasib pegawai negeri sipil (PNS) pemerintah pusat berkaitan dengan pemindahan ibu kota negara? Simak info terkininya berikut. https://t.co/ZORFgyeXtZ,2,0,0,0,2022-01-28,1,Friday,5,2,0
1486878457132896261,2022-01-28 01:47:03,Wimboh menegaskan proyeksi optimis ini didorong oleh kondisi perekonomian dan sektor jasa keuangan yang terus membaik.  https://t.co/57rL6Og9D0,2,0,0,0,2022-01-28,1,Friday,5,2,0
1486878439474966533,2022-01-28 01:46:59,Hasil analisis BMKG menyebutkan bahwa gempa tersebut merupakan jenis gempa dangkal. https://t.co/4rKKiBJZnd,1,0,1,0,2022-01-28,1,Friday,5,2,0
1486878438011318274,2022-01-28 01:46:59,"Kemenkes merespons meninggalnya seorang siswa berinisial R (9) di Deli Serdang, Sumut, usai menjalani vaksinasi. R disebut memiliki penyakit tetanus. https://t.co/J4PSdUL7ao",4,13,2,2,2022-01-28,1,Friday,5,6,15
1486878078961922050,2022-01-28 01:45:33,"""Di tahun 2022 investasi kita naik Rp 1.200 triliun targetnya. Ini bukan angka kecil, tumbuhnya 33% dari realisasi sekarang."" papar Menteri Investasi Bahlil Lahadalia  https://t.co/4HFhiARr9N",5,0,1,1,2022-01-28,1,Friday,5,6,1
1486876894083657728,2022-01-28 01:40:51,"Selain memberhentikan Elfien Goentoro dari posisi Direktur Utama PTDI, RUPS juga langsung menunjuk penggantinya yakni Gita Amperiawan.  https://t.co/NKsZEqn0zn",8,1,0,0,2022-01-28,1,Friday,5,8,1
1486876889365032967,2022-01-28 01:40:49,"Kementerian Keuangan memblokir anggaran kementerian dan lembaga (K/L) sebesar Rp 39,7 triliun demi jaga-jaga bila corona meledak lagi!   https://t.co/Jh9RVcb4KO",3,0,0,0,2022-01-28,1,Friday,5,3,0
1486875567584595973,2022-01-28 01:35:34,"Menteri Perencanaan Pembangunan Nasional PPN/Kepala Bappenas, Suharso Monoarfa buka-bukaan hasil peninjauan langsung Pansus ke kawasan BSD.  https://t.co/owZtXjGxdY",4,0,0,2,2022-01-28,1,Friday,5,4,2
1486875552619413507,2022-01-28 01:35:31,Jamaluddin Jompa resmi jadi Rektor Unhas Terpilih. Dirinya menyingkirkan dua pesaing lainnya. Inilah profil sosok yang dulunya bermimpi jadi peneliti itu. https://t.co/JWbkIW2zdS,5,0,4,0,2022-01-28,1,Friday,5,9,0
1486874623304212481,2022-01-28 01:31:49,"Sky Views Dubai memiiliki atraksi yang memacu adrenalin untuk traveler. Kamu bisa meluncur dari ketinggian 219,5 meter!  https://t.co/m6EPnSX19K",5,0,0,0,2022-01-28,1,Friday,5,5,0
1486873657783771140,2022-01-28 01:27:59,"CEO Apple, Tim Cook, adalah penerus Steve Jobs yang sukses mencatatkan prestasi mentereng. Dia mendapat gangguan dari wanita tak dikenal. https://t.co/DoWLJtsdtq",6,0,1,1,2022-01-28,1,Friday,5,7,1
1486872126573486080,2022-01-28 01:21:54,Turis asal Republik Ceko diusir dari Venesia setelah wisatawan perempuan berusia 30 tahun tersebut berpose bugil di monumen perang!  https://t.co/m7iMjCv81c,4,0,2,0,2022-01-28,1,Friday,5,6,0
1486871844800057346,2022-01-28 01:20:47,Benua Australia punya sejarah penemuan panjang. Masyarakat benua ini bahkan disebut sudah berdagang dengan Indonesia sebelum Inggris datang dan menguasainya.  https://t.co/durEHf4Ali,10,0,2,0,2022-01-28,1,Friday,5,12,0
1486871307560132610,2022-01-28 01:18:39,"Proses sidang antara Qatar Airways dan Airbus masih terus berlangsung. Dalam bukti di video, terlihat jelas pesawat A350 seperti rongsokan.  https://t.co/itsX01KxiN",4,0,2,0,2022-01-28,1,Friday,5,6,0
1486870791211868160,2022-01-28 01:16:36,Musisi Danilla Riyadi kembali mengingat masa lalunya. Danilla Riyadi dahulu pernah dibayar hanya dengan mengunakan nasi besek saja. https://t.co/DBjiizQiMz,7,1,1,0,2022-01-28,1,Friday,5,8,1
1486868893595574274,2022-01-28 01:09:03,Thailand resmi hapus ganja dari daftar obat-obatan terlarang. Thailand juga jadi negara pertama di Asia Tenggara yang legalkan ganja untuk medis dan penelitian. https://t.co/yYepYs61Mn,167,25,76,19,2022-01-28,1,Friday,5,243,44
1486866780224163845,2022-01-28 01:00:39,"Anak dari anggota DPR Fraksi PKS Tifatul Sembiring, Fathan Sembiring, mengkritik ayahnya sendiri soal polemik 'jin buang anak'. Siapakah Fathan Sembiring? https://t.co/uE2mnW41VS",68,41,17,12,2022-01-28,1,Friday,5,85,53
1486866488560603144,2022-01-28 00:59:30,"Menurutnya, apa yang dilakukan oleh KKB begitu meresahkan dan mengganggu kebahagiaan rakyat Papua dan Papua Barat. https://t.co/yr2zGngI2P",12,5,0,1,2022-01-28,0,Friday,5,12,6
1486866228006330371,2022-01-28 00:58:28,Perempuan difabel di Bogor diperkosa tiga anak jalanan. Korban dibuat tidak berdaya dengan dicekoki miras terlebih dahulu. https://t.co/GWeQyFhjim,4,1,1,0,2022-01-28,0,Friday,5,5,1
1486866211975708680,2022-01-28 00:58:24,DJ Indah Cleo termasuk ke dalam 17 orang yang menjadi korban tewas terbakar di Double O. Keluarga kaget nyawa Indah melayang saat bentrok Sorong. https://t.co/UG6cRtD90o,2,1,1,0,2022-01-28,0,Friday,5,3,1
1486865652539346945,2022-01-28 00:56:10,"Jose Mourinho masih berharap AS Roma bisa mengontrak Granit Xhaka. Namun, Giallorossi harus menjual Amadou Diawara terlebih dahulu. https://t.co/kUbW6IY5oO",3,0,0,0,2022-01-28,0,Friday,5,3,0
1486865629659512837,2022-01-28 00:56:05,PKS berpesan agar partai baru seperti Partai Gelora tidak mencari ikan di kolam yang sama. Partai Gelora pun meminta PKS santai saja. https://t.co/7siHqjRStL,3,15,0,6,2022-01-28,0,Friday,5,3,21
1486865002707525634,2022-01-28 00:53:35,"Dedik Setiawan belum bertaji di lini depan Timnas Indonesia. Namun, pelatih Shin Tae-yong menegaskan tidak ada yang boleh menyalahkan striker Arema FC itu. https://t.co/XqAweT7JIQ",8,0,2,0,2022-01-28,0,Friday,5,10,0
1486864690802221056,2022-01-28 00:52:21,"Dua rumah dan satu tempat produksi tahu rusak akibat pergerakan tanah yang terjadi di Desa Cilangkap, Kalanganyar, Lebak Banten. https://t.co/M5wA9sUwco",5,0,0,0,2022-01-28,0,Friday,5,5,0
1486864675832795138,2022-01-28 00:52:17,Polisi berhasil meringkus anggota ormas GMBI yang menunggangi patung Maung Lodaya saat aksi demo anarkis. Tampang penunggang itupun beredar. https://t.co/5pFlKXqg97,8,4,2,1,2022-01-28,0,Friday,5,10,5
1486864384576086017,2022-01-28 00:51:08,"Eggi Sudjana mengaku bagian dari Forum Komunikasi Keluarga Purnawirawan Baret Merah. Danjen Kopassus, Mayjen Teguh Muji, membantah pengakuan Eggi Sudjana. https://t.co/lSnqMsiUPi",22,18,5,2,2022-01-28,0,Friday,5,27,20
1486864130883694596,2022-01-28 00:50:08,"""Hanya karena keterangannya gagal tender, beberapa pihak menuding, menggiring opini publik, seolah-olah Formula E pasti gagal,"" kata Bambang Kusumanto. https://t.co/UHo4gLRgqc",10,15,0,1,2022-01-28,0,Friday,5,10,16
1486864100709838851,2022-01-28 00:50:00,"Bentrok yang terjadi antardua desa di Pulau Haruku, Maluku, menimbulkan duka mendalam. Korban meninggal bertambah menjadi 3 orang dan 4 orang luka. https://t.co/BZd0odBMih",6,0,3,0,2022-01-28,0,Friday,5,9,0
1486863612396380171,2022-01-28 00:48:04,Perkara ribut-ribut murid SD hendak memberi kejutan ulang tahun ke gurunya berujung seorang oknum guru dipolisikan karena menghukum murid mengunyah sampah. https://t.co/YxWQ1slBMa,14,9,6,7,2022-01-28,0,Friday,5,20,16
1486863298276601856,2022-01-28 00:46:49,Jumlah kasus COVID-19 tengah melonjak imbas penularan Omicron. Apa yang harus dilakukan jika dinyatakan positif COVID-19? Ini 10 langkah yang perlu dicatat. https://t.co/3BIyxMGUSj,2,0,2,0,2022-01-28,0,Friday,5,4,0
1486862962744770566,2022-01-28 00:45:29,"Surat Yunus ayat 24 memaparkan tentang gambaran kehidupan di dunia yang diibaratkan dengan tumbuhan yang subur. Kenapa?

via: detikedu  https://t.co/txA1IVzOkH",17,1,3,0,2022-01-28,0,Friday,5,20,1
1486862666467618824,2022-01-28 00:44:18,"#terpopuler Afiliator trading dari binary option sedang ramai menjadi pergunjingan. Doni Salmanan dituding sebagai afiliator yang mengeruk keuntungan. Lalu sebenarnya, siapakah dia?  https://t.co/LM5G4tF8GG",12,6,1,0,2022-01-28,0,Friday,5,13,6
1486861164189523968,2022-01-28 00:38:20,Gelombang kecaman terhadap Arteria Dahlan tak kunjung mereda. Kecaman ditunjukkan dengan melaporkan Arteria Dahlan ke MKD DPR hingga melalui aksi debus. https://t.co/oJWaWPVlDJ,21,4,7,1,2022-01-28,0,Friday,5,28,5
1486861126528913413,2022-01-28 00:38:11,"Bagaimana jadwal Samsat dan SIM keliling di Jadetabek hari ini, Jumat 28 Januari 2022? Simak di sini informasinya. https://t.co/cp3W4V9UbK",0,0,1,0,2022-01-28,0,Friday,5,1,0
1486860887046737922,2022-01-28 00:37:14,Polisi menyatakan kantor pinjol di PIK yang digerebek belum melakukan penagihan ke debitur. Namun polisi punya alasan mengama pinjol digerebek. https://t.co/W1mbNJr1xs,6,3,1,0,2022-01-28,0,Friday,5,7,3
1486860090225344517,2022-01-28 00:34:04,"Jubir Menko Marves Luhut Binsar Pandjaitan, Jodi Mahardi, berbicara kemungkinan PPKM Jakarta naik level. Kenaikan level diprediksi terjadi pekan depan. https://t.co/MBnid9IoHh",7,6,4,4,2022-01-28,0,Friday,5,11,10
1486859418142662656,2022-01-28 00:31:24,"Sopian Effendi (37), seorang difabel asal Cimahi ini tak pernah lelah berjuang untuk menafkahi keluarga. Dari jadi pak ogah dan kini meniti karir jadi atlet. https://t.co/joCxLnBXfF",20,0,4,1,2022-01-28,0,Friday,5,24,1
1486858514781855747,2022-01-28 00:27:49,Rancangan Undang-Undang Pelindungan Data Pribadi dipastikan akan segera dibahas kembali oleh pemerintah dan DPR RI. https://t.co/EvOADx8ofV,8,2,1,0,2022-01-28,0,Friday,5,9,2
1486858175118811143,2022-01-28 00:26:28,"Link Net, penyedia layanan internet di bawah Lippo Group 'diangkut' XL Axiata dengan mahar Rp 8,72 triliun. Ini kata Direktur Eksekutif Lippo Group, John Riady:  https://t.co/vNmdmABORU",6,0,1,0,2022-01-28,0,Friday,5,7,0
1486857322425204740,2022-01-28 00:23:04,Beredar surat edaran yang menyebut orang tua bertanggung jawab atas risiko setelah anak divaksinasi. Warga di Bone memprotes edaran tersebut. https://t.co/IdkKjmmxce,18,8,5,1,2022-01-28,0,Friday,5,23,9
1486856813408628739,2022-01-28 00:21:03,Danjen Kopassus menegaskan Eggi Sudjana bukan warga korps Baret Merah dan tak ada kontribusinya. https://t.co/gVnX1ebU9r,21,5,4,2,2022-01-28,0,Friday,5,25,7
1486856289586139139,2022-01-28 00:18:58,"Kebakaran rumah penduduk terjadi di Jalan Pangeran Jayakarta, Mangga Dua Selatan, Jakpus. Sebanyak 90 personel pemadam kebakaran dikerahkan untuk padamkan api. https://t.co/orK4K3ndnz",2,0,1,0,2022-01-28,0,Friday,5,3,0
1486855533525192707,2022-01-28 00:15:58,"Awet muda di usia 39 tahun, Melanie Putria rajin olahraga dan makan sehat. Mantan Puteri Indonesia ini juga sering bagikan menu sehatnya.  https://t.co/waMemaI1Cb",5,1,1,0,2022-01-28,0,Friday,5,6,1
1486855260052332555,2022-01-28 00:14:53,Aliando Syarief mengaku didiagnosa OCD. Kondisinya semakin sulit saat dia juga dinyatakan terpapar COVID-19. https://t.co/e0lfjfIMDC,11,1,1,0,2022-01-28,0,Friday,5,12,1
1486854688167407620,2022-01-28 00:12:36,"Ribuan santri dari Pondok Pesantren Darul Hikmah Al-Ghazaalie, Jember, Jawa Timur berbaris dan membentuk formasi lafaz Allah di halaman Ponpes mereka. https://t.co/11VyitgeDq",41,0,6,0,2022-01-28,0,Friday,5,47,0
1486852928723984384,2022-01-28 00:05:37,Awal bulan Rajab 2022 akan jatuh pada Rabu (2/2/2022) mendatang. Salah satu amalan yang dapat dilakukan pada bulan tersebut adalah berpuasa. https://t.co/KXGlbSbrEE,20,1,7,0,2022-01-28,0,Friday,5,27,1
1486852271774253063,2022-01-28 00:03:00,Seorang gadis nyaris tewas karena terlalu banyak menghirup zat dari semprotan obat nyamuk usai membunuh kecoak. Videonya viral di media sosial. https://t.co/b0z1XGDOdV,10,0,7,4,2022-01-28,0,Friday,5,17,4
1486851934661361666,2022-01-28 00:01:40,"Warga Kota Makassar, Sulawesi Selatan, dua kali dibuat geger oleh kemunculan ular sanca sepanjang 3 meter. Penangkapan satu ekor ular berlangsung dramatis. https://t.co/WLJar3ofvi",2,0,1,0,2022-01-28,0,Friday,5,3,0
1479241295780532225,2022-01-06 23:59:42,"PDIP sebut kemajuan DKI Jakarta era Anies jauh di bawah era Jokowi, Basuki Tjahaja Purnama-Djarot Saiful Hidayat. Ketua DPP PKS Mardani Ali Sera membela Anies. https://t.co/3NAyW4nYIE",119,64,15,8,2022-01-06,23,Thursday,4,134,72
1479240296256913410,2022-01-06 23:55:44,"Manchester United resmi menunjuk Richard Arnold sebagai CEO baru, menggantikan Ed Woodward. Pria 51 tahun itu akan mulai bekerja pada 1 Februari mendatang. https://t.co/8pq45nGRcb",3,1,3,1,2022-01-06,23,Thursday,4,6,2
1479239803854073862,2022-01-06 23:53:46,Letnan Louise Elisabeth Coldenhoff ditunjuk langsung Presiden Soekarno sebagai pengibar bendera merah putih di Irian Barat pada 1963. https://t.co/N8mxdDM7vN,7,0,2,1,2022-01-06,23,Thursday,4,9,1
1479238759359168514,2022-01-06 23:49:37,Nama Mardani Ali Sera tak masuk daftar 10 kader yang ditunjuk jadi Jubir PKS. Begini respons Mardani tak ditunjuk jadi Jubir PKS. https://t.co/fGqIF187Ke,7,2,2,1,2022-01-06,23,Thursday,4,9,3
1479237461251444737,2022-01-06 23:44:28,"Diding Aprianto (27) tega menghabisi nyawa pasangan suami istri, Marsidi (80) dan Sumini (65), di Sumsel karena tersinggung kerap kepergok mencuri rambutan. https://t.co/vIHJAfmJEV",7,5,2,0,2022-01-06,23,Thursday,4,9,5
1479236597266661376,2022-01-06 23:41:02,"PP Hikmahbudhi menekankan Indonesia adalah bangsa yang sangat majemuk. Jadi, lanjut dia, saling menghormati satu sama lain adalah kewajiban. https://t.co/O5kXWNWdV8",3,0,0,0,2022-01-06,23,Thursday,4,3,0
1479235600737873923,2022-01-06 23:37:04,"Cerita seram soal sumur hampir selalu beredar dari mulut ke mulut anak-anak zaman dulu, seperti halnya yang satu ini. Dengarkan di sini: #Podcast #TawaSetan  https://t.co/74WBAdCWvi",5,0,2,0,2022-01-06,23,Thursday,4,7,0
1479234825424982016,2022-01-06 23:33:59,Ustaz Yusuf Mansur diberondong gugatan perdata berkaitan bisnisnya yaitu patungan investasi. Ada 3 gugatan perdata yang ditujukan pada Ustaz Yusuf Mansur. https://t.co/P57zS9POba,8,8,2,1,2022-01-06,23,Thursday,4,10,9
1479234101844627461,2022-01-06 23:31:07,"Kakek di Kabupaten Gunungkidul, DIY itu tewas disengat kawanan tawon vespa saat mencari rumput. https://t.co/Xomod8twwP",8,1,3,1,2022-01-06,23,Thursday,4,11,2
1479233099162652672,2022-01-06 23:27:08,"Warna Sungai Ledeng di Kecamatan Mojoanyar, Mojokerto berubah menjadi merah darah. Menurut warga, fenomena ini terjadi sejak tiga hari lalu. https://t.co/vFKOMuPvAp",3,2,2,1,2022-01-06,23,Thursday,4,5,3
1479231857065705475,2022-01-06 23:22:12,"Pengeroyokan remaja AD (15) dan AH (18) di Jakarta Timur, memasuki babak baru. Dua oknum anggota Mabes Polri inisial TP dan SS ditetapkan sebagai tersangka https://t.co/G5J4zuuwmt",8,1,1,0,2022-01-06,23,Thursday,4,9,1
1479230612489875456,2022-01-06 23:17:15,Skoliosis adalah kondisi tulang belakang melengkung atau menyamping secara tidak normal. Kondisi ini kebanyakan terjadi pada anak-anak sebelum pubertas. https://t.co/yVTSObWzHg,8,0,2,0,2022-01-06,23,Thursday,4,10,0
1479229871566077955,2022-01-06 23:14:18,DPRD Kabupaten Bandung Barat geram lantaran banyak wajib pajak yang tidak melakukan penyetoran pajak dari konsumen ke pemerintah sehingga tidak masuk kas daerah https://t.co/7XmJPdYlKk,8,2,1,1,2022-01-06,23,Thursday,4,9,3
1479229114137595904,2022-01-06 23:11:18,Tebak-tebakan bisa jadi cara asik untuk menguji ketajaman berpikir. Apakah kamu bisa menjawab teka-teki ini dan membuktikan kecerdasanmu? https://t.co/Tcskzm4v5H,5,1,0,0,2022-01-06,23,Thursday,4,5,1
1479228366339325953,2022-01-06 23:08:19,"Laga Juventus vs Napoli selesai imbang 1-1. Napoli cetak gol lebih dulu lewat Dries Mertens, lalu dibalas Federico Chiesa usai turun minum. https://t.co/WM4uzddFQm",2,0,0,0,2022-01-06,23,Thursday,4,2,0
1479227386692612097,2022-01-06 23:04:26,Vaksin booster untuk siapa? Pertanyaan ini mulai dicari tahu karena pemerintah bakal menggencarkan vaksin booster. https://t.co/rAbDk2QpQg,10,1,1,0,2022-01-06,23,Thursday,4,11,1
1479226032012079110,2022-01-06 22:59:03,Shin Tae-yong tak memanggil pemain klub luar negeri di Piala AFF U-23 2022. Asnawi Mangkualam Cs diberikan kesempatan berkonsentrasi buat klubnya masing-masing. https://t.co/E65WHAhE7x,30,2,2,1,2022-01-06,22,Thursday,4,32,3
1479224052027904001,2022-01-06 22:51:11,"PDIP menilai kemajuan DKI beberapa tahun terakhir ini jauh di bawah era Jokowi, Ahok hingga Djarot. Gerindra mengatakan penilaian harus dikembalikan ke publik. https://t.co/UC0S1SQfVV",40,54,9,2,2022-01-06,22,Thursday,4,49,56
1479223555472691209,2022-01-06 22:49:12,Atletico Madrid meraih kemenangan telak atas Rayo Majadahonda di babak 32 besar Copa del Rey. Los Colchoneros menang 5-0 atas tim divisi tiga itu. https://t.co/RjMsQJaNbN,4,0,0,0,2022-01-06,22,Thursday,4,4,0
1479222579953086468,2022-01-06 22:45:20,"Satgas COVID-19 menyebut vaksinasi booster bakal dimulai 12 Januari, akan diberikan pada usia 18 tahun ke atas yang sudah vaksinasi lengkap lebih dari 6 bulan. https://t.co/mfwAjIpfMW",8,3,4,0,2022-01-06,22,Thursday,4,12,3
1479221817000828930,2022-01-06 22:42:18,"Tak ada pemenang dalam duel Juventus Vs Napoli di lanjutan Liga Italia tengah pekan ini. Napoli unggul duluan dan dibalas Juventus, skor akhir 1-1. https://t.co/4DDQjxiheE",10,0,0,0,2022-01-06,22,Thursday,4,10,0
1479220238780702723,2022-01-06 22:36:02,"Milan menang berkat gol-gol dari Giroud (8'), Junior Messias (17'), dan Rafael Leao (82'). Hasil ini membuat Milan tempel ketat Inter di puncak klasemen. https://t.co/smyk7bJQWs",5,0,1,0,2022-01-06,22,Thursday,4,6,0
1479218963762536453,2022-01-06 22:30:58,Kasus COVID-19 di RI mulai menunjukkan perkembangan ke arah yang kurang baik. Berikut beberapa daerah yang mengalami kenaikan kasus COVID-19 selama 4 pekan. https://t.co/RKbU3MuAkJ,3,0,1,0,2022-01-06,22,Thursday,4,4,0
1479217941006757894,2022-01-06 22:26:54,Puluhan anak-anak di Kabupaten Kulon Progo dilarang ikut vaksinasi COVID-19 oleh orang tuanya. Satgas COVID-19 setempat membeberkan alasannya. https://t.co/oM8Yq3t5pd,13,5,8,2,2022-01-06,22,Thursday,4,21,7
1479216161237651456,2022-01-06 22:19:50,Wali Kota Bekasi Rahmat Effendi terjerat kasus korupsi. Perkara ini terkait penetapan APBD Perubahan 2021 berkenaan dengan belanja modal ganti rugi tanah. https://t.co/OzsUjGF4kQ,9,0,1,2,2022-01-06,22,Thursday,4,10,2
1479215422041907200,2022-01-06 22:16:53,Kemunculan varian B.1.640.2 atau varian IHU menimbulkan kekhawatiran di tengah serangan Omicron. Apakah varian tersebut sudah masuk ke RI? Ini kata Kemenkes: https://t.co/hrQQhEHnk8,31,33,21,17,2022-01-06,22,Thursday,4,52,50
1479213445425864704,2022-01-06 22:09:02,"Ketum PSI Giring Ganesha dikritik usai sidak venue Formula E di Ancol, yang kejeblos dan bertemu kambing. PSI balik menyerang kritik tersebut. https://t.co/GJYCzLwooS",13,14,3,1,2022-01-06,22,Thursday,4,16,15
1479211917902331914,2022-01-06 22:02:58,"Staf Khusus Menteri Sekretaris Negara, Faldo Maldini, meminta semua pihak mengesampingkan kepentingan politik demi tercapainya cita-cita tersebut. https://t.co/nJkPCW3eLu",7,2,0,2,2022-01-06,22,Thursday,4,7,4
1479209330218246148,2022-01-06 21:52:41,"Wakil Presiden Ma'ruf Amin memberikan respons terkait ditangkapnya Wali Kota Bekasi, Rahmat Effendi oleh Komisi Pemberantasan Korupsi (KPK). https://t.co/poZnyGlIDz",10,2,0,1,2022-01-06,21,Thursday,4,10,3
1479208333219405826,2022-01-06 21:48:43,BMKG mengeluarkan peringatan dini cuaca di DKI Jakarta hari ini. BMKG memprediksi hujan disertai angin kencang bakal terjadi di sebagian wilayah Jakarta. https://t.co/Ko2TzhgFZL,8,1,1,0,2022-01-06,21,Thursday,4,9,1
1479207113360658437,2022-01-06 21:43:52,"PPKB dan TS merupakan jalur undangan masuk UI di jenjang S1 paralel, D3 Vokasi, &amp; S1 Internasional. Apa saja syaratnya? Cek yuk! Via: detikedu https://t.co/W4aJjnrffc",6,0,2,0,2022-01-06,21,Thursday,4,8,0
1479205571685453824,2022-01-06 21:37:45,Residivis ditangkap polisi lantaran mencuri sepeda motor milik peternak di Tasikmalaya. Pelaku kembali masuk bui setelah tiga bulan lalu menghirup udara bebas. https://t.co/24DK2rmqnu,5,0,0,0,2022-01-06,21,Thursday,4,5,0
1479204268615811073,2022-01-06 21:32:34,Ferdinand Hutahaean dilaporkan ke Bareskrim Polri atas cuitan 'Allahmu ternyata lemah' di Twitter. Polisi telah menaikkan kasus dari penyelidikan ke penyidikan. https://t.co/073DxEtfM5,38,12,11,5,2022-01-06,21,Thursday,4,49,17
1479202616097878022,2022-01-06 21:26:00,"""Orang Indonesia itu kreatif-kreatif. Untuk vaksinasi ada namanya joki vaksinasi, saya dengar juga untuk karantina ada joki karantina,"" kata Menkes Budi Gunadi. https://t.co/1wWWeK43Px",32,13,11,9,2022-01-06,21,Thursday,4,43,22
1479199811484139523,2022-01-06 21:14:51,Mendagri Tito meminta kepala daerah agar mengutamakan program pengendalian pandemi COVID-19 di tahun 2022. https://t.co/Tj3EN9BtFU,5,0,0,0,2022-01-06,21,Thursday,4,5,0
1479198716947017729,2022-01-06 21:10:30,Transplantasi rambut menjadi tren baru di kalangan selebriti untuk mengatasi kerusakan rambut. Berikut sederet fakta terkait transplantasi rambut. https://t.co/oKRuSRFvH2,6,0,0,0,2022-01-06,21,Thursday,4,6,0
1479197213414895626,2022-01-06 21:04:32,Rekaman video menampilkan odong-odong nyemplung sungai viral di media sosial. Seperti apa? https://t.co/zPeDwHOhTj,5,0,0,0,2022-01-06,21,Thursday,4,5,0
1479195727565922308,2022-01-06 20:58:38,Kepala BIN Budi Gunawan membeberkan modus-modus kecurangan yang terjadi saat karantina untuk mencegah penyebaran virus Corona. Apa saja? https://t.co/FI2BY3nLpD,12,1,0,0,2022-01-06,20,Thursday,4,12,1
1479194597104439302,2022-01-06 20:54:08,PT Mayora Indah Tbk membuka lowongan kerja untuk para calon pegawai melalui jalur MDP 2022. Cek syaratnya di sini. https://t.co/vIgQOrybu9,7,0,0,0,2022-01-06,20,Thursday,4,7,0
1479193111842758667,2022-01-06 20:48:14,"PDIP sebut kemajuan DKI Jakarta era Anies jauh di bawah era Jokowi, Basuki Tjahaja Purnama-Djarot Saiful Hidayat. Ketua DPP PKS Mardani Ali Sera membela Anies. https://t.co/f3Y90xyFOO",101,80,16,6,2022-01-06,20,Thursday,4,117,86
1479192123002036230,2022-01-06 20:44:18,Muncul temuan bocornya 6 juta data pasien COVID-19 Kemenkes RI hingga dijual. Bagaimana penjelasan Kemenkes RI? https://t.co/nfNffRD3gp,12,4,4,1,2022-01-06,20,Thursday,4,16,5
1479190853205864461,2022-01-06 20:39:16,Bihun goreng selalu enak dimakan kapan saja. Yang satu ini tidak memakai kecap manis tetapi rasanya dijamin gurih nagih. Karena isiannya udang dan telur. https://t.co/VbCBA1vCet,9,0,3,0,2022-01-06,20,Thursday,4,12,0
1479189549192519680,2022-01-06 20:34:05,Bocah perempuan berusia 16 tahun diperkosa ayah tirinya di Sukabumi. Polisi menjebloskan pria bejat tersebut ke sel tahanan. https://t.co/D8xk7TjmS4,8,4,2,1,2022-01-06,20,Thursday,4,10,5
1479188269049036801,2022-01-06 20:28:59,"Melalui Tol Banjarmasin-Samarinda, waktu yang dibutuhkan sekitar dua jam ke IKN.  https://t.co/4OPwCjs9yk",12,2,3,0,2022-01-06,20,Thursday,4,15,2
1479186792444272644,2022-01-06 20:23:07,Anggota DPRD memang bertugas mengawasi. Giring memang ditemani oleh anggota DPRD DKI saat berada di lokasi itu. https://t.co/qAw3r6QJvU,7,1,1,1,2022-01-06,20,Thursday,4,8,2
1479185264723566596,2022-01-06 20:17:03,"AC Milan meraih kemenangan perdana di tahun 2022. Menjamu AS Roma di pekan ke-20 Serie A, Rossoneri menang 3-1. https://t.co/WD4XTYx8kv",3,0,1,0,2022-01-06,20,Thursday,4,4,0
1479183408429473799,2022-01-06 20:09:41,Pasukan keamanan Sudan menembak mati tiga pengunjuk rasa dalam demonstrasi menentang militer pada Kamis (6/1). https://t.co/XLa2XeDnlr,7,0,1,0,2022-01-06,20,Thursday,4,8,0
1479181855333171202,2022-01-06 20:03:30,KPK berjanji menindaklanjuti laporan itu. https://t.co/ZNGp8aS7Xt,9,3,5,2,2022-01-06,20,Thursday,4,14,5
1479179890448547846,2022-01-06 19:55:42,Orang-orang berduit pun mulai membeli tanah virtual di metaverse. Salah satunya digunakan untuk mengadakan konser virtual. https://t.co/lQIJ16twTe,11,6,2,3,2022-01-06,19,Thursday,4,13,9
1479178594966515714,2022-01-06 19:50:33,"Suami dari korban, Askari (35) menduga pelaku mempunyai masalah lalu menjadikan istrinya sasaran pelampiasan masalah. https://t.co/10qZu6oISn",12,0,1,0,2022-01-06,19,Thursday,4,13,0
1479177203002880003,2022-01-06 19:45:01,Momen seperti ini dinilai memang disengaja oleh Jokowi untuk memberi pesan khusus. Apa itu? https://t.co/JiB6LfK4Jg,10,4,2,1,2022-01-06,19,Thursday,4,12,5
1479175721289457672,2022-01-06 19:39:08,"Kondisi jalan yang rusak dan bergelombang karena tanah, kini sudah bersih. #detikcomdoyourmagic https://t.co/6CgaSiQ4YR",8,0,1,0,2022-01-06,19,Thursday,4,9,0
1479173951230070786,2022-01-06 19:32:06,"Hingga akhir 2021, total jalan tol yang beroperasi di Indonesia telah mencapai 2.457 km. Tapi tahukah kamu tol mana yang paling panjang di Indonesia? https://t.co/5qx8s0Iuze",17,4,5,1,2022-01-06,19,Thursday,4,22,5
1479172339199885319,2022-01-06 19:25:42,"Kantor Dinas Sosial (Dinsos) Kendari, Sulawesi Tenggara (Sultra) terbakar. Kerugian akibat kebakaran itu ditaksir lebih dari Rp 1 miliar. https://t.co/ouzhnMGlaw",7,0,3,0,2022-01-06,19,Thursday,4,10,0
1479170583317426178,2022-01-06 19:18:43,Bareskrim segera memanggil Ferdinand Hutahaean di kasus cuitan 'Allahmu lemah' usai kasusnya naik penyidikan. Ferdinand Hutahaean masih berstatus sebagai saksi. https://t.co/fOEIVuealN,13,12,2,1,2022-01-06,19,Thursday,4,15,13
1479169266221993988,2022-01-06 19:13:29,Petenis dunia Novak Djokovic tidak diperkenankan masuk ke Australia setelah dia tidak bisa menunjukkan bukti vaksinasi COVID-19. https://t.co/yDAH6Ecqs0,5,1,1,0,2022-01-06,19,Thursday,4,6,1
1479167916310515722,2022-01-06 19:08:07,Menlu Retno Marsudi mengatakan pandemi telah menyadarkan dunia bahwa ketahanan kesehatan menjadi hal yang sangat krusial. https://t.co/DtsqMijezc,5,0,4,0,2022-01-06,19,Thursday,4,9,0
1479166623646990344,2022-01-06 19:02:59,"Bagi kamu yang sedang ingin mencari harga minyak goreng murah, kamu bisa kok memanfaatkan promo Alfamart yang satu ini. https://t.co/plB05sHAK6",6,0,6,1,2022-01-06,19,Thursday,4,12,1
1479165050531295235,2022-01-06 18:56:44,Aston Villa dikabarkan mendekati Philippe Coutinho. Manajer Aston Villa Steven Gerrard pun memberikan tanggapannya. https://t.co/jxoYxRPIxy,4,0,1,0,2022-01-06,18,Thursday,4,5,0
1479163288101347328,2022-01-06 18:49:44,Penjualan tiket MotoGP 2022 mulai dibuka pada 6 Januari secara online dan offline. Mau beli tiket MotoGP via aplikasi? Begini caranya. https://t.co/4oTH7UzpkE,6,0,2,1,2022-01-06,18,Thursday,4,8,1
1479161178840616963,2022-01-06 18:41:21,Walikota Bekasi ditangkap KPK karena diduga terkait jual beli jabatan. Apa saja hal yang terungkap? https://t.co/atWlYegYSI,11,0,5,0,2022-01-06,18,Thursday,4,16,0
1479158575352135684,2022-01-06 18:31:00,Ada masanya Scarlett Bordeaux jadi bintang gulat di arena WWE. Tapi semua berubah akibat 'kecelakaan' implan payudara. Ia pun merambah situs dewasa. https://t.co/8btYsrgt8m,5,0,0,0,2022-01-06,18,Thursday,4,5,0
1479157079705198593,2022-01-06 18:25:03,"Sebidang real estat virtual di metaverse terjual seharga US$ 4,3 juta di The Sandbox. Nilainya setara Rp 61,9 miliar (asumsi kurs: Rp 4.400). https://t.co/Rk3HSAEbyp",11,2,3,0,2022-01-06,18,Thursday,4,14,2
1479155646884827140,2022-01-06 18:19:22,"Tak mau minum air mineral dari merek lain, wanita ini punya cara cerdik atasi kebiasaan suaminya. Mengisi ulang botol dengan air keran, membuatnya lebih hemat. https://t.co/7q1yxGmoeb",4,0,1,0,2022-01-06,18,Thursday,4,5,0
1479154314211954688,2022-01-06 18:14:04,"Menurut Erick, siklus pasokan ini seharusnya sudah diantisipasi. Dia bilang, sebuah kesalahan besar jika masalah pasokan ini tidak terencana. https://t.co/rbfaclwA6H",8,2,1,0,2022-01-06,18,Thursday,4,9,2
1479151800641015818,2022-01-06 18:04:05,Musisi Addie MS akhirnya bertemu dengan pasangan suami-istri pengamen keroncong yang viral bersuara merdu. Simak lagi kisahnya: #detiktif https://t.co/MvLTtqNl8v,31,3,3,1,2022-01-06,18,Thursday,4,34,4
1479149741783105537,2022-01-06 17:55:54,Tren spirit doll atau boneka arwah ramai dibicarakan. Sebagian orang mungkin merasa ngeri atau takut melihat boneka tersebut. Namanya pediophobia. https://t.co/bdjBq0jsqo,5,4,1,2,2022-01-06,17,Thursday,4,6,6
1479148488529166339,2022-01-06 17:50:55,Seberapa fokus kamu saat ini? Yuk coba latih otak dengan teka-teki matematika berikut. Ada teka-teki yang mudah sampai susah. https://t.co/CRiR3NAPG1,4,3,1,1,2022-01-06,17,Thursday,4,5,4
1479147190694166530,2022-01-06 17:45:46,Kejadian itu berawal dari adanya ke khawatiran warga telah terjadi kebakaran di salah satu rumah sekitar pukul 10.00 WIB. Begini ceritanya: https://t.co/rzhaKqVC2d,1,0,3,0,2022-01-06,17,Thursday,4,4,0
1479146106936348676,2022-01-06 17:41:27,"LTMPT memberi bocoran kisi-kisi materi tes UTBK SBMPTN 2022, yang berbeda dengan tahun sebelumnya. Simak yuk, semoga kamu sukses ya! Via: detikedu https://t.co/tQyGqnsLXd",27,1,4,0,2022-01-06,17,Thursday,4,31,1
1479145082578214918,2022-01-06 17:37:23,Ternyata bukan kali ini saja Ustaz Yusuf Mansur berurusan dengan hukum. https://t.co/OKfy8PO2Q0,4,7,4,0,2022-01-06,17,Thursday,4,8,7
1479143805270044679,2022-01-06 17:32:18,"Kemunculan berbagai varian Corona baru semakin membuat dunia khawatir. Berikut perbedaan antara varian Delta, Omicron, dan IHU yang wajib diketahui. https://t.co/fDGNkbecc3",17,6,8,6,2022-01-06,17,Thursday,4,25,12
1479142460118999048,2022-01-06 17:26:58,"Veteran tertua Amerika Serikat, Lawrence Brooks, meninggal pada Rabu (5/1) waktu setempat pada usia 112 tahun. https://t.co/Sv3ug93rYc",10,0,3,0,2022-01-06,17,Thursday,4,13,0
1479141165677129728,2022-01-06 17:21:49,Gubernur Jawa Barat Ridwan kamil tanggapi soal Wali Kota Bekasi Rahmat Effendi yang kena OTT KPK. Kang Emil mengingatkan ke pejabat publik tentang benteng pertama adalah integritas. https://t.co/6llkgFxQhA,14,4,7,0,2022-01-06,17,Thursday,4,21,4
1479139758093873152,2022-01-06 17:16:14,Kader dan anggota Fraksi PDIP DPRD Sukoharjo membagikan 12 ribu paket beras bergambar Puan Maharani mulai hari ini. Seperti apa penampakannya? https://t.co/97tDUKSIJk,4,23,1,4,2022-01-06,17,Thursday,4,5,27
1479137469991989259,2022-01-06 17:07:08,"Polisi menangkap dua pelaku pembunuhan sopir angkot dalam bentrokan maut di Kendari, Sulawesi Tenggara (Sultra). Kedua pelaku berinisial ID dan AH. https://t.co/ZAWX7htcco",7,0,0,0,2022-01-06,17,Thursday,4,7,0
1479136686886068231,2022-01-06 17:04:01,"Kebakaran terjadi pada rumah tinggal di daerah Slipi, Jakarta Barat (Jakbar). Ada 10 unit mobil pemadam kebakaran yang dikerahkan untuk memadamkan api. https://t.co/FXpXzQ2kuA",6,0,1,0,2022-01-06,17,Thursday,4,7,0
1479136202129297411,2022-01-06 17:02:06,"Penemuan ikan berukuran jumbo membuat heboh warga di Lhokseumawe, Aceh. Ikan itu disebut jenis arapaima dan sengaja dibuang pemiliknya. https://t.co/cKPM2Kt9XB",3,2,0,0,2022-01-06,17,Thursday,4,3,2
1479134895444303877,2022-01-06 16:56:54,"Nur Afiah (28), ART warga keturunan asal Bulukumba, Sulsel dibunuh secara sadis oleh majikan eks finalis MasterChef Malaysia. Bagaimana kisahnya? https://t.co/4XOVC4sSIn",38,6,15,2,2022-01-06,16,Thursday,4,53,8
1479133796125618183,2022-01-06 16:52:32,Ayah dari dua orang wisatawan korban tewas dan hilang di Pantai Glagah mengungkap detik-detik peristiwa memilukan yang terjadi kemarin. Seperti apa? https://t.co/n3ybzZG9wJ,7,1,0,0,2022-01-06,16,Thursday,4,7,1
1479132443521208324,2022-01-06 16:47:10,Kapolri Jenderal Listyo Sigit Prabowo meminta seluruh jajarannya mewaspadai adanya joki karantina. Kapolri juga memerintahkan anggotanya untuk mengamankan para pasien karantina yang keluar sebelum waktunya. https://t.co/6aCfO6CfPv,16,8,7,3,2022-01-06,16,Thursday,4,23,11
1479131941446242309,2022-01-06 16:45:10,"Ketua Umum Pemuda Muhammadiyah, Sunanto menilai sudah sepantasnya Ferdinand dilaporkan ke polisi. https://t.co/o65ZY9nXps",22,10,5,0,2022-01-06,16,Thursday,4,27,10
1479131142649528326,2022-01-06 16:41:59,"Azis Syamsuddin sambil menangis menyampaikan terima kasih kepada saksi meringankan yakni seorang warga dari Lampung Timur, Yanti Sumiati. Azis menyebut Yanti adalah titipan Allah yang membantunya. https://t.co/bLMXJvK1kl",8,5,0,1,2022-01-06,16,Thursday,4,8,6
1479130117016227841,2022-01-06 16:37:55,Presiden Jokowi kerap mengunggah foto saat sedang memakai sepatu saat blusukan ke daerah. Ini sejumlah momennya. https://t.co/0E4OUUkPEK,7,1,0,1,2022-01-06,16,Thursday,4,7,2
1479129323596660737,2022-01-06 16:34:46,"Heboh makam muncul tiba-tiba di pinggir jalan Kecamatan Prigen Pasuruan. Polisi pun turun tangan, ternyata makam ini sengaja dibuat agar tak ada lagi warga buang sampah sembarangan. https://t.co/bNNJtLtNt9",13,2,2,0,2022-01-06,16,Thursday,4,15,2
1479127738539782150,2022-01-06 16:28:28,Demonstrasi berujung ricuh terjadi di Kazakhstan. Ada 18 orang petugas keamanan yang tewas dan 748 lainnya terluka saat berupaya meredam kerusuhan. https://t.co/EmVXWT8WFq,13,0,2,0,2022-01-06,16,Thursday,4,15,0
1479127517915144197,2022-01-06 16:27:35,Vamos Indonesia resmi mengumumkan skuadnya musim ini. Tim Vamos yang kini bermarkas di Kota Bekasi mengusung semangat dan optimisme.  https://t.co/OdWioL8qUW,3,0,1,1,2022-01-06,16,Thursday,4,4,1
1479126480793784325,2022-01-06 16:23:28,Kapolri Jenderal Listyo Sigit Prabowo menyebut telah menerjunkan 618 personel untuk berjaga di 206 lokasi karantina demi mengawasi proses karantina yang dilakukan para pelaku perjalanan luar negeri yang tiba di Tanah Air.  https://t.co/tWkZPj5odP,4,2,0,0,2022-01-06,16,Thursday,4,4,2
1479125315339313156,2022-01-06 16:18:50,"Ayam kukus biasa jadi pilihan untuk olahan ayam enak. Berbumbu minimalis jahe, bawang putih dan kecap rasanya tetap gurih enak. Apalagi disantap saat hangat. https://t.co/PQwcOaXSZd",4,0,2,0,2022-01-06,16,Thursday,4,6,0
1479124459227385862,2022-01-06 16:15:26,"Chicco Jerikho mengaku belum ingin menambah momongan dengan sang istri, Putri Marino. Chicco menyebut karena dirinya dan Putri masih sama-sama sibuk syuting film. https://t.co/TPyP6XDO1n",2,0,0,1,2022-01-06,16,Thursday,4,2,1
1479123606378618880,2022-01-06 16:12:03,Suhu udara di Kota Yogyakarta belakangan ini terasa panas padahal masih musim hujan. BMKG memberi penjelasan. https://t.co/RJMdJeYTSg,18,1,7,4,2022-01-06,16,Thursday,4,25,5
1479123013597597698,2022-01-06 16:09:41,"Kasetpres Heru Budi Hartono dinilai layak menjadi Penjabat Gubernur DKI. Sebelum menjadi Kasetpres, Heru pernah mengisi berbagai macam posisi jabatan di DKI. Begini sosoknya: https://t.co/dkdmOb9KPN",9,1,1,2,2022-01-06,16,Thursday,4,10,3
1479121871945748482,2022-01-06 16:05:09,Kabar hilangnya gadis tersebut juga sempat viral di Facebook. Informasi yang tersebar di Facebook menyebutkan bahwa korban hilang diculik pria bermotor. https://t.co/xbZdJ2ikxj,6,0,1,0,2022-01-06,16,Thursday,4,7,0
1479120371311792133,2022-01-06 15:59:11,"Seorang guru di Toba, Sumatera Utara ditangkap polisi. Guru berinisial HMS ini diduga memeluk dan mencium seorang siswi kelas VII SMP di ruang guru. https://t.co/5B9m6HBCmZ",25,7,7,0,2022-01-06,15,Thursday,4,32,7
1479120147138764801,2022-01-06 15:58:18,Petenis Novak Djokovic dipastikan tak bisa tampil di Australia Open 2022 meski sudah dapat pengecualian medis vaksin COVID-19. https://t.co/jJHdD4tH2E,6,2,0,1,2022-01-06,15,Thursday,4,6,3
1479119004119670789,2022-01-06 15:53:45,"Pemerintah menerbitkan aturan baru karantina bagi pelaku perjalanan dari luar negeri. Kini, pejabat tak bisa lagi karantina di rumah. Ini lokasi karantinanya: https://t.co/vEDK9S7AAa",9,1,2,0,2022-01-06,15,Thursday,4,11,1
1479117667483074560,2022-01-06 15:48:27,Seorang pria mencuri ransel milik warga yang salat di Masjid Dengok Kidul Klaten. Korban justru tulis pesan menyentuh untuk pelakunya. Seperti apa? https://t.co/A5NfKinXSv,13,1,3,0,2022-01-06,15,Thursday,4,16,1
1479115839156592649,2022-01-06 15:41:11,"Wali Kota Bekasi, Rahmat Effendi bungkam saat meninggalkan gedung merah putih KPK, Kamis 6/1/2022 malam usai ditetapkan sebagai tersangka korupsi. https://t.co/BptVStEsqu",21,3,3,1,2022-01-06,15,Thursday,4,24,4
1479115323722776577,2022-01-06 15:39:08,Kazakhstan rusuh. Negara besar tanpa lautan itu menjadi palagan demonstarsi hingga Presiden membubarkan kabinetnya. Ini sejumlah faktanya. https://t.co/5r4hfBRuhX,20,2,11,2,2022-01-06,15,Thursday,4,31,4
1479114493636448264,2022-01-06 15:35:50,Persija Jakarta berhasil mengalahkan PSIS Semarang di pekan ke-18 BRI Liga 1 musim ini. Marko Simic menjadi bintang kemenangan Macan Kemayoran lewat dua golnya. https://t.co/EeX8Zj1QHS,6,0,3,0,2022-01-06,15,Thursday,4,9,0
1479114271329906692,2022-01-06 15:34:57,"Pada waktu kejadian, tidak ada keluarga korban yang mengetahui kejadian lakalantas ini. https://t.co/AX0TIm16DL",13,0,2,0,2022-01-06,15,Thursday,4,15,0
1479113413297016836,2022-01-06 15:31:32,"Pihak Azis Syamsuddin menghadirkan saksi meringankan, salah satunya seorang warga dari Lampung Timur. Sambil menangis, ia berterima kasih kepada Azis yang pernah membantu biaya operasi bayi yang baru dilahirkannya dan divonis hydromakoli. https://t.co/tmHtsQMuOd",11,7,4,4,2022-01-06,15,Thursday,4,15,11
1479112013221490697,2022-01-06 15:25:59,Shin Tae-yong mengakui ada klub Korea Selatan yang meminati pemain Timnas Indonesia. Hal ini menguatkan kabar yang beredar usai gelaran Piala AFF 2020.  https://t.co/QaDfKlAjoi,98,2,11,2,2022-01-06,15,Thursday,4,109,4
1479111806081634307,2022-01-06 15:25:09,Scarlett Bordeaux pernah jadi bintang gulat WWE. Akibat 'kecelakaan' implan payudara ia kini jualan foto syur di situs dewasa.  https://t.co/pU9gpOpZ2V,10,0,0,0,2022-01-06,15,Thursday,4,10,0
1479111752323272705,2022-01-06 15:24:56,CEO Erajaya Digital Joy Wahjudi mengatakan model kemitraan seperti ini merupakan bagian dari strategi untuk mengembangkan jaringan ritel bisnis Erajaya. https://t.co/R2dOD1mysF,6,0,1,0,2022-01-06,15,Thursday,4,7,0
1479110659933573128,2022-01-06 15:20:36,Legenda bulutangkis Luluk Hadiyanto angkat bicara soal rumor dicoretnya Praveen Jordan/Melati Daeva Oktavianti dari Pelatnas PBSI.  https://t.co/Sbwlb9PjoJ,19,2,3,2,2022-01-06,15,Thursday,4,22,4
1479110658511699973,2022-01-06 15:20:36,"Samuel Morse memperkenalkan telegraf, alat pengirim pesan telegram pada 6 Januari 1838. Kini orang malah tahu Telegram sebagai nama aplikasi pesan. Ini potret telegram asli:  https://t.co/PCekfAGArA",20,0,6,0,2022-01-06,15,Thursday,4,26,0
1479110346619031556,2022-01-06 15:19:21,Irfan Jaya resmi memperkuat Bali United. Dia akan segera bergabung dengan tim usai menjalankan masa karantina sekembalinya dari Singapura.  https://t.co/c9JngCvFmy,16,2,7,0,2022-01-06,15,Thursday,4,23,2
1479110125113643009,2022-01-06 15:18:29,"Tisu magic dipercaya dapat mengatasi masalah ejakulasi dini pada pria. Bahkan, dapat membuat penis lebih lama mengalami ereksi saat berhubungan seksual. https://t.co/FHeGxd7hyw",10,5,2,3,2022-01-06,15,Thursday,4,12,8
1479108695908708359,2022-01-06 15:12:48,"Samsung Indonesia masih rahasiakan harga Galaxy S21 FE. Berbeda di negara tetangga, banderol ponsel penerus Galaxy S20 FE ini sudah terungkap, segini harganya: https://t.co/pfzZpxG0D6",16,1,3,2,2022-01-06,15,Thursday,4,19,3
1479108130193608716,2022-01-06 15:10:33,"Di sisi lain, selama tiga bulan pertama di tahun 2021, Telkomsel terus membangun Base Transceiver Station yang seluruhnya berbasis 4G. https://t.co/e9ahr3uoRm",13,0,5,1,2022-01-06,15,Thursday,4,18,1
1479108107791863813,2022-01-06 15:10:28,Masa jabatan Anies Baswedan selaku Gubernur DKI habis pada Oktober 2022. Nama Kasetpres Heru Budi Hartono pun muncul sebagai kandidat Penjabat Gubernur DKI. https://t.co/bbKrifItvT,22,2,6,0,2022-01-06,15,Thursday,4,28,2
1479107247510720516,2022-01-06 15:07:02,"Setelah puncak infeksi di Juli 2021, perlahan kasus COVID-19 di Indonesia terkendali. Apakah ini disebabkan adanya super immunity COVID-19 di Indonesia? https://t.co/ILkRJEmk5l",9,0,7,0,2022-01-06,15,Thursday,4,16,0
1479105007026794499,2022-01-06 14:58:08,"Bisnis terima gadai motor bodong, emak-emak di Semarang ditangkap polisi. Di rumahnya, polisi menemukan 46 sepeda motor tanpa dilengkapi dokumen kendaraan. https://t.co/f9E4jUPnQF",12,0,0,1,2022-01-06,14,Thursday,4,12,1
1479104199530934280,2022-01-06 14:54:56,Samsung membawa sederet teknologi canggih dan ramah lingkungan di pesta teknologi dunia CES 2022. Mulai dari SolarCell remote hingga The Freestyle. https://t.co/hOE8sGrA7m,17,0,4,1,2022-01-06,14,Thursday,4,21,1
1479103181510430720,2022-01-06 14:50:53,"LaNyalla mendorong agar Pemprov Sulsel bisa lebih menekan angka stunting, bahkan hingga mencapai 0 persen. https://t.co/l5Cj7XAdsb",20,0,10,1,2022-01-06,14,Thursday,4,30,1
1479102362073505800,2022-01-06 14:47:38,"Wagub DKI Jakarta Ahmad Riza Patria mengaku tak masalah anggaran sumur resapan tahun 2022 dihapus. Menurutnya, program penanganan banjir tak cuma sumur resapan. https://t.co/B3FCkJt54B",22,11,7,3,2022-01-06,14,Thursday,4,29,14
1479102041876164612,2022-01-06 14:46:21,"Di aplikasi PeduliLindungi, kita bisa mengecek sertifikat vaksin orang lain. Begini caranya:  https://t.co/E05CkTj064",17,2,6,1,2022-01-06,14,Thursday,4,23,3
1479100972664188936,2022-01-06 14:42:06,"Tank-tank Israel menembaki para tersangka di sepanjang perbatasan Suriah di Dataran Tinggi Golan, setelah mereka terdeteksi berada di dekat pasukan Israel. https://t.co/pjdBOYwrm9",6,0,3,0,2022-01-06,14,Thursday,4,9,0
1479100050538070017,2022-01-06 14:38:27,"Rasulullah SAW menjadi teladan dan panutan bagi umat muslim. Semasa hidupnya, beliau menganjurkan untuk selalu berbagi makanan, termasuk dengan tetangga. https://t.co/xIHCo2gWGP",54,1,18,2,2022-01-06,14,Thursday,4,72,3
1479099196347084808,2022-01-06 14:35:03,Seorang pelajar inisial R (15) tewas dengan celurit tertancap di kepala. Korban diduga terlibat tawuran dengan kelompok lawan. https://t.co/UCbnxENRFM,137,72,33,27,2022-01-06,14,Thursday,4,170,99
1479098693118619648,2022-01-06 14:33:03,"Pancake bisa dijadikan menu sarapan ala barat. Kalau ingin membuatnya sendiri, ikuti cara membuat pancake yang sederhana dan fluffy. https://t.co/oXAvoOJ1nb",10,0,4,2,2022-01-06,14,Thursday,4,14,2
1479098334816079872,2022-01-06 14:31:37,Hakim agung Eddy Army menilai Djoko Tjandra layak dilepaskan karena yang diperbuatnya adalah perkara perdata. Siapakah Eddy? https://t.co/1dJVu0eAKJ,22,10,11,8,2022-01-06,14,Thursday,4,33,18
1479096449291853828,2022-01-06 14:24:08,"Kaotmilti II Jakarta Brigjen TNI Edi Imran mengatakan akan bekerja ekstra agar kasus ini segera selesai, sesuai perintah Jenderal TNI, Andika Perkasa. https://t.co/gNXygXIGi0",5,1,3,0,2022-01-06,14,Thursday,4,8,1
1479095963419484163,2022-01-06 14:22:12,"Olahan ayam berbumbu klasik selalu bikin keluarga kangen. Mulai dari ayam goreng ungkep, sop ayam kampng hingga semur ayam yang gurih legit. https://t.co/7fk3n68pKD",5,0,2,1,2022-01-06,14,Thursday,4,7,1
1479094755174674435,2022-01-06 14:17:24,Seorang investor dan miliarder ini memberikan nasihat bagi anak-anak muda buat yang mau sukses. Apa nih katanya? https://t.co/6UKmSA4M54,9,0,6,0,2022-01-06,14,Thursday,4,15,0
1479093969250406401,2022-01-06 14:14:17,"Biznet Gio, anak usaha Biznet di bidang layanan komputasi awan meyakini bisa bersaing dengan kompetitornya yang berskala global.  https://t.co/Bv4cjn4BWO",2,0,3,0,2022-01-06,14,Thursday,4,5,0
1479093176560500741,2022-01-06 14:11:08,Sering kali kelakuan suami membuat para istri jengkel hingga frustrasi. Contohnya terdapat pada perlakuan mereka terhadap makanan ini. Adakah yang senasib? https://t.co/TCXmTCIctz,3,0,3,1,2022-01-06,14,Thursday,4,6,1
1479091606426992640,2022-01-06 14:04:53,"#Terpopuler Giring meninjau lokasi Formula E dan mengeluhkan sejumlah hal, termasuk bertemu kambing. Gerindra berkelakar apakah kambingnya meminta foto kepada Giring. https://t.co/gYP2A3Erk1",43,7,9,3,2022-01-06,14,Thursday,4,52,10
1479091368479895553,2022-01-06 14:03:57,#Terpopuler Anwar Abbas menilai pernyataan Ferdinand menyakiti hati umat Islam. https://t.co/s4xlg7UY8z,20,2,7,2,2022-01-06,14,Thursday,4,27,4
1479091344354205696,2022-01-06 14:03:51,"Sebuah rumah mewah yang juga bersejarah di Kota Pekanbaru, Riau terbakar. Akibatnya ada puluhan kucing dan benda bersejarah di rumah tua yang terbakar. https://t.co/F5l5xR8VJb",43,5,8,7,2022-01-06,14,Thursday,4,51,12
1479090500384829440,2022-01-06 14:00:30,"Kekerasan seksual adalah tindakan mengarah pada ajakan seksual tanpa persetujuan, termasuk pada anak. Ini peran orang tua agar agar anak terhindar dari hal itu. #detikNetwork  https://t.co/gqtrIz4Ar6",9,2,2,0,2022-01-06,14,Thursday,4,11,2
1479089928365649920,2022-01-06 13:58:13,Lukisan ikonik dan terbesar karya Rembrandt van Rijn yang berjudul The Night Watch kini bisa dilihat lebih dekat. https://t.co/8dZH8WOwRt,6,0,1,0,2022-01-06,13,Thursday,4,7,0
1479089628003147777,2022-01-06 13:57:02,Juru Bicara Satgas COVID-19 Prof Wiku Adisasmito mengatakan bakal ada perubahan aturan. https://t.co/fSTmsfI9qi,11,0,3,0,2022-01-06,13,Thursday,4,14,0
1479089144618000389,2022-01-06 13:55:06,#Terpopuler Ketum DPP PSI Giring Ganesha kejeblos lumpur saat melakukan sidak di lokasi sirkuit Formula E di Ancol. Simak momennya: https://t.co/zJm92SWZSx,9,0,1,0,2022-01-06,13,Thursday,4,10,0
1479089129354846216,2022-01-06 13:55:03,Anang Hermansyah melakukan transplantasi rambut di Turki. Ada komentar netizen yang nyeleneh soal penampilan Anang yang kini disebut mirip Raul Lemos. Hmm🤔 https://t.co/rtvazwFnv5,56,54,5,11,2022-01-06,13,Thursday,4,61,65
1479088907782397952,2022-01-06 13:54:10,Saul Niguez tampil apik saat Chelsea mengalahkan Tottenham Hotspur. Thomas Tuchel menilai Saul perlahan mulai melewati masa adaptasi yang sulit di Chelsea.  https://t.co/pIp58vwMrw,5,0,0,0,2022-01-06,13,Thursday,4,5,0
1479088885984546824,2022-01-06 13:54:05,"Terlepas dari kontroversinya, Snowdrop meraih popularitas di mancanegara. Drama yang dibintangi Jisoo BLACKPINK itu menjadi acara terpopuler di Disney+. https://t.co/pxEDrgjKqe",9,0,0,0,2022-01-06,13,Thursday,4,9,0
1479088359586906112,2022-01-06 13:51:59,"""Sudah satu tahun lebih kondisi jembatan seperti itu. Memang mengerikan,"" kata Yono, warga Sukamekarsari, Lebak. https://t.co/zerSDU4pzT",6,1,2,0,2022-01-06,13,Thursday,4,8,1
1479088093114339332,2022-01-06 13:50:56,Park Min Young akan kembali berakting dengan membintangi drama terbaru JTBC Weather People. Ini deretan drama terbaik Park Min Young:  https://t.co/sRfYNhBH3V,23,0,6,1,2022-01-06,13,Thursday,4,29,1
1479087798846173188,2022-01-06 13:49:46,Pemerintah mencatat ada ratusan perusahaan yang tidak memasok batu bara melalui Domestic Market Obligation (DMO) untuk PLN hingga Oktober 2021. https://t.co/zs1zFjhis7,20,4,4,6,2022-01-06,13,Thursday,4,24,10
1479087561607950341,2022-01-06 13:48:49,#Terpopuler Ramai tagar #TangkapFerdinand di media sosial. Tagar itu muncul usai cuitan Ferdinand Hutahaean soal 'Allahmu ternyata lemah'. https://t.co/n94JrDMJm1,8,0,2,0,2022-01-06,13,Thursday,4,10,0
1479087544323260416,2022-01-06 13:48:45,Video seorang oknum TNI di Maluku memukul remaja viral di medsos. Video tersebut menjadi sorotan karena tindakan oknum TNI tersebut dinilai arogan. https://t.co/3TWg8pR3LH,13,2,7,0,2022-01-06,13,Thursday,4,20,2
1479085055188291585,2022-01-06 13:38:51,Kehadiran gedung tersebut diharapkan dapat mendorong tata kelola arsip berbasis IT sehingga semakin efektif. https://t.co/oryMDs8xqc,11,0,4,1,2022-01-06,13,Thursday,4,15,1
1479083704903471113,2022-01-06 13:33:29,"Di tengah ledakan kasus COVID-19, para nakes yang positif Corona di Prancis tetap bekerja merawat pasien. Kok bisa? Berikut penjelasannya. https://t.co/l6DY7rZ8n1",11,0,3,0,2022-01-06,13,Thursday,4,14,0
1479083181483737092,2022-01-06 13:31:25,Pelukis muda Surabaya ini peduli dengan lingkungan. Ia melukis dengan sampah agar warga lebih peduli akan lingkungan yang bebas sampah. Wow! https://t.co/eoshQTT63N,5,0,0,0,2022-01-06,13,Thursday,4,5,0
1479082587075325956,2022-01-06 13:29:03,"""Saya yakin Bapak Ibu kalau punya tanah di sini harganya sebentar lagi naik semuanya,"" ungkap Sri Mulyani. https://t.co/H9djGB5x9r",14,4,3,4,2022-01-06,13,Thursday,4,17,8
1479081817198280710,2022-01-06 13:25:59,Satreskrim Polresta Bandung menerima laporan kasus dugaan pencabulan yang diduga dilakukan oknum pengurus salah satu pondok pesantren di Kabupaten Bandung. Korban dilaporkan masih berusia di bawah umur ketika mengalami pencabulan tersebut. https://t.co/VGlJvqPwN5,6,0,4,2,2022-01-06,13,Thursday,4,10,2
1479080476736430082,2022-01-06 13:20:40,"Pria yang menertawakan relawan saat memberi imbauan keselamatan pada masyarakat di Gunung Semeru akhirnya minta maaf. Sebelumnya, video ini sempat viral. https://t.co/XddCvrfaCX",9,4,1,1,2022-01-06,13,Thursday,4,10,5
1479080193092431873,2022-01-06 13:19:32,Film Ben &amp; Jody garapan sutradara Angga Dwimas Sasongko mengisahkan sebuah persahabatan yang membela kelompok petani. Adaptasi cerita tersebut merupakan keinginan tertunda mendiang Glenn Fredly yang ingin membuat film action. https://t.co/ypw0Z69CUe,6,0,0,0,2022-01-06,13,Thursday,4,6,0
1479078551173410818,2022-01-06 13:13:01,KPK buka opsi untuk mendalami keterlibatan DPRD Kota Bekasi atas kasus suap jual beli jabatan dan pengadaan barang dan jasa Wali Kota Bekasi Rahmat Effendi. https://t.co/jd9WVLwcAs,13,1,4,1,2022-01-06,13,Thursday,4,17,2
1479078324299309060,2022-01-06 13:12:07,#Terpopuler Heri Santoso membuat pesawat terbang jenis STOL. Pesawat buatannya juga akan didarmabaktikan ke negara loh. Keren ya! https://t.co/exbyfCGbyM,16,2,2,1,2022-01-06,13,Thursday,4,18,3
1479078044811902980,2022-01-06 13:11:00,"Menanggapi hal itu, Kepala Staf Angkatan Laut Laksamana Yudo Margono mendesak BP2MI mengungkap siapa sosok TNI AL yang diduga terlibat dalam praktik pengiriman PMI ilegal tersebut. https://t.co/sNpU8HLnn3",7,1,0,0,2022-01-06,13,Thursday,4,7,1
1479077062291902467,2022-01-06 13:07:06,Diana Wardhani cerita awal kenal sampai jatuh hati dengan sang suami yang berprofesi sebagai anggota TNI. Ini kisahnya:  https://t.co/zvrl85gxoT,5,0,0,2,2022-01-06,13,Thursday,4,5,2
1479076730044305416,2022-01-06 13:05:47,Azis menyebut Yanti adalah titipan Allah yang membantunya. Dia pun mendoakan keluarga Yanti selalu dilindungi Allah SWT. https://t.co/xJ44ScWY9f,7,4,2,1,2022-01-06,13,Thursday,4,9,5
1479076170989723650,2022-01-06 13:03:33,Mulai dari comeback grup hingga bisnis NFT jadi beberapa rencana besar agensi Big 4 tahun ini.  https://t.co/se4hc7bKel,6,0,0,0,2022-01-06,13,Thursday,4,6,0
1479073719909855234,2022-01-06 12:53:49,Kenaikan harga bahan bakar LPG di Kazakhstan memicu gelombang protes. Situasi darurat pun diterapkan. https://t.co/jiUMuxZrII,3,0,1,1,2022-01-06,12,Thursday,4,4,1
1479073467211333633,2022-01-06 12:52:49,Presiden memerintahkan Menkum HAM serta Menteri Pemberdayaan Perempuan dan Perlindungan Anak (PPPA) segera berkoordinasi dengan DPR demi mempercepat pembahasan RUU Tindak Pidana Kekerasan Seksual (TPKS).  https://t.co/YLmXfEAo76,20,1,3,0,2022-01-06,12,Thursday,4,23,1
1479073449897254912,2022-01-06 12:52:44,Alun-alun Utara Yogyakarta dijual dengan nilai yang fantastis di situs bernama Next Earth. Ini penjelasan pakar IT:  https://t.co/WUBiggj03r,11,2,4,3,2022-01-06,12,Thursday,4,15,5
1479072910455480323,2022-01-06 12:50:36,"Tim K-Talk kali ini ngobrol bareng April 2nd, band asal Korea Selatan. Mereka buka-bukaan soal album baru hingga kesuksesan OST drakor yang mereka ciptakan. #KTalk  https://t.co/HQdTgJhDvM",3,0,1,0,2022-01-06,12,Thursday,4,4,0
1479072875533508612,2022-01-06 12:50:28,Lesti Kejora menangis saat mengingat lagi sang buah hati harus dilahirkan lebih cepat dari perkiraan. Ini kesedihan Lesti bicara ukuran baju sang buah hati. https://t.co/nzwdvUST7H,107,126,10,23,2022-01-06,12,Thursday,4,117,149
1479071234914664448,2022-01-06 12:43:56,Irfan Jaya resmi memperkuat Bali United. Dia akan segera bergabung dengan tim usai menjalankan masa karantina sekembalinya dari Singapura. https://t.co/pqMNaOq8AZ,11,0,1,0,2022-01-06,12,Thursday,4,12,0
1479070956878508034,2022-01-06 12:42:50,Dua pesawat tak berawak yang dilengkapi dengan bahan peledak dihancurkan. Drone tersebut awalnya menyasar pangkalan udara Ain al-Asad di Irak yang ditempati pasukan militer Amerika Serikat. https://t.co/9h1Wkvw1S5,5,0,0,0,2022-01-06,12,Thursday,4,5,0
1479070467902394375,2022-01-06 12:40:54,Urusan cuitan Ferdinand Hutahaean yang menyebut 'Allahmu ternyata lemah' berbuntut panjang. Bareskrim Polri langsung bergerak cepat. https://t.co/HNKno4WvuI,14,10,4,2,2022-01-06,12,Thursday,4,18,12
1479069728543055876,2022-01-06 12:37:57,Pasutri bernama Pak Eno dan Ibu Im itu tak menyangka videonya ditonton musisi pendiri Twilite Orchestra itu. #detiktif https://t.co/eIicCe0pwb,8,0,1,0,2022-01-06,12,Thursday,4,9,0
1479069139515977730,2022-01-06 12:35:37,Sejumlah sekolah di Amerika Serikat menunda pembelajaran tatap muka. Hal ini dilakukan karena infeksi Covid-19 varian omicron terus melonjak. https://t.co/RyJJ1pA4QG,12,1,2,0,2022-01-06,12,Thursday,4,14,1
1479067848240623617,2022-01-06 12:30:29,KPK menunjukan barang bukti uang kasus suap Wali Kota Bekasi Rahmat Effendi. Ketua KPK Firli mengatakan uang tunai Rp 3 miliar disita dalam kasus ini. https://t.co/VNVwuMTuDc,27,2,1,1,2022-01-06,12,Thursday,4,28,3
1479067365279154178,2022-01-06 12:28:34,"Makan kenyang dengan menu ayam goreng kampung berempah disajikan dengan sambal ganja, atau cicip mie Aceh versi kekinian bisa dicoba di sini. https://t.co/fIWCw85EoA",8,2,1,0,2022-01-06,12,Thursday,4,9,2
1479066594512932868,2022-01-06 12:25:30,Ternyata Atta Halilintar juga melakukan transplantasi rambut seperti Anang Hermansyah. Ini alasan Atta mau transplantasi rambut:  https://t.co/ms2t3XoqQe,6,0,0,1,2022-01-06,12,Thursday,4,6,1
1479066326958321668,2022-01-06 12:24:26,"Tren memiliki spirit doll membuat Ria Enes yang selama ini dikenal bersama Boneka Susan ikut berkomentar. Sejauh ini, Ria Enes dan Susan terus bersama. Ini potretnya:  https://t.co/ce3Nmo5dNU",13,9,4,3,2022-01-06,12,Thursday,4,17,12
1479066001731952646,2022-01-06 12:23:09,"Bologna vs Inter Milan kabarnya batal digelar akibat penggawa Bologna menjalani karantina. Ketidakjelasan duel ini disesalkan oleh CEO Inter, Beppe Marotta. https://t.co/U82ILLWpnk",6,0,3,0,2022-01-06,12,Thursday,4,9,0
1479065495890444296,2022-01-06 12:21:08,"Ibunda Rachel Vennya, Viens Tasman, berikan dukungan dan doa untuk anaknya. Ia berharap Rachel Vennya bisa kuat menjalani lika-liku kehidupan. https://t.co/6LmDNkFfAM",6,5,0,2,2022-01-06,12,Thursday,4,6,7
1479064964593823744,2022-01-06 12:19:01,Perwira TNI AD ini merupakan alumnus Akmil Tahun 1987. Dia mendapat tugas sebagai Pangdam Jaya sejak akhir Mei 2021. https://t.co/r3okdNI2Mk,10,0,0,0,2022-01-06,12,Thursday,4,10,0
1479064122436329475,2022-01-06 12:15:41,"Ling Jingwei diculik saat usianya 4 tahun. Terpisah selama 30 tahun, ia berhasil bertemu dengan ibu kandungnya berkat sebuah peta yang digambarnya. Ini kisahnya! https://t.co/sKjZN2Ljgq",8,0,0,0,2022-01-06,12,Thursday,4,8,0
1479063609854545923,2022-01-06 12:13:38,"Tangan diborgol, Kolonel Priyanto jalani rekonstruksi kasus tabrak lari serta pembunuhan H dan S. Simak selengkapnya di detikX https://t.co/qlZa1lS6ES https://t.co/0le8TDHDnw",25,4,4,0,2022-01-06,12,Thursday,4,29,4
1479063044026249220,2022-01-06 12:11:24,"""Kita sudah minta kepala daerah untuk supaya bekerja dengan baik jangan sampai mengalami hal yang seperti itu, jangan sampai terkena KPK,"" ujar Ma'ruf Amin. https://t.co/uzOiE9Yc71",5,2,0,1,2022-01-06,12,Thursday,4,5,3
1479062012135100418,2022-01-06 12:07:17,Dunia pariwisata mulai menggeliat kembali di tahun 2021. Hal itu tampak dari penjualan tiket domestik dan internasional yang mulai kembali melejit. https://t.co/BVVe2tYoN1,1,0,1,0,2022-01-06,12,Thursday,4,2,0
1479061751127855108,2022-01-06 12:06:15,Wali Kota Bekasi Rahmat Effendi jadi tersangka kasus pengadaan barang dan jasa serta lelang jabatan. Begini penampakannya saat mengenakan rompi tahanan KPK. https://t.co/7RmpjGWGWV,20,5,5,5,2022-01-06,12,Thursday,4,25,10
1479061317470277640,2022-01-06 12:04:32,"Mobil ambulans sempat melambat saat berpapasan dengan iring-iringan rombongan mobil Presiden di Jateng. Pengawal presiden lantas mengisyaratkan agar ambulans melanjutkan perjalanan, sementara rombongan memperlambat kecepatan. https://t.co/i7qwI0wrCX https://t.co/EXuMtNekLx",46,3,6,2,2022-01-06,12,Thursday,4,52,5
1479060387303723009,2022-01-06 12:00:50,"Bek Timnas Indonesia, Asnawi Mangkualam, mendapat perlakuan berbeda di klub Ansan Greeners setelah perhelatan Piala AFF 2020. #CNNIndonesia #detikNetwork  https://t.co/9b5MYTg37s",7,0,0,0,2022-01-06,12,Thursday,4,7,0
1479060168948297734,2022-01-06 11:59:58,Petugas Damkar Lamongan menangkap ular sanca sepanjang 3 meter. Ular ini telah memakan ayam peliharaan warga setiap harinya. https://t.co/7HdRSLYn3M,7,3,0,2,2022-01-06,11,Thursday,4,7,5
1479060144424210433,2022-01-06 11:59:52,Sederet brand busana muslim pun membuat inovasi dan kreasi baru yang dipopulerkan. Bagaimana ya untuk tren hijab 2022? https://t.co/0e6AAC3oKT,4,0,2,0,2022-01-06,11,Thursday,4,6,0
1479059597054947331,2022-01-06 11:57:42,"Ketersediaan konektivitas 5G di Indonesia diyakini bakal memberikan ragam keuntungan bagi masyarakat umum, industri lintas sektor, hingga pemerintahan. https://t.co/qIJCFXVi1g",9,0,5,1,2022-01-06,11,Thursday,4,14,1
1479059069986123788,2022-01-06 11:55:36,"Ada buah khas Bedugul, Bali yang banyak diperbincangkan karena viral di TikTok. Namanya buah salju yang ternyata kaya akan manfaat sehat. https://t.co/svwcOJOVj2",7,0,2,0,2022-01-06,11,Thursday,4,9,0
1479059047454236673,2022-01-06 11:55:31,Total tersangka dalam kasus korupsi Damkar Depok menjadi tiga. https://t.co/3IfPrOZKqk,8,0,4,1,2022-01-06,11,Thursday,4,12,1
1479058518397313026,2022-01-06 11:53:25,"TransJakarta sampai jam berapa hari ini? Pengguna busway cenderung mencari tahu informasi tersebut. Saat PPKM Level 2, apakah jam operasional busway berubah? https://t.co/3egZUFZQK0",2,0,2,1,2022-01-06,11,Thursday,4,4,1
1479058052066201601,2022-01-06 11:51:33,#Foto Pameran seni Let's Fly di Museum Balon Roma menampilkan balon dan karya seni tiup. Pengunjung bisa berfoto ria hingga mandi bola lho. Asyik banget! https://t.co/FZodSPrTt0,2,1,1,0,2022-01-06,11,Thursday,4,3,1
1479057802874212364,2022-01-06 11:50:34,Bocah perempuan 6 tahun di Jember meninggal diduga dianiaya ibunya. Berikut pengakuan ibu korban kepada polisi. https://t.co/O2NHgGHJ4q,1,0,3,1,2022-01-06,11,Thursday,4,4,1
1479057557012504579,2022-01-06 11:49:35,"Belakangan ini ramai soal sertifikasi halal sebuah tempat makan AYCE. Tanpa disadari, banyak restoran yang menggunakan bumbu dapur haram pada masakannya. https://t.co/cr32pLAChn",18,12,13,4,2022-01-06,11,Thursday,4,31,16
1479057533105061888,2022-01-06 11:49:30,"KPK menetapkan 9 orang tersangka kasus dugaan suap dari OTT di Bekasi. Termasuk Walkot Bekasi Rahmat Effendi, ini rincian 9 tersangkanya. https://t.co/n0YwUNZHKB",8,1,1,1,2022-01-06,11,Thursday,4,9,2
1479057531595108352,2022-01-06 11:49:29,"Polisi meringkus dua penjambret yang meresahkan warga Surabaya. Saat hendak ditangkap, kedua pelaku mencoba kabur hingga dilumpuhkan dengan tembakan. https://t.co/ZavmJTIpcB",2,1,0,0,2022-01-06,11,Thursday,4,2,1
1479056995462402051,2022-01-06 11:47:21,"Transisi kekuasaan yang damai, dilihat sebagai contoh cemerlang demokrasi AS selama lebih dari dua abad. https://t.co/F38ihldV5F",2,0,0,0,2022-01-06,11,Thursday,4,2,0
1479056713445781510,2022-01-06 11:46:14,"Seorang pembeli keripik kentang tak sengaja menemukan keripik berbentuk hati. Ia lantas menjualnya lewat situs lelang, harga yang ditawarkan Rp 4,8 juta. Gokil! https://t.co/DMudDqwchd",26,0,3,0,2022-01-06,11,Thursday,4,29,0
1479056216378822659,2022-01-06 11:44:16,Jalan tol Gedebage-Tasikmalaya-Cilacap bakal membuat waktu tempuh menuju ke Pangandaran lebih cepat. Kapan kita bisa melewati jalan tol ini? https://t.co/3Lpxx8jaFy,11,2,4,3,2022-01-06,11,Thursday,4,15,5
1479055695479717891,2022-01-06 11:42:11,KPK telah menetapkan Wali Kota Rahmat Effendi sebagai tersangka dugaan korupsi. Rahmad Effendi tertangkap tangan di kediamannya di Kota Bekasi. https://t.co/5wnbthNr4r,9,1,5,0,2022-01-06,11,Thursday,4,14,1
1479055554106507267,2022-01-06 11:41:38,Anak 11 tahun di Surabaya yang hilang akhirnya ditemukan. Dia ditemukan oleh warga dan diserahkan ke polsek setempat. #detiktif https://t.co/t7fGFOFKYh,10,0,2,1,2022-01-06,11,Thursday,4,12,1
1479055118976929793,2022-01-06 11:39:54,Media di Korea Utara disorot karena mengklaim 'wheat wraps' yang mirip burrito diciptakan pertama kali oleh Kim Kong Il pada tahun 2011. Begini kisahnya. https://t.co/Y51g4w08fT,7,1,0,1,2022-01-06,11,Thursday,4,7,2
1479054598400876544,2022-01-06 11:37:50,Sidang Jerinx terkait kasus pengancaman terhadap Adam Deni digelar Rabu (5/1). Hakim pun menolak nota keberatan Jerinx. Namun permohonan Jerinx untuk dihadirkan secara offline pada sidang selanjutnya dikabulkan oleh hakim. https://t.co/B6WA0S740X,6,0,0,0,2022-01-06,11,Thursday,4,6,0
1479054055934771205,2022-01-06 11:35:41,"Omicron menggila di banyak negara, kasusnya juga terus meningkat di Indonesia. Ada dua gejala Omicron aneh yang baru-baru ini ditemukan. https://t.co/psg4D9XKCj",32,0,16,2,2022-01-06,11,Thursday,4,48,2
1479052697118646275,2022-01-06 11:30:17,Tahun 2021 jadi momentum kemajuan teknologi komunikasi dan informasi di Indonesia. Penyediaan 5G oleh Telkomsel disesuaikan dengan ekosistem yang tersedia. https://t.co/aQ9to0GVFH,5,0,2,1,2022-01-06,11,Thursday,4,7,1
1479052675903856651,2022-01-06 11:30:12,KPK menetapkan Wali Kota Bekasi Rahmat Effendi atau Pepen sebagai tersangka. Dia diduga menerima suap terkait pengadaan barang dan jasa serta lelang jabatan. https://t.co/lkHtvEF23m,55,14,18,5,2022-01-06,11,Thursday,4,73,19
1479052414602952705,2022-01-06 11:29:09,"Polisi menyebut sekeluarga itu merasa ketakutan, bahkan sempat mengungsi ke Bogor. https://t.co/O7Q5qEKhNS",4,1,1,0,2022-01-06,11,Thursday,4,5,1
1479052146117156873,2022-01-06 11:28:05,Situasi di Kazakhstan memanas. Pasukan keamanan menewaskan puluhan demonstran yang mencoba menyerbu gedung-gedung pemerintah. https://t.co/PusMgRs07y,9,0,2,0,2022-01-06,11,Thursday,4,11,0
1479052144984608771,2022-01-06 11:28:05,"Wali Kota Bekasi Rahmat Effendi bersama sejumlah orang lainnya ditangkap KPK. Dari OTT kasus dugaan korupsi ini, KPK juga mengamankan uang total Rp 5,7 miliar. https://t.co/mxmhjNdlHF",19,3,2,1,2022-01-06,11,Thursday,4,21,4
1479051611515281413,2022-01-06 11:25:58,"Seorang bocah warga Brebes, Jawa Tengah, Aenur Rofiq (7), sehari-hari menjadi pemulung. Hal itu dilakukan agar bisa menabung untuk biaya sekolah. https://t.co/v5CGrgM3zJ",21,5,3,1,2022-01-06,11,Thursday,4,24,6
1479051392396500992,2022-01-06 11:25:06,Tahun baru di Amerika Serikat turut diwarnai peristiwa alam yang unik yaitu ledakan meteor. Meteor ini mengeluarkan ledakan yang setara dengan 30 ton TNT. https://t.co/tX42rwYHLv,12,1,0,0,2022-01-06,11,Thursday,4,12,1
1479051130944602116,2022-01-06 11:24:03,"Universitas Kyoto di Jepang tengah apes, karena mereka kehilangan data hasil penelitian penting sebesar 77TB. Kok bisa? https://t.co/tHeAlspEZZ",8,0,3,2,2022-01-06,11,Thursday,4,11,2
1479050874756505601,2022-01-06 11:23:02,"KPK menjabarkan belasan pihak yang tertangkap OTT Wali Kota Bekasi, Rahmat Effendi atau Pepen. Belasan pihak itu terdiri dari swasta hingga ASN Pemkot Bekasi. https://t.co/DDyCnBhLlp",15,2,1,1,2022-01-06,11,Thursday,4,16,3
1479050003322707971,2022-01-06 11:19:34,"Meski keluarga tersebut saat ini tinggal di Desa Paulan, Kecamatan Colomadu, Kabupaten Karanganyar, Gibran mengatakan mereka masih ber-KTP Solo. https://t.co/MmgJgKBt5B",10,0,1,0,2022-01-06,11,Thursday,4,11,0
1479049980614742022,2022-01-06 11:19:29,"10 orang tersangka kasus penipuan dan pengancaman lewat modus video call seks di Batam, Kepulauan Riau ditangkap. Para pelaku merupakan warga China dan Vietnam. https://t.co/4nv5SszDwM",7,0,4,0,2022-01-06,11,Thursday,4,11,0
1479047365847826434,2022-01-06 11:09:06,Presiden PKS Ahmad Syaikhu menunjuk 10 kader menjadi jubir resmi partai. Dalam daftar 10 jubir resmi PKS tidak ada nama Mardani Ali Sera. https://t.co/IDFZc3dc8I,6,1,2,0,2022-01-06,11,Thursday,4,8,1
1479047344096260098,2022-01-06 11:09:00,"Salju tebal menyelimuti Tokyo, ibu kota Jepang pada Kamis (6/1) ini dan menyebabkan pembatalan lebih dari 100 penerbangan domestik. https://t.co/F3CZ6Q3uH5",2,0,1,1,2022-01-06,11,Thursday,4,3,1
1479047123131846660,2022-01-06 11:08:08,Manajer Chelsea Thomas Tuchel senang dengan performa Kai Havertz saat mengalahkan Tottenham Hotspur. Terlebih Havertz bermain dengan menahan sakit.  https://t.co/n4YKjnF5LI,5,0,0,0,2022-01-06,11,Thursday,4,5,0
1479046645287432196,2022-01-06 11:06:14,Video yang menampilkan seorang pria di Kudus membawa samurai di tengah dangdutan viral di medsos. Polisi mengungkap fakta di baliknya. https://t.co/DiQlUy1Uph,4,1,2,0,2022-01-06,11,Thursday,4,6,1
1479046625075027969,2022-01-06 11:06:09,Kedatangan paket beras 5 kilogram ini memunculkan sejumlah jawaban menggelitik dari para politisi PDIP. Seperti apa? https://t.co/jSV2iPpyrk,7,0,1,0,2022-01-06,11,Thursday,4,8,0
1479046394119921664,2022-01-06 11:05:14,Bocah 5 tahun yang ditemukan warga Sumedang dalam posisi tangan dan kakinya diikat rantai besi kabarnya sering mendapat tindak kekerasan. https://t.co/vwxZkT902J,15,2,7,3,2022-01-06,11,Thursday,4,22,5
1479046373672632324,2022-01-06 11:05:09,Dell mengenalkan Concept Luna di CES 2022. Ini adalah konsep yang dikembangkan bersama intel sebagai upaya mengurangi limbah elektronik di dunia. #CES2022  https://t.co/VFJ8pCnafQ,2,0,0,0,2022-01-06,11,Thursday,4,2,0
1479046132798005256,2022-01-06 11:04:12,Ibunda Gaga Muhammad akhirnya muncul dan bicara soal kasus sang putra yang buat Laura Anna lumpuh. Pernyataan-pernyataan ibu Gaga justru tuai kecaman. https://t.co/gazgHQEyct,11,10,0,2,2022-01-06,11,Thursday,4,11,12
1479045863834062856,2022-01-06 11:03:07,Jumlah santriwati yang diduga jadi korban dugaan pencabulan bertambah menjadi tiga orang. Saat ini polisi masih memeriksa saksi-saksi https://t.co/v3iO16nDdI,45,14,9,4,2022-01-06,11,Thursday,4,54,18
1479045367970865154,2022-01-06 11:01:09,"Masih bingung mau milih prodi apa saat SNMPTN 2022? Yuk, simak daftar prodi sepi peminat dari sejumlah kampus favorit ini. Bisa jadi peluang kamu nih! Via: @detikedu https://t.co/8I1XIyWAv0",1,0,1,0,2022-01-06,11,Thursday,4,2,0
1479045126538375170,2022-01-06 11:00:12,PB Djarum Kudus mengakui ganda campuran Praveen Jordan/Melati Daeva Oktavianti dan Gloria Emanuelle Widjaja mengalami penurunan prestasi.  https://t.co/xo4ioYXgYC,2,0,0,0,2022-01-06,11,Thursday,4,2,0
1479045110654451718,2022-01-06 11:00:08,"BlackBerry Gemini dan Bellagio, dua handphone ini sempat digilai di Indonesia, bahkan saat penjualan perdananya pernah bikin kericuhan. Pernah pakai? https://t.co/GkF2w7T50W",7,1,1,2,2022-01-06,11,Thursday,4,8,3
1479044334305615873,2022-01-06 10:57:03,Panitia seleksi KPU-Bawaslu telah selesai menyortir calon komisioner KPU dan Bawaslu RI. kini pansel mengajukan 14 nama calon komisioner KPU dan 10 nama calon anggota Bawaslu ke Presiden Jokowi. https://t.co/wpVBmMexV1,2,1,2,1,2022-01-06,10,Thursday,4,4,2
1479044096547332098,2022-01-06 10:56:06,"Shin Tae-yong mengumpulkan pemain-pemain yang main di luar negeri setelah pembubaran Timnas Indonesia, Kamis (6/1/2022). Apa yang dibicarakan?  https://t.co/DBRoaPbUvy",5,0,0,0,2022-01-06,10,Thursday,4,5,0
1479043731055689729,2022-01-06 10:54:39,KPK menetapkan Wali Kota Bekasi Rahmat Effendi atau Pepen sebagai tersangka kasus dugaan korupsi. Pepen terlihat telah mengenakan rompi tahanan KPK. https://t.co/Ik8n4viITt,5,2,3,2,2022-01-06,10,Thursday,4,8,4
1479043344378609664,2022-01-06 10:53:07,Persipura Jayapura bermain imbang dengan Persela Lamongan di lanjutan Liga 1 2021/2022. Mutiara Hitam seri 1-1 saat melawan Laskar Joko Tingkir.  https://t.co/uqqPgrmSV4,3,0,0,0,2022-01-06,10,Thursday,4,3,0
1479043213252042752,2022-01-06 10:52:35,"Adhie Massardi melaporkan eks Gubernur DKI Jakarta, Basuki Tjahaja Purnama (Ahok) ke KPK. Pelaporan berkaitan dengan kasus dugaan korupsi semasa Ahok menjabat di Pemprov DKI. https://t.co/ChEZkToyTS",83,22,17,6,2022-01-06,10,Thursday,4,100,28
1479042990530256898,2022-01-06 10:51:42,Puspomad menyerahkan barang bukti dan tiga tersangka kasus pembunuhan Handi Saputra dan Salsabila. Seperti apa penampakannya? https://t.co/cw9LAhxSOu,11,2,3,0,2022-01-06,10,Thursday,4,14,2
1479042970695385093,2022-01-06 10:51:38,Asus memamerkan laptop layar lipat di ajang CES 2022. Laptop bernama Zenbook 17 Fold OLED itu memiliki layar jumbo dan bisa digunakan beberapa mode. https://t.co/ee81I4Dvru,8,0,2,1,2022-01-06,10,Thursday,4,10,1
1479042693640642567,2022-01-06 10:50:32,Asnawi Mangkualam mendorong rekan-rekannya di Timnas Indonesia menyusul bermain di luar negeri. Bek kanan itu sudah semusim main di Korea bareng Ansan Greeners.  https://t.co/upaUI8fAh0,54,10,9,1,2022-01-06,10,Thursday,4,63,11
1479042460076621824,2022-01-06 10:49:36,Kuasa hukum Irwansyah berkonsultasi kepada pihak kepolisian untuk pertimbangan pidana dan perdata kasus pemalsuan Hafiz Fatur di Polres Jakarta Selatan. Hal itu akan diputuskan oleh Irwansyah. https://t.co/mZXeembnXq,2,0,1,0,2022-01-06,10,Thursday,4,3,0
1479042447460163586,2022-01-06 10:49:33,"Sebuah video bentrokan antara personel TNI AD dan warga di Deli Serdang, Sumatera Utara, viral di medsos. Kapendam I/BB Letkol, Inf Donald Erickson menyebut peristiwa itu berawal saat personel TNI ingin memasang plang di tanah HGU milik Puspokar TNI. https://t.co/WwFBxE3TWj",6,6,3,0,2022-01-06,10,Thursday,4,9,6
1479040943361863681,2022-01-06 10:43:34,Pelatih biliar dijewer oleh Gubernur Sumatera Utara (Gubsu) Edy Rahmayadi. Dia dijewer dan diusir saat acara pemberian tali asih pada Senin (27/12) lalu. https://t.co/ouGfnZ9LXH,3,1,1,0,2022-01-06,10,Thursday,4,4,1
1479040435725111298,2022-01-06 10:41:33,EF memerkosa anak tirinya sejak Agustus 2021. Dia mengancam akan menggugat cerai ibu dari korban bila korban buka suara. https://t.co/C6r2GZM6S2,8,1,4,1,2022-01-06,10,Thursday,4,12,2
1479039857540440066,2022-01-06 10:39:15,"Anak 11 tahun warga Benowo, Surabaya, kabur dari rumah dan belum kembali. Kedua orang tuanya kemudian menyebar foto dan mencari siswi kelas SD itu. #detiktif https://t.co/f6Ngwf9QjH",31,2,41,4,2022-01-06,10,Thursday,4,72,6
1479039604040908801,2022-01-06 10:38:15,"Ketiga tersangka yang diserahkan adalah Kolonel Priyanto, Kopda Ahmad Sholeh, Kopda Dwi Atmoko. Kolonel Priyanto merupakan otak pembunuhan tersebut. https://t.co/UkWMiHeknO",10,0,2,2,2022-01-06,10,Thursday,4,12,2
1479039351640178693,2022-01-06 10:37:15,"Bareskrim membeberkan peran kedua tersangka. Dalam kasus ini, korbannya merupakan pensiunan jenderal TNI AD, yakni Mayjen (Purn) Emack Syadzily. https://t.co/9KgVvMYOBx",8,0,3,0,2022-01-06,10,Thursday,4,11,0
1479038788064235520,2022-01-06 10:35:00,"KPK di masa kepemimpinan Agus Rahardjo pernah menyebut tidak ada perbuatan melawan hukum dalam kasus itu, tetapi kemudian disebutkan ada fakta baru. https://t.co/WGO4fwP4zV",12,5,2,0,2022-01-06,10,Thursday,4,14,5
1479037690016317442,2022-01-06 10:30:39,Farida Nurhan ternyata memiliki kisah sedih yang tak banyak diketahui orang lain. Kali ini ia blak-blakan soal hamil di luar nikah.  https://t.co/EE3kICwY2g,5,2,1,0,2022-01-06,10,Thursday,4,6,2
1479036970869444608,2022-01-06 10:27:47,Selebgram hijrah Lola Diara akhirnya buka suara setelah 3 tahun diam atas gosip yang menyebut dirinya pelakor dalam kisah Layangan Putus. Ini 5 fakta Lora. https://t.co/btGSPlOlva,4,1,2,0,2022-01-06,10,Thursday,4,6,1
1479036948748673025,2022-01-06 10:27:42,Pernikahan anak secara resmi telah menjadi ilegal di Filipina mulai hari Kamis (6/1) ini karena undang-undang yang melarang praktik tersebut mulai berlaku. https://t.co/0qnUmBq8kb,7,0,1,1,2022-01-06,10,Thursday,4,8,1
1479036179710361600,2022-01-06 10:24:39,Sarjana terapan bisa jadi pilihan untuk melanjutkan studi. Ada 21 prodi dari UGM yang bisa dijadikan rekomendasi dan memungkinkan bisa langsung kerja. Kamu minat? https://t.co/9vzuLeMrre,13,0,6,1,2022-01-06,10,Thursday,4,19,1
1479036153969975296,2022-01-06 10:24:32,Pemerintah Kabupaten Lebak akan memberikan bantuan stimulan kepada 614 korban banjir bandang dan tanah longsor 2020. https://t.co/djZsJi9gdl,2,0,1,0,2022-01-06,10,Thursday,4,3,0
1479035410919698433,2022-01-06 10:21:35,"Jaenab (49) wanita yang sempat viral di media sosial karena tiduran di tengah jalan, Banjarnegara, kembali bikin geger. https://t.co/AUlSwPf1rL",9,2,1,0,2022-01-06,10,Thursday,4,10,2
1479034978914779138,2022-01-06 10:19:52,"Heboh makam muncul tiba-tiba di pinggir jalan Kecamatan Prigen Pasuruan. Polisi pun turun tangan, ternyata makam ini sengaja dibuat agar tak ada lagi warga buang sampah sembarangan. https://t.co/x3qbDEiIL5 https://t.co/IWBVsOzBos",36,1,6,10,2022-01-06,10,Thursday,4,42,11
1479034460234518533,2022-01-06 10:17:49,"Musisi Eric Nam segera merilis album terbarunya bertajuk, There And Back Again. Album terbaru Eric Nam digarap penuh emosi dan siap rilis bulan ini. https://t.co/iaXuKjdoEz",3,0,2,0,2022-01-06,10,Thursday,4,5,0
1479034439002902528,2022-01-06 10:17:44,Mahasiswa UMY terduga pelaku pemerkosaan berinisial MKA akhirnya diberhentikan alias drop out (DO) secara tetap dengan tidak hormat. https://t.co/6vlvihe0oz,7,2,3,4,2022-01-06,10,Thursday,4,10,6
1479034192960835584,2022-01-06 10:16:45,Media sosial ramai membicarakan penjualan virtual Alun-alun Utara Yogyakarta. Bagaimana kondisi terkini di kawasan tersebut? https://t.co/vexkjk4qRg,9,0,2,1,2022-01-06,10,Thursday,4,11,1
1479033404104581120,2022-01-06 10:13:37,Polisi akhirnya menetapkan seorang perempuan sebagai tersangka atas kasus penyekapan dan kekerasan terhadap anak usia 5 tahun. https://t.co/iXuRNDtQpt,4,0,3,1,2022-01-06,10,Thursday,4,7,1
1479032396670541826,2022-01-06 10:09:37,"BTS dinominasikan dalam ajang Grammy Awards ke-64. Namun karena acara ditunda, mereka pun membatalkan rencana ke Amerika Serikat. #BTS  https://t.co/obIaWpMbZ4",9,0,3,0,2022-01-06,10,Thursday,4,12,0
1479032148699103235,2022-01-06 10:08:37,"Cuaca di kawasan Jl DI Panjaitan, Jakarta Timur cerah. Namun, terdapat genangan di bawah Tol Becakayu. #detikcomdoyourmagic https://t.co/61E3h5Fgux",9,0,0,0,2022-01-06,10,Thursday,4,9,0
1479031903034515456,2022-01-06 10:07:39,"Ketua Umum PSSI, Mochamad Iriawan membubarkan skuad pemain yang sebelumnya berlaga di Piala AFF 2020. Ketum PSSI berharap para pemain menjaga stamina dan performa saat bermain di klub masing-masing. https://t.co/ifYXpYRibS",7,0,1,0,2022-01-06,10,Thursday,4,8,0
1479031657009229825,2022-01-06 10:06:40,KPK menyegel salah satu ruangan di kompleks perkantoran Pemerintah Kota Bekasi. Segel tampak dipasang di pintu masuk ruangan itu. https://t.co/Rfgx8mJ2bW,4,0,0,0,2022-01-06,10,Thursday,4,4,0
1479031655822147587,2022-01-06 10:06:40,Profesi sopir bus umumnya digeluti oleh kaum laki-laki. Tapi PO Agra Mas punya driver wanita bernama Liena Ozora. Yuk kenalan!  https://t.co/d6fqw1Nqrf,46,17,16,4,2022-01-06,10,Thursday,4,62,21
1479031414154842115,2022-01-06 10:05:42,Ketua Pelaksana LTMPT mengatakan bahwa materi tes UTBK-SBMPTN 2022 berbeda dengan 2021. Simak penjelasannya yuk! Via: detikedu https://t.co/rsI25h1X5N,6,0,1,0,2022-01-06,10,Thursday,4,7,0
1479031394261159943,2022-01-06 10:05:38,"#Foto Sosok Sekdes Pati, Nur Chamim belakangan jadi viral karena memberikan hadiah mobil Rp 3 miliar untuk anak. Jadi penasaran, gimana potret rumahnya? https://t.co/CSqDdTSG5l",5,0,1,1,2022-01-06,10,Thursday,4,6,1
1479029985683849222,2022-01-06 10:00:02,"Hai para suami, yuk kasih tau istrinya suruh ikutan program ""Modal Usaha untuk Suami"" dari detikcom! Di program ini para istri berkesempatan mendapatkan hadiah ""Modal Usaha untuk Suami"" senilai jutaan rupiah lho.⁣⁣⁣
⁣⁣⁣
Langsung aja kunjungi https://t.co/dG0yoZjoLq ya! https://t.co/ESg9eGOn1x",4,0,0,0,2022-01-06,10,Thursday,4,4,0
1479029977693790211,2022-01-06 10:00:00,"Yuk! Ulas Kilas Balik Peristiwa Penting Sepanjang 2021 Bareng detikcom
https://t.co/TfZyprxXHq.",3,0,1,0,2022-01-06,10,Thursday,4,4,0
1479029764606332929,2022-01-06 09:59:09,"Dalam proses pengadilan, Elizabeth Holmes diputus bersalah atas dakwaan menipu investor dan terancam hukuman puluhan tahun penjara. https://t.co/AqInVAu4Ev",13,0,3,0,2022-01-06,9,Thursday,4,16,0
1479029479636967426,2022-01-06 09:58:01,"Sudah hampir dua tahun pelaku bisnis kecil hingga besar mencari jalan selamat dari pandemi COVID-19, bagaimana model bisnis di tahun 2022? https://t.co/b86cG1FY2A",7,0,2,0,2022-01-06,9,Thursday,4,9,0
1479028961107603456,2022-01-06 09:55:58,Sebuah bank Swiss tengah mengejar Pangeran Arab Saudi di pengadilan terkait gagal bayar utang. Utang yang diambil untuk membeli rumah mewah dan kapal pesiar. https://t.co/fXMJeoze2T,15,5,4,1,2022-01-06,9,Thursday,4,19,6
1479028694807195652,2022-01-06 09:54:54,Pansel menyodorkan 14 nama calon komisioner KPU dan 10 nama calon anggota Bawaslu ke Jokowi. Siapa saja? https://t.co/NuedmO6Op4,4,0,2,3,2022-01-06,9,Thursday,4,6,3
1479028443899699201,2022-01-06 09:53:54,#Terpopuler Tiket masuk ke Wana Wisata Padusan di Mojokerto dikeluhkan wisatawan lantaran harus membayar 5 macam karcis. Keluhan tersebut viral. https://t.co/NvqqWfqzDo,7,0,5,1,2022-01-06,9,Thursday,4,12,1
1479027871733661696,2022-01-06 09:51:38,Situasi di Kazakhstan memanas usai gelombang demonstrasi berhari-hari. Ini imbauan dari Kedubes kepada seluruh WNI di Kazakhstan. https://t.co/oOr3ehujCV,34,5,8,3,2022-01-06,9,Thursday,4,42,8
1479027633132388356,2022-01-06 09:50:41,"Sebelum menjadi seorang mahasiswa, ada baiknya memahami SKS terlebih dahulu. Simak penjelasan berikut ini ya biar cepat lulus! Via: detikedu https://t.co/MorOwmSNIg",9,0,3,0,2022-01-06,9,Thursday,4,12,0
1479027152536354819,2022-01-06 09:48:46,Kebijakan Presiden Jokowi melarang sementara ekspor batu bara didukung hampir seluruh fraksi di DPR. Begini peta politik di DPR soal larangan ekspor batu bara. https://t.co/nNmINkOCVc,30,1,7,1,2022-01-06,9,Thursday,4,37,2
1479027137751433216,2022-01-06 09:48:43,Wanita ini buktikan pada pacarnya yang kerap memberi kritik tajam dengan turun berat badan 21 kg dalam 3-4 bulan. Begini ceritanya: https://t.co/nS2esd7YeO,10,0,3,1,2022-01-06,9,Thursday,4,13,1
1479026832888504320,2022-01-06 09:47:30,"Agar bisnis tidak terjebak perang harga, kalian harus berani ciptakan satu keunikan dari produknya. Contohnya? https://t.co/wvKJ5xqEVJ",5,0,1,0,2022-01-06,9,Thursday,4,6,0
1479026319908384771,2022-01-06 09:45:28,"Mahasiswa S1 ternyata bisa menyelesaikan kuliahnya lebih cepat dalam waktu 3,5 tahun. Bisa disiapkan sejak maba! Begini lho caranya. Via: detikedu https://t.co/s66w6CccwP",25,0,4,0,2022-01-06,9,Thursday,4,29,0
1479026087309025281,2022-01-06 09:44:32,"Transplantasi rambut seperti Anang Hermansyah memang menjadi salah satu solusi untuk mengatasi kebotakan. Tapi, efektifkah? https://t.co/tUCWmIBjcm",8,3,0,1,2022-01-06,9,Thursday,4,8,4
1479025804512272385,2022-01-06 09:43:25,Sidang perdana gugatan wanprestasi Ustaz Yusuf Mansur ditunda. Hal itu karena adanya salah alamat. Kok bisa? https://t.co/OkhCDov2be,7,0,2,0,2022-01-06,9,Thursday,4,9,0
1479025787080740866,2022-01-06 09:43:21,Amerika Serikat (AS) kini menjadi negara pengekspor LPG terbesar di dunia. https://t.co/DyhpDhFmyB,5,0,3,0,2022-01-06,9,Thursday,4,8,0
1479025267192614913,2022-01-06 09:41:17,"Pelatih Timnas, Shin Tae-yong akan bantu pemain timnas untuk bisa bermain di Korea. Hal ini terkait adanya minat klub Korea untuk merekrut pemain timnas.  https://t.co/hwGe3RpBSM",35,0,4,0,2022-01-06,9,Thursday,4,39,0
1479025239061319682,2022-01-06 09:41:10,"#Foto Soal penampilan, Kahiyang Ayu selalu menyempurnakannya dengan sepasang sepatu dari brand ternama. Bikin kaget, ini beberapa koleksi sepatunya.  https://t.co/2TVqpwySqF",4,1,0,0,2022-01-06,9,Thursday,4,4,1
1479024743529521153,2022-01-06 09:39:12,Santriwati korban pemerkosaan yang dilakuka Herry Wirawan mengajukan restitusi atau pembayaran ganti rugi atas apa yang diderita. https://t.co/N7SWQghuXE,16,0,5,0,2022-01-06,9,Thursday,4,21,0
1479024472682340354,2022-01-06 09:38:07,"Jangan sampai salah memilih jenis bisnis. Karena kalau salah yang ada bukan untung, malah bisa buntung. https://t.co/3KNKmVUVTn",9,1,5,0,2022-01-06,9,Thursday,4,14,1
1479023985354579977,2022-01-06 09:36:11,Masalah yang dikeluhkan itu terjadi pada Oktober 2021. Begini penjelasannya: https://t.co/DNwKGrTnyg,2,0,1,0,2022-01-06,9,Thursday,4,3,0
1479023757519990786,2022-01-06 09:35:17,"Bintang ‘Snowdrop’, Kim Mi Soo meninggal dunia di usia 31 tahun. Penyabab kematiannya pun sampai sekarang masih menjadi misteri. https://t.co/b79QQqCuwF",2,0,1,0,2022-01-06,9,Thursday,4,3,0
1479023739400511490,2022-01-06 09:35:13,"Olahan daging ini rasanya manis gurih, mirip empal kelem Jawa. Dagingnya empuk dan berkuah kental pekat. Cocok dimakan dengan nasi hangat dan sambal. https://t.co/U0NyAkBhPT",4,0,1,0,2022-01-06,9,Thursday,4,5,0
1479022980072153089,2022-01-06 09:32:12,"KPK melakukan operasi tangkap tangan (OTT) terhadap Wali Kota Bekasi Rahmat Effendi atau Pepen, Rabu (5/1) malam. Diduga OTT ini berkaitan dengan kasus jual beli jabatan dan pengadaan barang jasa. https://t.co/xKnx1Ut3E7",6,0,2,0,2022-01-06,9,Thursday,4,8,0
1479022745975459844,2022-01-06 09:31:16,"Seorang pengguna ganja, Danto menceritakan sakitnya penderitaan yang dialaminya. Ia mengaku sembuh bila pakai ganja. Tapi karena ilegal, ia kini dibui 9 tahun. https://t.co/kUAuEZim8n",11,2,8,9,2022-01-06,9,Thursday,4,19,11
1479022715340308483,2022-01-06 09:31:08,"Timnas Indonesia menjalani karantina 5 hari usai berlaga di Piala AFF 2020. Ketua Umum PSSI, Mochamad Iriawan membeberkan alasan durasi karantina skuad Garuda.  https://t.co/d1Ze3fJnus",5,1,3,1,2022-01-06,9,Thursday,4,8,2
1479022199457595392,2022-01-06 09:29:05,"#Terpopuler Efriyani (42), warga Klaten yang hilang akhirnya ditemukan dan disambut bahagia keluarga. Pencarian Efriyani yang hilang sejak Juli 2021 sempat disayembarakan. https://t.co/V59HTh2nAB",7,0,0,0,2022-01-06,9,Thursday,4,7,0
1479021940048281605,2022-01-06 09:28:04,Ferdinand Hutahaean meminta maaf karena telah menimbulkan kegaduhan atas cuitannya itu. https://t.co/Z9KBCpCb5h,32,75,1,6,2022-01-06,9,Thursday,4,33,81
1479021916602179588,2022-01-06 09:27:58,"Berdasarkan hasil tes DNA, Tristan Thompson terbukti merupakan ayah dari anak selingkuhannya, Maralee Nichols. Karena perbuatannya tersebut, Tristan Thompson meminta maaf ke Khloe Kardashian. https://t.co/H4c8r7L0Z9",1,0,0,0,2022-01-06,9,Thursday,4,1,0
1479021713438425091,2022-01-06 09:27:10,Kasus korupsi kembali menjerat kepala daerah di Kota Bekasi. Wali Kota Bekasi Rahmat Effendi terjaring operasi tangkap tangan oleh Komisi Pemberantasan Korupsi (KPK). https://t.co/MQ7K2D6gON https://t.co/37FurMYah5,25,1,14,2,2022-01-06,9,Thursday,4,39,3
1479021645893357571,2022-01-06 09:26:53,"Konflik ketenagakerjaan tiada habisnya. Salah satunya PHK tanpa disertai hak-hak, seperti pesangon dan uang penghargaan. Apakah si pengusaha bisa dipidanakan? #detiksAdvocate https://t.co/ftnGcafUkH",9,1,3,0,2022-01-06,9,Thursday,4,12,1
1479021400929280001,2022-01-06 09:25:55,"Ibunda Gaga Muhammad, Janariyah jadi sorotan, ia tidak percaya jika Laura Anna meninggal dunia akibat lumpuh setelah kecelakaan bersama Gaga Muhammad. https://t.co/Y2dfn55sf9",215,216,27,106,2022-01-06,9,Thursday,4,242,322
1479021388094656515,2022-01-06 09:25:52,Asnawi Mangkualam baru saja teken kontrak baru yang membuatnya lanjut di Ansan Greeners. Berikut momen-momen terbaik Asnawi di klub K League 2 itu.  https://t.co/lydhnCymQQ,7,0,1,0,2022-01-06,9,Thursday,4,8,0
1479021144854482944,2022-01-06 09:24:54,Saksi meringankan yang dihadirkan Azis Syamsuddin menangis di sidang. Azis sendiri jadi ikutan menitikkan air mata. https://t.co/cKvoJ3npT3,4,1,0,1,2022-01-06,9,Thursday,4,4,2
1479020870257586180,2022-01-06 09:23:49,Situasi di Kazakhstan memanas. Pasukan keamanan menewaskan puluhan demonstran yang mencoba menyerbu gedung-gedung pemerintah. https://t.co/NU0ukEt5W8,31,1,14,2,2022-01-06,9,Thursday,4,45,3
1479020156802195461,2022-01-06 09:20:58,Total pihak yang ditangkap dalam OTT menjadi 14 orang. https://t.co/UqNDHiclnE,5,0,1,1,2022-01-06,9,Thursday,4,6,1
1479019910772625410,2022-01-06 09:20:00,"Buat detikers yang menjadi anak pertama, atau bahkan punya kakak anak pertama ada kejutan spesial nih dari detikcom untuk kamu. Di program ini, semua anak pertama berkesempatan mendapatkan handphone senilai belasan juta rupiah lho.⁣⁣
⁣⁣
Klik link https://t.co/7nSz174sWC ya! https://t.co/IwFu622h5R",8,0,1,0,2022-01-06,9,Thursday,4,9,0
1479019252006989825,2022-01-06 09:17:23,"Ebanie Bridges, jawara tinju putri kelas bantam, juga populer berkat lekukan tubuhnya. Ia berkelakar vaksin Pfizer bikin payudaranya semakin besar!  https://t.co/gZzGUb0iFa",2,0,0,0,2022-01-06,9,Thursday,4,2,0
1479019123933859843,2022-01-06 09:16:52,VP Technology Strategy Telkomsel Indra Mardiatna menyampaikan Telkomsel menyediakan layanan 5G untuk mendukung produktivitas masyarakat. https://t.co/VTEYgptxHI,4,0,0,0,2022-01-06,9,Thursday,4,4,0
1479019100991115265,2022-01-06 09:16:47,PSSI juga membidik Kroasia dan Yunani buat menjadi lawan uji coba Timnas Indonesia. Keduanya disiapkan untuk jeda internasional atau FIFA Matchday Bulan Maret.  https://t.co/EOa4MacTt4,6,0,0,1,2022-01-06,9,Thursday,4,6,1
1479018843146272771,2022-01-06 09:15:45,"Inter Milan akan coba melanjutkan tren positifnya di Serie A saat menghadapi Bologna. Meski lawan tengah pincang karena badai corona, Nerazzurri enggan lengah. https://t.co/gJ4n18OymM",5,0,0,0,2022-01-06,9,Thursday,4,5,0
1479018594583425024,2022-01-06 09:14:46,Amanda Manopo berencana membuat sebuah rumah baru. Kediaman itu sudah digambarkan dan tampak akan begitu megah. https://t.co/Mw5XUBFNLD,10,0,0,1,2022-01-06,9,Thursday,4,10,1
1479018346054135813,2022-01-06 09:13:47,Rumah masa depan adalah yang bisa dikendalikan dengan perangkat tablet. Samsung pun meluncurkan Home Hub di ajang CES 2022.  https://t.co/Wz0SShRhFH,2,0,0,0,2022-01-06,9,Thursday,4,2,0
1479017601967734791,2022-01-06 09:10:49,The Batman jadi film yang paling dinanti pada 2022. The Batman bakal tayang bulan Maret. #TheBatman  https://t.co/MoHxU7H73b,3,0,1,0,2022-01-06,9,Thursday,4,4,0
1479017580526456833,2022-01-06 09:10:44,Praveen/Melati santer disebut-sebut ada di antara pebulutangkis yang dicoret dari pelatnas. Pelatih ganda campuran Nova Widianto enggan berspekulasi.  https://t.co/Ip7pvGMZYV,1,0,1,0,2022-01-06,9,Thursday,4,2,0
1479017331997253635,2022-01-06 09:09:45,Transplantasi rambut menjadi tren baru di kalangan selebriti. Atta Halilintar menjalani prosedur tersebut di Turki. Adakah risikonya? https://t.co/yM7GXRyCi8,8,8,1,1,2022-01-06,9,Thursday,4,9,9
1479016821982380034,2022-01-06 09:07:43,Berita terpopuler: Bakso viral bikin ngiler menarik perhatian pembaca. Ada makanan syubhat yang harus diwaspadai Muslim. https://t.co/RF1uwJkzZG,5,0,1,0,2022-01-06,9,Thursday,4,6,0
1479016298281635840,2022-01-06 09:05:38,"Setelah tuduhan JK Rowling antisemitisme viral, pembawa acara AS Jon Stewart pun mengklarifikasi kalau tidak benar. https://t.co/vcj0Y92PQF",1,1,1,0,2022-01-06,9,Thursday,4,2,1
1479015410573791232,2022-01-06 09:02:07,"Hai detikers, udah pada ikutan program Kalung untuk Istri belum? Kali ini para suami se-Indonesia punya kesempatan bikin senang istri dengan bawa pulang hadiah kalung emas lho. Program ini hanya berlaku bagi yang memiliki istri sah ya. 
Klik di sini https://t.co/fdrW1ukSpm ya! https://t.co/z0K3h0mo6b",5,3,0,0,2022-01-06,9,Thursday,4,5,3
1479015351379705857,2022-01-06 09:01:53,"Sandiaga Uno membagikan momen haru ketika harus melepas putri sulungnya, Anneesha Atheera yang akan merantau. Hal itu sampai membuat Nur Asia menangis. #detikNetwork  https://t.co/m1dOvDX815",4,0,0,1,2022-01-06,9,Thursday,4,4,1
1479015350176030720,2022-01-06 09:01:52,"Irwansyah melaporkan adiknya, Hafiz Fatur ke Polres Jaksel. Laporan itu terkait kasus korupsi Hafiz Fatur di Bogor. https://t.co/pdD64di7i6",3,0,0,0,2022-01-06,9,Thursday,4,3,0
1479015176091299841,2022-01-06 09:01:11,"Hai detikers, udah pada ikutan program Motor untuk Mertua belum? Di program ini para menantu dan calon menantu se-Indonesia bisa bawa pulang motor untuk para mertua / calon mertua. Ini saatnya kamu menjadi menantu idaman. Caranya bisa cek di sini ya https://t.co/T0EAWsdQMi https://t.co/ogL0olfgS4",1,0,0,0,2022-01-06,9,Thursday,4,1,0
1479014958373519366,2022-01-06 09:00:19,Pemkot Solo baru saja meluncurkan wisata mobil listrik dengan tujuh numpang. Antusiasme masyarakat untuk naik mobil ramah lingkungan itu cukup tinggi. Tapi...  https://t.co/jrB6L5P8SQ,3,0,0,0,2022-01-06,9,Thursday,4,3,0
1479014688054722562,2022-01-06 08:59:15,"Selepas sidang, pengacara Yusuf Mansur bernama Ariel Mohtar menyampaikan pesan dari Yusuf Mansur. Apa katanya? https://t.co/1VEA6sWwOv",3,0,0,0,2022-01-06,8,Thursday,4,3,0
1479014285082873856,2022-01-06 08:57:38,"Indonesia mencatat sebanyak 533 kasus baru COVID-19, Kamis (6/1/2022). DKI menyumbang kasus terbanyak dengan jumlah 267. https://t.co/oVxHctnSPC",2,1,1,1,2022-01-06,8,Thursday,4,3,2
1479014196234887168,2022-01-06 08:57:17,Retno Marsudi memamerkan capaian vaksinsi COVID-19 Indonesia 2021. Indonesia masuk 5 besar terbesar di dunia dengan 270 juta dosis suntikan. https://t.co/N7TP7fDQBG,11,2,4,0,2022-01-06,8,Thursday,4,15,2
1479014179612905479,2022-01-06 08:57:13,Adhie Massardi Cs melaporkan sejumlah menteri hingga kepala daerah ke KPK. Salah satu yang dilaporkan adalah Ganjar Pranowo. Bagaimana respons Ganjar? https://t.co/8Xs8HtkU3k,7,3,2,1,2022-01-06,8,Thursday,4,9,4
1479013935634391047,2022-01-06 08:56:15,Anies melarang gedung dengan luas 5 ribu meter persegi atau lebih serta gedung 8 lantai atau lebih untuk menyedot air tanah. Larangan itu berlaku mulai 2023. https://t.co/eT4WLdstDY,47,12,4,1,2022-01-06,8,Thursday,4,51,13
1479013934334156804,2022-01-06 08:56:15,"Sebuah video bentrokan antara personel TNI AD dan warga di Deli Serdang, Sumatara Utara, viral. Kodam I/BB pun menjelaskan terkait peristiwa itu. https://t.co/thpWwh3Dt3",4,0,0,0,2022-01-06,8,Thursday,4,4,0
1479013658877378562,2022-01-06 08:55:09,KPK telah melakukan OTT terhadap Wali Kota Bekasi Rahmat Effendi. Kini total ada 13 orang yang diperiksa secara intensif. https://t.co/mCjAgE3B5u,4,2,1,0,2022-01-06,8,Thursday,4,5,2
1479013516308889602,2022-01-06 08:54:35,"Indonesia melaporkan 533 kasus COVID-19 pada Kamis (6/1/2022). Total kasus positif menjadi 4.264.669, sembuh 4.115.358, dan meninggal 144.116. https://t.co/u0u5dkTdsi",2,0,1,0,2022-01-06,8,Thursday,4,3,0
1479013425816735747,2022-01-06 08:54:14,Bunga Zainal sadar akan ancaman penyebaran COVID-19 varian Omicron yang tinggi di New York. Ia menyebut Omicron hanya dianggap sebagai flu biasa di sana. https://t.co/8r6sA5Z2XB,7,0,2,0,2022-01-06,8,Thursday,4,9,0
1479013406875262979,2022-01-06 08:54:09,"Sesuai arahan Presiden Jokowi, saat ini tak ada lagi dispensasi aturan karantina bagi pejabat yang pulang dari luar negeri. https://t.co/lSU1T62PI0",6,2,1,0,2022-01-06,8,Thursday,4,7,2
1479013129543684097,2022-01-06 08:53:03,Ribuan warga masih mengungsi di titik-titik pengungsian. #Aceh #Banjir https://t.co/zIF2yFriXK,2,0,2,0,2022-01-06,8,Thursday,4,4,0
1479012868255268869,2022-01-06 08:52:01,Seorang bocah perempuan di Jember meninggal dengan tubuh penuh luka memar. Bocah 6 tahun itu meninggal diduga dianiaya ibunya. https://t.co/ftK83vHvfh,8,1,0,0,2022-01-06,8,Thursday,4,8,1
1479011363158573056,2022-01-06 08:46:02,"Kaleidoskop 2021: Inovasi Layanan &amp; Kontribusi IndiHome bagi Indonesia
https://t.co/FBZ8kKgK12",2,0,1,0,2022-01-06,8,Thursday,4,3,0
1479011242891268097,2022-01-06 08:45:33,Tanggul Sungai Citarum di Bekasi ambles. Sebanyak 60 ribu warga Cabangbungin Bekasi terancam terdampak banjir. https://t.co/BIvJG3ZYga,2,0,1,0,2022-01-06,8,Thursday,4,3,0
1479011166114488322,2022-01-06 08:45:15,Para peneliti mengungkap ternyata selera kopi juga dipengaruhi garis DNA. Begini penjelasannya: https://t.co/ogclmLPZS7,4,0,1,0,2022-01-06,8,Thursday,4,5,0
1479010424376995840,2022-01-06 08:42:18,Ed Sheeran akan menggelar tur konsernya dengan mobil campervan elektrik tahun ini. #EdSheeran  https://t.co/5M1x5ZbkUm,6,1,1,0,2022-01-06,8,Thursday,4,7,1
1479010402696585217,2022-01-06 08:42:13,Menteri Badan Usaha Milik Negara (BUMN) Erick Thohir mengangkat dan menetapkan Hartanto Wibowo sebagai Direktur Energi Primer. https://t.co/XXZgimHgQO,3,0,0,0,2022-01-06,8,Thursday,4,3,0
1479010233393504257,2022-01-06 08:41:32,Ini akan jadi kabar yang menggembirakan bagi penggemar game open World besutan miHoYo. Ada kode redeem Genshin Impact terbaru dan gratis. Cek di sini: https://t.co/Jtr9EiQLV0,3,0,0,0,2022-01-06,8,Thursday,4,3,0
1479009487092654086,2022-01-06 08:38:35,Mangaka Eiichiro Oda menyebut Arc Wano sebagai pertempuran terbesar yang menjadi bagian dari Monkey D Luffy dan tim bajak lautnya. #OnePiece  https://t.co/2LpQ5LQxAd,11,0,5,0,2022-01-06,8,Thursday,4,16,0
1479009462790803459,2022-01-06 08:38:29,"RI resmi tutup pintu untuk WNA asal 14 negara terkait varian Omicron. Terdapat sejumlah pengecualian, misalnya untuk orang terpandang. Apa maksudnya? https://t.co/wOxGvrYCIT",10,0,0,0,2022-01-06,8,Thursday,4,10,0
1479008708873052165,2022-01-06 08:35:29,"Pengumuman hasil sanggah PPPK Guru 2021 tahap II dijadwalkan hari ini, Kamis (6/1/2022). Hasilnya dapat dilihat melalui laman berikut. Cek yuk! Via: detikedu https://t.co/VOgdqgOuVc",3,0,1,0,2022-01-06,8,Thursday,4,4,0
1479008218512859136,2022-01-06 08:33:32,Di media sosial beredar informasi palsu soal biaya pembuatan smart SIM secara online. Dalam informasi yang beredar disebutkan biaya tinggi dalam pembuatan smart SIM. https://t.co/TdGJEyhzRT,0,0,0,0,2022-01-06,8,Thursday,4,0,0
1479008199898546177,2022-01-06 08:33:28,"Hakim Ziyech mengungkap bagaimana skuad Chelsea bereaksi kepada Romelu Lukaku yang baru-baru ini bikin ""gaduh"" lewat wawancaranya.  https://t.co/0Ii2lKhf4s",5,0,1,0,2022-01-06,8,Thursday,4,6,0
1479007456076386305,2022-01-06 08:30:30,"Harga tiket MotoGP Mandalika dijual mulai Rp 115 ribu hingga Rp 15 juta. Jika konsumen membeli harga tiket termahal, dapatnya fasilitas apa saja ya?  https://t.co/MFt5rUGPPR",18,11,6,3,2022-01-06,8,Thursday,4,24,14
1479006773717585920,2022-01-06 08:27:48,"Wah apa jadinya yah kalo duo teknisi magang IndiHome ikut posko siaga Natal dan Tahun Baru, lalu datang ke rumah pelanggan?🤔
Yuk saksikan keseruannya di youtube @IndiHome melalui link :
https://t.co/BRlqa6dTgj",2,1,1,0,2022-01-06,8,Thursday,4,3,1
1479006416610508803,2022-01-06 08:26:22,Pihak Irwansyah akhirnya memberikan penjelasan soal rumah yang disita bank. Begini penjelasannya:  https://t.co/AxvWomELrn,4,0,1,0,2022-01-06,8,Thursday,4,5,0
1479006167842050050,2022-01-06 08:25:23,Sebuah daftar memunculkan nama Cristiano Ronaldo sebagai pesepakbola terkaya di awal 2022 ini. Tapi Ronaldo tak sendirian.  https://t.co/8eIRKTzEBM,6,0,0,0,2022-01-06,8,Thursday,4,6,0
1479005899863777280,2022-01-06 08:24:19,Drama Korea Weather People akan menggantikan Snowdrop. Seperti apa kisah Song Kang dan Park Min Young di drakor itu? Ini sinopsis dan jadwal tayangnya. https://t.co/I1TG8gcS12,4,0,1,2,2022-01-06,8,Thursday,4,5,2
1479005882897809409,2022-01-06 08:24:15,"Sebuah foto potongan telapak tangan manusia di Taman Bumi Wangi, Kudus, viral di media sosial. Bagaimana faktanya? https://t.co/JUss8tVqSV",9,0,0,0,2022-01-06,8,Thursday,4,9,0
1479005632133009408,2022-01-06 08:23:15,Sebuah mobil ringsek usai masuk kolong truk dan terseret sejauh 50 meter di ruas jalan Tol Cipularang. Begini penampakannya: https://t.co/NIzJ2UUEDe,2,0,0,0,2022-01-06,8,Thursday,4,2,0
1479005362112053250,2022-01-06 08:22:11,Belum lama ini telah terjadi kecelakaan lalu lintas yang melibatkan anggota komunitas pengawal ambulans di Subang. Ini pelajaran pentingnya.  https://t.co/Jn3QQpkTTs,3,1,0,0,2022-01-06,8,Thursday,4,3,1
1479005343959109632,2022-01-06 08:22:07,"Inovasi berupa Electronic Traffic Law Enforcement (E-TLE) mobile sudah diluncurkan sejak tahun lalu. Kini, Polda Jawa Timur mulai menerapkannya.  https://t.co/tIvy8yE98f",3,0,0,0,2022-01-06,8,Thursday,4,3,0
1479005120155299846,2022-01-06 08:21:13,Valentino Rossi dilarang geber Ferrari 488 GT3 usai kontak erat dengan seseorang penderita COVID-19. Begini nasibnya.  https://t.co/qBlpA3lEoI,4,0,1,0,2022-01-06,8,Thursday,4,5,0
1479005096684007426,2022-01-06 08:21:08,Sosok motor baru Honda U-GO sudah mulai didaftarkan di Indonesia. Yuk intip penampakannya!  https://t.co/CLUBuHJL1W,6,4,1,1,2022-01-06,8,Thursday,4,7,5
1479004369278447621,2022-01-06 08:18:14,Ridwan Kamil angkat bicara soal OTT Wali Kota Bekasi Rahmat Effendi oleh KPK. Dia mengaku prihatin atas kejadian tersebut. https://t.co/rYGhc7AWZg,15,17,1,0,2022-01-06,8,Thursday,4,16,17
1479004341147217925,2022-01-06 08:18:08,Pakar IDI menegaskan belum ada data lebih lanjut terkait varian 'IHU' yang menunjukkan B.1.640.2 lebih berbahaya ketimbang Omicron. https://t.co/XMiF5WPIXW,7,9,3,8,2022-01-06,8,Thursday,4,10,17
1479003735078625285,2022-01-06 08:15:43,"Ketua Umum PSSI, Mochamad Iriawan membubarkan skuad pemain yang berlaga di Piala AFF 2020. Ketum PSSI berharap pemain tetap menjaga stamina dan performa.  https://t.co/CJ9RcDyWYr",18,5,1,0,2022-01-06,8,Thursday,4,19,5
1479003720557989891,2022-01-06 08:15:40,Pebulutangkis Indonesia nomor ganda campuran Hafiz Faizal kini tengah berbahagia. Ia baru saja dikaruniai anak pertama!  https://t.co/acF4DiH8HC,3,0,1,0,2022-01-06,8,Thursday,4,4,0
1479003482975784961,2022-01-06 08:14:43,Ferdinand Hutahaean kerap terlibat dalam kontroversi. Mulai dari cuitan 'Allahmu Lemah' hingga cuitan 'Si Caplin'. Berikut daftar kontroversinya! https://t.co/3kibfYjYOG,2,0,1,2,2022-01-06,8,Thursday,4,3,2
1479003466706173954,2022-01-06 08:14:39,"Dari jabatan Aspers KSAD, dia lalu ditunjuk sebagai Pangdam Jaya, menggantikan Jenderal Dudung Abdurachman yang kala itu dimutasi sebagai Pangkostrad. https://t.co/lQ52szcvcp",7,0,1,0,2022-01-06,8,Thursday,4,8,0
1479002225620013058,2022-01-06 08:09:43,"PSSI menyerahkan bonus ke Timnas Indonesia usai kiprah mereka di Piala AFF 2020. Total ada Rp 2,5 miliar yang diberikan.  https://t.co/E2gPsxaPhT",7,1,0,1,2022-01-06,8,Thursday,4,7,2
1479002224315576320,2022-01-06 08:09:43,"Buat para pelaku usaha kecil-menengah, segera cek penerima BLT UMKM 2022 sebesar Rp 1,2 juta. https://t.co/IhiGtbLcdK",7,0,3,0,2022-01-06,8,Thursday,4,10,0
1479001578141016065,2022-01-06 08:07:09,Asnawi Mangkualam resmi memperpanjang kontraknya di Ansan Greeners. Pilar timnas Indonesia ini diikat kontrak anyar untuk mengarungi musim 2022/2023.  https://t.co/32eyJMetdh,11,1,0,1,2022-01-06,8,Thursday,4,11,2
1479001222338289671,2022-01-06 08:05:44,Wanita di Bali bernama Renny Matondang kehilangan anjing ras Pomerania kesayangannya. Dia membuat sayembara berhadiah hingga Rp 5 juta bagi yang menemukan. #detiktif https://t.co/KmA1rLKqcg,5,0,3,0,2022-01-06,8,Thursday,4,8,0
1479000707202260994,2022-01-06 08:03:41,Tujuh dari 12 penggugat Ustaz Yusuf Mansur rela datang meski berdomisili di luar kota. Sayang UYM tak datang dan hanya diwakili oleh pengacaranya. https://t.co/X1Fgx7ArPh,11,1,3,2,2022-01-06,8,Thursday,4,14,3
1479000113875931136,2022-01-06 08:01:20,Viral di media sosial rombongan Jokowi minggir saat ada ambulans lewat. Ini selengkapnya.   https://t.co/HAugs89Ucw,23,8,5,0,2022-01-06,8,Thursday,4,28,8
1478999754726072320,2022-01-06 07:59:54,Akting Anya Geraldine jadi pelakor di Layangan Putus bikin geregetan. Teryata Anya sampai mau nyamar biar tak diserang haters Lydia. https://t.co/TF8XUO8phN,10,0,1,1,2022-01-06,7,Thursday,4,11,1
1478999285484163073,2022-01-06 07:58:02,Ferdinand Hutahaean dilaporkan karena cuitan 'Allahmu ternyata lemah' yang diduga melanggar UU ITE. Ini kata pengamat soal kasus tersebut:  https://t.co/VxWXeXdoJi,3,0,0,0,2022-01-06,7,Thursday,4,3,0
1478999261236846594,2022-01-06 07:57:57,"Kim Mi Soo meninggal dunia di usia 31 tahun. Selain Snowdrop, Kiss Sixth Sense merupakan proyek drama terakhirnya. #KimMiSoo  https://t.co/tzKHyhVbhx",12,0,1,1,2022-01-06,7,Thursday,4,13,1
1478998763280687105,2022-01-06 07:55:58,"Jonathan Frizzy meminta hak asuh anak kepada majelis hakim karena sejak awal menggugat, Dhena Devanka tidak meminta hal itu. https://t.co/NiagJ4uwxM",1,0,0,0,2022-01-06,7,Thursday,4,1,0
1478998516567580681,2022-01-06 07:54:59,"Awal tahun tak berjalan manis untuk Bologna yang dilanda badai COVID-19. Alhasil, duel kontra Inter Milan kemungkinan dibatalkan!  https://t.co/m6VZmSQBcR",1,0,0,0,2022-01-06,7,Thursday,4,1,0
1478998515217014787,2022-01-06 07:54:59,Kabar baru dari WHO soal vaksin Sinovac terhadap varian Omicron. Disebutkan vaksin ini masih melindungi dari efek parah yang disebabkan Omicron. https://t.co/7udH0EnWG7,3,1,0,1,2022-01-06,7,Thursday,4,3,2
1478997608161058817,2022-01-06 07:51:22,PBSI disebut-sebut telah mencoret Praveen Jordan/Melati Daeva Oktavianti dari Pelatnas. Induk organisasi bulutangkis nasional itu pun memberi komentarnya.  https://t.co/hBM7hfDKWw,4,2,0,0,2022-01-06,7,Thursday,4,4,2
1478997519661215748,2022-01-06 07:51:01,"Menteri Keuangan Sri Mulyani Indrawati menyebut harga tanah di Kalimantan Timur akan naik seiring pembangunan ibu kota baru. Hal itu ia sampaikan saat mengunjungi Institut Teknologi Kalimantan (IKN) di Balikpapan, Rabu (5/1). https://t.co/hFidesKVpY",1,2,1,0,2022-01-06,7,Thursday,4,2,2
1478996778649366528,2022-01-06 07:48:05,"Sistem operasi atau OS pada BlackBerry disuntik mati pada 4 Januari 2022. Semua layanan pada ponsel yang akrab disebut BB ini terhenti, termasuk SMS dan panggilan telepon.  https://t.co/3N3ClPEVoE",4,0,0,0,2022-01-06,7,Thursday,4,4,0
1478995760498806786,2022-01-06 07:44:02,"""Faktanya walaupun dia begitu, Pak Edy tetap mencairkan bonusnya. Rp 100 juta untuk dia pribadi,"" kata pengacara Gubsu Edy. https://t.co/WScIhzU3tW",70,83,10,11,2022-01-06,7,Thursday,4,80,94
1478995742081572866,2022-01-06 07:43:57,"Di SNMPTN 2022, siswa IPS dan lulusan pesantren boleh mengambil jurusan IPA. Namun LTMPT mengingatkan risiko yang bisa terjadi jika siswa lintas jurusan. Via: detikedu https://t.co/qU7wzReM7u",4,0,0,1,2022-01-06,7,Thursday,4,4,1
1478994763407937539,2022-01-06 07:40:04,Rahmat Effendi Wali Kota Bekasi terjerat OTT oleh KPK. Ini profil Rahmat Effendi. https://t.co/QlcUgAncY0,5,2,0,0,2022-01-06,7,Thursday,4,5,2
1478994015383175168,2022-01-06 07:37:06,"Mengepel rumah biasanya menggunakan sabun atau cairan sejenisnya. Tapi di desa ini, pakai kotoran sapi. Unik! https://t.co/UolzSgvQKb",4,2,0,2,2022-01-06,7,Thursday,4,4,4
1478993024260710402,2022-01-06 07:33:10,Warga Kelurahan Menteng Atas mengeluhkan dugaan pencemaran udara berupa polusi dari asap genset Mal Kokas. Pemprov DKI pun berencana memanggil pihak Kokas. https://t.co/6uaXERvafg,2,0,3,0,2022-01-06,7,Thursday,4,5,0
1478992474748108804,2022-01-06 07:30:58,Keberadaan Ancilla Irish Gabriella (25) peserta Meditation Camp di Tangsel masih misteri. Berikut kronologi hilangnya Ancilla. #detiktif https://t.co/eRiz84HfS1,6,0,4,0,2022-01-06,7,Thursday,4,10,0
1478992182476423169,2022-01-06 07:29:49,"""Ya sebaiknya dialihkan ke hal-hal yang positif ya, dalam artian bisa mengadopsi anak-anak yang terlantar,"" kata Ketua Komisi VIII DPR, Yandri Susanto. Gimana menurut detikers? https://t.co/LuhgD78R1Z",11,3,2,2,2022-01-06,7,Thursday,4,13,5
1478991452625682434,2022-01-06 07:26:55,Pemerintah memutuskan untuk menyetop ekspor batu bara pada 1-31 Januari 2022 guna menjamin ketersediaan komoditas tersebut untuk pembangkit listrik dalam negeri.  https://t.co/fJu8drUiby,9,0,1,0,2022-01-06,7,Thursday,4,10,0
1478990439407570945,2022-01-06 07:22:53,"Dengan panjang 206,65 km, tol yang akan menghubungkan Jawa Barat dengan Jawa Tengah ini jadi tol terpanjang di Indonesia sejauh ini setelah Padang-Pekanbaru. https://t.co/rftrwc29jK",26,7,10,7,2022-01-06,7,Thursday,4,36,14
1478989424574840837,2022-01-06 07:18:51,"Siapa yang penasaran berapa gaji pramugari kereta api? Selain pesawat yang memiliki pramugari, di kereta api antar kota juga ada. Segini nih kisaran gajinya: https://t.co/bJNhrL3MXD",4,0,0,0,2022-01-06,7,Thursday,4,4,0
1478988913968615424,2022-01-06 07:16:50,Film Makmum 2 membangkitkan rasa penasaran masyarakat Indonesia untuk menyaksikannya. Angka yang mengejutkan untuk film Makmum 2 di hari keempat penayangannya. #Makmum2  https://t.co/b1adtBIbAB,12,1,5,2,2022-01-06,7,Thursday,4,17,3
1478988429794983936,2022-01-06 07:14:54,Kim Seon Ho disebut tak lagi menerima proyek baru di 2022. Ia kini tengah menyelesaikan syuting untuk film Sad Tropics. #KimSeonHo  https://t.co/7gkWo8qboQ,42,3,6,4,2022-01-06,7,Thursday,4,48,7
1478987928982503426,2022-01-06 07:12:55,"Pemerintah Indonesia resmi menutup sementara pintu masuk untuk WNA dari 14 negara imbas varian Omicron. Diketahui, aturan itu akan berlaku mulai besok. https://t.co/4ECzC4cxAC",5,0,3,0,2022-01-06,7,Thursday,4,8,0
1478987409043906561,2022-01-06 07:10:51,"Demi mencegah penyebaran varian Omicron, RI resmi menutup pintu bagi WNA asal negara-negara tertentu. Berikut daftar 14 negara beserta kriterianya: https://t.co/UuPOQF37mj",10,2,3,2,2022-01-06,7,Thursday,4,13,4
1478986000064032768,2022-01-06 07:05:15,Sejumlah menteri hingga kepala daerah dilaporkan ke KPK. Ada Luhut Pandjaitan hingga Anies Baswedan dan Ganjar Pranowo. https://t.co/Rks7fU6U5W,3,2,7,0,2022-01-06,7,Thursday,4,10,2
1478985908556906498,2022-01-06 07:04:53,"Visinema Pictures merilis poster dan trailer film aksi pertamanya, Ben &amp; Jody di Epicentrum XXI, kemarin.  https://t.co/wGBtf1IR21",2,0,2,1,2022-01-06,7,Thursday,4,4,1
1478984857955012608,2022-01-06 07:00:43,Polri menyebut bahwa pegiat media sosial Ferdinand Hutahaean tengah diselidiki oleh kepolisian atas dugaan tindak pidana ujaran kebencian berkaitan dengan SARA yang berpotensi menimbulkan keonaran. #CNNIndonesia #detiknetwork  https://t.co/8IOpn9Qdl5,14,3,2,4,2022-01-06,7,Thursday,4,16,7
1478984342571470851,2022-01-06 06:58:40,Fase pertama dari komik Star Wars yang berlatar era High Republic telah berakhir. Kini fase kedua segera rilis di Oktober 2022 dan latarnya pergi ke masa lalu. https://t.co/FHv20SyULB,3,0,1,0,2022-01-06,6,Thursday,4,4,0
1478983813543956481,2022-01-06 06:56:33,Recording Academy mengumumkan penundaan Grammy Awards pada 31 Januari mendatang. Keputusan ini dibuat karena adanya varian Omicron yang menimbulkan terlalu banyak risiko. https://t.co/j1DpELQ9EN,1,0,0,0,2022-01-06,6,Thursday,4,1,0
1478983570265985027,2022-01-06 06:55:35,"Umrah di masa pandemi menawarkan suasana berbeda. Jika biasanya jemaah akan berdesakan, kini amat longgar. https://t.co/Rx3Rjo5Eyd",5,0,1,0,2022-01-06,6,Thursday,4,6,0
1478982829933481985,2022-01-06 06:52:39,KPK menangkap Walkot Bekasi Rahmat Effendi. Ketua KPK Firli Bahuri menyebut penangkapan itu menjadi catatan buruk terkait upaya pemberantasan korupsi. https://t.co/mTvJsEsqXs,4,1,0,0,2022-01-06,6,Thursday,4,4,1
1478982238322757632,2022-01-06 06:50:18,"#Foto Belakangan ini Hotman Paris sering terlihat berfoto tanpa mengenakan kaca matanya. Tak hanya itu saja, Hotman juga disebut makin kurus. Ini potretnya. #HotmanParis https://t.co/qqtZtkRDvb",7,1,1,1,2022-01-06,6,Thursday,4,8,2
1478981990493954050,2022-01-06 06:49:19,"Prodi Kedokteran biasanya memiliki stigma prodi dengan UKT mahal di kalangan masyarakat Indonesia. Untuk membuktikannya, yuk cek besarannya di PTN berikut! Via: detikedu https://t.co/p9MpKTL7wZ",7,0,3,0,2022-01-06,6,Thursday,4,10,0
1478980973559795712,2022-01-06 06:45:16,"Sains, terutama sains baru, sering menghadapi penolakan. Namun ketika krisis kesehatan melanda, orang cenderung lebih baik dalam belajar bagaimana tetap sehat. https://t.co/vPs6XzuIbZ",2,0,0,1,2022-01-06,6,Thursday,4,2,1
1478979994592423938,2022-01-06 06:41:23,Kai Havertz tampak mengalami cedera tangan saat membantu Chelsea menang 2-0 atas Tottenham Hotspur. Jari kelingkingnya diduga mengalami dislokasi atau fraktur.  https://t.co/us4xeVaV61,2,0,0,0,2022-01-06,6,Thursday,4,2,0
1478979246051803140,2022-01-06 06:38:25,Cythia Lamusu mengatakan ingin berhenti bernyanyi. Kenapa ya?  https://t.co/E3p98Quvz2,3,0,0,0,2022-01-06,6,Thursday,4,3,0
1478978502615617537,2022-01-06 06:35:27,Eks pesepakbola Ze Roberto kini kekar banget! Mantan bintang Bayern Munich itu pun sempat memberi tantangan ke Cristiano Ronaldo.  https://t.co/wNZWjp8qPD,3,0,0,0,2022-01-06,6,Thursday,4,3,0
1478978501382443010,2022-01-06 06:35:27,Asus VivoBook Pro 14 OLED (K3400) dirilis menyasar kreator anak muda. Mengusung panel OLED yang memukau mata namun dibanderol dengan harga terjangkau. https://t.co/fr9Lj3QTEA,2,0,0,0,2022-01-06,6,Thursday,4,2,0
1478977957163302915,2022-01-06 06:33:17,Perusahaan raksasa elektronik Sony telah mengumumkan rencana untuk meluncurkan perusahaan mobil listrik pada akhir tahun ini. https://t.co/GZ7XP5liM2,12,3,3,0,2022-01-06,6,Thursday,4,15,3
1478977479113121796,2022-01-06 06:31:23,Ustaz Yusuf Mansur hari ini tidak datang hadiri sidang gugatan wanprestasi di Pengadilan Negeri Tangerang. Dirinya diwakili oleh pengacara. https://t.co/D0ZT6dl3xZ,2,5,1,1,2022-01-06,6,Thursday,4,3,6
1478977468195295234,2022-01-06 06:31:21,Kim Mi Soo meninggal pada 5 Januari. Sang mendiang disebut telah menyelesaikan syuting untuk sebelum meninggal dunia. Ini fakta tentang peran Kim Mi Soo:  https://t.co/mtScFI3lsa,4,1,3,2,2022-01-06,6,Thursday,4,7,3
1478976647722381312,2022-01-06 06:28:05,Erajaya menawarkan para investor perseorangan yang bergabung Erafone Cloud Retail Partner dengan keuntungan yang cukup menggiurkan. https://t.co/WwfxUvDlzA,3,1,1,0,2022-01-06,6,Thursday,4,4,1
1478976112562774017,2022-01-06 06:25:57,Cuitan kontroversial Ferdinand Hutahaean masih ramai dibahas dan dikecam oleh para netizen. https://t.co/AS9RfdWIk1,5,3,3,1,2022-01-06,6,Thursday,4,8,4
1478976111463874567,2022-01-06 06:25:57,"Mengenang 100 hari kepergian Gunawan Maryanto, Teater Garasi membuat mini festival untuk merayakan cara berkesenian pria yang akrab disapa Cindhil tersebut. https://t.co/7tfW9KlE8Q",5,0,1,0,2022-01-06,6,Thursday,4,6,0
1478975611578241024,2022-01-06 06:23:58,"Ratusan perusahaan teknologi bergabung di Pameran CES 2022, Las Vegas, Amerika Serikat. Beragam alat canggih mereka pamerkan. Ini potretnya: #CES2022  https://t.co/CPDTXipkG9",2,1,1,0,2022-01-06,6,Thursday,4,3,1
1478974607113822208,2022-01-06 06:19:59,"Di belakang berdirinya ITB, ada sosok etnis Tionghoa yang berjasa. Begini kisah Phoa Keng Hek yang kini dilupakan. Via: detikedu https://t.co/529S6nyxYR",18,0,4,0,2022-01-06,6,Thursday,4,22,0
1478974355292016641,2022-01-06 06:18:58,Masyarakat RI disebut-sebut sudah memiliki 'super immunity'. Apa itu sebenarnya? Apakah berarti warga RI makin kebal dari COVID-19? Ini fakta-fakta di baliknya: https://t.co/NIlOE8d0wL,7,1,6,1,2022-01-06,6,Thursday,4,13,2
1478973584131469312,2022-01-06 06:15:55,"Manajer Tottenham Hotspur Antonio Conte tidak mau beralasan usai timnya digebuk Chelsea 0-2. Conte mengatakan, Chelsea memang jauh lebih kuat daripada Spurs.  https://t.co/B63yYK7Tt9",8,0,2,0,2022-01-06,6,Thursday,4,10,0
1478972602433609730,2022-01-06 06:12:01,Kim Mi Soo mengembuskan napas terakhir di usia 31 tahun pada 5 Januari 2022. Ini profil aktris Kim Mi Soo:  https://t.co/xtPbllrDe9,8,0,2,1,2022-01-06,6,Thursday,4,10,1
1478971892509904898,2022-01-06 06:09:11,Pembangunan rel ganda kereta api (KA) yang menghubungkan Stasiun Kiaraconding hingga Stasiun Cicalengka terus dikebut. Seperti apa progresnya? https://t.co/XyZXaRUL21,7,1,2,1,2022-01-06,6,Thursday,4,9,2
1478971293949206532,2022-01-06 06:06:49,Pihak Medina Zein mengungkap poin-poin yang menjadi kesalahan Marissya Icha sampai akhirnya dilaporkan ke polisi.  https://t.co/gf92l1oOkU,2,0,1,0,2022-01-06,6,Thursday,4,3,0
1478971054622228484,2022-01-06 06:05:52,"Erajaya tidak hanya fokus untuk melakukan penjualan secara online saja. Namun, gerai konvensional pun turut ditambah di berbagai daerah. https://t.co/4QxxctpWwV",3,0,2,0,2022-01-06,6,Thursday,4,5,0
1478970308971352065,2022-01-06 06:02:54,Smartphone entry-level terbaru dari Samsung ini hadir dengan sejumlah fitur yang dapat menunjang berbagai aktivitas harian kamu. Ini spesifikasinya:   https://t.co/zIsmPZNIHw,2,0,1,1,2022-01-06,6,Thursday,4,3,1
1478969778102489090,2022-01-06 06:00:47,"Penasaran dengan kepribadian sesungguhnya yang kamu miliki? Tes kepribadian bisa menjawab rasa penasaranmu. Jadi, gambar apa yang pertama kali kamu lihat? https://t.co/ENpHcxG125",1,1,0,0,2022-01-06,6,Thursday,4,1,1
1478969531112513541,2022-01-06 05:59:48,Kim Mi Soo meninggal dunia. Kematian Kim Mi Soo yang masih misteri dan mendadak membuat publik terkejut. Selamat jalan Kim Mi Soo...  https://t.co/j8knlGRorN,6,0,3,0,2022-01-06,5,Thursday,4,9,0
1478969294113361920,2022-01-06 05:58:52,Ustaz Yusuf Mansur digugat 3 kasus perdata sekaligus di Pengadilan Negeri Tangerang. Ini sudah diprediksi sebelumnya oleh Ustaz Yusuf Mansur. https://t.co/G52aoccYMm,14,6,3,0,2022-01-06,5,Thursday,4,17,6
1478969279433297923,2022-01-06 05:58:48,"Mayoritas pasien Omicron RI bergejala batuk-pilek. Sulit dibedakan dengan flu biasa, harus bagaimana jika alami gejala serupa? Jangan panik, ini pesan dokter: https://t.co/f7e8nBDy9W",8,4,1,0,2022-01-06,5,Thursday,4,9,4
1478968792277557248,2022-01-06 05:56:52,"Ada beberapa fitur, keunggulan, ataupun hal ikonik dari ponsel dengan OS buatan Research in Motion tersebut. Ini fitur unggulan BlackBerry pada zamannya:  https://t.co/DWp3aeX0YM",10,1,2,1,2022-01-06,5,Thursday,4,12,2
1478968298679291905,2022-01-06 05:54:54,"Pengacara Gubsu Edy Rahmayadi, Junirwan Kurnia mengatakan akan melaporkan balik pelatih Biliar, Choki terkait ucapan 'gubernur jahanam'. https://t.co/Z3xa5q1jpS",10,21,3,3,2022-01-06,5,Thursday,4,13,24
1478968051152441348,2022-01-06 05:53:55,"Ribuan tahun sebelum ada Facebook, Twitter, Instagram, dan TikTok, sekitar 50 ribu tahun lalu bangsa Afrika menjalin hubungan sosial dengan media ini:  https://t.co/SnqOWinqw7",6,2,5,0,2022-01-06,5,Thursday,4,11,2
1478967524108742658,2022-01-06 05:51:50,Jajaran televisi anyar LG diperkenalkan di CES 2022. Perangkat tersebut mencakup OLED dan Mini LED generasi terbaru yang diklaim optimal untuk ngegame. #CES2022  https://t.co/WJFTbSyX90,3,0,1,0,2022-01-06,5,Thursday,4,4,0
1478967270755950593,2022-01-06 05:50:49,Medina Zein polisikan balik Marissya Icha usai jadi tersangka. Medina melaporkan sang selebgram terkait pencemaran nama baik melalui media elektronik. https://t.co/cI19xznlvC,2,0,1,0,2022-01-06,5,Thursday,4,3,0
1478966051085946882,2022-01-06 05:45:59,Bitcoin saat ini semakin populer. Uang digital itu diprediksi akan mengambil pangsa pasar dari emas pada tahun 2022. https://t.co/pdxOyC4glI,10,6,3,1,2022-01-06,5,Thursday,4,13,7
1478965867249606660,2022-01-06 05:45:15,Ahok dilaporkan ke KPK terkait dugaan tindak pidana korupsi. https://t.co/OtzlB8J2tv,351,111,66,15,2022-01-06,5,Thursday,4,417,126
1478965717361963012,2022-01-06 05:44:39,Kekayaan yang dihasilkan Elon Musk pada 2021 sangat mengejutkan karena adanya peningkatan yang signifikan. Segini jumlah kekayaan Elon Musk:  https://t.co/cZcUW2awcJ,6,4,2,1,2022-01-06,5,Thursday,4,8,5
1478965139890180096,2022-01-06 05:42:21,Samsung Galaxy Z Fold3 hadir dengan sejumlah peningkatan dari pendahulunya. Salah satu yang menonjol adalah bagian layar dari ponsel layar lipat ini. https://t.co/MNwRrJtZ2L,3,0,2,0,2022-01-06,5,Thursday,4,5,0
1478964363843276800,2022-01-06 05:39:16,"Selebgram ini mengalami gejala serangan jantung karena terlalu banyak kentut. Dalam seminggu, ia bisa meraup ratusan juta dari jualan kentut dalam stoples. Haduh. https://t.co/jVVD6JpLvI",79,35,26,46,2022-01-06,5,Thursday,4,105,81
1478963591277649920,2022-01-06 05:36:12,"Marcelo sedang menjalani 6 bulan terakhir masa kontraknya di Real Madrid. Kendati masa depannya belum jelas, dia berjanji terus tampil habis-habisan!  https://t.co/tJ0BodpaLh",1,0,0,1,2022-01-06,5,Thursday,4,1,1
1478962865214214144,2022-01-06 05:33:19,"Setelah divaksinasi COVID-19 dengan vaksin Pfizer, petinju Ebanie Bridges berkelakar payudaranya makin besar -- merujuk viralnya klaim efek samping vaksin itu.  https://t.co/Al9PmUSadH",6,0,3,0,2022-01-06,5,Thursday,4,9,0
1478962193244856321,2022-01-06 05:30:39,"Sebagai orang nomor satu di BCA, Jahja memiliki cerita hidup yang menarik. Dia bukanlah pewaris tahta di Grup Djarum. Begini kisahnya: https://t.co/J9Fg3R8W5O",2,1,1,0,2022-01-06,5,Thursday,4,3,1
1478961445329059843,2022-01-06 05:27:40,"Pemeran Yeong Jeong Min di Snowdrop, Kim Mi Soo meninggal pada 5 Januari 2022. Berikut profil mengenainya: https://t.co/u7f3nrw7UP",5,1,1,0,2022-01-06,5,Thursday,4,6,1
1478960430705958914,2022-01-06 05:23:39,Tol Gedebage-Tasikmalaya-Cilacap akan segera dibangun. Hal ini menyusul penetapan pemenang lelang pengusahaan Tol Gedebage-Tasikmalaya-Cilacap. https://t.co/LwLrzxKcmL,25,0,6,4,2022-01-06,5,Thursday,4,31,4
1478959638020304902,2022-01-06 05:20:30,"Orang terkaya kedua dunia, Jeff Bezos, seakan tak mau lepas dari pacarnya, Lauren Sanchez. Kemana-mana mereka selalu berdua. Ini potretnya:  https://t.co/udBslkshb5",7,4,1,0,2022-01-06,5,Thursday,4,8,4
1478959136398319618,2022-01-06 05:18:30,"Bagi kamu yang sedang mencari nama bayi perempuan islami dan artinya dari huruf A hingga Z dengan makna atau doa yang indah, berikut inspirasinya: https://t.co/stF4hAQr3E",19,0,5,0,2022-01-06,5,Thursday,4,24,0
1478958392605614080,2022-01-06 05:15:33,Ayu Aulia akhirnya meminta maaf atas hebohnya video dengan Zikri Daulay. Ia menuliskan hal tersebut dalam media sosial miliknya. https://t.co/87s0GL331O,6,0,1,0,2022-01-06,5,Thursday,4,7,0
1478957341383008256,2022-01-06 05:11:22,Sejumlah eks pegawai BPPT mengadu Komnas HAM soal pemberhentian hubungan kerja yang dialami. Pemberhentian imbas dari peleburan BRIN. https://t.co/k5i72KrlxV,7,0,1,1,2022-01-06,5,Thursday,4,8,1
1478957323989233673,2022-01-06 05:11:18,China meluncurkan aplikasi dompet untuk yuan digital. Begini fakta-faktanya: https://t.co/gW9Kctfdrg,4,0,4,0,2022-01-06,5,Thursday,4,8,0
1478956597258948608,2022-01-06 05:08:25,Apple diperkirakan sukses menjual 40 juta unit iPhone 13 dari berbagai varian selama musim liburan 2021 lalu. #iPhone  https://t.co/UZOFZjDqAD,2,0,1,0,2022-01-06,5,Thursday,4,3,0
1478956335748329473,2022-01-06 05:07:22,"Demi mencegah penyebaran varian Omicron, pemerintah resmi menutup sementara pintu masuk untuk WNA dari negara-negara tertentu. Berikut aturannya; https://t.co/116hquF0gK",10,5,3,1,2022-01-06,5,Thursday,4,13,6
1478956080394866689,2022-01-06 05:06:21,"Dua gugatan terkait perbuatan melawan hukum, sedangkan satunya lagi terkait wanprestasi. https://t.co/uJWdQxwMQO",6,1,4,4,2022-01-06,5,Thursday,4,10,5
1478955299725795328,2022-01-06 05:03:15,Fans Marvel harus menunggu lebih lama untuk menyaksikan aksi Jared Leto di Morbius yang harus ditunda penayangannya. Huftt...  https://t.co/1ixDjlxeN1,5,0,0,1,2022-01-06,5,Thursday,4,5,1
1478954704843546633,2022-01-06 05:00:53,Pemerintah resmi mengeluarkan surat edaran baru bagi pelaku perjalanan luar negeri. Pelaku perjalanan luar negeri wajib karantina 7-10 hari. https://t.co/fNBa5WqAdA,4,0,2,0,2022-01-06,5,Thursday,4,6,0
1478954689303617536,2022-01-06 05:00:50,Marissya Icha melaporkan Medina Zein soal postingan 'berlian palsu' hingga 'sogokan penghargaan' ke polisi. Ini kata Marissya Icha. https://t.co/noNhX9RGTG,1,1,1,0,2022-01-06,5,Thursday,4,2,1
1478954477512282113,2022-01-06 04:59:59,Tahun 2021 jadi tahun lahirnya 5G di Indonesia. Babak baru jaringan seluler ini ditandai dengan komersialisasi 5G. Kita tunggu gebrakannya untuk 2022! https://t.co/SfZ38xKecv,2,1,0,0,2022-01-06,4,Thursday,4,2,1
1478953555113521157,2022-01-06 04:56:19,"""Jadi wacana Kortas Tipidkor tentu kawan-kawan itu eks (pegawai) KPK akan ditempatkan di sana,"" ujar Brigjen Ahmad Ramadhan. https://t.co/xEokBNLTzc",1,0,0,0,2022-01-06,4,Thursday,4,1,0
1478953538835427333,2022-01-06 04:56:15,"Mobil dijadikan travel tanpa trayek masuk kolong truk dan terseret sejauh 50 kilometer di ruas jalan Tol Cipularang, Kabupaten Purwakarta. https://t.co/IP7coZpWCV",4,5,0,1,2022-01-06,4,Thursday,4,4,6
1478952975229988864,2022-01-06 04:54:01,Aktris Kim Mi Soo membintangi sejumlah drama Korea papan atas selama tiga tahun kariernya. Ini drama-drama terbaik yang pernah dibintangi:  https://t.co/N8OCupXE9Z,7,0,3,0,2022-01-06,4,Thursday,4,10,0
1478952230036422656,2022-01-06 04:51:03,"Sesuai peraturan yang ada hingga kini, program relaksasi PPnBM telah usai. Sempat ada usulan perpanjangan PPnBM 0% bahkan sampai dipermanenkan, tapi belum ada kepastian soal itu.   https://t.co/iX6iHLJ4LJ",5,0,2,0,2022-01-06,4,Thursday,4,7,0
1478951653386735616,2022-01-06 04:48:46,Pandemi ternyata tak menghentikan para orang kaya yang ingin makan kaviar. Kok bisa laris manis terus? https://t.co/wMFaJe6ZFu,2,0,0,1,2022-01-06,4,Thursday,4,2,1
1478951405662654465,2022-01-06 04:47:47,"Terkait Omicron, WNA dari 14 negara ini tak diperbolehkan masuk Indonesia. Aturan berlaku mulai Jumat besok! https://t.co/TiFp2K5jDc",3,0,2,0,2022-01-06,4,Thursday,4,5,0
1478951111935545349,2022-01-06 04:46:37,Para peneliti kutub di Antartika tertular virus Corona. Tak diketahui bagaimana para peneliti yang sudah divaksinasi penuh dan tinggal terisolasi ini tertular. https://t.co/EZFmbyBQA5,36,6,24,4,2022-01-06,4,Thursday,4,60,10
1478950804937748482,2022-01-06 04:45:24,Ketua PB Djarum Yoppy Rosimin menilai wajar pencoretan atlet ke klub dari Pelatnas Bulutangkis. Itu termasuk dengan atlet binaannya.  https://t.co/JVlXEBRi7J,4,0,2,0,2022-01-06,4,Thursday,4,6,0
1478950803859718144,2022-01-06 04:45:23,Empat kiper Timnas Indonesia di Piala AFF 2020 seluruhnya masuk dalam daftar estimasi valuasi harga para penjaga gawang termahal di turnamen itu.  https://t.co/mACD8DQyQs,22,0,1,0,2022-01-06,4,Thursday,4,23,0
1478949892227747840,2022-01-06 04:41:46,Narji yang kini kader partai PKS pernah mengucapkan permintaan maaf atas tindakannya mendukung aksi pencopotan baliho HRS. Narji mengakui bahwa permintaan maafnya murni dilakukan olehnya tanpa intervensi partai. https://t.co/S3KtNIoy6H,8,0,1,0,2022-01-06,4,Thursday,4,9,0
1478949458473848836,2022-01-06 04:40:03,Rasa bosan dan jenuh kerap muncul dalam hubungan suami dan istri. Lantas bagamana menghindari rasa bosan dalam rumah tangga? Ini kata ustaz:  https://t.co/WZvxvE7Z1b,5,4,2,2,2022-01-06,4,Thursday,4,7,6
1478948659387678726,2022-01-06 04:36:52,PUBG Mobile Pro League Indonesia Season 5 telah membuka pendaftaran. Ini berlangsung sejak tanggal 31 Desember 2021 hingga 12 Januari mendatang. https://t.co/IzSseimkIj,3,0,1,0,2022-01-06,4,Thursday,4,4,0
1478948391832989696,2022-01-06 04:35:48,"Wilayah yang tidak ada kasus COVID-19 per 2 Januari 2022 mencapai 106 wilayah. Lagi-lagi tak ada DKI Jakarta, ini daftar sebaran zona hijau COVID-19: https://t.co/MZ0xfKlPYt",9,0,2,0,2022-01-06,4,Thursday,4,11,0
1478947138398822406,2022-01-06 04:30:49,"BlackBerry Gemini dan Bellagio, dua handphone ini sempat digilai di Indonesia, bahkan saat penjualan perdananya pernah bikin kericuhan. Pernah pakai? https://t.co/OFs81oMrK5",6,2,5,4,2022-01-06,4,Thursday,4,11,6
1478947120136740864,2022-01-06 04:30:45,Film Ben &amp; Jody yang dibintangi oleh Chicco Jerikho dan Rio Dewanto mempromosikan hastag #SahabatSampaiMati karena kepergian Glenn Fredly.  https://t.co/Yltb8G44Fb,9,2,1,0,2022-01-06,4,Thursday,4,10,2
1478946333126021123,2022-01-06 04:27:37,"Setelah tudingan transfobia merajalela selama dua tahun belakangan, JK Rowling kini menghadapi tuduhan antisemitisme gara-gara Goblin. #JKRowling  https://t.co/ix1lTrEmiT",4,0,0,0,2022-01-06,4,Thursday,4,4,0
1478946074496806913,2022-01-06 04:26:36,Pengumuman! Raffi Ahmad buka lowongan kerja melalui RANS Entertainment. Gajinya segini nih: https://t.co/PMgr5oUaIc,99,22,19,15,2022-01-06,4,Thursday,4,118,37
1478945829452922884,2022-01-06 04:25:37,Jadwal Liga 1 hari ini mempertemukan PSIS dengan Persija. Duel antara Macan Kemayoran dengan Mahesa Jenar digelar di Stadion Kapten I Wayan Dipta.  https://t.co/SlqqBn7Hq6,6,0,0,0,2022-01-06,4,Thursday,4,6,0
1478945825879433218,2022-01-06 04:25:37,Ibunda Gaga Muhammad dihujat netizen lantaran ucapannya soal kemungkinan operasi Laura Anna. https://t.co/tDpcy7EYed,3,0,2,0,2022-01-06,4,Thursday,4,5,0
1478945577266262019,2022-01-06 04:24:37,"Sudah hampir setahun Sony memboyong PlayStation 5 ke Indonesia. Namun sampai saat ini, masih sangat sulit membeli konsol tersebut dengan harga resmi. https://t.co/vxOpS0IwKl",6,0,1,0,2022-01-06,4,Thursday,4,7,0
1478945326044176384,2022-01-06 04:23:37,"Pernah ngecas HP ""kentang"" pakai charger fast charge nggak? Baterainya lebih cepat penuh atau tidak? Yuk, cari tahu jawabannya. Via: detikedu https://t.co/j92Ws4QlfX",7,1,2,1,2022-01-06,4,Thursday,4,9,2
1478944838208868355,2022-01-06 04:21:41,"Meski sedang liburan, Marissya Icha tetap memantau perkembangan berita yang sedang hits. Inikah sindiran Marissya Icha untuk Medina Zein? https://t.co/ZbUqKCEuMv",2,0,2,0,2022-01-06,4,Thursday,4,4,0
1478944817170288642,2022-01-06 04:21:36,Kehidupan asmara Yang Mi selalu jadi perbincangan warganet. Kali ini ia disebut telah putus dari Wei Daxun dan siap untuk cari pacar lagi. https://t.co/ihdqk6Hv4U,2,0,0,0,2022-01-06,4,Thursday,4,2,0
1478944469567352833,2022-01-06 04:20:13,Medina Zein ternyata kembali dilaporkan oleh Marissya Icha. Marissya Icha polisikan Medina dengan dugaan laporan palsu.  https://t.co/wxXgBEgFhl,0,0,2,0,2022-01-06,4,Thursday,4,2,0
1478944448633520128,2022-01-06 04:20:08,TNKB atau pelat baru nantinya bakal dilengkapi dengan chip. Simak penjelasannya di sini.  https://t.co/zGv98i3fkV,10,8,4,4,2022-01-06,4,Thursday,4,14,12
1478943970113826818,2022-01-06 04:18:14,Mungkin kadang kita curiga saat makan ikan di restoran disajikan ikan yang tidak sesuai dengan pesanan kita. Dubai menghadirkan teknologi untuk cegah ikan tipu-tipu. https://t.co/nXRAJpJCc1,0,0,2,0,2022-01-06,4,Thursday,4,2,0
1478943953898680320,2022-01-06 04:18:10,"Romelu Lukaku menyampaikan keinginan untuk bisa kembali bermain lagi di Inter Milan. Pelatih Nerazzurri, Simone Inzaghi, tak mau membicarakan hal tersebut.  https://t.co/L2zUcxOWLR",2,0,0,3,2022-01-06,4,Thursday,4,2,3
1478943704417251328,2022-01-06 04:17:11,"Jika kamu termasuk penumpang yang merasa terganggu dengan teriakan bayi di pesawat, bisa pilih bangku di posisi ini yang lebih nyaman. Di mana ya posisi itu? https://t.co/zmtlWVEPri",0,1,1,0,2022-01-06,4,Thursday,4,1,1
1478943218263863301,2022-01-06 04:15:15,Christian Eriksen ingin melanjutkan karier sepakbolanya. Pria asal Denmark itu menegaskan tidak takut jika kembali mengalami serangan jantung.  https://t.co/1NqYIYW965,5,0,1,0,2022-01-06,4,Thursday,4,6,0
1478943196499656709,2022-01-06 04:15:10,"Calon suami Melanie Putria, Aldico Sapardan sudah jalani operasi tumor otak. Begini kondisi terbaru calon suami Melanie Putria:  https://t.co/m5jGzLzWGh",4,1,2,0,2022-01-06,4,Thursday,4,6,1
1478942465205972993,2022-01-06 04:12:15,"Wajib coba nih! Dengan menggunakan aplikasi ini, presentasi kamu tidak akan membosankan dan tentunya bisa lebih menarik. Apa saja ya aplikasi itu? https://t.co/mq5vDuqVjY",13,0,8,0,2022-01-06,4,Thursday,4,21,0
1478942163597774858,2022-01-06 04:11:03,Polisi menetapkan Medina Zein sebagai tersangka kasus pencemaran nama baik yang dilaporkan Marissya Icha pada Rabu (5/1). Pertimbangan tersebut berdasarkan dua alat bukti dan proses mediasi yang gagal. https://t.co/S696GQ4xgz,2,2,1,0,2022-01-06,4,Thursday,4,3,2
1478941663741497352,2022-01-06 04:09:04,Driver ojol (ojek online) melakukan demonstrasi menuntut Kementerian Perhubungan agar menerbitkan payung hukum yang jelas untuk profesi ojol.  https://t.co/XHO5aF5qgK,5,1,1,0,2022-01-06,4,Thursday,4,6,1
1478940631661785094,2022-01-06 04:04:58,"Mulai hari ini, tiket MotoGP Indonesia 2022 yang akan digelar di Pertamina Mandalika International Street Circuit sudah bisa dibeli.  https://t.co/5i1xtlc8FN",7,1,5,3,2022-01-06,4,Thursday,4,12,4
1478940453160595464,2022-01-06 04:04:16,"Intan RJ sudah dua tahun ditinggal pergi oleh suaminya, Wahyu Indra Utama. Intan RJ sempat konsultasi ke psikiater untuk menghilangkan rasa sedihnya tersebut. https://t.co/4YcLLCMS7e",9,4,1,1,2022-01-06,4,Thursday,4,10,5
1478940435255017472,2022-01-06 04:04:11,"Bagi kamu berpikir untuk resign dari perusahaan sekarang, 10 kota ini bisa menjadi rekomendasi untuk menemukan pekerjaan baru dan gajinya tinggi. Ada Jakarta? https://t.co/mLECto1x3D",6,1,2,0,2022-01-06,4,Thursday,4,8,1
1478940188239974401,2022-01-06 04:03:12,Satgas COVID-19 menerbitkan surat edaran baru yang mengatur kebijakan penanganan pandemi. Salah satunya soal aturan karantina pejabat dari luar negeri. https://t.co/Kf3P0fYiQl,9,0,1,0,2022-01-06,4,Thursday,4,10,0
1478940167276797954,2022-01-06 04:03:07,"Mobil nasional Vietnam, Vinfast, terus melakukan pengembangan teknologi bantuan pengemudi (drive assist).  https://t.co/0uh6Zvtjnz",11,6,4,2,2022-01-06,4,Thursday,4,15,8
1478939640841347074,2022-01-06 04:01:02,"Indonesia Telecommunication and Digital Research Institute Telkom berupaya mengaktualisasi sebagai digital hub, ekosistem digital, dan telenta digital. https://t.co/Abd6lTrPiW",4,0,1,0,2022-01-06,4,Thursday,4,5,0
1478939619710447621,2022-01-06 04:00:57,"Aku dan suami memang jarang bersilahturahmi ke keluarga, namun sekalinya aku datang malah mendapat tudingan jika suami mengguna-gunaiku dan harus ruqyah. #detiknetwork  https://t.co/aAlArgUWB2",2,1,1,0,2022-01-06,4,Thursday,4,3,1
1478939225051602944,2022-01-06 03:59:23,Di media sosial beredar informasi palsu soal biaya pembuatan smart SIM secara online. Dalam informasi yang beredar disebutkan biaya tinggi dalam pembuatan smart SIM.  https://t.co/mP0zkIpDKM,5,0,2,0,2022-01-06,3,Thursday,4,7,0
1478939210124038145,2022-01-06 03:59:19,"India kembali menghadapi lonjakan kasus COVID-19, diprediksi merupakan awal dari gelombang ketiga. Varian Delta yang tadinya dominan mulai digantikan Omicron. https://t.co/jibJ6WpWZK",4,0,0,1,2022-01-06,3,Thursday,4,4,1
1478938887435214848,2022-01-06 03:58:02,#Terpopuler Dunia hiburan Korea Selatan kembali kehilangan satu lagi aktris berbakat. Kim Mi Soo mengembuskan napas terakhir di usia 31 tahun. Netizen pun berduka. https://t.co/V9XbShqrL5,11,2,6,0,2022-01-06,3,Thursday,4,17,2
1478938871060705280,2022-01-06 03:57:58,"Bagi kamu yang bosan dengan mobil MPV atau hatchback, maka SUV kompak bisa menjadi salah satu pilihan menarik. Ini harganya di bulan Januari 2022  https://t.co/UQRaodNB32",6,0,1,1,2022-01-06,3,Thursday,4,7,1
1478938439420628995,2022-01-06 03:56:15,"Ketum DPP PSI Giring Ganesha mengunggah vlog di akun twitternya saat mendatangi lokasi sirkuit Formula E di Ancol. Saat sidak tersebut, Giring sempat terperosok ke lumpur yang ia sebut sangat lembek. https://t.co/H9KwznWKeZ https://t.co/CIHv3w6d6j",49,96,13,11,2022-01-06,3,Thursday,4,62,107
1478938374010458112,2022-01-06 03:56:00,Bagaimana impresi kami setelah mencoba Mitsubishi New Xpander tipe Sport untuk sehari-hari?  https://t.co/WpN7EOd0RN,3,0,1,1,2022-01-06,3,Thursday,4,4,1
1478937875987193859,2022-01-06 03:54:01,"Kim Mi Soo meninggal dunia di usia 31 tahun. Pihak manajemen akhirnya buka suara, dan membenarkan kabar duka tersebut. #KimMiSoo  https://t.co/rgBcxhUrko",5,1,2,0,2022-01-06,3,Thursday,4,7,1
1478937645984198656,2022-01-06 03:53:06,Perseteruan Medina Zein dan Marissya Icha berawal dari kasus tas palsu. Medina pun sampai melontarkan kalimat tak pantas terhadap Marissya lewat media sosial. https://t.co/mwY31Zy4o0,3,0,1,0,2022-01-06,3,Thursday,4,4,0
1478937630180057089,2022-01-06 03:53:03,Wakil Presiden Maruf Amin menyoroti melambungnya harga minyak goreng di pasaran. Ia pun meminta pihak-pihak yang memiliki stok minyak goreng tidak memanfaatkan situasi ini untuk mencari keuntungan. https://t.co/ImJOBJF2EM,9,1,3,0,2022-01-06,3,Thursday,4,12,1
1478936896470499329,2022-01-06 03:50:08,"Intan RJ masih belum terpikir untuk mencari pegganti Wahyu Indra Utama. Sebab prioritasnya kini bukanlah pasangan lagi, namun anak.  https://t.co/8lnefWsRao",12,1,6,1,2022-01-06,3,Thursday,4,18,2
1478936383389671424,2022-01-06 03:48:05,"Real Madrid berhasil menyingkirkan Alcoyano 3-1 untuk maju ke babak 16 Copa del Rey. Pelatih Madrid Carlo Ancelotti mengatakan, ketenangan menjadi kuncinya.  https://t.co/2UJkI9eFVN",5,0,0,0,2022-01-06,3,Thursday,4,5,0
1478936360648122377,2022-01-06 03:48:00,"#Foto Jisoo BLACKPINK memulai debut akting sebagai pemeran utama drama Korea Snowdrop. Intip cantiknya Jisoo, masih pantas perankan anak kuliahan ya. https://t.co/Ag9sE8zeqW",962,8,157,5,2022-01-06,3,Thursday,4,1119,13
1478936134310936580,2022-01-06 03:47:06,Berbicara tahun baru tak lengkap rasanya jika tidak membahas tentang tren. Inilah tren kecantikan 2022. Seperti apa ya? https://t.co/Le0SSRiYeA,2,0,1,0,2022-01-06,3,Thursday,4,3,0
1478936113054113794,2022-01-06 03:47:01,"Dalam formasi 4-2-3-1, berikut starting XI pemain paling mahal berdasarkan posisi masing-masing di Piala AFF 2020 seperti dirangkum TransferMarkt.  https://t.co/Z8qjoFpuou",5,1,1,0,2022-01-06,3,Thursday,4,6,1
1478935829699604482,2022-01-06 03:45:53,Dani Alves telah melakoni debut keduanya untuk Barcelona. Pemain Brasil itu menandainya dengan manis usai tampil apik yang membantu Barca meraih kemenangan.  https://t.co/8E9F7jvRVE,4,0,0,0,2022-01-06,3,Thursday,4,4,0
1478935586060779523,2022-01-06 03:44:55,"Kenalin, ini Risma. Wanita itu mengaku tidak lulus SD, namun penghasilannya sekitar Rp 3,7 Miliar pada saat melayani catering haji plus di tahun 2010. Ini kisahnya. https://t.co/CTo2qj3Q92",10,0,2,0,2022-01-06,3,Thursday,4,12,0
1478934804020215809,2022-01-06 03:41:49,"Sebelum mulai melangkah, ada baiknya mempertimbangkan terlebih dahulu jenis bisnis yang akan dipilih. Biar cuan gitu loh. https://t.co/M7Frfc0aRZ",10,0,5,0,2022-01-06,3,Thursday,4,15,0
1478934472104251401,2022-01-06 03:40:30,Muncul rumor tak enak dari ruang ganti Manchester United di bawah arahan Ralf Rangnick. Ada 11 pemain MU yang tak kerasan lagi dan mau hengkang!  https://t.co/D3f0ElOztF,6,0,0,2,2022-01-06,3,Thursday,4,6,2
1478934470715715584,2022-01-06 03:40:29,"Lionel Messi sudah dinyatakan negatif virus Corona. Lantas, apakah La Pulga bakal langsung dimainkan Paris Saint-Germain akhir pekan ini?  https://t.co/JSMpkfOdOt",3,0,4,0,2022-01-06,3,Thursday,4,7,0
1478933386781724673,2022-01-06 03:36:11,Pebulutangkis Praveen Jordan/Melati Daeva Oktavianti dan Gloria Emanuelle Widjaja viral disebut kena coret dari Pelatnas PBSI. Benarkah?  https://t.co/HYeqoAnwbz,7,6,0,2,2022-01-06,3,Thursday,4,7,8
1478932738203869185,2022-01-06 03:33:36,Produsen otomotif Yamaha sudah memiliki beberapa pilihan sepeda motor roda tiga andalannya lho. Penasaran?  https://t.co/cXreJ9o6Ir,10,1,3,0,2022-01-06,3,Thursday,4,13,1
1478931924848717827,2022-01-06 03:30:22,"Mobil ambulans sempat melambat saat berpapasan dengan iring-iringan rombongan mobil Presiden di Jateng. Pengawal presiden lantas mengisyaratkan agar ambulans melanjutkan perjalanan, sementara rombongan memperlambat kecepatan. https://t.co/WUQnEXdAIm",19,6,2,1,2022-01-06,3,Thursday,4,21,7
1478931430357057543,2022-01-06 03:28:24,AMPHURI menceritakan perjalanan umrahnya. Begini pengalaman saat menuju Madinah. https://t.co/x0wgied0qR,3,0,1,0,2022-01-06,3,Thursday,4,4,0
1478930940340625413,2022-01-06 03:26:28,"Beasiswa Holland kembali dibuka untuk tahun 2022. Calon mahasiswa S1-S2 yang ingin kuliah di Belanda, cuss cek syaratnya ya: Via: detikedu https://t.co/VNi7ihwkpe",27,1,4,0,2022-01-06,3,Thursday,4,31,1
1478930680725790729,2022-01-06 03:25:26,"Lelang ikan tuna pertama di tahun 2022 digelar di pasar ikan Toyosu di Tokyo pada Rabu (5/1) dini hari. Ikan tuna sirip biru dari Oma, prefektur Aomori dengan bobot 211 kilogram laku dengan harga sekitar Rp 2 miliar. https://t.co/lDAEYkueng",9,0,3,1,2022-01-06,3,Thursday,4,12,1
1478929704522600450,2022-01-06 03:21:33,"Dinas Kesehatan Provinsi DKI Jakarta membeberkan data kasus harian Covid-19. Tercatat, bahwa mayoritas penambahan kasus Covid-19 di DKI Jakarta didominasi oleh pelaku perjalanan yang datang dari luar negeri. https://t.co/Z2KyWosG1q",5,1,1,0,2022-01-06,3,Thursday,4,6,1
1478928448651505669,2022-01-06 03:16:33,"Berikut hari-hari besar nasional dan internasional bidang pendidikan tahun 2022. Catat tanggal-tanggal pentingnya ya, detikers! Via: detikedu https://t.co/80ncOxHxIm",5,0,3,1,2022-01-06,3,Thursday,4,8,1
1478927671899742213,2022-01-06 03:13:28,"@detikfinance China bukan sih, Min?",4,1,0,1,2022-01-06,3,Thursday,4,4,2
1478927110970486786,2022-01-06 03:11:15,Cuitan Ferdinand Hutahaean di media sosial yang menyebut “Allahmu ternyata lemah” berujung laporan polisi.  https://t.co/siQoNyhMQz,14,10,5,0,2022-01-06,3,Thursday,4,19,10
1478927092263882755,2022-01-06 03:11:10,Mayjen Mulyo Aji mendapat promosi menduduki job bintang tiga sebagai Seskemenko Polhukam. https://t.co/g5VdXJWZPO,10,0,1,0,2022-01-06,3,Thursday,4,11,0
1478925624765034497,2022-01-06 03:05:20,"#Foto Bikin melongo! Rumah yang satu ini memiliki desain luar dan dalam yang sangat berbeda. Dari luar terlihat bak gubuk, dalamnya mewah. https://t.co/fXKYU3sGp2",9,1,2,0,2022-01-06,3,Thursday,4,11,1
1478924858037833731,2022-01-06 03:02:17,"Secara bertahap TNKB bakal berganti dari warna dasar hitam ke putih, kendaraan apa saja yang bakal berganti pada tahap awal?  https://t.co/bZ9LZnmeXP",8,1,1,3,2022-01-06,3,Thursday,4,9,4
1478923986285309961,2022-01-06 02:58:50,Kasus korupsi kembali menjerat kepala daerah di Kota Bekasi. Wali Kota Bekasi Rahmat Effendi terjaring operasi tangkap tangan oleh Komisi Pemberantasan Korupsi (KPK).  https://t.co/zKW11TNw0p,7,2,5,4,2022-01-06,2,Thursday,4,12,6
1478923493936877573,2022-01-06 02:56:52,"Memasuki tahun 2022, Direktorat Lalu Lintas Polda Metro Jaya kembali melayani masyarakat dengan menghadirkan pelayanan mobil SIM keliling di Jakarta.  https://t.co/11OJr88L9d",6,1,1,0,2022-01-06,2,Thursday,4,7,1
1478923237128126465,2022-01-06 02:55:51,Industri hiburan Korea kembali dirundung duka. Kematian Kim Mi Soo yang mendadak membuat publik terkejut. #KimMiSoo  https://t.co/44XYCciIJm,7,0,1,0,2022-01-06,2,Thursday,4,8,0
1478922482493149188,2022-01-06 02:52:51,Ferdinand Hutahaean bakal melapor balik pihak yang melaporkannya ke polisi. Upaya itu memicu kemarahan netizen bikin tagar #TangkapFerdinand bergaung lagi. https://t.co/cxUs7flSdn,56,25,13,9,2022-01-06,2,Thursday,4,69,34
1478921831641976840,2022-01-06 02:50:16,Siapa yang zodiaknya Cancer? Bila ada persoalan sebaiknya bisa bersikap tegas dan jangan sampai timbul keraguan sedikitpun. Intip yuk #RamalanZodiak hari ini: https://t.co/a7ODnaiNPr,6,1,1,0,2022-01-06,2,Thursday,4,7,1
1478921350089781252,2022-01-06 02:48:21,Fase bulan baru jadi salah satu peristiwa fase bulan yang terjadi di bulan Januari 2022 ini. Berikut fase bulan yang terjadi pada bulan ini! https://t.co/2kuArPXcgx,5,0,1,0,2022-01-06,2,Thursday,4,6,0
1478920817996185600,2022-01-06 02:46:14,Rachel Vennya bicara soal 2021 yang dianggap sebagai tahun terberatnya...  https://t.co/1iTtoyTabF,33,45,5,14,2022-01-06,2,Thursday,4,38,59
1478920805530619911,2022-01-06 02:46:11,"Harga emas Antam hari ini kembali naik. Setelah sempat turun di awal pekan, hari ini harga emas batangan 24 karat tersebut naik tipis Rp 1.000. Jadi segini harganya: https://t.co/QFYw2P6wn8",4,0,1,0,2022-01-06,2,Thursday,4,5,0
1478920305582223361,2022-01-06 02:44:12,Deputi Gubernur terpilih Bank Indonesia (BI) Juda Agung dan Aida S Budiman hari ini akan dilantik di Mahkamah Agung. https://t.co/tFD76Echdy,5,0,2,1,2022-01-06,2,Thursday,4,7,1
1478920065424805891,2022-01-06 02:43:15,Boneka arwah atau spirit doll sedang viral belakangan ini. Ini fakta dan sejarang tentang spirit doll:  https://t.co/zHuOpXcYxD,9,3,1,1,2022-01-06,2,Thursday,4,10,4
1478919043935612930,2022-01-06 02:39:11,Prince Chiu dan Puff Kuo disebut menjalin asmara usai terlibat dalam sebuah film. Di sana keduanya sempat beradegan ciuman hingga enam kali. https://t.co/SRiy5gIvoq,4,0,0,0,2022-01-06,2,Thursday,4,4,0
1478918305301909506,2022-01-06 02:36:15,Surat Tanda Nomor Kendaraan atau STNK merupakan salah satu dokumen penting yang menunjukkan kepemilikan suatu kendaraan bermotor.  https://t.co/vMC2TdOzuI,37,0,17,0,2022-01-06,2,Thursday,4,54,0
1478917314972209157,2022-01-06 02:32:19,Awal 2022 diramaikan dengan pemberitaan heboh Zikri Daulay dan Ayu Aulia di Bali saat pergantian tahun. Zikri akhirnya meminta maaf kepada publik. https://t.co/brOvD45zvk,11,0,1,0,2022-01-06,2,Thursday,4,12,0
1478916303142408194,2022-01-06 02:28:18,Ferdinand merasa difitnah terkait laporan Haris Pertama. Ferdinand bakal melaporkan balik Haris. https://t.co/E68VfZdshp,65,46,3,7,2022-01-06,2,Thursday,4,68,53
1478915273663070212,2022-01-06 02:24:12,"Usai ditetapkan sebagai tersangka atas kasus pencemaran nama baik yang dilaporkan Marissya Icha, Medina Zein tak tinggal diam. https://t.co/o3gjdb3E4J",10,1,1,0,2022-01-06,2,Thursday,4,11,1
1478914779330842626,2022-01-06 02:22:14,Seorang pria mengklaim telah merekam penampakan alien berwujud aneh dengan kameranya. Ia pun menunjukkan seperti apa fotonya. https://t.co/WsiWhTcKl3,9,1,2,0,2022-01-06,2,Thursday,4,11,1
1478913782692950021,2022-01-06 02:18:17,Ma'ruf Amin melakukan kunker ke Palu. Ma'ruf akan menghadiri rapat mengenai pemulihan pascabencana di Palu. https://t.co/wxB7U163oF,24,0,0,1,2022-01-06,2,Thursday,4,24,1
1478912724981669888,2022-01-06 02:14:05,Chicco Jerikho menceritakan kedekatannya dengan mendiang Glenn Fredly. Chicco bahkan mengaku masih ingat keinginan tertunda Glenn untuk membuat film action. https://t.co/SjRx3Uyjyy,8,0,1,0,2022-01-06,2,Thursday,4,9,0
1478912005767675906,2022-01-06 02:11:13,KPK menduga Rahmat Effendi terlibat dalam kasus dugaan suap jual beli jabatan. https://t.co/w2GRVVhyCE,22,1,3,1,2022-01-06,2,Thursday,4,25,2
1478910707055927300,2022-01-06 02:06:04,Keberadaan wahana 'Ngopi In The Sky' menuai polemik. Pemkab Gunungkidul meminta pengelola melengkapi dokumen keamanan crane. #Gunungkidul https://t.co/KMp9eUntjg,8,1,2,1,2022-01-06,2,Thursday,4,10,2
1478910685757284352,2022-01-06 02:05:58,KPK telah melakukan OTT terhadap Wali Kota Bekasi Rahmat Effendi. Total pihak yang diamankan yakni 12 orang. https://t.co/IAW56HAvz0,22,2,1,0,2022-01-06,2,Thursday,4,23,2
1478910405439275013,2022-01-06 02:04:52,"Di tengah kabar keberadaan Hafiz Fatur yang masih misteri, Irwansyah dan Zaskia Sungkar melaporkan bank pemberi pinjaman ke OJK. https://t.co/DliM0Wi778",8,4,3,2,2022-01-06,2,Thursday,4,11,6
1478909347270901768,2022-01-06 02:00:39,AC Milan akan aktif di bursa transfer musim dingin. Milan mencari bek tengah tangguh usai Simon Kjaer absen lama karena menjalani operasi lutut.  https://t.co/Hulz7gYpD2,6,2,0,2,2022-01-06,2,Thursday,4,6,4
1478909338232176642,2022-01-06 02:00:37,"Berkaca dari pergerakan beragam instrumen investasi pada 2021, lantas bagaimana peluang investasi di tahun macan air? #CNNIndonesia #detiknetwork  https://t.co/rk4CtkYLku",0,0,0,0,2022-01-06,2,Thursday,4,0,0
1478909079020093445,2022-01-06 01:59:35,AC Milan mulai misi mengejar Inter Milan saat menjamu AS Roma. Milan ingin berambisi melaju kencang di paruh kedua musim.  https://t.co/ernbAMe6Ry,10,1,1,0,2022-01-06,1,Thursday,4,11,1
1478908576718598144,2022-01-06 01:57:36,"Barcelona susah payah menumbangkan tim divisi tiga Spanyol, Linares Deportivo, di Copa del Rey. Blaugrana malah bisa saja tersingkir.  https://t.co/VnrqPC06OP",4,1,0,0,2022-01-06,1,Thursday,4,4,1
1478908071502127106,2022-01-06 01:55:35,"Pelatih Valencia, Jose Bordalas, melancarkan serangan ke Barcelona. Dia mengkritik Blaugrana yang jor-joran belanja pemain di tengah jeratan utang.  https://t.co/j8ynHcI7Oy",7,1,0,0,2022-01-06,1,Thursday,4,7,1
1478907845978599426,2022-01-06 01:54:41,"Chelsea menang 2-0 lawan Tottenham di semifinal leg pertama Piala Liga Inggris. Chelsea kini sudah diperkuat Lukaku lagi, usai dirinya diparkir Thomas Tuchel.  https://t.co/x2xKMvQ8mF",2,0,0,0,2022-01-06,1,Thursday,4,2,0
1478907724838617088,2022-01-06 01:54:13,Harga tiket MotoGP Mandalika 2022 dibanderol dari Rp 115 ribu hingga termahal Rp 15 juta. Seperti apa prosedur pembeliannya?  https://t.co/FpRu0XoDs9,11,1,9,2,2022-01-06,1,Thursday,4,20,3
1478907350660616195,2022-01-06 01:52:43,"Massimiliano Allegri membenarkan bahwa Aaron Ramsey sedang menuju pintu keluar Juventus. Lantas, pemain yang dijuluki Rambo itu bakal gabung ke mana?  https://t.co/P0f234YFV7",4,2,0,0,2022-01-06,1,Thursday,4,4,2
1478906808114765826,2022-01-06 01:50:34,AS Roma dikabarkan tertarik untuk mendapatkan Ainsley Maitland-Niles dari Arsenal. Pelatih Jose Mourinho buka suara terkait hal itu.  https://t.co/9sPLm0sFFc,4,0,0,0,2022-01-06,1,Thursday,4,4,0
1478906578782797827,2022-01-06 01:49:39,"Prakirawan BMKG menjelaskan dampak sirkulasi siklonik terhadap cuaca di Pulau Jawa. Simak prakiraan cuaca selengkapnya yang berlaku untuk hari Kamis, 6 Januari 2022. https://t.co/NhA0Db03cW",4,0,0,0,2022-01-06,1,Thursday,4,4,0
1478906559505838083,2022-01-06 01:49:35,"Wali Kota Bekasi Rahmat Efendi kena operasi tangkap tangan (OTT) Komisi Pemberantasan Korupsi (KPK). Mengintip kekayaannya, ada koleksi mobil apa saja?  https://t.co/xnvAWiT1cN",15,1,2,2,2022-01-06,1,Thursday,4,17,3
1478905086952808449,2022-01-06 01:43:44,"Perusahaan konsol game asal Jepang, Sony, mulai merambah industri mobil listrik. Sony memperkenalkan konsep SUV listrik Vision-S 02. Yuk lihat tampangnya.  https://t.co/EYplgNwpFJ",21,1,6,2,2022-01-06,1,Thursday,4,27,3
1478905029012643841,2022-01-06 01:43:30,"Philippe Coutinho bisa saja kembali ke Premier League. Coutinho dikabarkan sedang didekati Aston Villa, yang dilatih Steven Gerrard, eks rekannya di Liverpool.  https://t.co/lcBEiV5k4l",0,0,0,0,2022-01-06,1,Thursday,4,0,0
1478904541655486464,2022-01-06 01:41:34,Jena Dammaya sedih parah. Akun Instagram-nya hilang dan berujung rugi ratusan juta. https://t.co/jJf1bY0kee,11,1,1,0,2022-01-06,1,Thursday,4,12,1
1478903787553271814,2022-01-06 01:38:34,Romelu Lukaku tampil penuh saat Chelsea mengalahkan Tottenham Hotspur di leg pertama semifinal Piala Liga Inggris. Lukaku dapat pujian dari Thomas Tuchel.  https://t.co/EqpoljXpz2,6,0,0,0,2022-01-06,1,Thursday,4,6,0
1478903771606536208,2022-01-06 01:38:30,Lionel Messi dipastikan sudah pulih dari COVID-19. Paris Saint-Germain mengumumkan hasil tes terkini La Pulga negatif virus Corona.  https://t.co/tTQSopu6gX,5,2,1,1,2022-01-06,1,Thursday,4,6,3
1478902765158084617,2022-01-06 01:34:30,Fenomena boneka arwah tengah menjadi tren di kalangan selebriti. Kali ini 'boneka arwah' menyimpan teka-teki yang harus kamu selesaikan. Berani coba? https://t.co/z7eUINaymS,8,1,1,1,2022-01-06,1,Thursday,4,9,2
1478901296245755907,2022-01-06 01:28:40,Barcelona memulai kiprahnya di Copa del Rey 2021/2022 dengan kemenangan. Barca menyingkirkan tim divisi tiga Linares Deportivo 2-1 untuk maju ke babak 16 besar.  https://t.co/rTwGQ0EpMh,2,0,0,0,2022-01-06,1,Thursday,4,2,0
1478901052170813441,2022-01-06 01:27:42,"Chelsea meraih hasil sempurna dalam semifinal leg pertama Piala Liga Inggris. The Blues menang 2-0 atas tim London lainnya, Tottenham Hotspur.  https://t.co/K6DyjRLui2",6,0,0,0,2022-01-06,1,Thursday,4,6,0
1478901046944612353,2022-01-06 01:27:40,"Di tengah kesibukannya promosi film, Chicco Jerikho ditanya awak media mengenai resolusi di 2022. Apakah ini memiliki momongan lagi?  https://t.co/llREqBUH73",4,0,2,0,2022-01-06,1,Thursday,4,6,0
1478900546325131275,2022-01-06 01:25:41,"Pelatih Juventus, Massimiliano Allegri, angkat bicara soal isu transfer Alvaro Morata ke Barcelona. Dia dengan tegas tak ingin pemainnya itu pindah klub.  https://t.co/u5G5XE1tfU",4,0,1,0,2022-01-06,1,Thursday,4,5,0
1478899566523133958,2022-01-06 01:21:47,Persebaya Surabaya berhasil mengalahkan Bali United dalam lanjutan Liga 1 2021. Tim besutan Aji Santoso menang dengan skor 3-1.  https://t.co/9WSybZ8Hnb,7,0,0,0,2022-01-06,1,Thursday,4,7,0
1478899314160242692,2022-01-06 01:20:47,Peta persaingan Proliga 2022 dinilai sulit terbaca. Apa alasannya?  https://t.co/C5PZrdvmZq,2,0,0,0,2022-01-06,1,Thursday,4,2,0
1478899061856083969,2022-01-06 01:19:47,"Real Madrid bertemu tim divisi tiga Spanyol, Alcoyano, di babak 32 besar Copa del Rey. Los Blancos berhasil meraih kemenangan 3-1.  https://t.co/6ADw6OSy4u",5,0,0,0,2022-01-06,1,Thursday,4,5,0
1478898736352923651,2022-01-06 01:18:30,"Tim bola voli putri Jakarta Elektrik PLN menatap Proliga 2022 dengan target bertahap. Mereka berupaya tembus final four dulu, juara kemudian.   https://t.co/N6nhRIpsaB",3,0,0,0,2022-01-06,1,Thursday,4,3,0
1478898238480687112,2022-01-06 01:16:31,"Tim bola voli putri Jakarta Elektrik PLN menatap Proliga 2022 dengan target bertahap. Mereka berupaya tembus final four dulu, juara kemudian.  https://t.co/b9GYNIbvPa",7,0,0,0,2022-01-06,1,Thursday,4,7,0
1478897743154368522,2022-01-06 01:14:33,"Novak Djokovic telah mendarat di Melbourne, tetapi masih menunggu izin memasuki Australia. Petenis asal Serbia itu saat ini masih berkutat di bandara.  https://t.co/l4y9zJhlJb",4,0,0,0,2022-01-06,1,Thursday,4,4,0
1478896075574587394,2022-01-06 01:07:55,"Novak Djokovic urung berlaga di Australia Terbuka 2022. Meski sudah mendapatkan 'keistimewaan', Djokovic tetap tak bisa tampil karena visanya ditolak!  https://t.co/rhZb9FHpJJ",2,0,0,0,2022-01-06,1,Thursday,4,2,0
1478895772083048448,2022-01-06 01:06:43,Aktris sekaligus produser film Inggrid Rhemanty diketahui hobi berkuda. Kini ia ngaku sudah lihai dalam olahraga tersebut. https://t.co/XWOb52wElM,1,0,1,1,2022-01-06,1,Thursday,4,2,1
1478894215627259909,2022-01-06 01:00:32,Haris Pertama datang ke Bareskrim Polri. Dia mengaku hendak melaporkan Ferdinand Hutahaean soal cuitan 'Allahmu lemah'. https://t.co/XfZgwJ1hjD,15,3,2,0,2022-01-06,1,Thursday,4,17,3
1478893951331491841,2022-01-06 00:59:29,"Sebuah truk mengalami gangguan di Tol Jagorawi, kilometer 11,800, Cimanggis. Imbas penanganan kendaraan gangguan ini, lalu lintas macet. https://t.co/HfrsV6IGgd",6,0,0,0,2022-01-06,0,Thursday,4,6,0
1478893710972702722,2022-01-06 00:58:31,"Seorang satpam warga Kudus, Jawa Tengah, dibekuk polisi. Satpam berinisial HY (29) itu nekat menjambret seorang emak-emak. https://t.co/10fnyYtOMp",6,0,0,0,2022-01-06,0,Thursday,4,6,0
1478893687069417473,2022-01-06 00:58:26,"Komnas HAM menyambut baik pernyataan Presiden Jokowi yang berharap RUU TPKS segera disahkan. Menurut Komnas HAM, pernyataan tersebut sinyal bagus. https://t.co/OG96w3qtn5",7,2,0,1,2022-01-06,0,Thursday,4,7,3
1478893685827903488,2022-01-06 00:58:25,"PT Denpasar menguatkan hukuman pengusaha Zaenal Tayeb di kasus tanah. Alhasil, Zaenal Tayeb tetap dihukum 3,5 tahun penjara sesuai vonis PN Denpasar. https://t.co/CeN6FmmBmq",3,0,0,0,2022-01-06,0,Thursday,4,3,0
1478893226903973889,2022-01-06 00:56:36,PB HMI menilai cuitan 'Allahmu lemah' Ferdinand Hutahaean menganggap rendah kebhinekaan Indonesia. https://t.co/BW0tZsUm7x,15,2,6,1,2022-01-06,0,Thursday,4,21,3
1478892697997955083,2022-01-06 00:54:30,"Pelatih Valencia, Jose Bordalas, melancarkan serangan ke Barcelona. Dia mengkritik Blaugrana yang jor-joran belanja pemain di tengah jeratan utang. https://t.co/y2jBSTEYqo",2,1,0,2,2022-01-06,0,Thursday,4,2,3
1478892438743826440,2022-01-06 00:53:28,Minyak zaitun dipercaya dapat memberikan nutrisi yang cukup serta menyehatkan rambut. Simak manfaat minyak zaitun untuk rambut lainnya berikut. https://t.co/kdPxVp1WxN,7,0,1,0,2022-01-06,0,Thursday,4,8,0
1478891901617065985,2022-01-06 00:51:20,Cuitan 'Allahmu ternyata lemah' bikin Ferdinand Hutahaean berurusan dengan kepolisian. Ada dua laporan polisi terhadap Ferdinand Hutahaean. https://t.co/pUyPWN33BZ,68,39,7,6,2022-01-06,0,Thursday,4,75,45
1478891653482094592,2022-01-06 00:50:21,Gigi geraham bungsu umumnya tumbuh pada usia 17 hingga 21 tahun. Penyebab gigi bungsu tumbuh paling akhir dipengaruhi oleh pertumbuhan manusia. https://t.co/GaIdf2PzND,1,0,3,0,2022-01-06,0,Thursday,4,4,0
1478891408174063617,2022-01-06 00:49:22,"Ahmad Riza Patria mengaku siap menjadi Wagub DKI Jakarta lagi. Namun Partai Gerindra tak sependapat, Partai pimpinan Prabowo itu menargetkan posisi Gubernur. https://t.co/MydL66uAyr",9,10,0,1,2022-01-06,0,Thursday,4,9,11
1478890875078037505,2022-01-06 00:47:15,"Novak Djokovic urung berlaga di Australia Terbuka 2022. Meski sudah mendapatkan 'keistimewaan', Djokovic tetap tak bisa tampil karena visanya ditolak. https://t.co/rjSzCTitaN",1,0,0,0,2022-01-06,0,Thursday,4,1,0
1478889130922811395,2022-01-06 00:40:19,Romelu Lukaku tampil penuh saat Chelsea mengalahkan Tottenham Hotspur di leg pertama semifinal Piala Liga Inggris. Lukaku dapat pujian dari Thomas Tuchel. https://t.co/UqTMC0hndN,2,0,1,2,2022-01-06,0,Thursday,4,3,2
1478888622875103237,2022-01-06 00:38:18,Maruf Amin meresmikan enam rumah ibadah di Universitas Pancasila. Ini menjadi yang pertama di Indonesia dimana sebuah kampus ada enam rumah ibadah sekaligus. https://t.co/e4grqr6gS8,163,19,34,11,2022-01-06,0,Thursday,4,197,30
1478888373330849794,2022-01-06 00:37:19,Kenaikan harga bahan bakar LPG di Kazakhstan memicu gelombang protes. Situasi darurat pun diterapkan. https://t.co/KGOgsYtc9i,30,1,9,1,2022-01-06,0,Thursday,4,39,2
1478887881368289280,2022-01-06 00:35:21,"Vaksinasi booster akan diberikan mulai bulan ini, tepatnya 12 Januari 2022. Ini sederet pernyataan dari pemerintah. https://t.co/iuODBshuY9",12,1,3,1,2022-01-06,0,Thursday,4,15,2
1478887388302778372,2022-01-06 00:33:24,"Pemimpin Hizbullah, Hassan Nasrallah, menyebut Raja Salman dari Arab Saudi sebagai 'teroris', sebagai balasan atas ungkapan serupa dari Riyadh. https://t.co/C4AfANzMTu",6,0,2,1,2022-01-06,0,Thursday,4,8,1
1478886886223630338,2022-01-06 00:31:24,Pemprov DKI mengajukan permohonan kepada DPRD memakai BTT untuk penyesuaian UMP 2022. DPRD DKI menjelaskan soal peruntukan dana yang diajukan Pemprov. https://t.co/0iM5W7f1ZG,3,0,0,0,2022-01-06,0,Thursday,4,3,0
1478886386564571138,2022-01-06 00:29:25,Hendrik menyampaikan agar satu sama lain saling menghormati dan merayakan perbedaan. Hendrik lalu mendorong pembangunan persaudaraan di antara anak bangsa. https://t.co/1tZuKmPGwV,23,12,4,1,2022-01-06,0,Thursday,4,27,13
1478886138437902344,2022-01-06 00:28:26,Misteri mengenai hilangnya 4 roda ambulans di Bengkulu terungkap. Pelaku pencurian kini dibekuk polisi. https://t.co/wN84YjGyi2,11,1,0,0,2022-01-06,0,Thursday,4,11,1
1478885643455549444,2022-01-06 00:26:28,Haris Pertama melaporkan Ferdinand Hutahaean ke Bareskrim terkait dugaan penodaan agama gara-gara cuitan 'Allahmu lemah'. Polisi langsung memeriksa tiga saksi. https://t.co/CreGBuKcsg,71,17,7,2,2022-01-06,0,Thursday,4,78,19
1478884290255589376,2022-01-06 00:21:05,"Rumah Wali Kota Bekasi Rahmat Effendi di Pekayon, Bekasi, Jawa Barat, tampak sepi usai terjaring OTT KPK sejak Rabu (5/1/2022) siang kemarin. Ini penampakannya. https://t.co/LUY4sGUC52",12,0,1,2,2022-01-06,0,Thursday,4,13,2
1478883264525910016,2022-01-06 00:17:01,"Wali Kota Bekasi, Rahmat Effendi kena operasi tangkap tangan (OTT) Komisi Pemberantasan Korupsi. Rahmat Effendi ditangkap bersama sejumlah orang lainnya. https://t.co/BHrH4OtKHP",17,3,3,1,2022-01-06,0,Thursday,4,20,4
1478882788581515264,2022-01-06 00:15:07,"Kasus COVID-19 di DKI mengalami peningkatan. Dari 955 kasus aktif yang tercatat para Rabu (5/1/2022), 706 di antaranya adalah pelaku perjalanan luar negeri. https://t.co/CUhjDJugOP",38,6,19,49,2022-01-06,0,Thursday,4,57,55
1478882538399617025,2022-01-06 00:14:08,"Persoalan Gubsu Edy Rahmayadi menjewer dan mengusir pelatih biliar Sumut untuk PON Papua, Khoirudin Aritonang atau Choki terus bergulir. https://t.co/85jO6cMvRN",13,0,2,0,2022-01-06,0,Thursday,4,15,0
1478882042809102337,2022-01-06 00:12:09,Ferdinand Hutahaean dilaporkan ke polisi terkait cuitannya 'Allahmu lemah'. Ini respons dari PWNU dan MUI Jatim. https://t.co/GO4HdG8New,14,5,3,1,2022-01-06,0,Thursday,4,17,6
1478881758980550660,2022-01-06 00:11:02,"Massimiliano Allegri membenarkan bahwa Aaron Ramsey sedang menuju pintu keluar Juventus. Lantas, pemain yang dijuluki Rambo itu bakal gabung ke mana? https://t.co/TECO4mkJGq",3,2,0,0,2022-01-06,0,Thursday,4,3,2
1478881261708009473,2022-01-06 00:09:03,Kasus penyekapan bocah laki-laki berusia 5 tahun terjadi di Sumedang. Kasus tersebut terjadi di salah satu rumah warga milik seorang perempuan berinisial S. https://t.co/yXukDX58qH,4,0,0,0,2022-01-06,0,Thursday,4,4,0
1478880777848905735,2022-01-06 00:07:08,Vertigo adalah kondisi yang kerap kali dialami oleh banyak orang. Gejala yang ditimbulkan dapat berupa sensasi pusing berputar yang muncul secara tiba-tiba. https://t.co/C2NpysQaN1,5,0,4,0,2022-01-06,0,Thursday,4,9,0
1478880522206171140,2022-01-06 00:06:07,"Wali Kota Bekasi, Rahmat Effendi terjerat operasi tangkap tangan (OTT) KPK. Pria yang akrab disapa Pepen itu, sedang menjalani pemeriksaan. https://t.co/Zfp9BBZMNU",9,0,0,0,2022-01-06,0,Thursday,4,9,0
1478880043829010441,2022-01-06 00:04:13,"Ada beberapa fitur, keunggulan, ataupun hal ikonik dari ponsel dengan OS buatan Research in Motion tersebut. Ini fitur unggulan BlackBerry pada zamannya:  https://t.co/1QhvPMulW0",4,0,1,0,2022-01-06,0,Thursday,4,5,0
1478880022685532164,2022-01-06 00:04:08,Tim bola voli putri Jakarta Elektrik PLN menggandeng pemain asing Azerbaijan demi memenuhi target tinggi di Proliga 2022. https://t.co/YnPfsi73Wq,4,0,1,0,2022-01-06,0,Thursday,4,5,0
1478879530165186561,2022-01-06 00:02:10,Siswa kelas XI salah satu SMK pelayaran Kota Semarang menjadi korban penganiayaan senior. Korban KHM (17) itu ditampar 140 kali oleh kakak kelasnya. https://t.co/RCJ5SmIiLJ,6,3,2,2,2022-01-06,0,Thursday,4,8,5
1478878709650272258,2022-01-05 23:58:55,Kumpulan bangkai pesawat membuat geger warga dan pengguna jalan di Kabupaten Bogor. Bangkai pesawat itu berserakan di lahan kosong Jalan Raya Parung-Bogor. https://t.co/MCy6Vgszy8,20,2,3,0,2022-01-05,23,Wednesday,3,23,2
1478877970643275778,2022-01-05 23:55:59,"Cuitan Ferdinand Hutahaean di media sosial yang menyebut ""Allahmu ternyata lemah"" berujung laporan polisi. Bareskrim Polri pun menindaklanjuti laporan tersebut. https://t.co/rCoSXMZx2j",28,11,4,3,2022-01-05,23,Wednesday,3,32,14
1478877449488326660,2022-01-05 23:53:54,Ketum DPP PSI Giring Ganesha kejeblos lumpur saat melakukan sidak di lokasi sirkuit Formula E di Ancol. https://t.co/bpmBTRd5c6,11,20,1,4,2022-01-05,23,Wednesday,3,12,24
1478875693568114689,2022-01-05 23:46:56,Ketua Umum PSI Giring Ganesha mengkritik program Gubernur DKI Anies Baswedan. Giring membuat manuver dengan kejeblos di lumpur venue Formula E DKI. https://t.co/GhGcrNMscE,21,52,4,5,2022-01-05,23,Wednesday,3,25,57
1478875471710457856,2022-01-05 23:46:03,Sebuah video warga menemukan gundukan makam di pinggir jalan Pasuruan viral. Berikut foto-foto dari dekat makam tersebut. https://t.co/HLZ0l5PkOV,6,0,2,1,2022-01-05,23,Wednesday,3,8,1
1478874353320271873,2022-01-05 23:41:36,Pemerintah melaporkan kasus baru Corona hari ini sebanyak 404 kasus. Provinsi yang paling banyak melaporkan kasus Corona dalam 24 jam terakhir DKI Jakarta. https://t.co/WQIp6I1DvI,6,6,7,1,2022-01-05,23,Wednesday,3,13,7
1478874013644607495,2022-01-05 23:40:15,Sekjen MUI Amirsyah mengatakan cuitan soal 'Alllahmu ternyata lemah' menunjukan pengetahuan yang dangkal soal agama. Dia menilai cuitan Ferdinand itu intoleran. https://t.co/9mkGrPcuq9,13,12,2,2,2022-01-05,23,Wednesday,3,15,14
1478873326567235592,2022-01-05 23:37:31,Presiden Jokowi mendorong agar Rancangan Undang-Undang tentang Tindak Pidana Kekerasan Seksual (RUU TPKS) segera disahkan menjadi Undang-Undang (UU). KSP pun membeberkan alasan Jokowi meminta RUU TPKS segera disahkan. https://t.co/3BHSE2pdUm,7,0,3,0,2022-01-05,23,Wednesday,3,10,0
1478872491435122688,2022-01-05 23:34:12,"Barcelona susah payah menumbangkan tim divisi tiga Spanyol, Linares Deportivo, di Copa del Rey. Blaugrana malah bisa saja tersingkir. https://t.co/svfI81TBPk",2,0,0,0,2022-01-05,23,Wednesday,3,2,0
1478871999380430848,2022-01-05 23:32:15,Kejari Kota Pasuruan menahan anggota DPRD dari PAN berinisial H. Kuasa hukum tersangka menyayangkan penahanan itu dan mengupayakan penangguhan. https://t.co/exQSiX5XwZ,2,0,0,0,2022-01-05,23,Wednesday,3,2,0
1478871247907868672,2022-01-05 23:29:16,"Data kemenkes menyebut sudah ada 254 kasus varian Omicron di Indonesia. Dari jumlah tersebut, gejala yang paling banyak ditemukan adalah batuk dan pilek. https://t.co/VEyrJzGKyD",19,5,4,1,2022-01-05,23,Wednesday,3,23,6
1478870511383949318,2022-01-05 23:26:20,"Tawuran antar-remaja terjadi di Cikarang, Kabupaten Bekasi, Jawa Barat. Seorang pelajar sekolah menengah pertama (SMP) berinisial B (15) tewas dibacok. https://t.co/hHWetIe3mM",25,20,7,7,2022-01-05,23,Wednesday,3,32,27
1478869747198570497,2022-01-05 23:23:18,Indosat Ooredoo dan Hutchison 3 Indonesia (Tri) bergabung menjadi Indosat Ooredoo Hutchison. Ada bonus gratis menelepon 200 menit/hari selasa sebulan. https://t.co/hAjxgJOEZ9,11,4,3,0,2022-01-05,23,Wednesday,3,14,4
1478868952973549574,2022-01-05 23:20:09,Ketum DPP PSI Giring Ganesha kejeblos lumpur saat melakukan sidak di lokasi sirkuit Formula E di Ancol. https://t.co/MtAW4mN7cr,719,483,108,75,2022-01-05,23,Wednesday,3,827,558
1478866614833631240,2022-01-05 23:10:51,"Real Madrid bertemu tim divisi tiga Spanyol, Alcoyano, di babak 32 besar Copa del Rey. Los Blancos berhasil meraih kemenangan 3-1. https://t.co/0jiF4kshvL",1,0,1,0,2022-01-05,23,Wednesday,3,2,0
1478865872882221060,2022-01-05 23:07:54,Sudin Dukcapil Jakarta tengah melakukan perekaman KTP Elektronik untuk siswa SMA. Sisten perekaman ini dilakukan dengan cara jemput bola. https://t.co/tLGETLOY7k,5,1,0,0,2022-01-05,23,Wednesday,3,5,1
1478865128879763458,2022-01-05 23:04:57,Inggris sedang berjibaku menangani lonjakan kasus COVID-19 di negaranya. Belakangan negara tersebut mencatat lebih dari 200.000 kasus baru COVID-19 per hari. https://t.co/VZfCozVo4z,5,0,1,0,2022-01-05,23,Wednesday,3,6,0
1478864050822033417,2022-01-05 23:00:40,"Warga Tanah Abang, Jakpus, mengusulkan dibuatnya ring tinju karena banyak anak muda terlibat tawuran. Begini respons Polsek Tanah Abang. https://t.co/KB5Hia7qgI",26,6,7,3,2022-01-05,23,Wednesday,3,33,9
1478863053542338560,2022-01-05 22:56:42,"Novak Djokovic telah mendarat di Melbourne, tetapi masih menunggu izin memasuki Australia. Petenis asal Serbia itu saat ini masih berkutat di bandara. https://t.co/2muqQ8sBdM",2,0,0,0,2022-01-05,22,Wednesday,3,2,0
1478861791790829572,2022-01-05 22:51:41,Akademi Ilmuwan Muda Indonesia (ALMI) menilai peleburan Eijkman dilakukan tanpa kebijakan transisi dengan waktu yang memadai. https://t.co/A5YjwP7EsR,4,0,1,0,2022-01-05,22,Wednesday,3,5,0
1478859794467504130,2022-01-05 22:43:45,Jokowi menunjuk Jamintel Sunarta menjadi Wakil Jaksa Agung. Sunarta akan menggantikan Wakil Jaksa Agung Setia Untung Arimuladi yang memasuki masa pensiun. https://t.co/Wq2ggLkSm1,7,0,1,1,2022-01-05,22,Wednesday,3,8,1
1478859565076815873,2022-01-05 22:42:50,"Eks bos perusahaan tes darah Theranos, Elizabeth Holmes, yang pernah dijuluki 'perempuan miliarder termuda di dunia' dinyatakan bersalah menipu para investor. https://t.co/h3pejrjtW7",6,1,1,0,2022-01-05,22,Wednesday,3,7,1
1478857484068605956,2022-01-05 22:34:34,Narji disorot lantaran sebelumnya sempat mendekat ke Demokrat dan bahkan mendukung aksi Jenderal Dudung mencopot baliho Habib Rizieq. Narji sudah buka-bukaan. https://t.co/QW7HlqDSII,10,3,0,2,2022-01-05,22,Wednesday,3,10,5
1478856476869410819,2022-01-05 22:30:34,Lionel Messi dipastikan sudah pulih dari COVID-19. Paris Saint-Germain mengumumkan hasil tes terkini La Pulga negatif virus Corona. https://t.co/c39rueyBFE,6,0,3,0,2022-01-05,22,Wednesday,3,9,0
1478855739385040904,2022-01-05 22:27:38,"Prancis mencatat rekor kasus baru Corona para Rabu waktu setempat. Menteri Kesehatan, Olivier Veran menyebut ada 335.000 kasus baru di Prancis dalam sehari. https://t.co/zheJCHLPAS",7,0,3,1,2022-01-05,22,Wednesday,3,10,1
1478854989879468032,2022-01-05 22:24:40,"Saat krisis ekonomi Turki semakin dalam, semakin banyak orang muda berpendidikan yang ingin memulai kehidupan baru di luar negeri. https://t.co/xB9qaYljv0",18,6,7,2,2022-01-05,22,Wednesday,3,25,8
1478853493607780352,2022-01-05 22:18:43,BMKG mengeluarkan peringatan dini cuaca di DKI Jakarta hari ini. BMKG memperkirakan terjadi hujan disertai petir di Jaktim dan Jaksel pada siang dan sore ini. https://t.co/nRV1ZCBqAc,6,1,1,0,2022-01-05,22,Wednesday,3,7,1
1478852727769862155,2022-01-05 22:15:40,"Seekor harimau menggigit tangan petugas jaga di Taman Safari Nasu di prefektur Tochigi, Jepang. Harimau itu juga menyerang dua orang penjaga lainnya. https://t.co/ZBM0IGvCVT",6,0,1,1,2022-01-05,22,Wednesday,3,7,1
1478851495340785672,2022-01-05 22:10:46,"Giring meninjau lokasi Formula E dan mengeluhkan sejumlah hal, termasuk bertemu kambing. Gerindra berkelakar apakah kambingnya meminta foto kepada Giring. https://t.co/Fe1a46W1My",128,37,37,9,2022-01-05,22,Wednesday,3,165,46
1478850196641660928,2022-01-05 22:05:37,GAMKI menilai cuitan Ferdinand yang berujung adanya pelaporan ke polisi tersebut telah menyebabkan keresahan di tengah masyarakat Indonesia yang majemuk. https://t.co/LGOND3otf9,14,3,9,1,2022-01-05,22,Wednesday,3,23,4
1478849213337415681,2022-01-05 22:01:42,Intan RJ punya masalah mata. Ini penyebabnya:   https://t.co/P0Injy2JZ8,3,0,0,0,2022-01-05,22,Wednesday,3,3,0
1478848307124445185,2022-01-05 21:58:06,"Roti bakar Bandung di gerai ini dibuat jadi lebih kekinian. Selain diolesi dengan aneka selai buah, di dalamnya juga diisi dengan puff pastry yang renyah. https://t.co/8sZh8a4bMl",8,0,5,0,2022-01-05,21,Wednesday,3,13,0
1478847349682229255,2022-01-05 21:54:18,Makam palsu yang dibuat warga Pasuruan untuk menakuti para pembuang sampah akhirnya dibongkar. Warga pun akan mengawasi pembuang sampah sembarangan. https://t.co/vfqSb0sQyI,2,0,0,1,2022-01-05,21,Wednesday,3,2,1
1478846041432727554,2022-01-05 21:49:06,Wali Kota Bekasi Rahmat Effendi (Pepen) terkena OTT KPK. Ironi bagi warga Bekasi karena dua wali kota tersandung kasus korupsi. https://t.co/hRo5bErYS5,291,68,80,34,2022-01-05,21,Wednesday,3,371,102
1478844037780148229,2022-01-05 21:41:08,"Chelsea meraih hasil sempurna dalam semifinal leg pertama Piala Liga Inggris. The Blues menang 2-0 atas tim London lainnya, Tottenham Hotspur. https://t.co/TFE88BjF7I",19,0,0,0,2022-01-05,21,Wednesday,3,19,0
1478842782886383617,2022-01-05 21:36:09,"Berdalih hiperseksual, warga Kabupaten Bantul tega mencabuli anak kandungnya sendiri sejak masih kelas 5 SD hingga kini kelas 1 SMK. https://t.co/sMNWcbJwCE",18,3,4,4,2022-01-05,21,Wednesday,3,22,7
1478841269891870721,2022-01-05 21:30:08,Kepala Staf Angkatan Laut Laksamana Yudo Margono mendesak BP2MI mengungkap siapa sosok TNI AL yang diduga terlibat dalam praktik pengiriman PMI ilegal. https://t.co/gqsCxqkI0h,12,0,0,0,2022-01-05,21,Wednesday,3,12,0
1478840455576043526,2022-01-05 21:26:54,"Selain untuk melembapkan, moisturizer yang bisa mencerahkan juga banyak dicari mereka yang punya masalah kulit kusam. Ini 8 rekomendasinya buat kamu. https://t.co/fCmER1cA3A",4,0,1,0,2022-01-05,21,Wednesday,3,5,0
1478838874201804804,2022-01-05 21:20:37,"Berdalih hiperseksual, warga Kabupaten Bantul tega mencabuli anak kandungnya sendiri sejak masih kelas 5 SD hingga kini kelas 1 SMK. https://t.co/q2ZAkU2YCZ",35,33,14,16,2022-01-05,21,Wednesday,3,49,49
1478837566417739776,2022-01-05 21:15:25,"Video dan foto memperlihatkan temuan ikan berukuran besar di Lhokseumawe, Aceh, viral di media sosial. BKSDA Aceh turun tangan melakukan pengecekan. https://t.co/BzySVc7VJg",7,0,0,0,2022-01-05,21,Wednesday,3,7,0
1478836498950766594,2022-01-05 21:11:11,Ghost Doctor jadi drama Korea terbaru di awal tahun. Drama ini dibintangi dengan sederet aktor dan aktris ternama. Ini profil para pemerannya:  https://t.co/iyCtdw6I5Z,2,0,0,0,2022-01-05,21,Wednesday,3,2,0
1478835138549145604,2022-01-05 21:05:47,Dua pesawat tak berawak yang dilengkapi dengan bahan peledak dihancurkan. Drone tersebut awalnya menyasar pangkalan udara Ain al-Asad di Irak. https://t.co/yjoBsaBlMM,1,0,0,0,2022-01-05,21,Wednesday,3,1,0
1478834913222737921,2022-01-05 21:04:53,Ketua Umum PSI Giring Ganesha mengunggah momen inspeksi ke lokasi Formula E di Ancol. Giring geleng-geleng kepala karena cuma menemukan barisan kambing di sana. https://t.co/zuYAKBJmvs,70,80,7,9,2022-01-05,21,Wednesday,3,77,89
1478833546706006016,2022-01-05 20:59:27,"Sunarji Riski Radifan atau Narji kini sudah resmi jadi kader PKS. Meski demikian, komedian itu menegaskan akan tetap aktif di dunia hiburan. https://t.co/yMYp3Ee6pT",14,10,1,2,2022-01-05,20,Wednesday,3,15,12
1478832561526910980,2022-01-05 20:55:32,Ponsel BlackBerry lawas yang dulu begitu populer praktis sudah mati karena pihak BlackBerry telah menghentikan dukungan untuk sistem operasinya. Ini penyebab kehancurannya:  https://t.co/6V6Yq7mtO1,15,0,3,2,2022-01-05,20,Wednesday,3,18,2
1478830959101415428,2022-01-05 20:49:10,"Kantor Dinsos Kendari, Sultra terbakar. Kepolisian Sektor (Polsek) Baruga menerjunkan Tim Inafis untuk menyelidiki penyebab kebakaran itu. https://t.co/CNv1Jv2zOp",1,1,0,0,2022-01-05,20,Wednesday,3,1,1
1478830697548853248,2022-01-05 20:48:08,Direktur Jenderal Perhubungan Darat Kemenhub Budi Setiyadi menemui massa ojol di Patung Kuda. Ia mengajak massa ikut merevisi Permenhub No 12. https://t.co/jxNyLnQ0vN,6,0,0,1,2022-01-05,20,Wednesday,3,6,1
1478829700000718857,2022-01-05 20:44:10,Flurona adalah istilah yang diciptakan untuk menggambarkan kondisi terinfeksi COVID-19 dan flu secara bersamaan. Lalu seberapa bahaya kondisi ini? https://t.co/31swBf3un4,8,0,2,2,2022-01-05,20,Wednesday,3,10,2
1478828678339612683,2022-01-05 20:40:06,"PWNU Jatim mendukung laporan terhadap Ferdinand Hutahaean terkait cuitannya 'Allahmu lemah'. Sebab, cuitan itu dinilai telah mencederai keyakinan umat beragama. https://t.co/nhIYCCzz1b",43,18,14,5,2022-01-05,20,Wednesday,3,57,23
1478827583114461191,2022-01-05 20:35:45,Seorang pria di Bali nekat menusuk tetangganya menggunakan tombak. Penusukan ini dipicu cekcok mulut keduanya. https://t.co/qpl8qbnmTY,4,2,1,0,2022-01-05,20,Wednesday,3,5,2
1478826575269449729,2022-01-05 20:31:45,"Sejak dulu, ekstrak lidah buaya dipercaya sangat bagus untuk perawatan wajah hingga rambut. Apa saja manfaat lidah buaya untuk rambut? Yuk, intip penjelasannya: https://t.co/m9K0JLgM19",4,0,0,0,2022-01-05,20,Wednesday,3,4,0
1478825715659423749,2022-01-05 20:28:20,Lima roket menargetkan pangkalan udara Irak. Seorang pejabat berwenang mengatakan tidak ada korban dan kerusakan akibat serangan roket itu. https://t.co/NvF2CzwX74,3,0,0,0,2022-01-05,20,Wednesday,3,3,0
1478824302741012481,2022-01-05 20:22:43,PMKRI menyatakan dukungan terhadap proses hukum atas Ferdinand Hutahaean. Benediktus menilai jerat hukum merupakan konsekuensi dari sikap Ferdinand tersebut. https://t.co/k9U6kbzEv5,9,2,4,0,2022-01-05,20,Wednesday,3,13,2
1478822836030607364,2022-01-05 20:16:53,"Demi menjadi WNI, Renan Silva kini memilih Madura United meskipun ditawar klub luar negeri. https://t.co/XnWrz9VtlV",6,2,1,0,2022-01-05,20,Wednesday,3,7,2
1478821741682212865,2022-01-05 20:12:33,Rusa yang ada di kompleks Istana Kepresidenan itu menyeruduk si tentara di bagian dada. https://t.co/bMQlXc0Rqp,17,0,1,1,2022-01-05,20,Wednesday,3,18,1
1478820134957600773,2022-01-05 20:06:09,"PWNU Jatim mendukung laporan terhadap Ferdinand Hutahaean terkait cuitannya 'Allahmu lemah'. Sebab, cuitan itu dinilai telah mencederai keyakinan umat beragama. https://t.co/KO17WYdMbn",21,7,4,4,2022-01-05,20,Wednesday,3,25,11
1478819342959710213,2022-01-05 20:03:01,"Presiden Jokowi meninjau vaksinasi anak usia 6-11 tahun di SDN 3 Nglinduk, Grobogan. Seperti ini semangat mereka ikut vaksin ditunggui Presiden Jokowi. https://t.co/R44pKWyZvA",6,0,1,2,2022-01-05,20,Wednesday,3,7,2
1478817427546951682,2022-01-05 19:55:24,WhatsApp Aero tengah ramah dibahas netizen baik fitur dan bagaimana cara mendownloadnya. Ini fitur dan bahaya WhatsApp Aero:  https://t.co/3ezpn1jPcS,9,0,1,0,2022-01-05,19,Wednesday,3,10,0
1478816443512799235,2022-01-05 19:51:29,Sejumlah bangkai pesawat berserakan di lahan kosong di Bogor. Bangkai pesawat itu dimiliki seorang pengusaha besi tua. https://t.co/POlLDpbUYl,6,1,1,2,2022-01-05,19,Wednesday,3,7,3
1478814900688494592,2022-01-05 19:45:22,"Buah impor khususnya dari Jepang terkenal punya rasa yang lezat. Cicip melon seharga Rp 7 juta, Sisca Kohl bandingkan rasanya dengan melon lokal. https://t.co/9oMszzcqjI",3,0,1,0,2022-01-05,19,Wednesday,3,4,0
1478813880876998656,2022-01-05 19:41:18,Wanita joki vaksin berinisial DS (41) tidak dijerat pidana usai tertangkap basah. Kenapa? https://t.co/NWRrQJkfZC,3,0,0,0,2022-01-05,19,Wednesday,3,3,0
1478812852848898053,2022-01-05 19:37:13,Muncul rumor tak enak dari ruang ganti Manchester United di bawah arahan Ralf Rangnick. Ada 11 pemain MU yang tak kerasan lagi dan mau hengkang! https://t.co/IshZ2oZvQz,6,0,3,2,2022-01-05,19,Wednesday,3,9,2
1478811603843825665,2022-01-05 19:32:16,Gundukan tanah menyerupai makam dibangun di salah satu jalan desa setempat di Pasuruan. Ini alasan di balik pembuatan makam palsu tersebut. https://t.co/EO4yB3XAC9,16,4,3,1,2022-01-05,19,Wednesday,3,19,5
1478810716165582861,2022-01-05 19:28:44,"Hampir dua tahun korban bencana banjir bandang dan longsor di Lebak, Banten tinggal di hunian sementara. Mereka minta pemerintah turun tangan. https://t.co/pv8GWOcrV7",3,0,0,0,2022-01-05,19,Wednesday,3,3,0
1478809648203505673,2022-01-05 19:24:29,Jenderal Sigit mengatakan ada beberapa petugas PCR di bandara yang terinfeksi Corona varian Omicron. Dia meminta semua pihak waspada. https://t.co/0v0VrnoRE5,18,1,8,2,2022-01-05,19,Wednesday,3,26,3
1478808332358111238,2022-01-05 19:19:16,"Kini, lampu lalu lintas telah terpasang. Bagaimana kondisi sebelum dan setelah? #detikcomdoyourmagic https://t.co/bKKufccxAx",2,0,0,0,2022-01-05,19,Wednesday,3,2,0
1478806520599093249,2022-01-05 19:12:04,Pria di Medan berinisial RS (42) ditangkap polisi. RS diciduk lantaran melakukan pungli terhadap pengendara mobil yang aksinya viral di media sosial (medsos). https://t.co/DYVHw1fCSs,3,1,0,0,2022-01-05,19,Wednesday,3,3,1
1478805806741082112,2022-01-05 19:09:13,"Budi Cahyono (38), tega membunuh bapaknya sendiri, Suradi (68). Pelaku diduga mengalami depresi. https://t.co/uMczuaq3wd",5,0,0,0,2022-01-05,19,Wednesday,3,5,0
1478804310318362631,2022-01-05 19:03:17,"Makam itu dipastikan palsu. Setelah dipastikan palsu, makam itu dibongkar. https://t.co/JrRiRWjf3t",1,1,0,0,2022-01-05,19,Wednesday,3,1,1
1478803224484265992,2022-01-05 18:58:58,Corona RI diprediksi bisa menyentuh 387 ribu kasus per hari di April 2022 karena diamuk Omicron. Kemenkes mengaku peningkatan varian ini nanjak dua kali lipat. https://t.co/uFGntbi4V1,79,99,50,52,2022-01-05,18,Wednesday,3,129,151
1478801580233269259,2022-01-05 18:52:26,Seorang purnawirawan Polri ditemukan meninggal di Jaksel usai sempat diikuti oleh sekelompok orang yang diduga debt collector (DC). Ini penyebab kematian korban: https://t.co/UxaNZdJLdh,4,0,0,0,2022-01-05,18,Wednesday,3,4,0
1478800549994708993,2022-01-05 18:48:20,"Presiden Jokowi mengeluarkan Perpres terkait posisi Wamendagri. Dengan posisi itu, kursi wakil menteri di Kabinet Indonesia Maju yang masih lowong bertambah. https://t.co/GbwvjhCEfE",4,3,4,1,2022-01-05,18,Wednesday,3,8,4
1478799304013881345,2022-01-05 18:43:23,Pemprov DKI Jakarta mengajukan permohonan kepada DPRD untuk mengalokasikan anggaran BTT untuk pemenuhan penyesuaian upah minimum provinsi (UMP) 2022. https://t.co/jabS3MqMrj,3,3,1,0,2022-01-05,18,Wednesday,3,4,3
1478797419202682880,2022-01-05 18:35:54,Medina Zein mengaku siap menghadapi status tersangka atas laporan pencemaran nama baik oleh Marissya Icha. Medina dipastikan akan hadir di pemeriksaan pada 10 Januari mendatang. https://t.co/kFUl0jrSCD,1,1,0,0,2022-01-05,18,Wednesday,3,1,1
1478796033329094658,2022-01-05 18:30:23,DS (41) tertangkap basah mengikuti vaksinasi dengan kartu identitas milik orang lain. Pelaku mendapatkan upah Rp 500 ribu dalam praktik joki vaksin. Haduh... https://t.co/WxN7jtZoU1,13,3,4,1,2022-01-05,18,Wednesday,3,17,4
1478794413446995968,2022-01-05 18:23:57,"Sebanyak 13 orang tewas dalam kebakaran rumah berlantai tiga di Philadelphia, Amerika Serikat (AS). Tujuh di antara korban tewas adalah anak-anak. https://t.co/0vsuPZ9XcX",2,1,2,0,2022-01-05,18,Wednesday,3,4,1
1478794175575474176,2022-01-05 18:23:00,Pelaku mencuri saat puskesmas tutup malam hari. Begini ceritanya: https://t.co/B6VusMguk9,3,0,2,1,2022-01-05,18,Wednesday,3,5,1
1478792913656193026,2022-01-05 18:17:59,"Ketum DPP PSI Giring Ganesha mengunggah vlog di akun twitternya saat mendatangi lokasi sirkuit Formula E di Ancol. Saat sidak tersebut, Giring sempat terperosok ke lumpur yang ia sebut sangat lembek. https://t.co/Knayo3GhuW",46,49,8,4,2022-01-05,18,Wednesday,3,54,53
1478791917664153607,2022-01-05 18:14:02,"KPK menggelar operasi tangkap tangan (OTT) di Kota Bekasi, Jawa Barat. Sejumlah pihak diamankan dalam operasi tersebut. https://t.co/uK8izqRB5v",7,1,1,1,2022-01-05,18,Wednesday,3,8,2
1478790943637708809,2022-01-05 18:10:10,"Bukan pakai alat masak, sekumpulan laki-laki ini memasak mie instan di wastafel hotel. Videonya viral dan mendapat kecaman tajam dari netizen. https://t.co/KwpbwL0CAY",11,1,2,1,2022-01-05,18,Wednesday,3,13,2
1478789277786034179,2022-01-05 18:03:33,"Kebakaran terjadi di sebuah bangunan rumah 3 lantai di Philadelphia, Pennsylvania, Amerika Serikat, Rabu (5/1) pagi. Insiden itu menewaskan 13 orang. https://t.co/tzdOnhSzut",4,2,1,0,2022-01-05,18,Wednesday,3,5,2
1478788303440723980,2022-01-05 17:59:40,"Belum ada sebulan pelawak Narji resmi masuk ke dunia politik, ia membuat pernyataan yang bikin ramai seperti soal baliho HRS. Ia pun buka suara. https://t.co/4el1cGqFnj",9,3,0,0,2022-01-05,17,Wednesday,3,9,3
1478787555961229320,2022-01-05 17:56:42,Wamenag Zainut Tauhid bicara terkait Bahar Smith yang ditetapkan tersangka karena ucapannya diduga mengandung ujaran kebencian. Apa katanya? https://t.co/WSWV4bxF3F,6,1,0,1,2022-01-05,17,Wednesday,3,6,2
1478786286739722241,2022-01-05 17:51:39,"Setiap wanita memiliki aroma vagina yang bervariasi dari yang bau asam hingga seperti bau amis. Kenali 7 variasi bau vagina, ada yang disebabkan oleh infeksi. https://t.co/ifc2l05nsT",5,0,0,0,2022-01-05,17,Wednesday,3,5,0
1478785030793183246,2022-01-05 17:46:40,"Jumlah kasus varian Omicron RI meroket, kini total sebanyak 254 kasus. Lantas jika bertemu pasien Omicron, harus bagaimana? Begini langkah-langkahnya: https://t.co/v9dFngg0fy",5,1,1,0,2022-01-05,17,Wednesday,3,6,1
1478783992853839877,2022-01-05 17:42:33,"Siapa saja bisa tampil stylish, termasuk kamu yang berbadan berisi. Nah, intip yuk tips memilih baju wanita gemuk agar gayamu lebih stylish. https://t.co/xTlicjYcCX",2,0,1,0,2022-01-05,17,Wednesday,3,3,0
1478782415652929545,2022-01-05 17:36:16,Habiburokhman mengatakan pihaknya tak masalah dengan berapapun jumlah presidential threshold yang berlaku. Ia juga menambahkan saat ini tak sulit bagi Gerindra mencari koalisi untuk Pilpres 2024 mendatang. https://t.co/V0w5vXPdCw,7,2,0,0,2022-01-05,17,Wednesday,3,7,2
1478780998947115008,2022-01-05 17:30:39,"Wali Kota Bekasi Rahmat Effendi alias Pepen terjaring operasi tangkap tangan KPK, Rabu (5/1). Pepen tiba di Gedung Merah Putih KPK pada pukul 22.50 WIB. https://t.co/lrc1JdxCqU",12,2,8,1,2022-01-05,17,Wednesday,3,20,3
1478780510738554886,2022-01-05 17:28:42,Masuknya Omicron yang lebih menular memunculkan kekhawatiran tersendiri bagi Indonesia. Sebuah lembaga di AS membuat prediksi yang makin bikin cemas. https://t.co/OCrFK6JQBD,9,5,2,2,2022-01-05,17,Wednesday,3,11,7
1478779176127811593,2022-01-05 17:23:24,"SBY dan Hendropriyono melayat ke rumah duka Ibunda Chairul Tanjung, Halimah. Berikut pantauannya: https://t.co/dK87nYilxa",30,0,2,1,2022-01-05,17,Wednesday,3,32,1
1478778142764544004,2022-01-05 17:19:18,Binance mengumumkan investasi strategisnya melalui jaringan modal venturanya ke WOO Network. https://t.co/TcrTAYcGti,12,0,2,0,2022-01-05,17,Wednesday,3,14,0
1478777248245338114,2022-01-05 17:15:44,Irjen Ferdy Sambo akan menghukum tegas anggota yang mencoreng nama baik Polri. Hal itu sesuai dengan arahan Kapolri Jenderal Sigit. https://t.co/gZiqGdMxKz,10,2,5,0,2022-01-05,17,Wednesday,3,15,2
1478776677429919744,2022-01-05 17:13:28,Narji sempat hampir bergabung dengan Partai Demokrat sebelum akhirnya memilih PKS. Narji mengaku tidak punya niat buruk ke Demokrat. https://t.co/qquKH8CSZ9,9,9,1,0,2022-01-05,17,Wednesday,3,10,9
1478775618015842309,2022-01-05 17:09:16,Kebiasaan yang kerap dilakukan pria berikut ini berisiko merusak penis. Termasuk di antaranya sering begadang dan naik sepeda asal-asalan. https://t.co/H0RtqhoodI,10,2,2,1,2022-01-05,17,Wednesday,3,12,3
1478774426237874182,2022-01-05 17:04:32,Komplotan maling itu membuat jembatan bambu saat beraksi. Tujuannya agar bebek yang dicuri bisa diangkut menyeberangi sungai. Niat! https://t.co/VEI02xtrZ6,18,4,4,0,2022-01-05,17,Wednesday,3,22,4
1478773496343932929,2022-01-05 17:00:50,"Desa Tetebatu punya banyak wisata alam yang memanjakan mata. Salah satunya air terjun yang satu ini, Sarang Walet. Cantik sekali..... https://t.co/42A8QYOh4t",15,0,0,0,2022-01-05,17,Wednesday,3,15,0
1478772139666911233,2022-01-05 16:55:27,"Mantan Kepala BIN, Jenderal (Purn) TNI AM Hendropriyono melayat ke rumah duka Ibunda Chairman CT Corp Chairul Tanjung, Halimah. Ia pun mengenang sosok Halimah sebagai orang tua yang berhasil. https://t.co/3Dvqp0JPDt",5,1,2,0,2022-01-05,16,Wednesday,3,7,1
1478771355038453768,2022-01-05 16:52:19,Sejumlah ulama hingga tokoh Islam di Sumatera Utara yang tergabung dalam forum Ijtima Ulama mendeklarasikan Menparekraf Sandiaga Uno sebagai calon presiden (Capres) 2024. Sandi dinilai dekat dengan ulama. https://t.co/NH2Br82ymu,4,23,4,7,2022-01-05,16,Wednesday,3,8,30
1478770425261928449,2022-01-05 16:48:38,Sebuah petisi beredar di jagat maya yang menginginkan pembuatan spin-off manga Sasuke Uchiha. Bagaimana ceritanya? https://t.co/eBgBjpo8F3,8,0,0,2,2022-01-05,16,Wednesday,3,8,2
1478769914081067012,2022-01-05 16:46:36,Furi Harun (50) hanya mau menjadi orang tua asuh boneka yang diisi dengan arwah anak kecil yang dibunuh maupun korban aborsi. Tidak menerima bagi yang meninggal karena bunuh diri. https://t.co/yLVDKd4RRi,8,0,1,1,2022-01-05,16,Wednesday,3,9,1
1478769640193069065,2022-01-05 16:45:31,"#FOTO Elon Musk dan Jeff Bezos, mereka adalah dua orang terkaya di dunia yang tahtanya saling berebut naik turun. Tapi mereka punya kesamaan: suka meme. https://t.co/3rZEuFmR4r",13,1,0,0,2022-01-05,16,Wednesday,3,13,1
1478769086129655812,2022-01-05 16:43:18,Puan Maharani menanggapi atensi Presiden Jokowi yang mendorong pengesahan RUU TPKS dipercepat. Apa katanya? https://t.co/00uNJY8ryb,15,5,1,0,2022-01-05,16,Wednesday,3,16,5
1478767323834368001,2022-01-05 16:36:18,Wali Kota Bekasi Rahmat Effendi ikut terjaring operasi tangkap tangan (OTT) yang digelar KPK. Rahmat kini telah tiba di Gedung Merah Putih KPK https://t.co/PurSJUHYRf,15,3,4,3,2022-01-05,16,Wednesday,3,19,6
1478766356254363650,2022-01-05 16:32:28,Kim Kardashian terbakar api cemburu pada Miley Cyrus hingga memutuskan untuk mengunfollownya. Hal itu terjadi usai Miley dianggap genit ke Pete Davidson. https://t.co/hcoPpLNbuD,11,2,1,0,2022-01-05,16,Wednesday,3,12,2
1478765414322741249,2022-01-05 16:28:43,"Pasutri lansia di Kabupaten Polman, Sulbar, hidup memprihatinkan di tengah kawasan hutan. Sehari-hari, keduanya harus bertahan hidup dalam belitan kemiskinan. https://t.co/9NvrZAcmlc",17,1,9,0,2022-01-05,16,Wednesday,3,26,1
1478764625013493770,2022-01-05 16:25:35,Kasus Covid-19 di Amerika Serikat (AS) melonjak tajam. Termasuk kasus varian Omicron yang terus berlipat ganda. Hal tersebut menyebabkan antrean tes Covid-19 mengular. Presiden AS Joe Biden pun mengaku frustrasi melihat antrean tersebut. https://t.co/kBmQ1LygCZ,8,1,1,0,2022-01-05,16,Wednesday,3,9,1
1478762931219226624,2022-01-05 16:18:51,Pemasangan simpang JICT Tanjung Priok di Jakut sudah selesai. Kini lalu lintas di simpang JICT menjadi lebih teratur. #detikcomdoyourmagic https://t.co/uMKqX9H9iG,4,1,0,0,2022-01-05,16,Wednesday,3,4,1
1478762374907711488,2022-01-05 16:16:38,Karina merupakan member tertua di aespa. Ia memang sudah dikenal memiliki visual memesona sejak kecil. Ini fakta tetang Karina aespa:  https://t.co/zmRNXPXEc9,7,0,0,0,2022-01-05,16,Wednesday,3,7,0
1478760322454458373,2022-01-05 16:08:29,Wali Kota Bekasi Rahmat Effendi ikut terjaring operasi tangkap tangan (OTT) yang digelar KPK. Rahmat kini telah tiba di Gedung Merah Putih KPK. https://t.co/rOgwa1J8oW,15,4,17,5,2022-01-05,16,Wednesday,3,32,9
1478759554234073096,2022-01-05 16:05:26,Kazakhstan dilanda demo besar-besaran gara-gara kenaikan harga bahan bakar. Presiden Kazakhstan pun menetapkan masa darurat akibat demo berujung ricuh. https://t.co/Zq97rAQKx6,9,1,4,2,2022-01-05,16,Wednesday,3,13,3
1478758981921300480,2022-01-05 16:03:09,Menteri-menteri Kazakhstan ramai-ramai mengajukan pengunduran diri di tengah gelombang protes besar-besaran merespons lonjakan harga LPG di negara tersebut. https://t.co/GlljCTw6ci,23,12,11,4,2022-01-05,16,Wednesday,3,34,16
1478758122453929987,2022-01-05 15:59:45,"""Kita mengetahui bahwa seminggu setelah pemberian dosis keempat, kita melihat peningkatan lima kali lipat dalam jumlah antibodi pada orang yang divaksinasi."" https://t.co/J4fvWrKEsh",3,0,1,4,2022-01-05,15,Wednesday,3,4,4
1478757322533003267,2022-01-05 15:56:34,Seorang anggota Siskommas Pulogadung nyaris jadi korban pemukulan. Kok bisa? https://t.co/0LvqlTVsmd,5,0,1,0,2022-01-05,15,Wednesday,3,6,0
1478756541335576577,2022-01-05 15:53:28,BlackBerry yang pernah menjadi 'HP wajib' di masa kejayaannya akhirnya tumbang. https://t.co/yYvXs73W1v,24,4,6,2,2022-01-05,15,Wednesday,3,30,6
1478755940346343426,2022-01-05 15:51:04,Aktor sekaligus presenter Andre Taulany baru-baru ini berlibur ke Yogyakarta bersama keluarga naik kereta dan menyewa gerbong mewah. Bayar berapa? https://t.co/mspvtbmtmC,6,0,0,0,2022-01-05,15,Wednesday,3,6,0
1478755384940711939,2022-01-05 15:48:52,Persebaya Surabaya berhasil mengalahkan Bali United dalam lanjutan Liga 1 2021. Tim besutan Aji Santoso menang dengan skor 3-1. https://t.co/YhoCW1CPFv,27,0,0,0,2022-01-05,15,Wednesday,3,27,0
1478754628997111809,2022-01-05 15:45:52,Dunia hiburan Korea Selatan kembali kehilangan satu lagi aktris berbakat. Kim Mi Soo mengembuskan napas terakhir di usia 31 tahun. Netizen pun berduka. https://t.co/aRH8o3rUFX,9,0,0,1,2022-01-05,15,Wednesday,3,9,1
1478753850660167683,2022-01-05 15:42:46,"Emak-emak di Desa Tabuyung Mandailing Natal, Sumut, menggeruduk beberapa rumah diduga pengedar narkoba. Polisi berjanji menelusuri dugaan kasus narkoba itu. https://t.co/0q53lLa2hq",17,7,1,1,2022-01-05,15,Wednesday,3,18,8
1478753509222797316,2022-01-05 15:41:25,Pemerintah menargetkan program booster vaksin COVID-19 atau vaksin ketiga dilakukan pada 12 Januari 2022 mendatang. Jadinya gratis atau bayar? https://t.co/1gHMg3Vw0E,7,1,1,1,2022-01-05,15,Wednesday,3,8,2
1478752967260094470,2022-01-05 15:39:15,Ferdinand Hutahaean resmi dipolisikan. Bareskrim Polri pun telah memprosesnya. Ferdinand disebut telah menyebarkan berita bohong. https://t.co/DFv8FgeTXO,153,46,39,11,2022-01-05,15,Wednesday,3,192,57
1478752451717214209,2022-01-05 15:37:13,Begini jawaban Anya Geraldine saat ditanya selingkuh atau diselingkuhin...  https://t.co/KY1NWEdaCI,6,0,0,0,2022-01-05,15,Wednesday,3,6,0
1478752432989646853,2022-01-05 15:37:08,Banyak warga Thailand yang merawat boneka-boneka ini karena untuk mengalihkan kecemasan akibat ekonomi yang sedang gonjang-ganjing. https://t.co/Tyl8G1JQrk,3,0,0,1,2022-01-05,15,Wednesday,3,3,1
1478752110405722113,2022-01-05 15:35:51,Penjualan tiket balap motor MotoGP Indonesia Grand Prix (MotoGP) 2022 mulai dibuka pada 6 Januari secara online dan offline. https://t.co/afay2hRgFr,24,4,1,1,2022-01-05,15,Wednesday,3,25,5
1478751809237831687,2022-01-05 15:34:39,"Di Indonesia, boneka arwah yang dianggap sebagai anak bikin heboh. Sementara di Jepang, dihebohkan dengan boneka seks. https://t.co/MijiJIM7qo",9,12,4,6,2022-01-05,15,Wednesday,3,13,18
1478751486502969346,2022-01-05 15:33:22,"Kantor Dinas Sosial Kota Kendari di Jalan Abunawas, Kelurahan Bende, Kecamatan Kadia, Sulawesi Tenggara (Sultra), ludes terbakar oleh amukan si jago merah. Terdapat 9 ruangan yang terbakar. https://t.co/KwhMvHigrk",3,0,0,0,2022-01-05,15,Wednesday,3,3,0
1478750117725446145,2022-01-05 15:27:56,Walkot Bekasi Rahmat Effendi terjaring OTT KPK. Karir politik Pepen melejit saat menggantikan eks Walkot Bekasi Mochtar Mohamad yang terjerat kasus korupsi. https://t.co/uyZRrtECtS,36,12,6,6,2022-01-05,15,Wednesday,3,42,18
1478749332350599179,2022-01-05 15:24:49,Forbidden merupakan serial arahan sutradara peraih penghargaan Anucha Boonyawatana. Sederet bintang muda tampil di sini seperti JJ Jaylerr dan Oabnithi. https://t.co/REQ7c0chDC,3,0,0,0,2022-01-05,15,Wednesday,3,3,0
1478748847484682243,2022-01-05 15:22:53,"Mengawali 2022, pameran seni kembali bergeliat lagi di Tanah Air. Salah satunya adalah pameran tunggal SketZamrud yang digelar di Semarang. https://t.co/bw5uXbqOiK",10,1,4,1,2022-01-05,15,Wednesday,3,14,2
1478748819391197186,2022-01-05 15:22:47,KPK melakukan OTT terhadap Wali Kota Bekasi Rahmat Effendi dan beberapa pihak lainnya. KPK juga mengamankan sejumlah uang saat melakukan OTT. https://t.co/iQZRPhjWIw,16,3,4,2,2022-01-05,15,Wednesday,3,20,5
1478748549785473025,2022-01-05 15:21:42,Kriteria penerima vaksin booster sudah disampaikan oleh Menteri Kesehatan Budi Gunadi Sadikin. Cek di sini informasinya. https://t.co/kZAVkEXvl4,11,0,1,0,2022-01-05,15,Wednesday,3,12,0
1478748322978480130,2022-01-05 15:20:48,Buya Yahya menjawab soal heboh spirit doll atau boneka arwah. Buya Yahya menegaskan tak ada roh masuk ke boneka. https://t.co/LitfaEaCJX,16,1,4,0,2022-01-05,15,Wednesday,3,20,1
1478747601231040513,2022-01-05 15:17:56,"Pemerintah akan kembali menyalurkan sejumlah bantuan sosial tahun ini, salah satunya BLT Desa. Cek syarat dan cara mendapatkannya berikut. https://t.co/NVr8XRy0XT",10,1,2,1,2022-01-05,15,Wednesday,3,12,2
1478747091308617729,2022-01-05 15:15:55,"Demi menemukan sang ibu yang pergi, Winarso (21) meminta tolong netizen. Wilayah pegunungan di Wonogiri juga dikelilingi demi menemukan sang ibu... #detiktif https://t.co/D0IjeicMy1",24,1,13,0,2022-01-05,15,Wednesday,3,37,1
1478745220393095170,2022-01-05 15:08:28,Walkot Bekasi Rahmat Effendi terjaring OTT KPK. Karir politik Pepen melejit saat menggantikan eks Walkot Bekasi Mochtar Mohamad yang terjerat kasus korupsi. https://t.co/YZaUmGCdHU,35,3,11,3,2022-01-05,15,Wednesday,3,46,6
1478744732889141252,2022-01-05 15:06:32,Wabup Mojokerto turun tangan menindaklanjuti keluhan wisatawan yang viral soal tiket Wana Wisata Padusan. Ini solusi Wabup terhadap viral tersebut. https://t.co/6qAxcDMZnY,2,0,0,0,2022-01-05,15,Wednesday,3,2,0
1478744453942845440,2022-01-05 15:05:26,"KMA People: Office Romance Cruelty mempertemukan Song Kang dan Park Min Young. Tayang Februari, siap dibikin baper lagi detikers?  https://t.co/oA4GE1xDEW",5,0,1,2,2022-01-05,15,Wednesday,3,6,2
1478743964329070592,2022-01-05 15:03:29,MA tetap jatuhkan hukuman 6 tahun penjara dan menolak menjatuhkan uang pengganti Rp 83 M di kasus Nurhadi. Bagaimana kronologi kasus tersebut? https://t.co/qx0OiQmGjR,6,0,0,0,2022-01-05,15,Wednesday,3,6,0
1478742958698647562,2022-01-05 14:59:29,"#FOTO Janganlah cepat percaya dan terhasut dengan foto-foto viral yang beredar di dunia maya, seperti kumpulan foto ini yang sempat bikin geger dunia. https://t.co/tck7f6fwoe",19,2,2,0,2022-01-05,14,Wednesday,3,21,2
1478742137147736064,2022-01-05 14:56:13,Ibu muda asal Klaten yang hilang hingga sempat disayembarakan Rp 5 juta ini pulang. Keluarga pun memenuhi janjinya membayar hadiah sayembara. https://t.co/exJYkmbnUo,9,0,0,0,2022-01-05,14,Wednesday,3,9,0
1478741582727819264,2022-01-05 14:54:01,#Terpopuler Tiga pelaku pembunuhan H dan S diduga berupaya menghilangkan jejak kejahatannya dengan mengganti warna cat mobil dan membuang identitas korban. Simak ceritanya: https://t.co/WxhaSdTgaj,13,1,3,2,2022-01-05,14,Wednesday,3,16,3
1478740784694407168,2022-01-05 14:50:51,"Perempuan asal Kota Tegal ditangkap polisi karena mengedarkan uang palsu di Pasar Banjardawa, Pemalang, Selasa (4/1/2022). Aksinya terekam kamera dan viral. https://t.co/yWGFuzMAzc",4,0,2,0,2022-01-05,14,Wednesday,3,6,0
1478740173085097986,2022-01-05 14:48:25,"Gubernur Jawa Tengah Ganjar Pranowo hadir mendampingi Presiden Joko Widodo dalam peresmian Pasar Johar, Semarang, Jawa Tengah, hari ini. https://t.co/qNLRZPXK0d",10,0,1,0,2022-01-05,14,Wednesday,3,11,0
1478739687820996610,2022-01-05 14:46:29,"#Terpopuler Selama melakoni adegan, Priyanto banyak menunduk. Mimiknya serius dan sesekali berbincang dengan Polisi Militer yang mengawalnya. https://t.co/TtpQighxlx",6,0,0,0,2022-01-05,14,Wednesday,3,6,0
1478739660335722502,2022-01-05 14:46:23,Momen rombongan mobil Presiden Jokowi memberikan jalan kepada ambulans viral di media sosial. Peristiwa itu terjadi saat Jokowi kunjungan kerja ke Jateng. https://t.co/wjrHKBldzI,50,8,4,3,2022-01-05,14,Wednesday,3,54,11
1478739356995276801,2022-01-05 14:45:11,#Terpopuler Narji menjelaskan alasannya memilih menjadi kader PKS. Narji juga menyampaikan permintaan maaf atas sikapnya terkait pencopotan baliho HRS. https://t.co/d7XpPX90hY,19,36,2,5,2022-01-05,14,Wednesday,3,21,41
1478738789858217985,2022-01-05 14:42:55,#Terpopuler Ancaman perubahan iklim kian nyata sepanjang 2021. Hal ini dibuktikan dengan sebagian bumi yang sudah mulai berubah. Begini potretnya. https://t.co/57VSfg9RXg,11,0,7,0,2022-01-05,14,Wednesday,3,18,0
1478737971385929728,2022-01-05 14:39:40,#Terpopuler Kolonel Priyanto dan dua anggota TNI itu sempat menginap satu malam di salah satu hotel di Bandung atau sebelum kejadian kematian Handi-Salsa. Begini ceritanya: https://t.co/jgzST9C2SU,7,1,1,0,2022-01-05,14,Wednesday,3,8,1
1478737942638125063,2022-01-05 14:39:33,Polri merespons perintah pengetatan pengawasan karantina yang disampaikan Presiden Jokowi. Polri menyiapkan satgas untuk mengawasi pelaksanaan karantina. https://t.co/gzQ58s1orJ,9,0,0,0,2022-01-05,14,Wednesday,3,9,0
1478737635246063617,2022-01-05 14:38:20,"Varian Omicron RI sudah mencapai 254 kasus sejak pertama teridentifikasi 16 Desember 2021. Agar tidak makin meluas, Kemenkes mengeluarkan pedoman berikut. https://t.co/KUDxEhOYpJ",13,0,7,2,2022-01-05,14,Wednesday,3,20,2
1478737021581602817,2022-01-05 14:35:54,Tiket masuk ke Wana Wisata Padusan di Mojokerto dikeluhkan wisatawan lantaran harus membayar 5 macam karcis. Keluhan soal tiket tersebut viral. https://t.co/5Hg1i5V3xs,2,0,1,0,2022-01-05,14,Wednesday,3,3,0
1478736809429544970,2022-01-05 14:35:03,Ternyata gara-gara ini nih! Yang bikin supermarket nyaris kosong diserbu warga. https://t.co/HiL4iTuIz4,3,0,1,0,2022-01-05,14,Wednesday,3,4,0
1478736434647474181,2022-01-05 14:33:34,#Terpopuler Choki berharap polisi memproses kasus ini secara adil. https://t.co/HkgWV1pDaK,6,0,1,0,2022-01-05,14,Wednesday,3,7,0
1478735483412832256,2022-01-05 14:29:47,Kim Mi Soo mengembuskan napas terakhir di usia 31 tahun pada 5 Januari 2022. Ini profil aktris Kim Mi Soo:  https://t.co/2DmYFf9ZD0,33,5,7,5,2022-01-05,14,Wednesday,3,40,10
1478735120848805888,2022-01-05 14:28:21,Michael Keaton memilih untuk tidak melanjutkan perannya sebagai Batman di film Batman Forever (1995). Ia mengungkap alasan ini:  https://t.co/e5tXg3hzuJ,5,2,3,0,2022-01-05,14,Wednesday,3,8,2
1478735013520760832,2022-01-05 14:27:55,Mobil Pajero di Pekanbaru hilang kendali dan langsung menghantam pohon palem hingga roboh. Ini foto-fotonya!  https://t.co/KiZhLYjpad,9,0,1,0,2022-01-05,14,Wednesday,3,10,0
1478734763716485122,2022-01-05 14:26:55,Ada beberapa tanda yang bisa menjadi patokan kapan kelahiran akan terjadi. Berikut ini 10 tanda akan melahirkan yang perlu calon ibu ketahui. https://t.co/itDqGJ73NW,5,0,2,0,2022-01-05,14,Wednesday,3,7,0
1478734073313046531,2022-01-05 14:24:11,"#Terpopuler ""Bawa...bawa! Masukin...masukin ke dalam mobil!"" ucap Kolonel Infanteri Priyanto bernada lantang selagi menatap sejoli korban kecelakaan. https://t.co/fxMBvmVYAm",6,6,3,0,2022-01-05,14,Wednesday,3,9,6
1478734052224118785,2022-01-05 14:24:06,"Phil Jones tak kuasa menahan emosi. Di bawah iringan chant suporter Manchester United, ia pun menangis haru.  https://t.co/BxRJTiJZuo",8,0,3,0,2022-01-05,14,Wednesday,3,11,0
1478733607946571780,2022-01-05 14:22:20,"Penampilan perdana dari Hulk dalam serial komik The Incredible Hulk #1 yang disebut langka sukses mencapai rekor Rp 6,4 miliar. Wow!  https://t.co/axR5TSyZ8r",3,0,0,0,2022-01-05,14,Wednesday,3,3,0
1478733376483905537,2022-01-05 14:21:25,Resor Konservasi Wilayah Cilacap BKSDA Jateng berencana segera menyelidiki dugaan keberadaan macan di Banyumas. https://t.co/bGl9xmLeaV,24,8,7,1,2022-01-05,14,Wednesday,3,31,9
1478732676462956544,2022-01-05 14:18:38,"Liverpool sedang diterpa badai virus corona di skuadnya, sampai kompleks latihannya ditutup. Kondisi itu mengancam laga melawan Arsenal di Piala Liga Inggris.  https://t.co/fkyO6lrXVp",16,1,1,1,2022-01-05,14,Wednesday,3,17,2
1478731863493685254,2022-01-05 14:15:24,Kerinduan tersebut tergambar jelas ketika Fuji mengunggah foto keluarga di Instagram. Foto itu ditambahkan wajah Vanessa dan Bibi. Mengharukan.... https://t.co/PzivSL33Du,12,0,0,0,2022-01-05,14,Wednesday,3,12,0
1478731834460672005,2022-01-05 14:15:17,Arema FC hanya harus puas dengan raihan satu poin saat menghadapi Tira Persikabo di Liga 1. Singo Edan ditahan imbang 0-0. https://t.co/v5DY1RW9vV,6,1,0,0,2022-01-05,14,Wednesday,3,6,1
1478731279025819648,2022-01-05 14:13:05,Predator seksual Reynhard Sinaga pernah mendekam di penjara Strangeways. Kini giliran Benjamin Mendy yang meringkuk di sana. Berikut foto-foto penjara tersebut.  https://t.co/nfRu93EaWX,8,0,1,0,2022-01-05,14,Wednesday,3,9,0
1478731258213679111,2022-01-05 14:13:00,Broadway yang berlokasi di Flavor Bliss Alam Sutera ini menawarkan food park dengan konsep bangunan ala Amerika. Pilihan tempat makan di sini beragam. https://t.co/1VsyLqV9LY,3,0,0,0,2022-01-05,14,Wednesday,3,3,0
1478730234291752965,2022-01-05 14:08:55,Antonio Conte mengatakan bahwa Harry Kane jadi pilar penting dalam skema yang dikembangkannya di Tottenham Hotspur. Conte menghidupkan kembali ketajaman Kane.  https://t.co/3Cmd5lHGfw,11,0,2,1,2022-01-05,14,Wednesday,3,13,1
1478729961901109249,2022-01-05 14:07:51,"Kabar duka datang dari keluarga Chairul Tanjung. Ibunda Chairul Tanjung, Halimah, meninggal dunia. Sejumlah tokoh nasional pun menyampaikan rasa belasungkawa. https://t.co/gJU5MPODHe",8,1,3,0,2022-01-05,14,Wednesday,3,11,1
1478729142363463685,2022-01-05 14:04:35,"Lionel Messi sempat positif virus corona. Pemilik 7 Ballon d'Or itu kabarnya sudah negatif, dan kembali ke Paris Saint-Germain.  https://t.co/JTWYCR98us",10,0,1,0,2022-01-05,14,Wednesday,3,11,0
1478728234476920837,2022-01-05 14:00:59,"Orang tua kerap dibuat luluh ketika anak meminta hadiah. Meski harus mengeluarkan uang banyak, pejabat di Pati ini viral karena membelikan mobil demi Anak. #detikNetwork  https://t.co/57qDljijnr",7,0,1,1,2022-01-05,14,Wednesday,3,8,1
1478728195486662663,2022-01-05 14:00:49,"Belasan sekolah di Lamongan terimbas banjir luapan Bengawan Njero. Selain itu, ada satu bangunan sekolah roboh diterjang angin kencang. https://t.co/43eHom8a8c",6,0,1,0,2022-01-05,14,Wednesday,3,7,0
1478728061495488519,2022-01-05 14:00:17,"Pemain-pemain Indonesia mengalami peningkatan harga pasaran usai gelaran Piala AFF 2020. Berikut daftarnya, di mana Asnawi Mangkualam jadi yang termahal.  https://t.co/yOgHvNdUcb",24,0,2,1,2022-01-05,14,Wednesday,3,26,1
1478727469809209344,2022-01-05 13:57:56,Perselingkuhan dalam keluarga juga akan berdampak pada kondisi anak.Hal ini bisa berimbas mulai dari mental hingga merambah ke fisik. Simak penuturan lengkapnya oleh Psikolog &amp; Grafolog Joice Manurung berikut ini: https://t.co/Qlgu8m2od4,18,3,8,0,2022-01-05,13,Wednesday,3,26,3
1478726537058914305,2022-01-05 13:54:14,Booster vaksin COVID-19 bakal dimulai 12 Januari 2022. Disebut Satgas COVID-19 nihil indikasi KIPI berat. Bakal seperti apa mekanisme pemberian booster? https://t.co/6yGFwVhKY0,10,0,5,2,2022-01-05,13,Wednesday,3,15,2
1478725787121594369,2022-01-05 13:51:15,Kusni Kasdut dikenal sebagai bromocorah kawakan pada 1960-1980. Ia kecewa setelah tak diakui sebagai pejuang dan masuk anggota TNI. https://t.co/iiLjm80Okf,21,1,3,2,2022-01-05,13,Wednesday,3,24,3
1478725042309586944,2022-01-05 13:48:18,Perusahaan kereta Arab Saudi sedang melatih para perempuan untuk menjadi masinis. Mereka nanti akan diterjunkan langsung untuk mengangkut penumpang. https://t.co/9HCtEIk8ZS,11,1,3,0,2022-01-05,13,Wednesday,3,14,1
1478724118811975694,2022-01-05 13:44:37,Adalah pilihan yang sulit saat Niko memutuskan resign dari Tesla dan kembali ke Tanah Air. Namun keputusannya itu untuk cita-cita yang lebih tinggi. Simak kisahnya! https://t.co/3v9pouaCMI,36,0,9,0,2022-01-05,13,Wednesday,3,45,0
1478722572992843780,2022-01-05 13:38:29,Pertandingan Arsenal vs Liverpool di leg pertama semifinal Piala Liga Inggris resmi ditunda. Ini menyusul badai COVID-19 yang tengah menerpa Liverpool. https://t.co/XgeFeEpuRl,5,0,0,0,2022-01-05,13,Wednesday,3,5,0
1478722284852555788,2022-01-05 13:37:20,Kementerian Kesehatan RI berencana mulai memberikan vaksin dosis ketiga pada 12 Januari 2022. Ini kriteria penerima vaksin booster: https://t.co/fH2OcG76uv,13,0,3,3,2022-01-05,13,Wednesday,3,16,3
1478721463108706304,2022-01-05 13:34:04,Uang merupakan salah satu alat pembayaran di berbagai negara di dunia. detikcom mengajak detikers untuk menebak uang kertas ini dari negara mana? https://t.co/5jX6l93SEU,5,3,1,0,2022-01-05,13,Wednesday,3,6,3
1478721202059464706,2022-01-05 13:33:02,Herry Wirawan membuat pengakuan dosa usai memperkosa 13 santriwati hingga hamil dan melahirkan. Herry meminta maaf dan mengaku khilaf. https://t.co/oauVnvUVN1,125,296,31,125,2022-01-05,13,Wednesday,3,156,421
1478720508770365445,2022-01-05 13:30:17,Daftar yuk! Beberapa beasiswa S1 fully funded sudah membuka pendaftaran di Januari 2022. Cek cakupan beasiswa dan laman pendaftarannya berikut! https://t.co/OkvuLdrKjE,14,0,5,0,2022-01-05,13,Wednesday,3,19,0
1478719211505692674,2022-01-05 13:25:07,Seorang anggota teroris MIT ditembak mati anggota gabungan Satgas Madago Raya. TNI-Polri sempat menyerukan kepada para DPO tersebut untuk menyerahkan diri. https://t.co/RZxZzyk5Id,16,0,4,0,2022-01-05,13,Wednesday,3,20,0
1478719190425120770,2022-01-05 13:25:02,"Kantor Dinas Sosial Kota Kendari di Jalan Abunawas, Kelurahan Bende, Kecamatan Kadia, Kendari, Sultra, ludes terbakar. Terdapat 9 ruangan yang terbakar. https://t.co/9JhP9CCKTV",5,4,1,1,2022-01-05,13,Wednesday,3,6,5
1478718434351403011,2022-01-05 13:22:02,"Energi matahari dapat digunakan secara langsung maupun diubah ke bentuk energi lain. Lalu, dari manakah energi matahari dihasilkan? Ketahui jawabannya yuk! 
Via: detikedu https://t.co/MGcxl3PGKR",9,1,1,0,2022-01-05,13,Wednesday,3,10,1
1478718211860353025,2022-01-05 13:21:09,FSGI menilai PTM masih riskan. Sejumlah kritik diutarakan untuk mengevaluasi kebijakan baru yang berdampak besar pada pendidikan ini. https://t.co/EtZyoEZoNf,6,0,1,1,2022-01-05,13,Wednesday,3,7,1
1478718187118247936,2022-01-05 13:21:03,"""Kemarin alasannya belum ada pencairan, tapi setelah ada pencairan malah tidak jelas (kontainer tak kunjung dilunasi),"" ungkap Andi. https://t.co/JXMW7f5b1J",5,0,1,0,2022-01-05,13,Wednesday,3,6,0
1478717255202623489,2022-01-05 13:17:21,"Viral di media sosial menampilkan oknum anggota TNI AD di Kabupaten Tanimbar, Maluku bertelanjang dada dan memukul remaja. Tak hanya itu, oknum tersebut juga mengajak duel warga sekitar. https://t.co/16b0oCc3AR https://t.co/VqevhmlcUM",36,2,15,3,2022-01-05,13,Wednesday,3,51,5
1478716825349332998,2022-01-05 13:15:39,"Ada perbedaan data varian Omicron, antara Pemerintah Pusat, dengan Pemerintah Provinsi DKI Jakarta. Pemprov DKI menjelaskan. https://t.co/nkOjgOlEM9",4,0,1,0,2022-01-05,13,Wednesday,3,5,0
1478716263002169345,2022-01-05 13:13:24,Tiga personel TNI AD terlibat pembunuhan sejoli Handi Saputra Hidayatullah (18) dan Salsabila (14). Otak pelakunya ialah Kolonel Inf Priyanto. https://t.co/FEodbWmJRo,27,1,15,1,2022-01-05,13,Wednesday,3,42,2
1478714733167620100,2022-01-05 13:07:20,Wali Kota Bekasi Rahmat Effendi atau Pepen terjaring operasi tangkap tangan (OTT) KPK. Pepen tercatat punya 39 bidang tanah. https://t.co/bcHE1InNtO,14,4,6,3,2022-01-05,13,Wednesday,3,20,7
1478714458205786117,2022-01-05 13:06:14,Pemberlakuan pembatasan kegiatan masyarakat (PPKM) kembali diperpanjang oleh pemerintah pusat terhitung 4-17 Januari 2022. Status PPKM di Jakarta meningkat dari sebelumnya di Level 1 kini menjadi Level 2. https://t.co/ext3d5spcX,15,2,2,2,2022-01-05,13,Wednesday,3,17,4
1478713626844401668,2022-01-05 13:02:56,"#Terpopuler Viral di media sosial 3 unit mobil mewah mendatangi sebuah rumah di Pati, Jateng. Ternyata mobil-mobil itu untuk kado ulang tahun. Wow! https://t.co/I1hpiCDxJE",4,1,2,0,2022-01-05,13,Wednesday,3,6,1
1478712166299615236,2022-01-05 12:57:08,Sebuah kasus 'catfishing' mengejutkan publik karena mereka berhubungan selama lebih dari 10 tahun. Setelah terungkap ternyata pelakunya saudara sendiri. Hiks... https://t.co/nMIWP1ZuYP,4,0,1,0,2022-01-05,12,Wednesday,3,5,0
1478712145844084739,2022-01-05 12:57:03,"Wali Kota Bekasi Rahmat Effendi alias Pepen terjaring OTT KPK. Selama menjabat menjadi Walkot Bekasi, Pepen pernah menuai beberapa kontroversi. https://t.co/grjX58vXC9",20,4,4,10,2022-01-05,12,Wednesday,3,24,14
1478711909121769474,2022-01-05 12:56:06,"Total sudah ada 254 kasus COVID-19 varian Omicron di Indonesia. Satgas COVID-19 menyebut, sudah terdapat transmisi komunitas varian Omicron. https://t.co/lndRPNnTGF",15,3,5,0,2022-01-05,12,Wednesday,3,20,3
1478711400092602369,2022-01-05 12:54:05,"""Terdakwa bersikap sopan menyadari dan menyesali perbuatannya. Masih berusia muda dan dapat memperbaiki sikapnya di kemudian hari,"" kata JPU. https://t.co/YECCbDB8Ib",16,6,2,3,2022-01-05,12,Wednesday,3,18,9
1478710400581525507,2022-01-05 12:50:07,"Wali Kota Bekasi Rahmat Effendi atau Pepen terjaring operasi tangkap tangan (OTT) KPK. Usai Pepen diamankan KPK, kantor dan rumahnya terlihat sepi. https://t.co/nGGWFJiUDI",18,0,5,1,2022-01-05,12,Wednesday,3,23,1
1478709623473549313,2022-01-05 12:47:01,Bareskrim Polri memproses laporan Haris Pertama terhadap Ferdinand Hutahaean hari ini. Laporan itu terkait dugaan tindak pidana menyebarkan berita bohong. https://t.co/w0PWDjypSf,61,26,13,4,2022-01-05,12,Wednesday,3,74,30
1478709622060068865,2022-01-05 12:47:01,"Mayat laki-laki tanpa identitas ditemukan di sungai Ciamut, Kelurahan Kertamaya, Kecamatan Bogor Selatan, Kota Bogor. https://t.co/5KlxOmLuGD",6,0,1,0,2022-01-05,12,Wednesday,3,7,0
1478709121738227714,2022-01-05 12:45:02,"Di museum ini tergantung 2 lukisan dengan kanvas kosong. Senimannya diberi Rp 1,1 M oleh museum. Woah, bagaimana ceritanya? https://t.co/dww1Dlfn9v",24,10,4,2,2022-01-05,12,Wednesday,3,28,12
1478708581469986825,2022-01-05 12:42:53,Medina Zein sudah ditetapkan sebagai tersangka atas kasus pencemaran nama baik yang dilaporkan Marissya Icha. Medina siap hadapi proses hukum. https://t.co/AXOhKzhAlB,10,0,0,0,2022-01-05,12,Wednesday,3,10,0
1478707294078709764,2022-01-05 12:37:46,"Warga Cigasong, Desa Cilawu, Kabupaten Garut dibuat resah dengan kehadiran monyet liar di permukiman mereka. https://t.co/7npXImJoxv",7,0,1,0,2022-01-05,12,Wednesday,3,8,0
1478707292581343238,2022-01-05 12:37:46,Wali Kota Bekasi Rahmat Effendi atau Pepen terjaring operasi tangkap tangan (OTT) KPK. Ketua KPK Firli Bahuri mengatakan Pepen sedang diperiksa. https://t.co/R8EmdGzih2,9,2,10,0,2022-01-05,12,Wednesday,3,19,2
1478706029160452097,2022-01-05 12:32:45,Demo buruh menuntut revisi UMK 2022 di depan di Kawasan Pusat Pemerintahan Provinsi Banten (KP3B) dibubarkan pihak kepolisian. https://t.co/mpj8JOYkDp,7,2,2,0,2022-01-05,12,Wednesday,3,9,2
1478704476680822786,2022-01-05 12:26:34,Banjir luapan yang melanda Aceh Tenggara meluas ke lima kecamatan. Sejumlah alat berat dikerahkan ke lokasi untuk memperbaiki tanggul yang jebol. https://t.co/2nAbNpsU2J,7,1,1,0,2022-01-05,12,Wednesday,3,8,1
1478704205963669510,2022-01-05 12:25:30,"Bagi detikers yang membutuhkan informasinya, simak yuk poin-poin mengenai sasaran vaksin, lokasi, cara mendaftar, dan syarat yang dibutuhkan. Via: detikedu https://t.co/R2ljvNZCbn",3,0,1,0,2022-01-05,12,Wednesday,3,4,0
1478703334487900164,2022-01-05 12:22:02,"Belum beres merebaknya varian Omicron, kini geger kasus gabungan influenza dan virus Corona 'Flurona'. Sebenarnya, umumkah kasus seperti ini? Ini kata ahli: https://t.co/gi47eM8LCZ",14,4,3,0,2022-01-05,12,Wednesday,3,17,4
1478702513847156740,2022-01-05 12:18:46,Aktris Kim Mi Soo membintangi sejumlah drama Korea papan atas selama tiga tahun kariernya. Ini drama-drama terbaik yang pernah dibintangi:  https://t.co/W4ddZcTbS8,3,0,1,0,2022-01-05,12,Wednesday,3,4,0
1478701636595990529,2022-01-05 12:15:17,"Bimbim menjelaskan, saat itu uang hasil manggung Slank habis hanya untuk membeli narkoba. Dia bahkan sampe menjual barang-barang berharga di rumah. https://t.co/TD19xhpRfl",7,0,1,0,2022-01-05,12,Wednesday,3,8,0
1478699854939496448,2022-01-05 12:08:12,CDC mengubah status COVID-19 Singapura menjadi 'unknown'. Hal ini didasari kasus Singapura yang disebut rawan dan besar kemungkinan tertular Corona di sana. https://t.co/CWtxFe6kqW,14,0,5,2,2022-01-05,12,Wednesday,3,19,2
1478699296841162758,2022-01-05 12:05:59,Narji sempat mendukung Jenderal TNi Dudung Abdurachman mencopot baiho HRS. PKS dulu mengkritik sikap Dudung. https://t.co/OIxeBqfppf,4,3,1,1,2022-01-05,12,Wednesday,3,5,4
1478699017144082435,2022-01-05 12:04:53,Dua Polsek di Aceh Utara Aceh ikut terendam banjir. Ketinggian air sempat mencapai dua meter. https://t.co/mXaZ7VQS8y,9,0,5,1,2022-01-05,12,Wednesday,3,14,1
1478698190937411585,2022-01-05 12:01:36,"Anang Hermansyah yang kini berada di Turki tengah menjalani transplantasi rambut, agar rambutnya kembali lebat. Bagaimana prosedurnya? Berikut penjelasannya: https://t.co/Ft6kTddUQZ",17,8,0,1,2022-01-05,12,Wednesday,3,17,9
1478698168577662976,2022-01-05 12:01:30,Pemerintah berencana memberlakukan sistem pembayaran tol tanpa sentuh pada 2022. Secara teknis proses pembayaran yang lebih singkat ini memiliki tiga cara. #CNNIndonesia #detikNetwork  https://t.co/zjJKVaOpOQ,14,0,1,1,2022-01-05,12,Wednesday,3,15,1
1478697341750235137,2022-01-05 11:58:13,Meski pakai aplikasi makanan online banyak pembeli yang tetap malas ketika harus mengambil makanan pesanan. Ada yang pakai ember. https://t.co/wYIhgFNp4j,5,0,0,0,2022-01-05,11,Wednesday,3,5,0
1478696866837585924,2022-01-05 11:56:20,Penanganan kasus itu dilakukan melalui serangkaian tahapan. https://t.co/5OusxQcpWX,7,5,0,0,2022-01-05,11,Wednesday,3,7,5
1478696292935254016,2022-01-05 11:54:03,"Kim Mi Soo yang menjadi pemeran Yeo Jeong-Min, teman sekamar Jisoo Blackpink di drama Korea Snowdrop meninggal dunia. Berikut fakta-fakta sang aktris. https://t.co/Fcftf9HLtd",10,0,2,0,2022-01-05,11,Wednesday,3,12,0
1478696099443531777,2022-01-05 11:53:17,#Terpopuler Bahar meminta umat Islam hingga ulama terus berjuang menyampaikan kebenaran apabila dia ditahan. https://t.co/lJYqdv4PSe,44,34,4,6,2022-01-05,11,Wednesday,3,48,40
1478695247337164806,2022-01-05 11:49:54,Komedian Narji baru saja bergabung dengan Partai Keadilan Sejahtera (PKS). Ia pun membantah kabar yang mengatakan dirinya pernah bergabung ke Partai Demokrat. https://t.co/EiFApKwPp7,10,3,3,0,2022-01-05,11,Wednesday,3,13,3
1478694752333844481,2022-01-05 11:47:56,Anwar Abbas menilai pernyataan Ferdinand menyakiti hati umat Islam. https://t.co/XvGXUhqK01,122,58,16,5,2022-01-05,11,Wednesday,3,138,63
1478694247482150912,2022-01-05 11:45:56,Samsung memperkenalkan proyektor portabel sekaligus smart speaker dan lighting di ajang CES 2022. Inilah dia The Freestyle:  https://t.co/U8gY93r9Sm,8,0,1,0,2022-01-05,11,Wednesday,3,9,0
1478694223075495941,2022-01-05 11:45:50,Pelatih Barcelona Xavi Hernandez meminta Ousmane Dembele menunjukkan usaha kalau mau bertahan. Kesepakatan kontrak baru Los Cules dengan Dembele belum tercapai.  https://t.co/4r5b6avh2R,5,1,0,0,2022-01-05,11,Wednesday,3,5,1
1478693409950945281,2022-01-05 11:42:36,#Terpopuler Tangan ketiga tersangka diborgol saat melakoni proses rekonstruksi. https://t.co/glajCFthS1,3,1,0,0,2022-01-05,11,Wednesday,3,3,1
1478692856688742404,2022-01-05 11:40:24,Paket beras itu dikirim memakai satu truk ke kantor sementara DPC PDIP Solo di Pucangsawit sebelum dibagikan. https://t.co/QvepBJRrcJ,4,2,1,1,2022-01-05,11,Wednesday,3,5,3
1478692606775283719,2022-01-05 11:39:24,Erajaya kini tengah menjalankan model bisnis barunya dengan konsep kemitraan Erafone Cloud Retail Partner. https://t.co/N37vNHuHaP,8,1,1,0,2022-01-05,11,Wednesday,3,9,1
1478692108873650183,2022-01-05 11:37:26,"Sambil nunggu info CPNS 2022, cek dulu yuk ini 10 kampus pencetak lulusan CPNS terbanyak yang tersebar di seluruh Indonesia. Kampus mana saja ya? Via: detikedu https://t.co/8M1I1K89nx",10,0,0,0,2022-01-05,11,Wednesday,3,10,0
1478691237691543553,2022-01-05 11:33:58,Vaksin booster ilegal beredar di Surabaya. Polisi tengah mendalami siapa saja oknum di balik penjualan vaksin dosis ketiga itu. https://t.co/gWHfCHHTvO,9,1,0,0,2022-01-05,11,Wednesday,3,9,1
1478690455168720898,2022-01-05 11:30:51,"Jokowi bicara tegas agar tak ada lagi dispensasi karantina bagi pelaku perjalanan yang datang dari luar negeri. Lalu, bagaimana dengan dispensasi bagi pejabat? https://t.co/49awgdau8E",6,3,3,0,2022-01-05,11,Wednesday,3,9,3
1478690245973626884,2022-01-05 11:30:02,Dua orang santri Ponpes di Magelang tenggelam di Sungai Elo. Seorang di antaranya telah ditemukan dalam kondisi tewas. https://t.co/fkfDmSYWN8,4,0,2,1,2022-01-05,11,Wednesday,3,6,1
1478689937050554373,2022-01-05 11:28:48,Presiden Jokowi meminta BIN dan Polri menjaga pelaksanaan karantina COVID-19. Kenapa TNI tak sekalian diminta Jokowi menjaga karantina? https://t.co/3EzN2JJG76,5,1,1,0,2022-01-05,11,Wednesday,3,6,1
1478688401511501825,2022-01-05 11:22:42,Bencana banjir bandang dan longsor pada 2020 membuat satu kampung di Cigobang hilang ditelan bumi. Namun masih ada juga warga yang tetap bertahan di rumahnya. https://t.co/PjyFWMVMPM,8,0,1,0,2022-01-05,11,Wednesday,3,9,0
1478687380475371521,2022-01-05 11:18:38,Susilo Bambang Yudhoyono melayat ke rumah duka Ibunda Chairul Tanjung. Presiden RI ke-6 itu mengenang kebaikan Ibunda Chairul Tanjung. https://t.co/BIhvwGQZzY,6,0,1,0,2022-01-05,11,Wednesday,3,7,0
1478687357473861638,2022-01-05 11:18:33,"Disela peresmian Bendungan Randugunting, Blora, Jawa Tengah, Presiden Jokowi bersama Gubernur Jateng Ganjar terlihat menanam pohon jati. https://t.co/xbRVZ7qPCS",20,3,5,0,2022-01-05,11,Wednesday,3,25,3
1478686536422014983,2022-01-05 11:15:17,Wali Kota Bekasi Rahmat Effendi dikabarkan kena operasi tangkap tangan (OTT) oleh KPK. Partai Golkar belum mendengar kabar resmi terkait penangkapan itu. https://t.co/KQ9iEk14gY,17,2,3,8,2022-01-05,11,Wednesday,3,20,10
1478686055675179014,2022-01-05 11:13:22,Khloe Kardashian ngaku jika dirinya selalu bangun subuh dan hidup terjadwal. Ini penuturan Khloe:  https://t.co/QmxrYX4VKr,39,26,2,20,2022-01-05,11,Wednesday,3,41,46
1478686037249515521,2022-01-05 11:13:18,"AS mencatat 1.082.549 kasus baru COVID-19 pada Senin (3/12/202). Dari jumlah tersebut, Omicron berkontribusi 95 persen. Ini penyebab naiknya kasus COVID-19: https://t.co/IuGVunrh1V",3,1,1,0,2022-01-05,11,Wednesday,3,4,1
1478685524357435393,2022-01-05 11:11:16,"Ada cerita menarik di balik bergabungnya Narji ke PKS. Narji, saat positif Corona, pernah tersinggung karena kader PKS beri bantuan makanan dan obat. Kenapa? https://t.co/C8fm3dUjOJ",8,3,2,0,2022-01-05,11,Wednesday,3,10,3
1478685205124853762,2022-01-05 11:10:00,"Hai para suami, yuk kasih tau istrinya suruh ikutan program ""Modal Usaha untuk Suami"" dari detikcom! Di program ini para istri berkesempatan mendapatkan hadiah ""Modal Usaha untuk Suami"" senilai jutaan rupiah lho.⁣⁣
⁣⁣
Penasaran bagaimana caranya? Klik https://t.co/dG0yoZjoLq https://t.co/uhRjZZ56Zl",6,1,2,0,2022-01-05,11,Wednesday,3,8,1
1478684699073687557,2022-01-05 11:07:59,"Presiden Jokowi meresmikan Pasar Johar Semarang, Jawa Tengah hari ini. Jokowi juga membagikan bantuan sembako kepada warga di sekitar Aloon-aloon Kota Semarang. https://t.co/yb80t70bLQ",7,2,1,1,2022-01-05,11,Wednesday,3,8,3
1478684424535486469,2022-01-05 11:06:54,Keluarga Ahmad Dhani dan Mulan Jameela kompak mengunggah foto liburan di Turki. Beberapa waktu lalu momen liburan mereka jadi sorotan karena isu karantina. Ini potretnya:  https://t.co/3opY5TvQwO,2,1,0,0,2022-01-05,11,Wednesday,3,2,1
1478684371091611650,2022-01-05 11:06:41,"PT Yamaha Indonesia Motor Mqnufacturing (YIMM) mengumumkan per 1 Januari 2022, harga motor Yamaha naik sekitar Rp 200-400 ribu.  https://t.co/2PKScLLwOV",3,0,0,0,2022-01-05,11,Wednesday,3,3,0
1478683160401612805,2022-01-05 11:01:52,Pemerintah Taliban memerintahkan para pemilik toko di wilayah Afghanistan sebelah barat untuk memenggal kepala manekin-manekin. https://t.co/Yz7lVdmJww,15,13,7,2,2022-01-05,11,Wednesday,3,22,15
1478682690673074179,2022-01-05 11:00:00,"Buat detikers yang menjadi anak pertama, atau bahkan punya kakak anak pertama ada kejutan spesial nih dari detikcom untuk kamu. Di program ini, semua anak pertama berkesempatan mendapatkan handphone senilai belasan juta rupiah lho.⁣⁣ 

Caranya klik https://t.co/7nSz16MS54 ya! https://t.co/kKS3kadwoH",7,3,1,0,2022-01-05,11,Wednesday,3,8,3
1478682337626017798,2022-01-05 10:58:36,"#FOTO Atlet bulu tangkis Indonesia, Shesar Hiren Rhustavito, melamar kekasihnya, Mitha Hardiyanti. Ini sosok Mitha Hardiyanti:  https://t.co/MPdrmJZ3GC",6,0,2,0,2022-01-05,10,Wednesday,3,8,0
1478681715291967493,2022-01-05 10:56:08,Marissya Icha siap memenuhi panggilan Kementerian Sosial. Hal itu usai buntut aduan Doddy Sudrajat perihal penggalangan dana untuk rumah Gala Sky. https://t.co/7wFJzyTbhX,3,0,3,0,2022-01-05,10,Wednesday,3,6,0
1478680675314278402,2022-01-05 10:52:00,"Hai detikers, udah pada ikutan program Kalung untuk Istri belum? Kali ini para suami se-Indonesia punya kesempatan bikin senang istri bawa pulang hadiah kalung emas lho. Program ini hanya berlaku bagi yang memiliki istri sah ya. Caranya klik di sini https://t.co/fdrW1u3hxO https://t.co/980bDKqQDI",9,3,1,0,2022-01-05,10,Wednesday,3,10,3
1478680316470435840,2022-01-05 10:50:34,"Hai detikers, udah pada ikutan program Motor untuk Mertua belum? Di program ini para menantu dan calon menantu se-Indonesia bisa bawa pulang motor untuk para mertua / calon mertua. Ini saatnya kamu menjadi menantu idaman. Caranya bisa cek di sini ya https://t.co/T0EAWsdQMi https://t.co/paWjqhthSF",2,3,1,1,2022-01-05,10,Wednesday,3,3,4
1478679922654732288,2022-01-05 10:49:00,Sarang tawon yang ditinju itu langsung hancur berserakan dan membuat tawon-tawon terbang. Pria yang meninju sarang tawon itu langsung lari ke area sawah. Aya-aya wae! https://t.co/cdvF57GuiD,19,7,8,12,2022-01-05,10,Wednesday,3,27,19
1478679398958125058,2022-01-05 10:46:55,Dia memiliki boneka bernama Nong Petch yang telah membawanya memenangkan lotre dan bahkan dia mengetahui nomor berapa saja yang harus dia beli. https://t.co/bis2sRn1Md,3,0,1,4,2022-01-05,10,Wednesday,3,4,4
1478678926939635715,2022-01-05 10:45:03,Emak-emak di Semarang nekat menjadi joki vaksin karena tergiur upah. Berapa sih upahnya? https://t.co/JXHGf0mpMr,4,2,3,3,2022-01-05,10,Wednesday,3,7,5
1478678905456316418,2022-01-05 10:44:58,"Tingginya harga pangan belakangan dikeluhkan masyarakat. Beberapa komoditas yang harganya melonjak yakni minyak goreng, telur ayam hingga cabai rawit merah. https://t.co/BkCaqTYnG2",10,1,2,0,2022-01-05,10,Wednesday,3,12,1
1478678377548730376,2022-01-05 10:42:52,POBSI menilai Choki harusnya tidak melaporkan karena sudah dimediasi. https://t.co/6KZuG37ara,16,13,1,1,2022-01-05,10,Wednesday,3,17,14
1478678358460452867,2022-01-05 10:42:47,"Seorang penumpang kapal feri KMP BSP I dilaporkan hilang dalam perjalanan menuju Pelabuhan Merak, Banten. Keluarga menemukan sepatu hingga topi milik korban. https://t.co/WbnWiE3dsz",4,0,2,1,2022-01-05,10,Wednesday,3,6,1
1478677577938186241,2022-01-05 10:39:41,"Indonesia mencatat sebanyak 404 kasus baru COVID-19, Rabu (5/1/2022). DKI menyumbang kasus terbanyak dengan jumlah 259. https://t.co/k5PpujoH0E",6,2,3,0,2022-01-05,10,Wednesday,3,9,2
1478677354868264963,2022-01-05 10:38:48,"Jenazah PMI atau TKI asal Lumajang, Sri Windari tiba di Bandara Juanda. Ia menjadi korban kapal karam di Malaysia. https://t.co/QjIgQwwSUt",4,0,1,0,2022-01-05,10,Wednesday,3,5,0
1478677353643618306,2022-01-05 10:38:48,"Asisten manajer Liverpool, Pep Lijnders, dinyatakan positif COVID-19. Laga melawan Arsenal di Piala Liga Inggris pun makin jadi tanda tanya.  https://t.co/x4Ga2MLgF3",3,0,0,0,2022-01-05,10,Wednesday,3,3,0
1478677033404317696,2022-01-05 10:37:31,Pelatih Barcelona Xavi Hernandez meminta Ousmane Dembele menunjukkan usaha kalau mau bertahan. Kesepakatan kontrak baru Los Cules dengan Dembele belum tercapai. https://t.co/N9S0qBUEg0,7,0,0,0,2022-01-05,10,Wednesday,3,7,0
1478676392346898438,2022-01-05 10:34:59,"Memiliki rambut yang tebal dan bervolume adalah impian bagi semua orang. Ada banyak cara menebalkan rambut dengan cepat, terutama menggunakan bahan-bahan alami. https://t.co/Q8VuYJUIcG",15,0,3,0,2022-01-05,10,Wednesday,3,18,0
1478676391151423491,2022-01-05 10:34:58,Petugas PMI Banjarnegara tidak menemukan adanya indikasi gangguan jiwa saat memeriksa Jaenab yang sempat viral tidur di tengah jalan. https://t.co/eEMlRbRjR7,5,0,2,0,2022-01-05,10,Wednesday,3,7,0
1478675528571887617,2022-01-05 10:31:33,"KPK melakukan operasi tangkap tangan (OTT) di Kota Bekasi. Pejabat yang terjaring OTT adalah Wali Kota Bekasi, Rahmat Effendi alias Pepen. https://t.co/spg2yV79F0",267,93,152,158,2022-01-05,10,Wednesday,3,419,251
1478674907718430721,2022-01-05 10:29:05,Sinergi antara pemerintah dan pelaku usaha harus mampu menghadirkan efek positif terhadap masyarakat dan lingkungan https://t.co/jOvu5WwOQ9,5,0,2,0,2022-01-05,10,Wednesday,3,7,0
1478674629828956163,2022-01-05 10:27:58,Presiden Joko Widodo (Jokowi) kembali menambah posisi wakil menteri (wamen) dalam struktur kabinet Indonesia Maju. Ini tugasnya: https://t.co/1XXaUZXecr,3,0,2,0,2022-01-05,10,Wednesday,3,5,0
1478674080320655362,2022-01-05 10:25:47,"Bumi kita menyimpan banyak misteri. Beberapa tempat bahkan ada yang menyimpan keanehan, termasuk tempat-tempat teraneh berikut ini. https://t.co/4DNUnqWrlY",36,2,12,0,2022-01-05,10,Wednesday,3,48,2
1478674038805475335,2022-01-05 10:25:37,"Nama Ahmad Riza Patria mencuat dalam bursa Pilgub DKI Jakarta 2024. Namun, Riza mengaku siap untuk menjadi Wakil Gubernur DKI dua periode. https://t.co/zU4gngCNXa",13,11,3,1,2022-01-05,10,Wednesday,3,16,12
1478673485396381698,2022-01-05 10:23:26,Pemerintah melarang sementara ekspor batu bara dari 1 hingga 31 Desember 2022. Seperti apa dampaknya ke PT Bukit Asam Tbk? https://t.co/lINxenUaZl,1,1,1,0,2022-01-05,10,Wednesday,3,2,1
1478673271855800323,2022-01-05 10:22:35,Sebelas napi kasus balon udara bebas pada Selasa (4/1/2022). Keluarga menyambut para napi dengan tangis histeris di halaman depan Rutan Ponorogo. https://t.co/hOQJuyXtwV,1,0,1,1,2022-01-05,10,Wednesday,3,2,1
1478673254810374144,2022-01-05 10:22:31,"Ahmad Riza Patria mengakui ada peningkatan kasus COVID-19, namun menurutnya kondisi masih terkendali. https://t.co/VQjaKAXflK",3,0,1,0,2022-01-05,10,Wednesday,3,4,0
1478671968060973056,2022-01-05 10:17:24,Amerika Serikat tengah menghadapi infeksi COVID-19 dalam beberapa hari terakhir hingga mencatat 1.082.549 kasus dalam kurun waktu 24 jam pada Senin (3/1/2022). https://t.co/nOuP9Tc0SE,3,1,6,1,2022-01-05,10,Wednesday,3,9,2
1478671966479556609,2022-01-05 10:17:23,"KPK telah melakukan operasi tangkap tangan (OTT) di wilayah Kota Bekasi, Jawa Barat. Kini KPK telah mengamankan pihak-pihak terkait. https://t.co/uKOgsKWWyT",9,2,2,0,2022-01-05,10,Wednesday,3,11,2
1478671965082853381,2022-01-05 10:17:23,"Massa driver ojol di sekitar Patung Kuda Arjuna Wijaya, Jakpus telah membubarkan diri. Jalan Medan Merdeka Barat yang sempat ditutup kini dibuka lagi. https://t.co/LkJ2Lrp42K",3,0,3,0,2022-01-05,10,Wednesday,3,6,0
1478671407752097793,2022-01-05 10:15:10,"KPK telah melakukan operasi tangkap tangan (OTT) di wilayah Kota Bekasi, Jawa Barat. Kini KPK telah mengamankan pihak-pihak terkait. https://t.co/CJGKu1IHGY",6,0,1,0,2022-01-05,10,Wednesday,3,7,0
1478671406070218768,2022-01-05 10:15:10,Hoax Ketua Umum PDI Perjuangan (PDIP) Megawati Soekarnoputri tutup usia kembali beredar di media sosial. PDIP akan mengambil tindakan. https://t.co/pOpeo6o3NS,25,26,3,2,2022-01-05,10,Wednesday,3,28,28
1478671129338384387,2022-01-05 10:14:04,Perusahaan yang memiliki kode entimen ERAA ini tetap melakukan pembukaan ratusan gerai offline meskipun pandemi COVID-19 belum kunjung reda. https://t.co/r82aVYU1VY,3,0,1,0,2022-01-05,10,Wednesday,3,4,0
1478670656300535810,2022-01-05 10:12:11,Park So Dam akhirnya buka suara setelah menjalani operasi kanker tiroid. Ia menulis pesan khusus untuk fans. Ini isinya: #ParkSoDam  https://t.co/eRpo4YtTZH,3,0,0,0,2022-01-05,10,Wednesday,3,3,0
1478670634477670400,2022-01-05 10:12:06,"Setelah vaksin COVID-19 biasanya menimbulkan efek samping. Untuk menguranginya, sebaiknya mengonsumsi 8 makanan dan minuman sehat ini:  https://t.co/DhJvwFqZ4T",2,1,0,0,2022-01-05,10,Wednesday,3,2,1
1478670386732716034,2022-01-05 10:11:07,Influencer perjalanan membocorkan tips buat traveler untuk mendapatkan makanan dan minuman gratis saat memesan hotel. Seperti apa ya? https://t.co/kxyRnr9kZN,5,0,3,0,2022-01-05,10,Wednesday,3,8,0
1478668786895101952,2022-01-05 10:04:45,Hyundai akan memasuki pasar MPV. Pabrikan asal Korea Selatan itu tengah menyiapkan MPV penantang Avanza cs. Namanya Hyundai Stargazer.  https://t.co/TrQFerrhvq,3,0,2,0,2022-01-05,10,Wednesday,3,5,0
1478668761657970691,2022-01-05 10:04:39,Boneka arwah ramai jadi perbincangkan netizen di Twitter. Menurut pakar UNS kebudayaan spirit doll sudah ada sejak zaman dahulu. Ini katanya. Via: detikedu https://t.co/YvRTXJAHkX,9,1,3,3,2022-01-05,10,Wednesday,3,12,4
1478668399492411395,2022-01-05 10:03:13,"Pemain drama Korea Snowdrop, Kim Mi Soo dikabarkan meninggal dunia. Inilah potret dan sederet faktanya yang menjadi teman sekamar Jisoo BLACKPINK. https://t.co/ky4dlohu5h",9,2,4,3,2022-01-05,10,Wednesday,3,13,5
1478667857017950213,2022-01-05 10:01:04,Pipi Anang tampil berbeda karena botak loh. Seperti apa penampilannya sekarang? #detikNetwork  https://t.co/tWbaYTsU8B,5,1,1,0,2022-01-05,10,Wednesday,3,6,1
1478667268762525698,2022-01-05 09:58:43,"Karier sepakbola Ze Roberto sudah lama berlalu, tapi ia masih terus menempa fisik. Tubuhnya kekar, fisiknya apik. Lebih oke ketimbang Cristiano Ronaldo?  https://t.co/fhUVn70r3n",5,0,3,0,2022-01-05,9,Wednesday,3,8,0
1478667267365871620,2022-01-05 09:58:43,"KPK melakukan operasi tangkap tangan (OTT) di wilayah Bekasi, Jawa Barat. Kini KPK masih melakukan pemeriksaan terhadap pihak-pihak terkait. https://t.co/DdP4MtvUlA",3,0,4,1,2022-01-05,9,Wednesday,3,7,1
1478666474810224640,2022-01-05 09:55:34,"Maskapai Super Air Jet resmi membuka penerbangan rute Jakarta-Solo-Jakarta, mulai hari ini. Super Air Jet menggunakan pesawat jenis Airbus 320-200. https://t.co/sicqBxPm0I",9,0,0,0,2022-01-05,9,Wednesday,3,9,0
1478665975281205251,2022-01-05 09:53:35,Rapper J $tash membunuh kekasihnya di depan anak-anaknya lalu mengakhiri hidupnya sendiri dengan senjata api.  https://t.co/g770gqEkrk,0,0,1,0,2022-01-05,9,Wednesday,3,1,0
1478665668933435394,2022-01-05 09:52:22,Rachmat Kaimuddin kini sudah memiliki tugas baru usai melepas kursi kepemimpinan Bukalapak Desember yang lalu. Ini calon penggantinya. https://t.co/yVvaOyKBkd,2,0,1,0,2022-01-05,9,Wednesday,3,3,0
1478665650348437504,2022-01-05 09:52:17,"Kabar duka datang dari keluarga Chairul Tanjung. Ibunda Chairul Tanjung, Halimah, meninggal dunia. Sejumlah tokoh hingga Wakil Presiden Maruf Amin datang melayat ke rumah duka ibunda Chairul Tanjung.  https://t.co/sKUrglFFq7",7,0,0,0,2022-01-05,9,Wednesday,3,7,0
1478665043898253313,2022-01-05 09:49:53,Thai Airways menganggap boneka ini seperti anak manusia yang bisa duduk dan menikmati penerbangan. https://t.co/dIrkA8LXyD,2,1,0,0,2022-01-05,9,Wednesday,3,2,1
1478664802897645570,2022-01-05 09:48:55,Fuji dan Chika Chandrika bertemu di Bali saat menghabiskan waktu liburannya. Fuji tuai pujian saat menutupi belahan dada ketika foto dengan Chika.  https://t.co/rpq3TsuoTI,1,2,1,2,2022-01-05,9,Wednesday,3,2,4
1478664291687538688,2022-01-05 09:46:54,Kemenkes RI kembali menemukan 92 kasus transmisi lokal varian Omicron. Berikut kronologi penemuan kasus Omicron pertama hingga 254 kasus: https://t.co/N7N4HnETEk,3,0,1,1,2022-01-05,9,Wednesday,3,4,1
1478664271798091780,2022-01-05 09:46:49,"Rumor soal iPhone 15 kembali berdatangan meski baru akan diluncurkan tahun depan. Terbaru, iPhone 15 dikabarkan akan punya lensa periskop ala Galaxy S21 Ultra. #iPhone15 https://t.co/9DbeBfv6jO",2,0,1,0,2022-01-05,9,Wednesday,3,3,0
1478662979092680707,2022-01-05 09:41:41,"Sebagai seorang muslim, ucapan Insya Allah tentu sudah tak asing lagi. Tapi seperti apa ya penulisan Insya Allah yang benar? Via: detikedu https://t.co/cR5tLZcLiC",17,11,9,1,2022-01-05,9,Wednesday,3,26,12
1478662952584679429,2022-01-05 09:41:34,"Seorang ABG di Empat Lawang, Sumatara Selatan diduga diperkosa bergilir oleh 6 pria usai dicekoki minuman keras. 4 Pelaku ditangkap dan 2 pelaku lainnya buron. https://t.co/k5GqrnDBgQ",10,2,5,1,2022-01-05,9,Wednesday,3,15,3
1478662723890302976,2022-01-05 09:40:40,Liz Hurley membuat heboh karena fotonya tampak ditindih oleh seorang pria berkostum Superman. Ini sosok pria tersebut:  https://t.co/0D1eLff6wU,4,0,1,0,2022-01-05,9,Wednesday,3,5,0
1478662722602606592,2022-01-05 09:40:39,"Film Makmum 2 membangkitkan rasa penasaran masyarakat Indonesia untuk menyaksikannya. Terbukti di hari keempat penayangannya, film ini berhasil nyaris tembus 300 ribu penonton.  https://t.co/5rTvl42sly",9,2,1,2,2022-01-05,9,Wednesday,3,10,4
1478662491949481984,2022-01-05 09:39:44,"Hingga kini, sudah 15 hari Ancilla belum ada kabar... #detiktif https://t.co/thA7GmEryZ",9,1,2,0,2022-01-05,9,Wednesday,3,11,1
1478662470625636352,2022-01-05 09:39:39,"Model asal Bosnia ngaku sempat 'disekap' di sebuah apartemen di Indonesia. Ia pun merasa trauma dan bilang ini pengalaman menyeramkan. Simak, yuk! #detikNetwork  https://t.co/IGWiMHeC7J",9,0,2,0,2022-01-05,9,Wednesday,3,11,0
1478662242648342531,2022-01-05 09:38:45,Kapolri Jenderal Listyo Sigit Prabowo menghadiri launching vaksinasi merdeka anak di wilayah Jakarta Pusat. Seperti apa acaranya? https://t.co/Otz7JQTkdk,1,0,1,0,2022-01-05,9,Wednesday,3,2,0
1478661731320836098,2022-01-05 09:36:43,"Pemain utama bisnis teknologi nyemplung ke industri kendaraan listrik. Di acara Consumer Electronic Show (CES), Sony memamerkan mobil listrik dengan genre SUV.   https://t.co/j4xPHRpcIK",5,0,2,0,2022-01-05,9,Wednesday,3,7,0
1478661730091868163,2022-01-05 09:36:43,"Pemain utama bisnis teknologi nyemplung ke industri kendaraan listrik. Di acara Consumer Electronic Show (CES), Sony memamerkan mobil listrik dengan genre SUV.  https://t.co/GLs6MiTzF2",4,0,1,0,2022-01-05,9,Wednesday,3,5,0
1478661439179083778,2022-01-05 09:35:33,Inovasi berupa Electronic Traffic Law Enforcement (E-TLE) Mobile sudah diluncurkan sejak tahun lalu. Wilayah mana saja yang sudah menerapkannya ya?  https://t.co/MfNDIPrGIm,2,0,3,0,2022-01-05,9,Wednesday,3,5,0
1478661144663535617,2022-01-05 09:34:23,Prof Amin Soebandrio mengungkapkan kecilnya gaji para peneliti kontrak di Eijkman selama ini. Simak selengkapnya di sini:  https://t.co/aenBXzHzbe,10,0,4,2,2022-01-05,9,Wednesday,3,14,2
1478661124308578304,2022-01-05 09:34:18,Irwansyah dan Zaskia Sungkar merasa janggal dalam aksi penipuan Hafiz Fatur. Mereka juga sudah melaporkan bank tempat Hafiz Fatur ajukan kredit ke OJK. https://t.co/j1ouv87QOH,4,0,2,0,2022-01-05,9,Wednesday,3,6,0
1478660861308944384,2022-01-05 09:33:16,"Menperin Agus menyebut harga mobil di bawah Rp 250 juta bukan lagi barang mewah, tapi jadi kebutuhan masyarakat.  https://t.co/HRvJG9KmTb",9,3,4,1,2022-01-05,9,Wednesday,3,13,4
1478660575416758275,2022-01-05 09:32:08,"Mitsubishi mengklaim dengan transmisi CVT-nya yang baru ini, New Xpander hadir lebih efisien.  https://t.co/dCiR3Yur5V",6,0,1,0,2022-01-05,9,Wednesday,3,7,0
1478660310450024452,2022-01-05 09:31:04,"Mitsubishi mengklaim dengan transmisi CVT-nya yang baru ini, New Xpander hadir lebih efisien.  https://t.co/MCJ3Ba5oYS",4,0,3,0,2022-01-05,9,Wednesday,3,7,0
1478660309112049670,2022-01-05 09:31:04,Camilan jadi makanan ringan yang punya jenis dan rasa beragam. Seperti kisah wanita ini yang berawal hanya membuka sistem pre-order kepada kerabat dan rekan kini omzetnya jutaan per bulan.  https://t.co/AX9nX4sKra,3,0,2,0,2022-01-05,9,Wednesday,3,5,0
1478660039510532096,2022-01-05 09:30:00,Ancilla peserta meditation camp yang hilang hingga kini belum ditemukan. Ini rekaman CCTV terakhit kali Ancilla terlihat. #detiktif https://t.co/tKjzCdJcUH,7,0,2,0,2022-01-05,9,Wednesday,3,9,0
1478660019646345216,2022-01-05 09:29:55,Honda Vario 150 menjadi salah satu skuter matik (skutik) yang diklaim irit bahan bakar (BBM). Berapa sih konsumsi BBM Vario 150?  https://t.co/PEvxxX9cyW,8,3,1,0,2022-01-05,9,Wednesday,3,9,3
1478659460835037193,2022-01-05 09:27:42,"Gadis bernama Salma Mahesa (15), warga Kecamatan Cikembar, Kabupaten Sukabumi dilaporkan hilang. Gadis itu pergi dari rumah sejak Jumat, 26 Desember 2021 lalu. https://t.co/mHXLw4E1VL",1,3,3,1,2022-01-05,9,Wednesday,3,4,4
1478659227149160448,2022-01-05 09:26:46,"Paris Saint-Germain sukses menggaet Lionel Messi. Selanjutnya, Les Parisiens membidik winger Barcelona, Ousmane Dembele.  https://t.co/5WBmkpptMk",2,1,3,0,2022-01-05,9,Wednesday,3,5,1
1478659225798819846,2022-01-05 09:26:46,"Manajer Chelsea, Thomas Tuchel, memuji Antonio Conte jelang menghadapi Tottenham Hotspur. Conte sudah membuktikan hal tersebut bersama The Blues sebelumnya.  https://t.co/PJPr3wJFkl",3,0,0,0,2022-01-05,9,Wednesday,3,3,0
1478658949150871552,2022-01-05 09:25:40,"Benjamin Mendy baru saja dipindahkan ke Strangeways, salah satu penjara dengan sejarah kematian di Inggris. Joey Barton dan Reynhard Sinaga adalah alumninya.  https://t.co/xRoJarWcJm",1,0,0,0,2022-01-05,9,Wednesday,3,1,0
1478658623249301504,2022-01-05 09:24:22,Bakso enak tak pernah habis dibicarakan. Ini beberapa penjual bakso yang terkenal dengan kelezatan menunya:  https://t.co/6rHY8oETq0,7,1,0,0,2022-01-05,9,Wednesday,3,7,1
1478658269820465152,2022-01-05 09:22:58,pengacara Marissya Icha menyebut Medina Zein telah ditetapkan sebagai tersangka atas dugaan pencemaran nama baik. https://t.co/5M15E1Lnsd,2,0,1,0,2022-01-05,9,Wednesday,3,3,0
1478658267765116935,2022-01-05 09:22:57,Presiden Jokowi mengunjungi kawasan Aloon-aloon Kota Semarang hari ini. Sudah tahu sejarah aloon-aloon yang pernah hilang itu? https://t.co/YLB15u2fxj,10,1,0,0,2022-01-05,9,Wednesday,3,10,1
1478657912121839616,2022-01-05 09:21:33,"Indonesia melaporkan 404 kasus COVID-19 pada Rabu (5/1/2022). Total kasus positif menjadi 4.264.136, sembuh 4.115.149, dan meninggal 144.109. https://t.co/c7ayCIe8LZ",7,0,6,3,2022-01-05,9,Wednesday,3,13,3
1478657405324042244,2022-01-05 09:19:32,"Rupanya destinasi impian Kinan itu bisa kamu kunjungi dengan mengeluarkan kocek Rp 7 jutaan. Yang menarik lagi, Turki ternyata lagi free visa! https://t.co/2VQXLwFSod",45,2,14,13,2022-01-05,9,Wednesday,3,59,15
1478656897309978632,2022-01-05 09:17:31,"Sopir truk menangkap pencuri HP di kolong Tol Kampung Rambutan, Jakarta Timur. Sopir truk menyerahkan pencuri itu ke polisi. Simak ceritanya: https://t.co/N10aSkCygP",2,0,1,0,2022-01-05,9,Wednesday,3,3,0
1478656876883623939,2022-01-05 09:17:26,"Usai Omicron, kini muncul 'varian IHU' atau B.1.640.2. Dalam penelitian, para ilmuwan mengungkap terduga pasien nol varian ini beserta gejala yang dialaminya. https://t.co/z32Y840b17",2,2,6,3,2022-01-05,9,Wednesday,3,8,5
1478656606221000708,2022-01-05 09:16:21,Mau tahu bakal seperti apa teknologi Samsung Electronics di 2022. Mereka mengembangkan teknologi canggih dan ramah lingkungan ke semua perangkatnya. https://t.co/vOAhwfZKBv,2,0,2,0,2022-01-05,9,Wednesday,3,4,0
1478656584620331016,2022-01-05 09:16:16,"Dibandingkan operator seluler lainnya, Indosat Ooredoo Hutchison punya 15 Komisaris. Apa alasan Indosat Ooredoo Hutchison dengan 15 komisaris? https://t.co/5FZeXaYVbL",2,0,5,0,2022-01-05,9,Wednesday,3,7,0
1478656078296539141,2022-01-05 09:14:15,Medina Zein ditetapkan jadi tersangka atas kasus dugaan pencemaran nama baik yang diadukan Marrisya Icha. #MedinaZein  https://t.co/wrcCo8qWqr,2,0,2,0,2022-01-05,9,Wednesday,3,4,0
1478655566314721280,2022-01-05 09:12:13,Mahkamah Agung (MA) tidak menerima peninjauan kembali (PK) yang diajukan Djoko Tjandra di kasus korupsi Rp 546 miliar terkait cessie Bank Bali. https://t.co/ImHsCJlidX,9,3,3,0,2022-01-05,9,Wednesday,3,12,3
1478655344784154624,2022-01-05 09:11:20,"Ditemukan tanpa identitas, dua anak korban tabrakan yang dibuang tiga anggota TNI akhirnya dimakamkan tanpa nama. Seusai identifikasi, makam dipindahkan. https://t.co/wUyXb3In4W",7,0,2,1,2022-01-05,9,Wednesday,3,9,1
1478655322520760321,2022-01-05 09:11:15,"Hingga saat ini, tagar #TangkapFerdinand masih ramai di media sosial terutama Twitter. Beberapa tokoh pun mulai menyuarakan kecamannya pada Ferdinand. https://t.co/GON5xMHENm",45,11,16,1,2022-01-05,9,Wednesday,3,61,12
1478655049370935296,2022-01-05 09:10:10,"Memasuki tahun 2022, muncul banyak prediksi tren makanan, termasuk tren makanan sehat. Ini makanan dan pola makan sehat yang bakal hits:  https://t.co/ZD4zB4IBh4",2,0,3,0,2022-01-05,9,Wednesday,3,5,0
1478655032279109636,2022-01-05 09:10:06,"Minum susu memang nikmat, namun usahakan tidak mengonsumsi susu berbarengan dengan makanan ini:  https://t.co/V2oGppzfN9",12,0,3,1,2022-01-05,9,Wednesday,3,15,1
1478654502391717897,2022-01-05 09:08:00,Asus memamerkan deretan laptop gaming terbaru di seri ROG. Berikut tiga di antaranya yang mencuri perhatian:  https://t.co/h6SdiUgaBg,3,0,1,0,2022-01-05,9,Wednesday,3,4,0
1478654477632786436,2022-01-05 09:07:54,"Pemeran film Ziarah, Ponco Sutiyem atau Mbah Ponco meninggal dunia. Mbah Ponco meninggal karena sakit stroke. https://t.co/vk5VK7Gzwj",3,1,1,0,2022-01-05,9,Wednesday,3,4,1
1478653137082896390,2022-01-05 09:02:34,"Manajer Chelsea, Thomas Tuchel, memuji Antonio Conte jelang menghadapi Tottenham Hotspur. Conte sudah membuktikan hal tersebut bersama The Blues sebelumnya. https://t.co/sNgq9gHE5b",4,0,0,0,2022-01-05,9,Wednesday,3,4,0
1478652896333946885,2022-01-05 09:01:37,Sebuah kapal pesiar Spectrum of the Seas diperintahkan kembali ke terminal kapal pesiar di Hong Kong untuk mengantisipasi merebaknya varian Omicron. https://t.co/WQdcrOH2YQ,2,0,1,0,2022-01-05,9,Wednesday,3,3,0
1478652865824665600,2022-01-05 09:01:29,"""Almarhumah ini tentu doanya sangat diijabah. Putra-putrinya sangat hebat. Ibu yang hebat dalam mendoakan anaknya,"" ujar JK. https://t.co/Oztcaxc69t",6,0,1,0,2022-01-05,9,Wednesday,3,7,0
1478652496683753472,2022-01-05 09:00:01,"Yuk! Ulas Kilas Balik Peristiwa Penting Sepanjang 2021 Bareng detikcom
https://t.co/TfZyprgmiQ",1,0,1,0,2022-01-05,9,Wednesday,3,2,0
1478652250146938881,2022-01-05 08:59:03,"Doddy Sudrajat, ayah mendiang Vanessa Angel, ngaku difitnah. Ia menyebut ada yang menuding jika dirinya sudah mengantongi uang Rp 500 juta dari asuransi Vanessa Angel. https://t.co/WPYWQMvjGK",66,19,4,1,2022-01-05,8,Wednesday,3,70,20
1478652002615898112,2022-01-05 08:58:04,"Pembelajaran tatap muka (PTM) 100 persen di SD Negeri Grogol Selatan 01 Kebayoran Lama, Jakarta Selatan sebabkan kemacetan dan kerumunan saat jam pulang sekolah.  https://t.co/TVXEIkyeT8",2,0,1,0,2022-01-05,8,Wednesday,3,3,0
1478651223679156228,2022-01-05 08:54:58,"Oppo Find X5 diprediksi akan rilis dalam beberapa bulan kemudian. Sebelum diluncurkan, spesifikasi dan harga Oppo Find X5 sudah bocor duluan. https://t.co/mgKfJ9fNf8",3,0,1,0,2022-01-05,8,Wednesday,3,4,0
1478650712531816450,2022-01-05 08:52:56,"Dengan diumumkan Indosat Ooredoo Hutchison, perusahaan juga mengungkapkan susunan manajemen operator seluler terbesar kedua di Indonesia. Ini susunannya:  https://t.co/TPBkKqHt3S",9,1,4,3,2022-01-05,8,Wednesday,3,13,4
1478650465411907585,2022-01-05 08:51:57,Furi Harun memiliki 349 boneka arwah dengan beragam bentuk dan asalnya. Seperti apa ya? Berikut koleksi boneka arwah Furi Harun: https://t.co/s0JCY2WKlG,13,1,2,0,2022-01-05,8,Wednesday,3,15,1
1478649433063452674,2022-01-05 08:47:51,Ahmad Dhani ngaku ciptakan lagu Kangen saat sedang kasmaran dan kangen berat dengan seseorang. https://t.co/nDOL9J9UdM,8,1,3,0,2022-01-05,8,Wednesday,3,11,1
1478649141576314884,2022-01-05 08:46:41,Romelu Lukaku merasa wawancara kontroversialnya beberapa waktu lalu disalahpahami. Striker Chelsea itu menjelaskan maksud sebenarnya dari wawancaranya itu.  https://t.co/EkrrGrWbNg,2,0,0,0,2022-01-05,8,Wednesday,3,2,0
1478648879402958851,2022-01-05 08:45:39,"Massa driver Ojol menggelar aksi unjuk rasa di Patung Kuda hari ini. Massa Ojol meminta Menhub Budi Karya Sumadi, untuk turun dari jabatannya. https://t.co/lgQTycgUCB",4,0,2,0,2022-01-05,8,Wednesday,3,6,0
1478648861656768513,2022-01-05 08:45:35,Almira Andani tak pernah pusing dengan persaingan penyanyi cantik bersuara bagus. Ia yakin semua ada jalan. https://t.co/3SR1xPEuMj,5,0,1,0,2022-01-05,8,Wednesday,3,6,0
1478648567996768256,2022-01-05 08:44:25,"Gelaran Piala AFF 2020 sudah usai. Bek Indonesia, Asnawi Mangkualam Bahar masuk dalam daftar 10 pemain termahal di Asia Tenggara usai turnamen.  https://t.co/mxabs7gzzJ",7,0,2,0,2022-01-05,8,Wednesday,3,9,0
1478648311359942659,2022-01-05 08:43:24,Pemerintah Republik Kosovo resmi melarang penambangan bitcoin di negaranya. Hal ini dilakukan demi menekan krisis energi. https://t.co/Xm45YM0ZsX,7,2,5,0,2022-01-05,8,Wednesday,3,12,2
1478648291604766722,2022-01-05 08:43:19,Liga 1 2021/2022 lanjut lagi hari ini. Persebaya Surabaya melawan Bali Unted menjadi salah satu sajiannya malam nanti.  https://t.co/q6c3fVsTks,0,0,1,0,2022-01-05,8,Wednesday,3,1,0
1478648061484224512,2022-01-05 08:42:24,Ferran Torres baru saja diperkenalkan sebagai pemain baru Barcelona. Tapi rumornya Barca sudah menawarkannya balik ke Manchester City sampai musim ini habis.  https://t.co/pXaHeHtyLO,0,0,0,0,2022-01-05,8,Wednesday,3,0,0
1478648026050834438,2022-01-05 08:42:16,Timnas Indonesia akan memanfaatkan FIFA Matchday untuk menggelar laga uji coba di Bali. Sejauh ini PSSI sudah membidik 2 negara yakni Bangladesh dan Brunei.  https://t.co/TJ6aB2UL6w,3,0,1,0,2022-01-05,8,Wednesday,3,4,0
1478647766566023173,2022-01-05 08:41:14,"Dalam suasana amarah, kadang kata-kata tidak terkendali. Salah satunya suami ada yang khilaf teriak mentalak istrinya. Tapi bisakah diralat saat itu juga? #detiksAdvocate https://t.co/YVzN3K2ZDg",4,0,2,0,2022-01-05,8,Wednesday,3,6,0
1478647754595483651,2022-01-05 08:41:11,Menggoreng ikan mungil seperti ikan selar perlu trik tersendiri. Agar hasil gorengan daging ikan tidak hancur berantakan tetapi garing renyah. Ini tipsnya:  https://t.co/xF2LeU3qbw,4,0,1,0,2022-01-05,8,Wednesday,3,5,0
1478647424830910467,2022-01-05 08:39:52,Liga Italia kembali bergulir usai libur akhir tahun. Tersaji laga sengit antara AC Milan vs AS Roma dan Juventus vs Napoli. Berikut jadwal Serie A pekan ke-20.  https://t.co/0jUaL6AL1V,3,0,0,0,2022-01-05,8,Wednesday,3,3,0
1478647139278495745,2022-01-05 08:38:44,"AC Milan diminta untuk mendatangkan penyerang baru. Striker Liverpool, Divock Origi, yang didesak untuk digaet Rossoneri.  https://t.co/qvygEClsZL",2,1,1,0,2022-01-05,8,Wednesday,3,3,1
1478646595587657728,2022-01-05 08:36:34,"Massa driver ojol bergerak menuju Istana Negara di Jalan Medan Merdeka Utara, Jakarta. Namun massa tertahan kawat besi di Jalan Medan Merdeka Barat. https://t.co/h0hx3rcZSH",11,3,1,1,2022-01-05,8,Wednesday,3,12,4
1478645786393165833,2022-01-05 08:33:22,"Tuntutan 4,5 tahun penjara untuk Gaga Muhammad ramai disorot karena dinilai terlalu ringan. Komisi Kejaksaan berpendapat begini. https://t.co/jsUuhHE706",0,0,1,1,2022-01-05,8,Wednesday,3,1,1
1478645142143782914,2022-01-05 08:30:48,#Terpopuler Sebuah rumah mewah di Tangsel menjadi tempat vandalisme. Pagar rumah tersebut nampak dicoret. Seperti apa? https://t.co/jCjy4mhTDv,7,0,5,1,2022-01-05,8,Wednesday,3,12,1
1478645123634315269,2022-01-05 08:30:44,Warganet diminta tidak merespons penjualan virtual Alun-alun Yogya itu secara berlebihan. https://t.co/Q4SJwxbHkX,0,0,0,0,2022-01-05,8,Wednesday,3,0,0
1478644879450329092,2022-01-05 08:29:45,"Fuji kembali dijodohkan dengan seorang pria. Dikabarkan sedang dekat dengan Thariq Halilintar, Fuji kini dijodohkan dengan Austin Alexander. Ini sosoknya:  https://t.co/7J2nPsVEbP",2,1,1,1,2022-01-05,8,Wednesday,3,3,2
1478644225784827907,2022-01-05 08:27:09,"Menurut BMKG, adanya fase bulan baru bersamaan dengan masa Perigee menyebabkan peningkatan pasang air laut. https://t.co/Eki6oMEaXi",2,0,3,0,2022-01-05,8,Wednesday,3,5,0
1478643973661016066,2022-01-05 08:26:09,"Kim Mi Soo meninggal dunia di usia 31 tahun. Pihak manajemen akhirnya buka suara, dan membenarkan kabar duka tersebut. #KimMiSoo https://t.co/u9Rv48Z3xl",29,1,5,2,2022-01-05,8,Wednesday,3,34,3
1478643709621293057,2022-01-05 08:25:06,Heboh serial Layangan Putus yang membuat emak-emak jadi semakin posesif. Seperti curhat suami ini yang diikuti kemana pun berada. Gimana tuh ceritanya? https://t.co/i22VH8FWOs,25,4,8,6,2022-01-05,8,Wednesday,3,33,10
1478643236847689735,2022-01-05 08:23:14,Eks Finalis Masterchef bunuh ART asal Indonesia terancam hukuman mati. Ini sederet faktanya. https://t.co/YC7IJCDUjJ,5,0,2,0,2022-01-05,8,Wednesday,3,7,0
1478643203482038274,2022-01-05 08:23:06,Gunung Semeru kembali luncurkan awan panas guguran sekitar pukul 08.35 WIB. Luncuran awan panas tersebut sejauh 5 kilometer. https://t.co/cOgebTKTAC,197,2,37,5,2022-01-05,8,Wednesday,3,234,7
1478642687712636928,2022-01-05 08:21:03,"PPKM Jawa-Bali diperpanjang hingga 17 Januari 2022. Menteri Dalam Negeri Tito Karnavian menerbitkan Instruksi Mendagri nomor 1 tahun 2022 tentang PPKM Level 3, 2 dan 1 di Jawa-Bali. https://t.co/wtJN4tCaIn",2,0,1,0,2022-01-05,8,Wednesday,3,3,0
1478642083812589570,2022-01-05 08:18:39,"Rayyanza Malik Ahmad, anak kedua pasangan Raffi Ahmad dan Nagita Slavina, disunat saat usianya belum genap 1 tahun. Apa sih manfaat sunat saat bayi? https://t.co/JFruVYxCCw",28,9,9,1,2022-01-05,8,Wednesday,3,37,10
1478641325679562753,2022-01-05 08:15:38,"Rain mengaku ditolak berkali-kali sebelum menikah dengan Kim Tae Hee. Namun, pemain drama Korea Ghost Doctor itu tidak pantang menyerah. Gimana kisahnya? https://t.co/JtXgDokW1n",20,2,4,2,2022-01-05,8,Wednesday,3,24,4
1478640514815696896,2022-01-05 08:12:25,"Untuk tambah nutrisi, sop serenek khas Magelang ini cocok sebagai piihan. Isiannya daging sapi, kacang merah dan wortel. Rasanya gurih mantap. Ini resepnya:  https://t.co/kPAEB8tYDY",5,3,1,0,2022-01-05,8,Wednesday,3,6,3
1478640222791512066,2022-01-05 08:11:15,"Ibunda Chairul Tanjung, Halimah meninggal dunia pagi tadi. Saat ini rumah duka dipenuhi karangan bunga dari para tokoh. https://t.co/olDcZsO3x4",6,0,1,0,2022-01-05,8,Wednesday,3,7,0
1478639725456019460,2022-01-05 08:09:17,Aturan masa karantina untuk pelaku perjalanan luar negeri dipangkas menjadi 10 hari dan 7 hari. Simak daftar dan cara pesan hotelnya ya: https://t.co/s0c62vKiGL,10,2,3,1,2022-01-05,8,Wednesday,3,13,3
1478638953637023746,2022-01-05 08:06:12,"Bekerja di restoran ayahnya sejak usia 16 tahun, wanita ini mendulang kesuksesan. Menjalani sekolah medis kini justru berhasil jadi pebisnis makanan cepat saji. https://t.co/08auGdaXaR",2,1,1,0,2022-01-05,8,Wednesday,3,3,1
1478638934431313922,2022-01-05 08:06:08,Aktris Kim Mi Soo meniggal dunia. Hingga kini penyebab kematiannya masih belum diketahui. #KimMiSoo  https://t.co/E4e3kKA6JA,12,0,2,0,2022-01-05,8,Wednesday,3,14,0
1478637930973442048,2022-01-05 08:02:09,Kejadian mengenaskan menimpa seorang wanita dan bayinya yang berusia tiga bulan. Mereka diinjak-injak oleh seekor gajah. Tragis! https://t.co/8pDqR19yHD,6,0,4,1,2022-01-05,8,Wednesday,3,10,1
1478636908821594114,2022-01-05 07:58:05,"Ada coffee shop di Kelapa Gading, Jakarta Utara, yang menawarkan konsep ramah keluarga. Menunya menyasar orang dewasa hingga anak-anak. Cobain di sini:  https://t.co/yedkSPwji0",3,0,3,0,2022-01-05,7,Wednesday,3,6,0
1478636890349838339,2022-01-05 07:58:01,MA menolak judicial review yang diajukan pengusaha PT Kreasi Mandiri Bahari dkk soal aturan larangan ekspor lobster. Pengusaha itu dibela Yusril Ihza Mahendra. https://t.co/CNd13Lfk5Z,4,0,1,1,2022-01-05,7,Wednesday,3,5,1
1478636095176941568,2022-01-05 07:54:51,"Mengawali awal tahun, banyak resolusi hidup sehat yang dijalankan orang-orang. Bisa mulai dari mencoba makanan enak di beberapa katering sehat ini: https://t.co/YoJRHtc6w2",3,1,0,0,2022-01-05,7,Wednesday,3,3,1
1478636074352222208,2022-01-05 07:54:46,"Salah satu hakim anggota Pengadilan Tipikor Jakarta, Mulyono Dwi Purwanto memiliki pendapat berbeda atau dissenting opinion dalam sidang putusan kasus korupsi PT ASABRI terhadap 4 terdakwa.  https://t.co/aspA4PoreU",4,0,1,0,2022-01-05,7,Wednesday,3,5,0
1478635763151560706,2022-01-05 07:53:32,Luncuran awan panas sejauh 5 KM dan mengarah ke wilayah Desa Besuk Kobokan. #Semeru https://t.co/9LiVh3QmNX,5,0,0,0,2022-01-05,7,Wednesday,3,5,0
1478635520670511110,2022-01-05 07:52:34,"Jusuf Kalla melayat ke rumah duka Ibunda Chairul Tanjung, Halimah. JK datang bersama istrinya Mufidah Jusuf Kalla. https://t.co/SQGDlVuv2K",5,1,2,0,2022-01-05,7,Wednesday,3,7,1
1478635503360565255,2022-01-05 07:52:30,"Suhud Alynudin menggantikan Anggota Fraksi PKS, Mohammad Arifin yang meninggal dunia karena sakit. https://t.co/D4q8jxYu92",3,0,1,0,2022-01-05,7,Wednesday,3,4,0
1478635003135340545,2022-01-05 07:50:31,"Presiden Jokowi menetapkan Peraturan Presiden soal posisi Wamendagri. Nantinya, Mendagri akan dibantu oleh Wamendagri. https://t.co/EqHOdkbp0f",2,2,1,0,2022-01-05,7,Wednesday,3,3,2
1478634986689413120,2022-01-05 07:50:27,SBY mengaku mengenal baik sosok Ibu Halimah. https://t.co/vk3JBBncgz,3,0,1,0,2022-01-05,7,Wednesday,3,4,0
1478634743092682753,2022-01-05 07:49:29,Sosok pria pelanggan prostitusi artis Cassandra Angelie hingga kini tidak dikenakan jerat pidana. Begini penjelasan polisi: https://t.co/xF7cFoOqW9,22,12,2,5,2022-01-05,7,Wednesday,3,24,17
1478633733406265344,2022-01-05 07:45:28,Beasiswa Astra dibuka untuk alumnus dan siswa SMA/SMK/MA sederajat semua jurusan hingga 6 Februari 2022. Ini syarat dan ketentuannya. Buruan daftar! Via: detikedu https://t.co/rNY0ZMtHno,6,0,2,0,2022-01-05,7,Wednesday,3,8,0
1478633731678261251,2022-01-05 07:45:27,Sebuah video yang menampilkan aksi pencurian dengan modus pecah kaca mobil di Depok viral di media sosial. Polisi turun tangan. https://t.co/9m3PIemU8J,0,0,1,0,2022-01-05,7,Wednesday,3,1,0
1478633225887043586,2022-01-05 07:43:27,Cuitan Politisi Ferdinand Hutahaean di akun Twitternya menjadi sorotan publik. Cuitan itu membuat #TangkapFerdinand menjadi trending topik. Ferdinand lantas membuat klarifikasi. https://t.co/9K5NC3cUrl,3,1,3,0,2022-01-05,7,Wednesday,3,6,1
1478632461714305024,2022-01-05 07:40:25,Ferdinand Hutahaean dipolisikan ormas BMI Sulawesi Selatan karena cuitan 'Allahmu lemah'. Apa kata Ferdinand? https://t.co/QKIMobmuGO,19,11,5,1,2022-01-05,7,Wednesday,3,24,12
1478632214757785601,2022-01-05 07:39:26,Pengumuman! Raffi Ahmad dan Nagita Slavina melalui RANS Entertainment membuka lowongan kerja untuk posisi Junior Combine Payroll. Gajinya segini: https://t.co/AMgfvTEgXz,213,46,86,22,2022-01-05,7,Wednesday,3,299,68
1478631806404644864,2022-01-05 07:37:48,"Mereka tampak membawa beberapa atribut mulai dari bendera hingga spanduk, salah satunya bertuliskan 'Profesi Ojek Online Bukan Anak Haram'. https://t.co/9jYcKfc5Xf",14,0,6,1,2022-01-05,7,Wednesday,3,20,1
1478631719163023362,2022-01-05 07:37:28,Sebuah video yang menunjukkan aksi sejumlah pemuda menghadang dan melempar batu ke mobil di jalan tol Medan viral. Bagaimana faktanya? https://t.co/sZBGc3Th5G,1,1,0,0,2022-01-05,7,Wednesday,3,1,1
1478631702050258944,2022-01-05 07:37:24,Semula Eijkman menargetkan uji praklinis selama tiga bulan pertengahan 2021. Kini mungkin mundur hingga ke awal 2023. Apa sebabnya? https://t.co/U6BI2BeYWQ,3,2,5,1,2022-01-05,7,Wednesday,3,8,3
1478631213799727108,2022-01-05 07:35:27,Syakir Daulay beri penjelasan bijaksana setelah video Zikri Daulay ciuman dengan Ayu Aulia viral. Syakir menganggap ini adalah ujian. https://t.co/4VEvUqiVvp,13,28,5,7,2022-01-05,7,Wednesday,3,18,35
1478629651819941888,2022-01-05 07:29:15,"Rayyanza Malik Ahmad sudah selesai jalankan sunat kemarin. Sebelum sunat, Rayyanza sempat mendapatkan kunjungan dari Menteri Luar Negeri Retno Marsudi. https://t.co/49yj29XFaP",18,3,3,1,2022-01-05,7,Wednesday,3,21,4
1478629627975372802,2022-01-05 07:29:09,Ma'ruf menyebut peran seorang ibu yang memotivasi dan mendoakan sangat berarti untuk kesuksesan anak. https://t.co/fe97HnuXIK,12,0,2,0,2022-01-05,7,Wednesday,3,14,0
1478629106690539524,2022-01-05 07:27:05,Sebuah video menampilkan warga menemukan gundukan makam di pinggir jalan viral. Belum diketahui makam siapa itu atau benarkah itu sebuah makam? https://t.co/DI5ogqUFAe,4,0,2,0,2022-01-05,7,Wednesday,3,6,0
1478628873059381249,2022-01-05 07:26:09,Kemendikbudristek bersama dengan LPDP Kemenkeu memperluas ruang lingkup dan sasaran program LPDP. Rencananya sosialisasi akan dilakukan awal tahun 2022. Via: detikedu https://t.co/dxfOIa6J3T,18,0,3,0,2022-01-05,7,Wednesday,3,21,0
1478628860006707202,2022-01-05 07:26:06,"Seorang pria berinisial HS (33), dikeroyok dan dianiya 2 orang. Kini para pelaku telah diamankan. https://t.co/3AN0eYIWid",1,0,1,0,2022-01-05,7,Wednesday,3,2,0
1478628113898741764,2022-01-05 07:23:08,"Perusahaan otomotif raksasa asal AS, General Motors (GM), telah kehilangan gelar sebagai penjual mobil top Amerika. Siapa gantinya? https://t.co/EYudG9AQ8A",4,0,2,1,2022-01-05,7,Wednesday,3,6,1
1478627196201746433,2022-01-05 07:19:29,"Kemenkes melaporkan gejala terbanyak pasien Omicron RI adalah batuk dan pilek. Mirip-mirip dengan flu biasa, bagaimana membedakannya dengan infeksi Omicron? https://t.co/4yhRTrzIkj",7,3,5,2,2022-01-05,7,Wednesday,3,12,5
1478626726691446788,2022-01-05 07:17:37,Tim AMPHURI yang tengah umrah mengungkapkan adanya kemudahan regulasi dari Arab Saudi. Mulai dari masa karantina hingga akses masuk masjid. https://t.co/yklDAcZlLB,7,0,1,0,2022-01-05,7,Wednesday,3,8,0
1478626706407804928,2022-01-05 07:17:33,Sejumlah hewan modern diketahui merupakan keturunan dari hewan prasejarah. Hewan apa saja ya? Via: detikedu https://t.co/ktD4BE2GjL,3,2,1,0,2022-01-05,7,Wednesday,3,4,2
1478626455890403330,2022-01-05 07:16:33,Penyelenggaraan vaksinasi itu diperuntukkan bagi anak anggota Dewan dan anak seluruh pegawai di lingkungan kesekretariatan DPR. https://t.co/gFUYbyl2xW,4,0,2,0,2022-01-05,7,Wednesday,3,6,0
1478625983238488068,2022-01-05 07:14:40,"Kabar duka datang dari keluarga Chairul Tanjung yang merupakan Chairman dari CT Corp. Ibunda Chairul Tanjung, Halimah, tutup usia pada Rabu (5/1) pukul 08.52 WIB. https://t.co/kuvvsWSYGc",15,4,4,0,2022-01-05,7,Wednesday,3,19,4
1478625966419329025,2022-01-05 07:14:36,Pemerintah sedang menggodok aturan penghapusan kelas BPJS Kesehatan jadi kelas rawat inap standar (KRIS) jaminan kesehatan nasional (JKN). https://t.co/CBF5TpFZmu,8,0,2,0,2022-01-05,7,Wednesday,3,10,0
1478625237625458689,2022-01-05 07:11:42,"Ahmad Sahroni digadang-gadang jadi Gubernur DKI pengganti Anies. Tapi sebetulnya, Sahroni punya cita-cita menjadi Presiden RI. https://t.co/rTmfxw9sam",9,3,2,1,2022-01-05,7,Wednesday,3,11,4
1478624764860243971,2022-01-05 07:09:50,"Sidang tuntutan Gaga Muhammad terkait kasus laka lantas yang membuat mendiang Laura Anna lumpuh digelar Selasa (4/1) di Pengadilan Negeri Jakarta Timur. Dirangkum 20Detik, berikut serba-serbinya: https://t.co/0QuqqJrtTg https://t.co/AIQ1qPNcUF",3,0,0,1,2022-01-05,7,Wednesday,3,3,1
1478623439808344066,2022-01-05 07:04:34,Rencana penghapusan kelas BPJS Kesehatan jadi kelas rawat inap standar (KRIS) JKN belum dilakukan bertahap. Berapa iurannya? https://t.co/XmtIHduMza,4,0,1,0,2022-01-05,7,Wednesday,3,5,0
1478623209285054465,2022-01-05 07:03:39,"Beredar informasi palsu soal biaya pembuatan Smart SIM secara online yang tarifnya berkisar Rp 400 ribu sampai Rp 1,6 juta. Padahal biaya pembuatan SIM tak semahal itu!  https://t.co/4cmuPanxzW",22,0,2,2,2022-01-05,7,Wednesday,3,24,2
1478623164330614786,2022-01-05 07:03:28,Salju tebal yang menutup jalan menimbulkan kekacauan di wilayah Washington. Ratusan pengemudi pun terjebak di jalan raya.   https://t.co/hyGlevyF1v,2,0,0,0,2022-01-05,7,Wednesday,3,2,0
1478623163034517505,2022-01-05 07:03:28,Siapa yang akan jadi pemenang dan pecundang di era digital? Akankah adaptasi baru menjadi kebiasaan baru di ekonomi digital atau ditinggalkan karena telah ada vaksin? https://t.co/qsJljBIesl,3,0,0,0,2022-01-05,7,Wednesday,3,3,0
1478622887707910144,2022-01-05 07:02:22,"BlackBerry resmi tumbang. Pada 4 Januari kemarin, OS pada Blackberry disuntik mati, atau dengan kata lain hp BB sudah tidak berfungsi lagi.  https://t.co/f40y74CzfG",12,4,5,2,2022-01-05,7,Wednesday,3,17,6
1478622870058278912,2022-01-05 07:02:18,Salju tebal yang menutup jalan menimbulkan kekacauan di wilayah Washington. Ratusan pengemudi pun terjebak di jalan raya.  https://t.co/4j39MGzdhl,1,0,1,0,2022-01-05,7,Wednesday,3,2,0
1478622538058158080,2022-01-05 07:00:59,Produsen otomotif Yamaha sudah memiliki beberapa pilihan sepeda motor roda tiga andalannya.  https://t.co/le2Bu4kQQL,0,0,0,0,2022-01-05,7,Wednesday,3,0,0
1478622521855516672,2022-01-05 07:00:55,Narji menegaskan permintaan maafnya bukan intervensi. Begini katanya: https://t.co/uKax0OjZE1,3,10,1,0,2022-01-05,7,Wednesday,3,4,10
1478622270629335041,2022-01-05 06:59:55,Honda disinyalir sudah memulai perburuan rider pebalap top. Joan Mir atau Fabio Quartararo yang tepat?  https://t.co/OBlQ20jdzU,5,0,0,0,2022-01-05,6,Wednesday,3,5,0
1478622251792674816,2022-01-05 06:59:50,"PPKM Jawa-Bali diperpanjang hingga 17 Januari 2022. Menteri Dalam Negeri Tito Karnavian menerbitkan Instruksi Mendagri nomor 1 tahun 2022 tentang PPKM Level 3, 2 dan 1 di Jawa-Bali.  https://t.co/jbEwHqEpxS",2,0,0,0,2022-01-05,6,Wednesday,3,2,0
1478622019679928321,2022-01-05 06:58:55,"Masih dikaji, Dirgakkum Korlantas Polri Brigjen Pol Aan Suhanan menyebut syarat rekaman dashcam bisa dijadikan bukti tilang pelanggaran lalu lintas.  https://t.co/q8CxgiJti5",5,0,0,0,2022-01-05,6,Wednesday,3,5,0
1478622018497093632,2022-01-05 06:58:55,Boris Johnson menyatakan negaranya akan mampu menghadapi lonjakan kasus Corona (COVID-19) tanpa menutup aktivitas perekonomian. https://t.co/kxwDBxoYfT,2,0,2,1,2022-01-05,6,Wednesday,3,4,1
1478621761826660355,2022-01-05 06:57:54,Dalam ajang CES 2022 Samsung meluncurkan sebuah remote TV yang dapat mengisi daya dengan menarik gelombang radio.  https://t.co/irDd42fx7M,0,0,0,0,2022-01-05,6,Wednesday,3,0,0
1478621502002114562,2022-01-05 06:56:52,Gugatan atas cover album Nevermind milik Nirvana yang diajukan Spencer Elden ditolak. Ini alasan gugatan itu ditolak:  https://t.co/J9xnhI8k6t,1,1,0,1,2022-01-05,6,Wednesday,3,1,2
1478621489398222850,2022-01-05 06:56:49,"Harga Toyota Avanza Januari 2022 mengalami kenaikan hingga Rp 30 jutaan. Tapi tenang, sebab Avanza masih bisa dikredit dengan angsuran Rp 3 jutaan per bulan.  https://t.co/WouYMB1QXY",1,0,0,0,2022-01-05,6,Wednesday,3,1,0
1478621205468958721,2022-01-05 06:55:41,"Pabrikan Italia, Aprilia, mencoba menantang dominasi skutik adventure Honda ADV150, dengan memperkenalkan Aprilia SR GT. Yuk lihat lebih dekat wujudnya.  https://t.co/a01xLQ75tE",2,1,1,0,2022-01-05,6,Wednesday,3,3,1
1478620942817452035,2022-01-05 06:54:38,Harga emas Antam hari ini naik Rp 5.000 per gram. Mau beli emas? Jadi segini harganya: https://t.co/7RADXOfEaf,5,0,1,0,2022-01-05,6,Wednesday,3,6,0
1478620922349293569,2022-01-05 06:54:33,"Rekaman dashcam dari mobil pribadi itu mulai digunakan sebagai bukti pelanggaran lalu lintas, seperti di Malaysia. Bagaimana dengan Indonesia?  https://t.co/b7SrMQOq8I",3,1,0,0,2022-01-05,6,Wednesday,3,3,1
1478620682682613763,2022-01-05 06:53:36,"Tahun baru, semangat baru! Suami ingin alih profesi jadi pengusaha, tapi dananya belum ada? Jangan khawatir, detikcom bantu modalin! https://t.co/lzcNwxZdye",3,3,4,0,2022-01-05,6,Wednesday,3,7,3
1478620424162496514,2022-01-05 06:52:35,"Dengan aplikasi pesan BlackBerry Mesenger (BBM), BB pernah menjadi primadona untuk beberapa tahun di seluruh dunia. Bagaimana kabarnya kini? https://t.co/O5ZmJD4cWb",24,0,8,3,2022-01-05,6,Wednesday,3,32,3
1478619937677746176,2022-01-05 06:50:39,Penumpang pesawat yang tingginya lebih dari 2 meter ini dapat upgrade bangku ke kelas satu karena dibangku ekonomi dia tidak muat. Dia pun merasa lega. https://t.co/qMN1ApjVmL,7,5,1,1,2022-01-05,6,Wednesday,3,8,6
1478619459019489283,2022-01-05 06:48:45,Zikri Daulay meminta maaf lewat Instagram Stories-nya usai heboh video dirinya berciuman dengan Ayu Aulia. Ia menyebut dirinya bukan malaikat. https://t.co/rzLNbOuuCH,5,0,1,2,2022-01-05,6,Wednesday,3,6,2
1478619440883421186,2022-01-05 06:48:40,Presiden Jokowi meminta RUU TPKS segera disahkan. KSP ungkap alasan Jokowi beri perhatian khusus. https://t.co/6GK1BON7zQ,8,1,1,0,2022-01-05,6,Wednesday,3,9,1
1478619004755488768,2022-01-05 06:46:56,"""Jangan ada lagi dispensasi, dispensasi. Apalagi yang bayar-bayar itu kejadian lagi,"" kata Jokowi. https://t.co/1MsCZ7TblH",12,5,5,1,2022-01-05,6,Wednesday,3,17,6
1478618699296878592,2022-01-05 06:45:43,Jubir tim komunikasi IKN mengklaim kunker ke Kazakhstan itu sudah dipersiapkan sebelum Jokowi melarang ke luar negeri. Simak penjelasannya: https://t.co/zkm6MeOvAU,7,3,0,0,2022-01-05,6,Wednesday,3,7,3
1478618674474926081,2022-01-05 06:45:38,Indosat Ooreodo dan Hutchison 3 Indonesia resmi jadi Indosat Ooreodo Hutchison. Ini dampak hasil merger Indosat Ooredoo Hutchison ke pelanggan:  https://t.co/HeoahbFBnz,16,0,2,0,2022-01-05,6,Wednesday,3,18,0
1478618149129969664,2022-01-05 06:43:32,PNS kecamatan digaji berdasarkan jenjang pendidikannya sesuai ketentuan pangkat dan golongan PNS. Berapa penghasilan yang mereka bisa dapatkan tiap bulan? https://t.co/xzIj8e2bIE,4,1,1,0,2022-01-05,6,Wednesday,3,5,1
1478617356716982277,2022-01-05 06:40:23,BMI meminta Ferdinand ditangkap. https://t.co/q8EhItz1vx,36,18,13,2,2022-01-05,6,Wednesday,3,49,20
1478617355450257413,2022-01-05 06:40:23,"Walau sudah hampir 5.000 exoplanet ditemukan, sebutan untuk planet di luar Tata Surya, belum ada yang benar-benar mirip dengan Bumi. https://t.co/uJzjaUzSNs",34,1,5,2,2022-01-05,6,Wednesday,3,39,3
1478617103011926025,2022-01-05 06:39:23,"""Khalayak saling menukar barang-barang di gedung yang sama, karena mereka tak lagi punya cukup makanan untuk disantap,"" kata seorang warga bermarga Wang. https://t.co/frGq3hAfjt",6,0,1,1,2022-01-05,6,Wednesday,3,7,1
1478616835855691778,2022-01-05 06:38:19,"Dari sekian banyak musik yang viral selama 2021, ada Lantas yang jadi salah satunya. Lagu dari Juicy Luicy itu sebenarnya dirilis pada akhir 2020. https://t.co/VLBNmXmlAX",9,0,5,1,2022-01-05,6,Wednesday,3,14,1
1478616815064518659,2022-01-05 06:38:14,Lola Diara angkat bicara seputar tuduhan dirinya adalah sosok asli Lydia sang pelakor dalam web series Layangan Putus. Ini 5 bantahannya: #LolaDiara #LayanganPutus https://t.co/vXULQK1BsQ,2,0,1,0,2022-01-05,6,Wednesday,3,3,0
1478616604988657666,2022-01-05 06:37:24,"Yahav Draizin membuat karya yang keren. Dia coba menyatukan gambar di HP dengan dunia nyata, meski tanpa editan Photoshop hasilnya keren. Yuk intip! https://t.co/WjteexDEkJ",3,0,1,0,2022-01-05,6,Wednesday,3,4,0
1478616582528114688,2022-01-05 06:37:19,"Bermain tebak-tebakan tidak hanya mengasah kecerdasan otak, tapi juga bisa kontrol emosi. Apalagi kalau jawabannya sangat tidak terduga. https://t.co/46YCN7V56a",1,1,1,1,2022-01-05,6,Wednesday,3,2,2
1478616322724536321,2022-01-05 06:36:17,Pebasket Dewa United Wendha Wijaya mau mencetak rekor pebasket profesional dengan karier terpanjang di Indonesia. IBL 2022 jadi musim ke-21 untuknya.  https://t.co/dK3NJYUr8t,2,0,2,0,2022-01-05,6,Wednesday,3,4,0
1478616321210388485,2022-01-05 06:36:16,Mbah Ponco pemeran film Ziarah wafat di usia 105 tahun. Selamat jalan Mbah Ponco...  https://t.co/NlUgB5mmzE,6,2,2,0,2022-01-05,6,Wednesday,3,8,2
1478616110459236354,2022-01-05 06:35:26,Penampilan Timnas Indonesia sepanjang Piala AFF 2020 membuat harga pasaran pemainnya meningkat. Skuad Garuda kini termahal kedua di Asia Tenggara!  https://t.co/6sUCZiXPsh,13,0,1,0,2022-01-05,6,Wednesday,3,14,0
1478616095267373056,2022-01-05 06:35:23,"Google jadi situs yang kerap dikunjungi dalam keseharian. Pertanyaannya, apa saja yang Google ketahui tentang dirimu? Simak di sini:  https://t.co/qFFky0s1zZ",2,1,1,0,2022-01-05,6,Wednesday,3,3,1
1478615786893762562,2022-01-05 06:34:09,"Meski aplikasi yang memuat serangan terhadap perempuan Muslim India dihapus, langkah pemerintah menghentikan tren kebencian berbau agama masih dipertanyakan. https://t.co/1vLyAD0SXk",5,0,2,0,2022-01-05,6,Wednesday,3,7,0
1478615520349929476,2022-01-05 06:33:06,Seorang pria di Singapura kaget menerima tagihan kartu kredit senilai Rp 211 juta. Ternyata tagihan itu datang dari putrinya yang sering top up Genshin Impact.  https://t.co/9tY5JMndul,4,2,0,2,2022-01-05,6,Wednesday,3,4,4
1478615491333734401,2022-01-05 06:32:59,Romelu Lukaku membuat gaduh Chelsea dengan wawancaranya beberapa waktu lalu. Striker Belgia itu akan dihukum klub berupa denda. https://t.co/uxXSdAYQgZ,1,0,0,0,2022-01-05,6,Wednesday,3,1,0
1478615241462276098,2022-01-05 06:31:59,"Tabrakan maut terjadi antara truk bermuatan besi dan mobil pikap terjadi di Jalan Raya Cikalongkulon-Jonggol, Kabupaten Cianjur. Akibatnya satu orang tewas. https://t.co/lYI0JjJZEc",2,0,0,0,2022-01-05,6,Wednesday,3,2,0
1478615103087939588,2022-01-05 06:31:26,"Atau pada link berikut: https://t.co/UFcMFXhi2o

--",3,0,1,0,2022-01-05,6,Wednesday,3,4,0
1478614971118342144,2022-01-05 06:30:55,"Untuk melihat apa saja permasalahan yang kami angkat dan bagaimana progresnya, detikers dapat membaca selengkapnya di sini ya: 
https://t.co/MhAoyaA6S0",2,2,1,0,2022-01-05,6,Wednesday,3,3,2
1478614501549391874,2022-01-05 06:29:03,Media sosial dihebohkan dengan foto ciuman Gabriella Ekaputri dengan Junior Roberts. Gabriella pun menuliskan permintaan maaf ini:  https://t.co/aEyHuVXZqe,8,3,1,0,2022-01-05,6,Wednesday,3,9,3
1478614077693853698,2022-01-05 06:27:22,"Bagi detikers yang punya informasi terkait pemberitaan #detiktif bisa berbagi informasi ke redaksi@detikcom dengan subjek ""[detiktif] orang hilang"".

Dan jangan lupa untuk sertakan nomor telepon yang bisa dihubungi untuk keperluan verifikasi.",2,2,1,0,2022-01-05,6,Wednesday,3,3,2
1478613914019680258,2022-01-05 06:26:43,"Jokowi bagikan sembako dan uang tunai untuk para pedagang di Pasar Grobogan, Jawa Tengah hari ini. Seperti apa suasananya? https://t.co/DAsZtrBlQe",7,0,2,0,2022-01-05,6,Wednesday,3,9,0
1478613830087241730,2022-01-05 06:26:23,"Pencarian Efriyani yang hilang sejak Juli 2021 sempat disayembarakan.

Efriyani pergi dari rumah sejak 25 Juli 2021. Per hari ini, tercatat Efriyani 163 hari meninggalkan rumah.",1,2,2,0,2022-01-05,6,Wednesday,3,3,2
1478613339207094272,2022-01-05 06:24:26,Mantan ilmuwan NASA mengungkap rencananya untuk mengubah Mars jadi planet yang bisa dihuni oleh manusia. Ini caranya:  https://t.co/umx45PrJI6,6,1,1,2,2022-01-05,6,Wednesday,3,7,3
1478613101217927168,2022-01-05 06:23:29,"Ada juga Amel, wanita asal Depok, Jawa Barat, sudah beberapa hari mencari ayahnya, Budiono (61), yang hilang. Ayahnya meninggalkan rumah sejak Kamis (30/12/2021).
 https://t.co/MCtROtM0JM",3,1,2,0,2022-01-05,6,Wednesday,3,5,1
1478612331621875716,2022-01-05 06:20:25,"Sang ibu yang hilang itu bernama Sri Lestari (43). Kabar hilangnya Sri Lestari, viral di beberapa grup media sosial Facebook.",4,1,2,0,2022-01-05,6,Wednesday,3,6,1
1478611931632070656,2022-01-05 06:18:50,"Demi menemukan sang ibu yang pergi, seorang warga Desa Beji, Klaten, Jawa Tengah, Winarso (21) meminta tolong netizen. Sempat dicari hingga wilayah pegunungan di Kabupaten Wonogiri, hingga kini keberadaan sang ibu belum diketahui.

https://t.co/YdJzR9xDcZ",6,1,8,0,2022-01-05,6,Wednesday,3,14,1
1478611650831814656,2022-01-05 06:17:43,"Sampai saat ini, #detiktif masih terus mengusahakan agar isu-isu lainnya bisa segera dituntaskan. Next, apa permasalahan publik yang butuh penanganan selanjutnya?",3,2,1,0,2022-01-05,6,Wednesday,3,4,2
1478611394945699842,2022-01-05 06:16:42,Pembaca bisa terlibat aktif memberikan informasi suatu isu yang sedang diberitakan #detiktif. Mencari orang  hilang contohnya.,3,1,1,0,2022-01-05,6,Wednesday,3,4,1
1478610931261132800,2022-01-05 06:14:51,"Sejak awal tahun 2014, @detikcom mencoba turun tangan memberi ruang dalam program ini. 

#detiktif adalah program jurnalisme kolaboratif yang melibatkan peran serta detikers.",0,1,1,0,2022-01-05,6,Wednesday,3,1,1
1478610690046713857,2022-01-05 06:13:54,"Lagi-lagi alasan ""Sopan dan Masih Muda"" dijadikan alasan untuk meringankan hukuman Gaga Muhammad dan beberapa artis lain. Gimana detikers? https://t.co/m4mloNVuJR",12,11,4,3,2022-01-05,6,Wednesday,3,16,14
1478610282159034370,2022-01-05 06:12:17,"Peristiwa orang hilang sering kita temui, namun tidak semua dapat tertangani dengan cepat. Melalui program #detiktif, @detikcom ingin mengambil peran sebagai solusi. Ada yang belum tahu?

#THREAD https://t.co/jNwMD7OvZ1",26,5,9,0,2022-01-05,6,Wednesday,3,35,5
1478610000788475908,2022-01-05 06:11:10,"Moonton kerap menyuguhkan hero terbaru setiap tahunnya. Karakter-karakter keren itu, selalu jadi rebutan pemain. Ini daftar hero Mobile Legends yang jadi rebutan:  https://t.co/4yEfviK6EW",3,1,0,0,2022-01-05,6,Wednesday,3,3,1
1478609528384020480,2022-01-05 06:09:17,Sebanyak 74 pelamar kini dinyatakan lolos menjadi CASN di kementerian yang berada di bawah naungan Tjahjo Kumolo ini. Cek situs berikut: https://t.co/KBH2WKAL2C,3,1,1,0,2022-01-05,6,Wednesday,3,4,1
1478609508188438529,2022-01-05 06:09:12,Realme GT 2 Pro resmi dirilis dan langsung jadi penantang berat Xiaomi 12 Pro. Sebab spesifikasi sama tinggi namun dibanderol dengan harga lebih murah. https://t.co/ycnZHasXbn,6,0,0,0,2022-01-05,6,Wednesday,3,6,0
1478608467959160834,2022-01-05 06:05:04,Sederet drama Korea terbaru dari berbagai stasiun TV akan segera tayang pada paruh pertama 2022. Ini daftarnya:  https://t.co/JuYAmoZmtt,7,0,2,1,2022-01-05,6,Wednesday,3,9,1
1478607608646885378,2022-01-05 06:01:39,"Fenomena spirit doll atau boneka arwah sedang marak dibicarakan. Salah satu yang menarik, video boneka arwah yang 'minum' soda pakai sedotan. Ini penjelasan fisikanya:  https://t.co/Yi2HIdgibz",7,5,1,1,2022-01-05,6,Wednesday,3,8,6
1478607589390929922,2022-01-05 06:01:35,JPU mengungkap alasan menuntut Gaga Muhammad 4 tahun 6 bulan penjara atas kasus laka lantas yang membuat mendiang Laura Anna Lumpuh. Apa alasannya? https://t.co/qz1rSnCecX,2,0,1,0,2022-01-05,6,Wednesday,3,3,0
1478607047394480128,2022-01-05 05:59:25,"Viral di media sosial menampilkan oknum anggota TNI AD di Kabupaten Tanimbar, Maluku bertelanjang dada dan memukul remaja. Tak hanya itu, oknum tersebut juga mengajak duel warga sekitar.  https://t.co/enj85eQEch",15,7,9,3,2022-01-05,5,Wednesday,3,24,10
1478606554295410690,2022-01-05 05:57:28,"Calon suami Melanie Putria, Aldico Sapardan jalani pengangkatan tumor di otak. Hal itu disampaikan Melanie Putria dalam sosial media miliknya. https://t.co/tHvTglSVwJ",3,2,2,0,2022-01-05,5,Wednesday,3,5,2
1478606018074529798,2022-01-05 05:55:20,"Reino Barack buka-bukaan soal pernikahannya dengan Syahrini. Setelah menikah, ia ngaku lebih dekat dengan Tuhan. #ReinoBarack  https://t.co/9RpGAe9zrw",26,5,2,2,2022-01-05,5,Wednesday,3,28,7
1478606004518588419,2022-01-05 05:55:17,"""Terdakwa bersikap sopan menyadari dan menyesali perbuatannya. Masih berusia muda dan dapat memperbaiki sikapnya di kemudian hari. Menjatuhkan pidana penjara 4 tahun 6 bulan dan denda Rp 10 juta,"" kata JPU. https://t.co/3t3w4Ct2hx",3,3,2,4,2022-01-05,5,Wednesday,3,5,7
1478605515869593604,2022-01-05 05:53:20,"#Terpopuler Kampung Bayam, Kelurahan Papanggo, Jakarta Utara, digusur oleh proyek JIS. Beberapa warganya memilih mendirikan bedeng di tepi rel kereta api. https://t.co/dQIQPbKe9S",6,3,1,0,2022-01-05,5,Wednesday,3,7,3
1478605240396046337,2022-01-05 05:52:15,Mulan Jameela mengunggah ulang ucapan selamat tahun baru 2022 dengan foto keluarganya. Mulan juga meminta maaf dan ucapkan terima kasih. https://t.co/xV0l9XvkjX,5,0,3,0,2022-01-05,5,Wednesday,3,8,0
1478604955309285376,2022-01-05 05:51:07,"Salah satu Youtuber dengan jumlah Subscriber terbanyak di dunia, yakni PewDiePie, mengungkapkan ia akan istirahat dari Youtube. Tepatnya bulan Januari. https://t.co/zzxBNueBSn",30,3,5,1,2022-01-05,5,Wednesday,3,35,4
1478604935289876481,2022-01-05 05:51:02,"Ma'ruf Amin melayat ke rumah duka Ibunda Chairul Tanjung, Halimah. Ma'ruf Amin datang disambut mantan Mendikbud M Nuh. https://t.co/pnMILH7uUL",7,0,2,0,2022-01-05,5,Wednesday,3,9,0
1478604442119331841,2022-01-05 05:49:04,Pendaftaran akun LTMPT bagi siswa digeser menjadi 10 Januari 2022 mendatang. Sudah tahu cara mendaftar akunnya? Simak yuk! Via: detikedu https://t.co/Br67olrTj0,4,0,5,0,2022-01-05,5,Wednesday,3,9,0
1478604204193296384,2022-01-05 05:48:08,"Indosat Ooredoo Hutchison, operator seluler hasil merger Indosat dan Tri resmi beroperasi. Indosat Ooredoo Hutchison siap memperluas jangkauan layanan 5G. https://t.co/h5yAyvXJeL",11,1,2,1,2022-01-05,5,Wednesday,3,13,2
1478603673479655425,2022-01-05 05:46:01,Anang Hermansyah melakukan transplantasi rambut di Turki. Ia menunjukkan penampilannya saat rambutnya sudah botak. Ini penampilan baru Anang:  https://t.co/3u6yHKtYQp,16,4,5,2,2022-01-05,5,Wednesday,3,21,6
1478602675419820034,2022-01-05 05:42:03,Benjamin Mendy ditahan karena kasus pemerkosaan dan pelecehan seksual. Bek Manchester City itu dipindah ke penjara penjara paling mengerikan di Inggris.  https://t.co/lTjKuEvgim,12,1,7,1,2022-01-05,5,Wednesday,3,19,2
1478602018671443970,2022-01-05 05:39:27,"Pelatih timnas Indonesia Shin Tae-yong minta kualitas Liga 1 ditingkatkan. Faktanya, peringkat Liga Indonesia memang tak masuk lima besar di Asia Tenggara.  https://t.co/pXfYH2Dbvp",41,2,5,0,2022-01-05,5,Wednesday,3,46,2
1478601953781374980,2022-01-05 05:39:11,Permainan Bruno Fernandes di Manchester United musim ini disorot. Pemain Portugal itu dinilai berubah sejak Cristiano Ronaldo datang.  https://t.co/8mBMGCjg2m,1,0,1,0,2022-01-05,5,Wednesday,3,2,0
1478601936517668866,2022-01-05 05:39:07,"Amerika Serikat mencatat 1.082.549 kasus baru COVID-19, Senin (3/12/202). Penambahan kasus diduga akibat varian Omicron yang menggeser dominasi varian Delta. https://t.co/6JwFF809gT",8,0,4,5,2022-01-05,5,Wednesday,3,12,5
1478601144607940609,2022-01-05 05:35:58,"Putra bungsu Arie Untung dan Fenita Arie mengalami infeksi saluran kemih hingga harus disunat. Arie terharu, ketika sang anak mendapat doa dari Palestina...  https://t.co/9QdSAlILdD",23,15,2,0,2022-01-05,5,Wednesday,3,25,15
1478600422642405378,2022-01-05 05:33:06,"Suara tembakan di Tangsel viral di media sosial. Ternyata, suara tembakan itu berasal dari senjata api polisi saat gerebek kasus narkoba. https://t.co/N0IsJKRpvg",18,0,2,0,2022-01-05,5,Wednesday,3,20,0
1478600399884013569,2022-01-05 05:33:01,Kontrak Asnawi Mangkualam bersama Ansan Greeners segera berakhir dalam waktu dekat. Pelatih Jo Min-guk mengindikasikan akan mempertahankan Asnawi.  https://t.co/LfGeTC9Pmw,12,0,0,0,2022-01-05,5,Wednesday,3,12,0
1478599868528881664,2022-01-05 05:30:54,"Megabintang UFC Conor McGregor melontarkan ancaman bakal melibas Neymar seiring tantangannya kepada sesama petarung UFC, Charles Oliveira.  https://t.co/ZvvvEUYGZO",1,0,0,0,2022-01-05,5,Wednesday,3,1,0
1478599617503768577,2022-01-05 05:29:54,"Official training (OT) Tira Persikabo di Bali diwarnai matinya lampu di Stadion Gelora Samudra, Selasa (4/1/2022). Surat komplain pun dilayangkan ke PT LIB.  https://t.co/hWfApWXqhS",1,0,1,1,2022-01-05,5,Wednesday,3,2,1
1478599372921266181,2022-01-05 05:28:56,Nota keberatan yang disampaikan oleh Jerinx ditolak majelis hakim. Sidang kasus pengancaman terhadap Adam Deni kembali dilanjutkan. https://t.co/j5UxEnmkCF,6,0,1,0,2022-01-05,5,Wednesday,3,7,0
1478598657754677251,2022-01-05 05:26:05,"Hasil Malaysia di Piala AFF 2020, yang tersisih di fase grup usai kalah dari Indonesia, membuat pelatihnya mundur. Kini Harimau Malaya punya segudang PR!  https://t.co/W3JnchqCAf",7,0,1,0,2022-01-05,5,Wednesday,3,8,0
1478598627710885888,2022-01-05 05:25:58,"Ivan Gunawan menanggapi pro kontra soal spirit doll. Sebagai orang yang mengadopsi dua spirit doll, Igun tegaskan 'anak-anaknya' bukan anak setan. https://t.co/UOXgqKogmW",36,80,3,11,2022-01-05,5,Wednesday,3,39,91
1478597867724058626,2022-01-05 05:22:57,"Dua mantan Direktur Utama Asabri, Adam Rahmat Damiri dan Sonny Widjaja, divonis 20 tahun penjara. Adam diwajibkan mengganti uang sebesar Rp 17,9 miliar, sementara Sonny diminta mengganti Rp 64,5 miliar. https://t.co/hvELui2s1k",35,4,6,0,2022-01-05,5,Wednesday,3,41,4
1478597601255890944,2022-01-05 05:21:53,Pandemi COVID-19 telah memukul perekonomian Indonesia. Adaptasi jadi kunci bagi industri ritel khususnya teknologi di sepanjang tahun 2021. https://t.co/9FZVuqWiPt,6,0,0,0,2022-01-05,5,Wednesday,3,6,0
1478596859899875331,2022-01-05 05:18:57,"RI sempat diprediksi IHME bebas dari gelombang 3 COVID-19, tetapi setelah diserang Omicron, prediksi menunjukkan kasus RI bisa mencapai 387 ribu per hari. https://t.co/4EJmMgLlt8",17,0,3,0,2022-01-05,5,Wednesday,3,20,0
1478596577216315392,2022-01-05 05:17:49,"Sidang tuntutan Gaga Muhammad terkait kasus laka lantas yang membuat mendiang Laura Anna lumpuh digelar Selasa (4/1) di Pengadilan Negeri Jakarta Timur. Dirangkum 20Detik, berikut serba-serbinya: https://t.co/APEnBeujKy",5,1,0,0,2022-01-05,5,Wednesday,3,5,1
1478595840163909633,2022-01-05 05:14:53,Irwansyah dan Zaskia Sungkar ditipu hingga Rp 5 miliar oleh sang adik. Kini keberadaan Hafiz Fatur masih misterius. https://t.co/5vByxSmtRg,10,3,2,4,2022-01-05,5,Wednesday,3,12,7
1478595291456720896,2022-01-05 05:12:43,Pulmonologist RSPI Sulianto dr Adria Rusli menjelaskan Florona bukanlah varian baru virus Corona dan bisa menyerang saat imunitas tubuh dalam kondisi buruk. https://t.co/HuR9Su5XTp,6,0,0,1,2022-01-05,5,Wednesday,3,6,1
1478594780577865733,2022-01-05 05:10:41,Penyanyi Jeff Chang tersangkut masalah karena dianggap mempromosikan situs judi online. Bahkan ia sampai dihujat oleh netizen.  https://t.co/BxHcdbwO1s,1,0,0,0,2022-01-05,5,Wednesday,3,1,0
1478594761040842756,2022-01-05 05:10:36,"Video relawan tak digubris saat mengingatkan warga tidak mendekati lokasi aliran lahar Semeru, viral. Selain tidak didengar, relawan bahkan ditertawakan warga. https://t.co/6KdhnQazml",5,1,3,1,2022-01-05,5,Wednesday,3,8,2
1478593760493809672,2022-01-05 05:06:38,Warga Jabar yang terpapar virus Corona varian Omicron baru pulang dari Timur Tengah. Mayoritas mereka adalah pekerja migran Indonesia (PMI). https://t.co/ZxjfBSnPCO,8,0,2,0,2022-01-05,5,Wednesday,3,10,0
1478593501998759938,2022-01-05 05:05:36,Ramai tagar #TangkapFerdinand di Twitter. Netizen banyak yang melontarkan kemarahannya gegara cuitan dari Ferdinan Hutahaean tersebut. https://t.co/Aabh4VsjLb,24,8,10,2,2022-01-05,5,Wednesday,3,34,10
1478592984325230592,2022-01-05 05:03:33,Riza menyampaikan seratusan unit rumah akan dibangun. https://t.co/xP8JVTaLux,11,2,1,1,2022-01-05,5,Wednesday,3,12,3
1478592490085273601,2022-01-05 05:01:35,"Cassandra Angelie nekat lakukan prostitusi karena ekonomi. Psikolog Intan Erlita, melihat prostitusi artis terjadi karena tuntutan gaya hidup. https://t.co/hGLmvdTrZO",14,9,3,1,2022-01-05,5,Wednesday,3,17,10
1478591961888079872,2022-01-05 04:59:29,Larissa Chou mendapatkan peringatan usai Zikri Daulay ciuman dengan Ayu Aulia....   https://t.co/BKpS9ay5fY,4,0,1,0,2022-01-05,4,Wednesday,3,5,0
1478591726486966273,2022-01-05 04:58:33,"Sejumlah aliansi sopir ojol hari ini bakal menggelar demonstrasi. Aksi itu rencananya akan dipusatkan di kawasan Patung Kuda, Jakarta Pusat. https://t.co/LMTkBIvl1A",4,0,2,0,2022-01-05,4,Wednesday,3,6,0
1478591467945967619,2022-01-05 04:57:31,"Bank sentral China telah meluncurkan versi percontohan aplikasi dompet untuk yuan digital. Dengan demikian, penggunaan uang digital akan semakin luas. https://t.co/Jlcprqixet",3,1,0,0,2022-01-05,4,Wednesday,3,3,1
1478590989304541186,2022-01-05 04:55:37,"Ibunda Chairul Tanjung, Hajah Halimah binti Amih telah meninggal dunia hari ini. Selama hidupnya, Halimah dikenal sebagai sosok yang penuh cinta. https://t.co/uOu2WQ9h5a",10,1,0,0,2022-01-05,4,Wednesday,3,10,1
1478590978646810626,2022-01-05 04:55:34,"Jenazah ibu Chairul Tanjung, Halimah sudah tiba di rumah duka. Para pelayat tetap menerapkan protokol kesehatan ketat saat menyampaikan bela sungkawanya. https://t.co/0XHX5rzxNG",1,0,0,0,2022-01-05,4,Wednesday,3,1,0
1478590815643578368,2022-01-05 04:54:55,Kemenkes RI mencatat ada 15 kasus transmisi lokal virus Corona varian Omicron dari total 254 kasus yang ditemukan. Tertular dari mana? https://t.co/uIEdiEF43r,1,1,3,0,2022-01-05,4,Wednesday,3,4,1
1478590377296859139,2022-01-05 04:53:11,Hujan meteor Quadrantid jadi salah satu fenomena langit yang akan terjadi pada Januari 2022 ini. Ini daftar fenomena lainnya. https://t.co/tM4Zdnpt7F,6,0,0,0,2022-01-05,4,Wednesday,3,6,0
1478589862840520704,2022-01-05 04:51:08,Ibunda Chairul Tanjung telah meninggal dunia hari ini. Berikut adalah profil singkat ibu dari pengusaha kenamaan Indonesia tersebut. https://t.co/AVQZmWCiby,4,0,1,0,2022-01-05,4,Wednesday,3,5,0
1478586864521068547,2022-01-05 04:39:13,Sebagian negara memutuskan memberikan booster atau dosis tambahan vaksin COVID-19. Peneliti mengakui strategi ini tak bisa terus dilakukan. https://t.co/QaCEjelktF,6,1,1,1,2022-01-05,4,Wednesday,3,7,2
1478586614867714050,2022-01-05 04:38:14,Boneka arwah atau dikenal spirit doll saat ini tengah jadi tren di sejumlah kalangan artis Indonesia. Ini kata Ria Enes soal tren boneka arwah di kalangan artis:  https://t.co/pMf8E3mvow,3,4,0,2,2022-01-05,4,Wednesday,3,3,6
1478586119373697026,2022-01-05 04:36:16,"Presiden Jokowi mengawali rangkaian kunjungan kerjanya di Jawa Tengah dengan menyambangi Pasar Gemolong, Sragen pagi ini. Apa saja kegiatannya? https://t.co/6NRw3fzFBL",10,0,1,2,2022-01-05,4,Wednesday,3,11,2
1478586102130872323,2022-01-05 04:36:12,PT KAI Daop 1 Jakarta diketahui membatalkan sekitar 9.000 tiket saat momen libur Natal dan Tahun Baru kemarin. Kenapa? https://t.co/qLCG6U82M9,2,0,0,0,2022-01-05,4,Wednesday,3,2,0
1478585358552027142,2022-01-05 04:33:14,"Pemerintah Kota Bekasi mengalokasikan pagu anggaran Rp 1,1 Miliar untuk belanja karangan bunga. Dilihat dari situs LPSE Kota Bekasi Tender tersebut kini telah rampung.  https://t.co/thlPyOJZe6",6,1,4,4,2022-01-05,4,Wednesday,3,10,5
1478585148270600195,2022-01-05 04:32:24,"Sayangnya saat popularitasnya meroket, Zheng Shuang menuai skandal. Berikut berbagai masalah yang menimpa aktris China: https://t.co/W5aPNYYGFU",3,0,0,0,2022-01-05,4,Wednesday,3,3,0
1478584552465616898,2022-01-05 04:30:02,"Netizen melaporkan macet total di Jalan Inspeksi Kalimalang, Bekasi, pukul 08.00 WIB tadi. Ada apa sih? https://t.co/kJj00a6yzV",10,8,2,3,2022-01-05,4,Wednesday,3,12,11
1478584000168005639,2022-01-05 04:27:51,"Perusahaan teknologi pangan asal Finlandia, Solar Foods mengembangkan protein buatan menggunakan udara. Perkembangan teknologi penghasil makanan alternatif diyakini bisa mengurangi potensi krisis pangan dan masalah emisi gas karbon. https://t.co/qBUmxLZe0T",7,2,3,2,2022-01-05,4,Wednesday,3,10,4
1478583479889707011,2022-01-05 04:25:47,Ampun dehhh Rupiah masih aja kebakaran. Nilai tukar dolar AS terhadap rupiah pagi ini menguat. Begini pergerakannya: https://t.co/SQSgMdV2jS,5,0,1,1,2022-01-05,4,Wednesday,3,6,1
1478583248661975042,2022-01-05 04:24:51,"#Foto Joey Wong adalah aktris Hong Kong yang dijuluki Ratu Film Horror. Kini, ia berusia 54 tahun, tapi penampilannya awet muda ya! https://t.co/prqUV0kGol",3,0,0,0,2022-01-05,4,Wednesday,3,3,0
1478583230991327235,2022-01-05 04:24:47,Pengamen keroncong bersuara merdu yang viral terungkap berada di Malang. Addie MS telah bertemu dengan pengamen tersebut lewat video call. https://t.co/W8pQQE3sC1,2,0,1,0,2022-01-05,4,Wednesday,3,3,0
1478582723493175301,2022-01-05 04:22:46,Cassandra Angelie jadi tersangka prostitusi online meski juga sebagai korban. Polisi menjelaskan beda kasus Cassandra dengan human trafficking:  https://t.co/qFQO5a5Yvj,13,6,0,0,2022-01-05,4,Wednesday,3,13,6
1478582495528591366,2022-01-05 04:21:52,"Resmi beroperasinya Indosat Ooredoo Hutchison ini, tidak ada lagi perusahaan Hutchison 3 Indonesia. Saat ini, Tri hadir sebagai produk layanan saja. https://t.co/Rwlc64CHFX",9,0,4,2,2022-01-05,4,Wednesday,3,13,2
1478582007449985029,2022-01-05 04:19:55,Doddy Sudrajat mempermasalahkan penggalangan dana yang dilakukan Marissya Icha. Pengacara menyebut uang donasi masuk ke rekening pribadi. https://t.co/sJDRqiXoEh,13,7,0,1,2022-01-05,4,Wednesday,3,13,8
1478581762758426625,2022-01-05 04:18:57,Aktris Carman Lee membuat fansnya khawatir dengan kesehatannya. Hal itu terjadi setelah mereka melihat penampilan terbarunya. #CarmanLee  https://t.co/dCZpmBOy0j,0,0,0,0,2022-01-05,4,Wednesday,3,0,0
1478581013412519942,2022-01-05 04:15:58,Viani Limardi resmi menggugat PSI atas pemecatan dirinya sebagai kader partai. Gugatan tersebut dilayangkan Viani ke PN Jakpus. https://t.co/oLFNmMFavU,5,0,0,1,2022-01-05,4,Wednesday,3,5,1
1478580010239893505,2022-01-05 04:11:59,"Bagi pencinta kuliner tak ada salahnya mencicipi nasi daun jati khas Kudus, Jawa Tengah ini. Berbagai lauk tersedia untuk menemani nikmatnya nasi daun jati. https://t.co/GpsZ38axw9",13,0,4,1,2022-01-05,4,Wednesday,3,17,1
1478579257681092608,2022-01-05 04:09:00,"Walaupun sederhana, sayur olah-olah khas Lombok bisa jadi alternatif lauk yang dinikmati saat sarapan. Terasa nikmat disantap bersama nsi putih dan telur dadar. https://t.co/F0zBAIuLtv",5,0,0,0,2022-01-05,4,Wednesday,3,5,0
1478577777091788800,2022-01-05 04:03:07,Zikri Daulay bikin heboh setelah aksi ciuman dengan Ayu Aulia tersebar. Netizen pun memperingatkan Larissa Chou.  https://t.co/gNZRxtMc5a,6,1,2,1,2022-01-05,4,Wednesday,3,8,2
1478577191285886982,2022-01-05 04:00:47,"Model asal Bosnia ini ceritakan pengalaman saat baru tinggal di Indonesia dan terkejut soal suhu udara yang amat panas, Bunda. Simak cerita selengkapnya, ya. #detiknetwork  https://t.co/zzZgi7cCXG",4,1,0,0,2022-01-05,4,Wednesday,3,4,1
1478576645422338053,2022-01-05 03:58:37,Wang Leehom mengalami kesulitan besar setelah bercerai dengan Lee Jinglei. Bahkan ia terancam penalti dari kontrak hingga Rp 143 miliar. https://t.co/UFedhJSDcS,3,0,0,0,2022-01-05,3,Wednesday,3,3,0
1478576159889801218,2022-01-05 03:56:41,"Status PPKM Jakarta yang naik ke level 2 dan pemberlakuan PTM 100 persen. Dengan kondisi ini, apa langkah tepat bagi orang tua? Via: detikedu https://t.co/jSIdiBdNFR",8,0,0,1,2022-01-05,3,Wednesday,3,8,1
1478575361252286464,2022-01-05 03:53:31,"Anang Hermansyah sedang ada di Turki bersama keluarganya. Dalam kesempatan itu, Anang Hermansyah terlihat jalani transplantasi rambut.  https://t.co/eDKEoattHR",10,4,0,0,2022-01-05,3,Wednesday,3,10,4
1478575118926462977,2022-01-05 03:52:33,"Wisata baru 'Ngopi in The Sky' di Gunung Kidul, DI Yogyakarta tengah disorot banyak kalangan terutama warga Jogja. Wahana ini dinilai berbahaya. https://t.co/JZhQ433lAl",54,7,17,11,2022-01-05,3,Wednesday,3,71,18
1478573789344534536,2022-01-05 03:47:16,"7. Gimana detikers, ada yang minat melamar pekerjaan buat jadi pengasuh boneka arwah?",1,1,0,0,2022-01-05,3,Wednesday,3,1,1
1478573786190413827,2022-01-05 03:47:15,"6. ""Asuransi kesehatan dan gaji minimal Rp 10 juta (exclude bonus). Harus yang berhati mulia dan lemah lembut,""

Ungkap influencer helenberkuman dalam video yang terlihat sedang menemani para boneka arwah tidur.",0,1,0,0,2022-01-05,3,Wednesday,3,0,1
1478573783329886212,2022-01-05 03:47:15,"5. #Foto Berikut deretan influencer dan selebritis yang memiliki boneka arwah:

Selain itu terdapat Siti Badriah, Ruben Onsu &amp; Sarwendah, Soimah, dan Nora Alexandra yang juga memiliki boneka tersebut.

Foto: dok.Instagram https://t.co/FxGO0lAfiD",3,5,0,1,2022-01-05,3,Wednesday,3,3,6
1478573781417279488,2022-01-05 03:47:14,"4. Mengutip dari akun anak arwah alejandro_nasution1 pengasuh anak mendapat fasilitas berupa tidur dengan boneka arwah di apartemen mewah, wifi gratis, makanan mewah, biaya transportasi hingga uang makan. Enak juga ya?",0,2,0,1,2022-01-05,3,Wednesday,3,0,3
1478573779613667328,2022-01-05 03:47:14,"3. Total gaji yang diberikan sangat fantantis, di mana pengasuh boneka arwah akan diberikan gaji senilai Rp 10 juta diluar bonus yang akan diberikan.",0,1,0,0,2022-01-05,3,Wednesday,3,0,1
1478573776140783620,2022-01-05 03:47:13,"2. Terangkum oleh tim detikFinance, para pengadopsi boneka arwah mulai dari Influencer TikTok sampai para selebritis ini juga membuat konten terkait lowongan kerja untuk menempati posisi pengasuh boneka arwah.
https://t.co/mvhZxOwjI7",0,1,1,0,2022-01-05,3,Wednesday,3,1,1
1478573774266003457,2022-01-05 03:47:13,1. Viral! Tren mengadopsi boneka arwah kini sudah bisa kita lihat diberbagai kalangan. Dan anehnya boneka arwah tersebut diperlakukan layaknya seorang bayi sungguhan.,0,1,1,0,2022-01-05,3,Wednesday,3,1,1
1478573771531292672,2022-01-05 03:47:12,#THREAD Ada lowongan kerja nih dengan gaji Rp 10 juta. Kerjanya ngapain aja? Jadi baby sitter boneka arwah. Tertarik? https://t.co/l7UO5hMaGG,68,44,13,22,2022-01-05,3,Wednesday,3,81,66
1478573624760152066,2022-01-05 03:46:37,Pemerintah menghentikan sementara ekspor batu bara demi memenuhi suplai domestik. Kebijakan ini tentu akan berpengaruh kepada saham-saham dari emiten batu bara. https://t.co/BamqLQwRr8,2,0,1,0,2022-01-05,3,Wednesday,3,3,0
1478573382660722690,2022-01-05 03:45:39,Pelanggan Cassandra Angelie didesak untuk dijerat dengan hukum. Polisi kembali berikan penegasan soal status pelanggan Cassandra Angelie:  https://t.co/8b6ZJwoEnc,2,0,0,1,2022-01-05,3,Wednesday,3,2,1
1478572885316935682,2022-01-05 03:43:41,Pelita Air Service (PAS) tengah bersiap untuk membuka penerbangan berjadwal reguler. Sudah sampai mana progresnya? https://t.co/frI1Zcufpn,5,1,0,0,2022-01-05,3,Wednesday,3,5,1
1478572109563637763,2022-01-05 03:40:36,Musyawarah Daerah (Musda) Partai Demokrat NTT diwarnai kericuhan. Sejumlah massa yang tak terima dengan hasil musda membakar atribut partai. https://t.co/MpalFpMaXd,2,1,0,0,2022-01-05,3,Wednesday,3,2,1
1478570337134645249,2022-01-05 03:33:33,Piala Liga Inggris menggelar laga semifinal tengah pekan. Duel mempertemukan Chelsea vs Tottenham Hotspur dan Arsenal vs Liverpool. Berikut jadwal lengkapnya.  https://t.co/3CSqUHkQsV,3,0,0,0,2022-01-05,3,Wednesday,3,3,0
1478570032225472516,2022-01-05 03:32:20,"Performa Timnas Indonesia di Piala AFF 2020 bikin eks pelatih timnas Malaysia terkesan, sampai menegaskan Harimau Malaya mesti menirunya!  https://t.co/OFjuSua3fO",6,2,0,0,2022-01-05,3,Wednesday,3,6,2
1478570014961811459,2022-01-05 03:32:16,Generasi milenial harus lebih meningkatkan literasi keuangan sehingga lebih memahami bagaimana mengelola utang dan keuangan pribadi secara keseluruhan. https://t.co/sPQoAHAujN,2,0,3,0,2022-01-05,3,Wednesday,3,5,0
1478569675554500614,2022-01-05 03:30:55,Ramai tagar #TangkapFerdinand di media sosial. Tagar itu muncul usai cuitan Ferdinand Hutahaean soal 'Allahmu ternyata lemah'. https://t.co/Oshohm5b4s,580,257,209,50,2022-01-05,3,Wednesday,3,789,307
1478569171197779970,2022-01-05 03:28:55,Zikri Daulay akhirnya meminta maaf atas apa yang terjadi belakangan ini dan bikin heboh. Ini permintaan maaf Zikri:  https://t.co/FgeLQgg4fz,30,15,2,4,2022-01-05,3,Wednesday,3,32,19
1478568682406268933,2022-01-05 03:26:59,"Sederet asrama mahasiswa ini punya desain dan lokasi yang tidak biasanya. Sangat indah dan bikin mahasiswa super betah. Wih, ada yang jadi impian kamu? Via: detikedu https://t.co/KbZp6pqXEW",2,0,0,0,2022-01-05,3,Wednesday,3,2,0
1478568183720206337,2022-01-05 03:25:00,Pasukan Pro-Pemerintah Yaman mengklaim telah merebut sebagian wilayah kekuasaan kelompok pemberontak Houthi. https://t.co/1EqHefez93,3,0,0,0,2022-01-05,3,Wednesday,3,3,0
1478567589882302473,2022-01-05 03:22:38,Kemenkes RI mewajibkan kasus konfirmasi dan probable Omicron diisolasi di rumah sakit. Harus bayar sendiri atau ditanggung pemerintah ya? Begini aturannya: https://t.co/KRXz81IzNK,7,1,2,0,2022-01-05,3,Wednesday,3,9,1
1478566600429252610,2022-01-05 03:18:42,Layangan Putus bikin penthouse ramai dibicarakan banyak orang. Sudah tahu belum Penthouse itu apa dan seperti apa bentuknya dengan nilai Rp 5 miliar? https://t.co/gNyUW3HuOF,7,0,0,1,2022-01-05,3,Wednesday,3,7,1
1478564839643652098,2022-01-05 03:11:42,Sarapan dinilai menjadi waktu makan terbaik. Beberapa ahli gizi menyarankan kebiasaan sarapan sehat untuk kendalikan kadar kolesterol tinggi dalam tubuh. https://t.co/YPqJACjR2P,3,0,1,0,2022-01-05,3,Wednesday,3,4,0
1478563847799726082,2022-01-05 03:07:46,Pihak Doddy Sudrajat mengklaim yayasan penggalangan dana untuk Gala Sky tidak mengantongi izin Kementerian Sosial. Pihak Doddy pun meminta agar Kemensos memeriksa yayasan tersebut. https://t.co/nZg1XvH4OG,24,13,0,1,2022-01-05,3,Wednesday,3,24,14
1478563348404916224,2022-01-05 03:05:47,Novak Djokovic dipastikan tampil di Australia Terbuka 2022. Ia mendapat izin khusus untuk bisa masuk lokasi turnamen.  https://t.co/y55pllRIJL,4,0,0,0,2022-01-05,3,Wednesday,3,4,0
1478563068665868288,2022-01-05 03:04:40,"Davy Propper memutuskan gantung sepatu di usia 30 tahun. Alasannya, ia tak lagi jatuh cinta dengan sepakbola dan rutinitasnya!  https://t.co/NvjZhMZQKo",3,0,1,0,2022-01-05,3,Wednesday,3,4,0
1478562824121106437,2022-01-05 03:03:42,Kementerian Perdagangan mengungkap saat ini harga telur ayam sudah terjadi penurunan. Tapi tak diakui oleh para pedagang. Bedanya berapa? https://t.co/ibzfjV9iSb,1,1,1,0,2022-01-05,3,Wednesday,3,2,1
1478562810309357569,2022-01-05 03:03:39,"Emma Watson ngaku pernah naksir dengan salah satu bintang 'Harry Potter'. Bukan Daniel Radcliffe bukan Rupert Grint, melainkan Tom Felton. Ihiy, gimana ceritanya? https://t.co/eOKoGgvtkp",22,0,5,3,2022-01-05,3,Wednesday,3,27,3
1478561213219024902,2022-01-05 02:57:18,Pasien Corona varian Omicron yang ditemukan di Indonesia kini sudah 254 orang. Kemenkes mengatakan 54 di antaranya sudah dinyatakan negatif. https://t.co/BM6yC9lay5,6,1,0,1,2022-01-05,2,Wednesday,3,6,2
1478560910503550977,2022-01-05 02:56:06,"Kabar duka datang dari keluarga Chairul Tanjung. Ibunda Chairul Tanjung, Halimah, meninggal dunia. https://t.co/YQ5dUiTAoV",40,5,4,3,2022-01-05,2,Wednesday,3,44,8
1478560491907788805,2022-01-05 02:54:26,"Di awal tahun 2022, Pemerintah kembali memperpanjang PPKM di Jawa-Bali. DKI Jakarta sendiri masuk PPKM level 2. Ingat lagi aturan berlaku ya! https://t.co/RwoN4gNOYk",2,0,1,0,2022-01-05,2,Wednesday,3,3,0
1478559977467961346,2022-01-05 02:52:23,Kepopuleran drakor Move to Heaven ternyata berbuah baik kepada jasa pembersih trauma di Korea Selatan. Ini kisahnya: #Spotlight #KimSaeByoul   https://t.co/VSxTHyiWsJ,7,1,1,0,2022-01-05,2,Wednesday,3,8,1
1478559749239095296,2022-01-05 02:51:29,"Surat Al Waqiah dikenal sebagai surat dengan keutamaan dalam urusan rezeki. Lebih afdholnya, jangan lupa baca doa setelah membaca surat Al Waqiah berikut. https://t.co/NsNUTzDMHo",241,1,59,0,2022-01-05,2,Wednesday,3,300,1
1478558369191546884,2022-01-05 02:46:00,"Selama 23 tahun, motor ini tak pernah jalan. Dengan kondisi yang serba baru sejak dilahirkan pada 1999, kini harga Suzuki RGV 120 melambung tinggi.  https://t.co/SZj4SwHnwv",9,0,2,3,2022-01-05,2,Wednesday,3,11,3
1478557874498461698,2022-01-05 02:44:02,"Selama tahun 2021 lalu, tak sedikit penumpang yang diusir keluar pesawat karena berpakaian tak pantas. Contohnya seperti 3 model pakaian ini nih traveler: https://t.co/uexvEGzPvQ",5,1,0,0,2022-01-05,2,Wednesday,3,5,1
1478557133222432769,2022-01-05 02:41:05,"Ketua MUI Sukabumi A. Komarudin tutup usia. Dia meninggal pada Rabu (5/1/2022), sekitar pukul 01.50 WIB. https://t.co/ejxFjjmpdH",6,1,0,0,2022-01-05,2,Wednesday,3,6,1
1478556318621487105,2022-01-05 02:37:51,"Jalan nasional penghubung akses antara Likupang, Kabupaten Minut dan Kota Bitung, terputus akibat longsor. Pemda bakal bangun jalan alternatif sementara. https://t.co/OA0x8w12kP",1,0,0,0,2022-01-05,2,Wednesday,3,1,0
1478556063154778112,2022-01-05 02:36:50,"Arsenal sedang mempertimbangkan tawaran yang masuk untuk Pierre-Emerick Aubameyang. Jika ada yang cocok, The Gunners tak ragu melepas penyerang Gabon tersebut.  https://t.co/iaIXsqDG2n",2,1,0,0,2022-01-05,2,Wednesday,3,2,1
1478555573150961673,2022-01-05 02:34:53,"Hai Gemini, pemasukan lumayan tinggi karena ada saja pemasukan yang datangnya tidak terduga sebelumnya. Mau tahu #RamalanZodiak kamu hari ini? https://t.co/MydxUCGpFJ",2,0,0,0,2022-01-05,2,Wednesday,3,2,0
1478554426600312832,2022-01-05 02:30:20,"Prof Amin Soebandrio mengungkapkan kecilnya gaji para peneliti kontrak di Eijkman selama ini.

""Saya benar-benar hampir menangis karena honor mereka ternyata lebih rendah dari sopir saya,"" ujarnya. Simak #blakblakan selengkapnya di https://t.co/YJFFv17iDJ https://t.co/c7dYnJ4i6d",20,3,5,4,2022-01-05,2,Wednesday,3,25,7
1478554330206818308,2022-01-05 02:29:57,"Gaga Muhammad dituntut 4,5 tahun penjara. Keputusan tersebut mengundang kontra dari pihak Laura Anna. https://t.co/TneaYLZEqn",15,7,3,0,2022-01-05,2,Wednesday,3,18,7
1478553082195816453,2022-01-05 02:24:59,"Tempat makan rawon bisa dengan mudah ditemui di Malang, Jawa Timur. Salah satunya Rawon Brintik yang paling legendaris, ada sejak 79 tahun lalu. Cobain yuk! https://t.co/qvmoPTqTZL",4,1,2,0,2022-01-05,2,Wednesday,3,6,1
1478552077181796353,2022-01-05 02:21:00,"""Eratkan tali sepatu, sebelum melangkah jauh. Pagi ini saya ke Jawa Tengah untuk kunjungan kerja ke Sragen, Grobogan, Blora, dan Semarang,"" tulis Jokowi. ""Siap, saya tunggu pak di Jateng,"" balas Ganjar. https://t.co/PacpCaezuK",32,9,5,3,2022-01-05,2,Wednesday,3,37,12
1478550794236571648,2022-01-05 02:15:54,Inggris mengalami lonjakan kasus Covid dalam beberapa hari terakhir imbas varian Omicron. Pemerintah Inggris memprediksi terjadinya peningkatan tingkat rawat inap di rumah sakit. https://t.co/T67iAoMSx6,14,1,2,0,2022-01-05,2,Wednesday,3,16,1
1478550775949406212,2022-01-05 02:15:49,Berikut pengaturan dan penyesuaian lalu lintas yang akan diterapkan terkait pemindahan Tugu Jam Thamrin. https://t.co/U7N7OqGDKX,7,0,0,1,2022-01-05,2,Wednesday,3,7,1
1478549511014391809,2022-01-05 02:10:48,Indonesia akan menerapkan sistem transaksi tol tanpa berhenti atau multi lane free flow (MLFF). Sistem bayar tol tanpa berhenti ini mulai diberlakukan tahun 2022 ini.  https://t.co/mqpMLwfUHb,12,0,8,2,2022-01-05,2,Wednesday,3,20,2
1478549285885161479,2022-01-05 02:09:54,"Memasuki bulan Januari 2022, Polda Metro Jaya tetap menghadirkan layanan Samsat Keliling untuk masyarakat di wilayah JADETABEK.  https://t.co/UyMFIicULa",3,0,0,0,2022-01-05,2,Wednesday,3,3,0
1478549285692190727,2022-01-05 02:09:54,Buya Yahya menjawab soal heboh spirit doll atau boneka arwah. Buya Yahya menegaskan tak ada roh masuk ke boneka. https://t.co/TTA7elFltk,17,3,3,0,2022-01-05,2,Wednesday,3,20,3
1478549265492365314,2022-01-05 02:09:49,Gianluigi Donnarumma menyebut tekanan di Paris Saint-Germain lebih besar daripada di AC Milan. PSG disebutnya punya target tinggi.  https://t.co/N7jmA9PZgc,4,1,3,0,2022-01-05,2,Wednesday,3,7,1
1478549015843254275,2022-01-05 02:08:50,Romelu Lukaku sempat bikin gaduh dalam sebuah wawancara terkait situasinya di Chelsea. Striker asal Belgia itu kini sudah meminta maaf kepada klub dan fans.  https://t.co/mwLbSjVbns,5,0,0,0,2022-01-05,2,Wednesday,3,5,0
1478548001891274759,2022-01-05 02:04:48,"Game survival horor, Resident Evil: Village, berhasil menyabet gelar Game of The Year dalam ajang penghargaan Steam Awards 2021, mengalahkan judul populer lain. https://t.co/3fxybuBbsr",23,3,3,2,2022-01-05,2,Wednesday,3,26,5
1478546968767049732,2022-01-05 02:00:42,"Gaya hidup sehat menjadi poin penting dalam kehidupan. Topik kesehatan, termasuk diet pun terus menjadi tren dan perbincangan hangat. Bagaimana dengan tren tahun ini? #CNNIndonesia #detiknetwork  https://t.co/rufyseq7ct",1,0,0,0,2022-01-05,2,Wednesday,3,1,0
1478545982602289152,2022-01-05 01:56:46,Bikin netizen respek! Beredar viral wanita yang memperlihatkan rumahnya yang berlantai baliho. Seperti apa ya? https://t.co/8rh9pbwoZI,10,0,2,1,2022-01-05,1,Wednesday,3,12,1
1478544498229665792,2022-01-05 01:50:53,"Resolusi baru di tahun 2022 bisa dimulai dari gaya hidup sehat. Yuk, hindari kebiasaan makanan ini agar tubuh bugar dan langsing. https://t.co/qrZuRMoNoD",2,0,0,0,2022-01-05,1,Wednesday,3,2,0
1478543230375538693,2022-01-05 01:45:50,Beberapa direktur PT PLN (Persero) diduga positif COVID-19 usai dari Bali. Hal itu membuat kantor pusat PLN di-lockdown. Informasi itu diketahui ketika Menteri BUMN Erick Thohir dan Menteri ESDM Arifin Tasrif sidak ke kantor pusat PLN. https://t.co/iNiqWTuSMA,10,3,8,9,2022-01-05,1,Wednesday,3,18,12
1478541997329850374,2022-01-05 01:40:56,Satgas Penanganan Covid-19 mengungkap Indonesia melewati masa libur Natal dan Tahun Baru 2022 tanpa adanya lonjakan kasus Corona. Hal itu berbeda dengan masa libur tahun sebelumnya. https://t.co/OeYPWcBwZK,2,2,0,1,2022-01-05,1,Wednesday,3,2,3
1478540759984922626,2022-01-05 01:36:01,"Prakirawan BMKG melaporkan adanya fenomena sirkulasi siklonik di Laut Natuna. Simak prakiraan cuaca selengkapnya yang berlaku untuk hari Rabu, 5 Januari 2022. https://t.co/g30ntUbYTR",4,0,0,1,2022-01-05,1,Wednesday,3,4,1
1478539772071235587,2022-01-05 01:32:06,Dalam Al-Qur'an dijelaskan soal makanan halal dan haram. Tapi selain itu ada juga makanan yang sifatnya syubhat yakni tidak jelas antara halal dan haram. https://t.co/k41un64ChJ,23,1,2,0,2022-01-05,1,Wednesday,3,25,1
1478538740758982661,2022-01-05 01:28:00,"#FOTO Atlet bulu tangkis Indonesia, Shesar Hiren Rhustavito, melamar kekasihnya, Mitha Hardiyanti. Ini sosok Mitha Hardiyanti:  https://t.co/X6Aj9NnsTu",5,0,0,0,2022-01-05,1,Wednesday,3,5,0
1478536254279065602,2022-01-05 01:18:07,"Diam-diam, tambang mineral yang nilainya hampir US$ 1 triliun atau Rp 14.400 triliun. Konon, harta karun itu yang jadi rebutan hingga pecah perang. https://t.co/bvuRAWRWju",42,2,7,2,2022-01-05,1,Wednesday,3,49,4
1478535254075924482,2022-01-05 01:14:09,Sederet drama terbaik dengan berbagai genre ini sukses dibintangi oleh Junho 2PM. Berikut daftarnya:  https://t.co/QOPiL1m75K,117,0,64,9,2022-01-05,1,Wednesday,3,181,9
1478533950125613057,2022-01-05 01:08:58,"Thiago Silva resmi memperpanjang kontraknya dengan Chelsea. Sudah 37 tahun, Silva disebut Thomas Tuchel bak Benjamin Button!  https://t.co/xKfaOMmZda",6,0,0,0,2022-01-05,1,Wednesday,3,6,0
1478532396433747974,2022-01-05 01:02:47,"Norwegia menjadi salah satu negara penghasil minyak terbesar di dunia. Tapi siapa sangka, di negara itu justru lebih banyak menjual kendaraan listrik!  https://t.co/HbvmOB82Ey",22,0,5,0,2022-01-05,1,Wednesday,3,27,0
1478532115377573891,2022-01-05 01:01:40,"Jika harga Avanza dirasa semakin mahal, tak ada salahnya melirik mobil LCGC (Low Cost Green Car) yang ternyata harganya masih stabil di bulan Januari 2022.  https://t.co/wdY7K75xmE",5,0,0,0,2022-01-05,1,Wednesday,3,5,0
1478531030327963654,2022-01-05 00:57:22,"Ada warga Korut yang membelot dan menyeberang masuk ke Korsel. Ternyata, hidup di negeri kapitalis malah lebih susah. Akhirnya, si pembelot balik lagi ke Korut. https://t.co/Cm3E0FVtn1",34,4,12,2,2022-01-05,0,Wednesday,3,46,6
1478530770084024320,2022-01-05 00:56:20,"David Alaba mengaku senang bisa beradaptasi cepat di Real Madrid. Hanya saja, Alaba sempat dibuat kaget dengan jam makan malam di Spanyol.  https://t.co/ytDZkFJiqz",4,0,0,0,2022-01-05,0,Wednesday,3,4,0
1478530750928543748,2022-01-05 00:56:15,"DKI Jakarta balik lagi menerapkan PPKM level 2. Apa penyebabnya, apakah karena penyebaran COVID-19 varian Omicron? Ini pangkal masalahnya. https://t.co/aSLmIsDb3m",4,3,0,1,2022-01-05,0,Wednesday,3,4,4
1478530728174530562,2022-01-05 00:56:10,Presiden Jokowi bertolak ke Jawa Tengah hari ini. Kunjungan kerja hari ini Jokowi akan meresmikan Bendungan Randugunting hingga beri bantuan ke PKL. https://t.co/OJP1Rnt5ia,4,1,1,1,2022-01-05,0,Wednesday,3,5,2
1478530476684062722,2022-01-05 00:55:10,"#FOTO Janganlah cepat percaya dan terhasut dengan foto-foto viral yang beredar di dunia maya, seperti kumpulan foto ini yang sempat bikin geger dunia. https://t.co/DCBtTeylHR",5,1,0,0,2022-01-05,0,Wednesday,3,5,1
1478530459185422341,2022-01-05 00:55:05,Romelu Lukaku telah meminta maaf kepada Chelsea dan Thomas Tuchel. Sang manajer juga menerima permintaan maaf Lukaku.  https://t.co/LCjnhDoquT,4,0,1,0,2022-01-05,0,Wednesday,3,5,0
1478529997216354307,2022-01-05 00:53:15,"Ikatan Pencak Silat Indonesia (IPSI) Pandeglang turut mengomentari aksi biadab ANS (48), guru ekstrakurikuler silat, yang memerkosa dua muridnya. https://t.co/KyUOnAHI5V",6,2,0,0,2022-01-05,0,Wednesday,3,6,2
1478529971769552901,2022-01-05 00:53:09,Juventus membidik Luis Suarez seiring kencangnya rumor Alvaro Morata ke Barcelona. El Pistolero dikabarkan menolak untuk hijrah ke Turin. Apa alasannya?  https://t.co/S6m54ny0Zd,5,1,0,0,2022-01-05,0,Wednesday,3,5,1
1478529676595404809,2022-01-05 00:51:59,Romelu Lukaku telah meminta maaf kepada Chelsea dan Thomas Tuchel. Sang manajer juga menerima permintaan maaf Lukaku. https://t.co/Pez5geQC2O,2,0,1,0,2022-01-05,0,Wednesday,3,3,0
1478529663274213378,2022-01-05 00:51:56,Kekalahan Manchester United dari Wolverhampton Wanderers mengundang kritik. Eks bek MU Rio Ferdinand menyayangkan taktik Ralf Rangnick.  https://t.co/kvbE46SlAx,6,0,1,3,2022-01-05,0,Wednesday,3,7,3
1478529661755867137,2022-01-05 00:51:55,"Seorang ibu muda asal Klaten, Jawa Tengah, pulang setelah menghilang selama 163 hari. Berikut 9 fakta yang terungkap dari hilangnya Efriyani. https://t.co/hQl56BemvI",3,0,0,0,2022-01-05,0,Wednesday,3,3,0
1478529660581523459,2022-01-05 00:51:55,Beberapa daerah di Jawa Tengah hari ini berpotensi hujan lebat disertai angin kencang dan petir. BMKG mengingatkan kewaspadaan ancaman bencana hidrometeorologi. https://t.co/03pQLyWThO,2,0,1,0,2022-01-05,0,Wednesday,3,3,0
1478529417311830018,2022-01-05 00:50:57,"Polda Metro Jaya menggerebek transaksi narkoba di wilayah Pamulang, Tangerang Selatan (Tangsel). Seorang pelaku tewas ditembak dalam penggerebekan tersebut. https://t.co/1wXsEYekI8",2,0,0,0,2022-01-05,0,Wednesday,3,2,0
1478529149119696898,2022-01-05 00:49:53,Romelu Lukaku sudah meminta maaf ke Chelsea atas kekacauan yang dibuatnya. Tapi dia juga menyadari suporter tak akan langsung menyambutnya meriah.  https://t.co/LkWFuI80J3,3,0,0,0,2022-01-05,0,Wednesday,3,3,0
1478528898363277313,2022-01-05 00:48:53,Romelu Lukaku sempat diparkir manajer Thomas Tuchel. Striker Belgia itu diprediksi turun kembali pada laga Chelsea vs Tottenham Hotspur di Piala Liga Inggris.  https://t.co/tdOZuEkXY8,6,1,0,0,2022-01-05,0,Wednesday,3,6,1
1478528880931741699,2022-01-05 00:48:49,"Southampton resmi berpindah kepemilikan. Klub Premier League itu dibeli pengusaha media asal Serbia senilai 100 juta paun atau sekitar Rp 1,94 triliun.  https://t.co/4ef4cp8TcN",4,3,0,0,2022-01-05,0,Wednesday,3,4,3
1478528655987032065,2022-01-05 00:47:55,Pemerintah akan segera menggelar program vaksinasi COVID-19 booster berbayar. Lantas berapa harga masing-masing vaksin yang tersedia di Indonesia? https://t.co/TVKhgCnjUa,10,8,5,2,2022-01-05,0,Wednesday,3,15,10
1478528634545713154,2022-01-05 00:47:50,Liverpool membatalkan sesi latihan hari Selasa karena merebaknya COVID-19. Kini laga kontra Arsenal di Piala Liga Inggris pun jadi tanda tanya.  https://t.co/EvmMtE6Oeb,2,0,0,0,2022-01-05,0,Wednesday,3,2,0
1478528376512073737,2022-01-05 00:46:49,FIFA telah mengumumkan tiga finalis untuk Puskas Award. Salah satu dari tiga gol sepanjang 2021 bakal dinobatkan sebagai yang terindah.  https://t.co/gwDwCXCtue,2,0,0,0,2022-01-05,0,Wednesday,3,2,0
1478528152527941637,2022-01-05 00:45:55,Mampu melakukan aktivitas seksual dalam waktu yang lebih lama dapat memuaskan pasangan hingga orgasme. Berikut 5 cara agar tahan lama dalam bercinta. https://t.co/aax1cagITG,3,0,3,1,2022-01-05,0,Wednesday,3,6,1
1478528130172264454,2022-01-05 00:45:50,Samuel Umtiti dikabarkan sudah lima kali menolak dijual Barcelona. Hal itu membuat raksasa LaLiga diklaim kesal.  https://t.co/hvJNxBdHbR,2,0,0,0,2022-01-05,0,Wednesday,3,2,0
1478527886843957250,2022-01-05 00:44:52,Paris Saint-Germain mengumumkan Gianluigi Donnarumma positif COVID-19. Kiper Italia tersebut kini tengah menjalani isolasi.  https://t.co/StxNRh1yvp,2,0,3,0,2022-01-05,0,Wednesday,3,5,0
1478527885489152006,2022-01-05 00:44:52,Daftar harga yang dikaitkan dengan tarif vaksin booster banyak beredar di media sosial. Kemenkes RI angkat bicara meluruskan informasi yang simpang siur. https://t.co/GvoZgmqMfg,2,1,1,0,2022-01-05,0,Wednesday,3,3,1
1478527656547205126,2022-01-05 00:43:57,Seorang ibu rumah tangga di Sleman nekat mengakhiri hidupnya dengan membakar diri. https://t.co/y3nyu4Tl0z,4,0,0,0,2022-01-05,0,Wednesday,3,4,0
1478527634174889990,2022-01-05 00:43:52,"Setelah absen panjang, Phil Jones jadi starter lagi di Manchester United. Hal itu kembali membuat Donny van de Beek kena bulan-bulanan.  https://t.co/CWxn7VTKkd",2,0,0,0,2022-01-05,0,Wednesday,3,2,0
1478527406793269257,2022-01-05 00:42:58,"Ketua DPRD Kota Bekasi Chairoman J Putro memaklumi pengadaan karangan bunga Rp 1,1 miliar oleh Pemkot Bekasi. https://t.co/Qa7tpm7gIi",3,3,0,0,2022-01-05,0,Wednesday,3,3,3
1478527144712151041,2022-01-05 00:41:55,"Jika di Indonesia tren dengan spirit doll, di luar negeri, ada 'reborn babies'. Wanita yang berduka juga termasuk pembeli boneka yang mirip dengan bayi ini. https://t.co/ySQpMsPGqX",1,0,0,0,2022-01-05,0,Wednesday,3,1,0
1478526868387213313,2022-01-05 00:40:49,"Kinerja Ralf Rangnick di Manchester United mulai disamakan dengan Ole Gunnar Solskjaer. Awalnya indah, pelan-pelan menjadi sorotan.  https://t.co/pxfWp4SCQn",2,0,0,0,2022-01-05,0,Wednesday,3,2,0
1478526586378936320,2022-01-05 00:39:42,"Romelu Lukaku membuat gaduh di Chelsea, usai mengaku tak bahagia dalam sebuah wawancara. Striker Belgia itu kini sudah meminta maaf.  https://t.co/heeMZoVjA8",4,0,0,0,2022-01-05,0,Wednesday,3,4,0
1478526360884813825,2022-01-05 00:38:48,Polisi telah memeriksa pria yang melakukan pemukulan ke orang berkebutuhan khusus di Depok. Pelaku ternyata marah korban menyenggol payudara pacarnya. https://t.co/SV86NxT8ql,5,0,0,2,2022-01-05,0,Wednesday,3,5,2
1478526095993548800,2022-01-05 00:37:45,"Antonio Conte kembali ke Liga Inggris dengan menjadi manajer Tottenham Hotspur. Di bawah tangan dingin Conte, Spurs sejauh ini belum pernah kalah!  https://t.co/NhnQZKxtCh",2,1,0,0,2022-01-05,0,Wednesday,3,2,1
1478525871380119558,2022-01-05 00:36:52,"#FOTO Elon Musk dan Jeff Bezos, mereka adalah dua orang terkaya di dunia yang tahtanya saling berebut naik turun. Tapi mereka punya kesamaan: suka meme. https://t.co/OueR0dWiDo",2,0,0,0,2022-01-05,0,Wednesday,3,2,0
1478525846721806341,2022-01-05 00:36:46,Persis mendorong polisi tak pandang bulu menegakkan hukum terhadap siapa saja yang berpotensi memecah belah bangsa dan menyebarkan ujaran kebencian. https://t.co/tTyBskoagW,5,2,1,0,2022-01-05,0,Wednesday,3,6,2
1478525604295327747,2022-01-05 00:35:48,"Manchester United masih jauh dari kata memuaskan di bawah polesan Ralf Rangnick. Jika Setan Merah masih terus kesulitan, rumornya Cristiano Ronaldo mau cabut!  https://t.co/tqUxkulyXd",2,3,0,1,2022-01-05,0,Wednesday,3,2,4
1478525603020165121,2022-01-05 00:35:48,PSM Makassar resmi memperkenalkan 10 pemain barunya menjelang putaran kedua Liga 1 musim 2021/2022. Ada Ferdinand Sinaga dan Marinus Wanewar dalam daftar itu. https://t.co/fsdJ4gKqIm,4,0,0,0,2022-01-05,0,Wednesday,3,4,0
1478525332240097280,2022-01-05 00:34:43,Gerard Pique terlibat perdebatan di Twitter. Ribut-ribut itu terkait menu makanan pemain Barcelona.  https://t.co/wg220OF0CS,1,1,0,0,2022-01-05,0,Wednesday,3,1,1
1478525058985439232,2022-01-05 00:33:38,"Dua pemain Juventus, Alvaro Morata dan Matthijs de Ligt ramai digosipkan akan berlabuh ke Barcelona. Miralem Pjanic mewanti-wanti keduanya. https://t.co/qOX4kkO2lB",7,0,0,0,2022-01-05,0,Wednesday,3,7,0
1478524546537996289,2022-01-05 00:31:36,"Dua pemain Juventus, Alvaro Morata dan Matthijs de Ligt ramai digosipkan akan berlabuh ke Barcelona. Miralem Pjanic mewanti-wanti keduanya.  https://t.co/BNKXsAAGXr",2,0,0,1,2022-01-05,0,Wednesday,3,2,1
1478523654791221248,2022-01-05 00:28:03,Real Madrid telah mengajukan 50 juta euro ke Paris Saint-Germain untuk mendapatkan Kylian Mbappe di Januari tahun ini. Hal itu diklaim oleh Giovanni Branchini!  https://t.co/o1cQV3AqwJ,4,3,0,1,2022-01-05,0,Wednesday,3,4,4
1478523559320375311,2022-01-05 00:27:40,Gubernur DKI Anies Baswedan bernostalgia ke masa-masa kampanye enam tahun lalu. Dia kembali ke warteg zaman kampanye yang berujung jadi meme di media sosial. https://t.co/2Oyl8ZGn8c,32,20,2,4,2022-01-05,0,Wednesday,3,34,24
1478522544252768256,2022-01-05 00:23:38,"Massa buruh hari ini rencananya akan menggeruduk kantor Gubernur Banten Wahidin Halim, mendesak agar UMP dan UMK 2022 direvisi. https://t.co/CdauIH5SRp",8,0,2,1,2022-01-05,0,Wednesday,3,10,1
1478521287911870466,2022-01-05 00:18:39,"Di antara Ahmad Riza Patria, Airin Rachmy Diani, dan Ahmad Sahroni, siapa yang paling unggul untuk menggantikan Anies Baswedan jadi Gubernur DKI Jakarta? https://t.co/D6fIzEenoy",26,34,2,3,2022-01-05,0,Wednesday,3,28,37
1478520806300913665,2022-01-05 00:16:44,"Yakin kamu merasa cerdas? Coba buktikan dengan teka-teki ini. Sekalian asah otak, biar pikiran enggak penat. https://t.co/uSxbO1AvcZ",4,2,0,0,2022-01-05,0,Wednesday,3,4,2
1478520069424656388,2022-01-05 00:13:48,"Mantan finalis Masterchef Malaysia, Etiqah Siti Noorashikeen Mohd Sulong dan suaminya didakwa oleh Pengadilan Malaysia atas pembunuhan ART asal Indonesia. https://t.co/KgIalXPgxY",41,6,12,1,2022-01-05,0,Wednesday,3,53,7
1478519567416705025,2022-01-05 00:11:49,Viral video seorang pria yang terbang hingga 9 meter karena terbawa layang-layang. Netizen pun dibuat ngeri melihatnya. https://t.co/vuGXXwb7Iw,13,1,2,0,2022-01-05,0,Wednesday,3,15,1
1478519059134177280,2022-01-05 00:09:47,Satgas COVID-19 mengungkapkan Indonesia melewati masa libur Natal dan tahun 2022 tanpa adanya lonjakan kasus positif. Berbeda dengan masa libur sebelumnya. https://t.co/6qm3ncwIpe,5,0,0,0,2022-01-05,0,Wednesday,3,5,0
1478518312782938112,2022-01-05 00:06:49,Juventus membidik Luis Suarez seiring kencangnya rumor Alvaro Morata ke Barcelona. El Pistolero dikabarkan menolak untuk hijrah ke Turin. Apa alasannya? https://t.co/icqCtZz1u6,5,0,0,0,2022-01-05,0,Wednesday,3,5,0
1478517822003322883,2022-01-05 00:04:52,"Kemenkes RII mencatat tambahan 92 kasus konfirmasi varian Omicron, Selasa (4/1/2022). Total kasus menjadi 254, didominasi gejala ringan hingga tanpa gejala. https://t.co/gummaON94x",5,2,2,1,2022-01-05,0,Wednesday,3,7,3
1478517082228768768,2022-01-05 00:01:56,"Kasus Omicron di Indonesia terus bertambah, sementara kegiatan pembelajaran tatap muka tengah direncanakan 100 persen. Akan tetap lanjut, atau dikaji ulang? https://t.co/C5aT5z62wx",16,11,3,3,2022-01-05,0,Wednesday,3,19,14
1478516250196287491,2022-01-04 23:58:38,Wanita di Bali bernama Renny Matondang kehilangan anjing kesayangannya. Dia membuat sayembara berhadiah hingga Rp 5 juta bagi penemu anjing ras Pomerania itu. https://t.co/EvadjovJqL,10,1,0,0,2022-01-04,23,Tuesday,2,10,1
1478515503706615808,2022-01-04 23:55:40,"Keluarga korban penyekapan dan pemerkosaan siswi SMP oleh anak anggota DPRD Pekanbaru, Riau, berakhir damai. Pelaku yang sempat ditahan kini dibebaskan. https://t.co/5WopnYPpsI",3403,950,1358,992,2022-01-04,23,Tuesday,2,4761,1942
1478515008137052161,2022-01-04 23:53:42,"Viral di media sosial menampilkan oknum anggota TNI AD di Kabupaten Tanimbar, Maluku bertelanjang dada dan memukul remaja. Kini oknum tersebut diproses hukum. https://t.co/D4vMzCe1Hq",19,8,6,1,2022-01-04,23,Tuesday,2,25,9
1478514121159102467,2022-01-04 23:50:10,Kekalahan Manchester United dari Wolverhampton Wanderers mengundang kritik. Eks bek MU Rio Ferdinand menyayangkan taktik Ralf Rangnick. https://t.co/1CPolqKK1N,7,1,1,0,2022-01-04,23,Tuesday,2,8,1
1478513633927831561,2022-01-04 23:48:14,Inggris mengalami krisis rumah sakit akibat gelombang infeksi Omicron di negara itu. Bahkan kasus harian COVID-19 di Inggris telah mencapai 200 ribu kasus. https://t.co/z4zftQyplj,9,3,8,1,2022-01-04,23,Tuesday,2,17,4
1478513137649426438,2022-01-04 23:46:16,LaporCovid-19 menerima 33 laporan penyelewengan vaksin booster yang diberikan kepada kelompok non-tenaga kesehatan di tahun 2021. Kemenkes pun angkat bicara. https://t.co/dcT43ZKYGU,5,3,3,1,2022-01-04,23,Tuesday,2,8,4
1478512584433315843,2022-01-04 23:44:04,Kolonel Priyanto dan dua anggota TNI itu sempat menginap satu malam di salah satu hotel di Bandung atau sebelum kejadian kematian Handi-Salsa. https://t.co/pNXnOAHxej,7,1,0,2,2022-01-04,23,Tuesday,2,7,3
1478511837578678272,2022-01-04 23:41:06,Pria perlu tahu bahwa penggunaan tisu magic yang terlalu sering bisa menyebabkan masalah pada genital bahkan memengaruhi masalah kesehatan lainnya. https://t.co/Bn3FF8WeIJ,2,0,1,0,2022-01-04,23,Tuesday,2,3,0
1478511096000663554,2022-01-04 23:38:09,Satpol PP Kota Depok menyebut tembok yang dibangun warga di jalan sehingga menghalangi saluran air tak memiliki izin. Tembok tersebut bakal dibongkar. https://t.co/L5liCSnITJ,5,0,2,0,2022-01-04,23,Tuesday,2,7,0
1478509837155774465,2022-01-04 23:33:09,Tuntas sudah perbaikan sumur resapan yang pernah jebol dilindas roda mobil Isyana politikus PSI. Begini perbandingan kondisi before dan after perbaikan. https://t.co/hXsykN19Ck,3,4,0,1,2022-01-04,23,Tuesday,2,3,5
1478508306687741973,2022-01-04 23:27:04,"Varian terbaru B.1.640.2 muncul di Prancis, dikenal sebagai varian IHU. WHO memasukkannya dalam kategori Variant Under Monitoring sejak November 2021. https://t.co/7KfcJ2FwDC",29,22,14,20,2022-01-04,23,Tuesday,2,43,42
1478508050310914048,2022-01-04 23:26:03,"Wakil Ketua Komisi VII Fraksi PAN, Eddy Soeparno mendukung keputusan Presiden Jokowi menghentikan ekspor batu bara untuk sementara https://t.co/t6e66megXk",5,0,0,0,2022-01-04,23,Tuesday,2,5,0
1478507824703496199,2022-01-04 23:25:09,PPKM di Jatim diperpanjang hingga 2 pekan ke depan. Malang Raya naik menjadi level 2. Namun Wali Kota Malang Sutiaji memprotes penetapan level 2. https://t.co/soLHr6439t,2,0,0,0,2022-01-04,23,Tuesday,2,2,0
1478507083779780608,2022-01-04 23:22:12,"Efriyani (42), warga Desa Bolopleret, Kecamatan Juwiring, Kabupaten Klaten, Jawa Tengah, yang hilang akhirnya ditemukan dan disambut bahagia keluarga. https://t.co/aKU3ahHG8b",7,1,0,0,2022-01-04,23,Tuesday,2,7,1
1478506093697548289,2022-01-04 23:18:16,Aktris Joan Collins mengungkapkan kisah hidupnya dalam sebuah film. Semua tragedi dan kesusahan yang dialaminya itu pun diungkapkan di sana.   https://t.co/KdomfyLT0v,8,0,0,0,2022-01-04,23,Tuesday,2,8,0
1478505087291084805,2022-01-04 23:14:16,"Mengawali tahun 2022, Indosat Ooredoo Hutchison, resmi beroperasi. Mereka siap maksimalkan layanan di tahun ini. https://t.co/hRrNZVRWwc",8,1,3,1,2022-01-04,23,Tuesday,2,11,2
1478504086538444803,2022-01-04 23:10:18,"Kelompok Indonesia Save Uighur melakukan aksi teatrikal di Jakarta, Selasa (4/1/2022). Aksi ini sebagai bentuk solidaritas atas kondisi muslim Uighur, China. https://t.co/wKKsWqp2Tg",14,3,3,0,2022-01-04,23,Tuesday,2,17,3
1478503355395756035,2022-01-04 23:07:23,Real Madrid telah mengajukan 50 juta euro ke Paris Saint-Germain untuk mendapatkan Kylian Mbappe di Januari tahun ini. Hal itu diklaim oleh Giovanni Branchini. https://t.co/uhje5Fv3vz,8,0,2,0,2022-01-04,23,Tuesday,2,10,0
1478503339407122432,2022-01-04 23:07:20,"Dua mantan petinggi PT ASABRI, Bachtiar Effendi dan Hari Setianto, divonis hukuman 15 tahun penjara. https://t.co/hcWDl5d30f",6,0,3,0,2022-01-04,23,Tuesday,2,9,0
1478502352705445891,2022-01-04 23:03:24,"Harga-harga naik lebih dari 36%, berdampak pada anggaran rumah tangga dan perusahaan. https://t.co/jxjLMr7PeU",40,9,11,3,2022-01-04,23,Tuesday,2,51,12
1478501080103366656,2022-01-04 22:58:21,"Banyaknya kasus penyalahgunaan identitas pribadi membuat bocah 14 tahun asal Yogyakarta ini membuat aplikasi yang sangat berguna, Watermark KTP.  https://t.co/02obFhwkxm",111,5,19,2,2022-01-04,22,Tuesday,2,130,7
1478500094064447494,2022-01-04 22:54:26,Kementerian Kesehatan mengumumkan adanya tambahan kasus varian Omicron di Indonesia. Mayoritas kasus ini adalah imported cases. https://t.co/pDdprICVo6,32,30,12,6,2022-01-04,22,Tuesday,2,44,36
1478499093630619653,2022-01-04 22:50:27,Samuel Umtiti dikabarkan sudah lima kali menolak dijual Barcelona. Hal itu membuat raksasa LaLiga diklaim kesal. https://t.co/8uk1sLAPFk,5,1,0,0,2022-01-04,22,Tuesday,2,5,1
1478498070564327431,2022-01-04 22:46:23,Pemerintah akan menentukan vaksin booster COVID-19 berbayar atau gratis pada 10 Januari 2022. Berapa kisaran harganya? https://t.co/wxZC11j1TE,6,2,0,1,2022-01-04,22,Tuesday,2,6,3
1478497080184348678,2022-01-04 22:42:27,Kementerian Perdagangan mengatakan saat ini harga telur ayam hingga cabai rawit merah sudah mulai turun. Cek daftar lengkapnya di sini. https://t.co/K1cqCD87Hi,4,1,1,0,2022-01-04,22,Tuesday,2,5,1
1478496091280756742,2022-01-04 22:38:31,"JPO Karet Sudirman sebentar lagi rampung dibangun. Namun, JPO bertema Kapal Pinisi yang dibanggakan Anies Baswedan itu menuai kritik dari komunitas pejalan kaki https://t.co/AroSVsvVSN",82,47,13,14,2022-01-04,22,Tuesday,2,95,61
1478494780841766922,2022-01-04 22:33:19,Ukuran penis besar diyakini para pria bisa memuaskan pasangan di ranjang. Memangnya berapa ukuran ideal penis yang bisa bikin klimaks? https://t.co/fTLQN4uSPY,3,0,0,1,2022-01-04,22,Tuesday,2,3,1
1478493785285967872,2022-01-04 22:29:22,"Pasien pertama dari Jatim asal Surabaya, TYC yang terpapar COVID-19 varian Omicron masih dirawat di RS. Gejalanya sakit di tenggorokan saat terpapar COVID-19. https://t.co/bod6sgbwfb",7,0,0,0,2022-01-04,22,Tuesday,2,7,0
1478492552588406786,2022-01-04 22:24:28,"Amerika Serikan (AS) mengalami lonjakan gila-gilaan kasus Corona. Dalam sehari, AS melaporkan kasus COVID-19 lebih dari 1 juta. https://t.co/lLc7pkCSUq",13,7,2,3,2022-01-04,22,Tuesday,2,15,10
1478490999550840832,2022-01-04 22:18:17,Gerard Pique terlibat perdebatan di Twitter. Ribut-ribut itu terkait menu makanan pemain Barcelona. https://t.co/R0Tjw8WlfC,4,1,0,0,2022-01-04,22,Tuesday,2,4,1
1478489512686800907,2022-01-04 22:12:23,"Selama delapan tahun, seorang pria mencari hard disk berisi 7.500 Bitcoin di tumpukan sampah. Nilainya Rp 5 triliun!  https://t.co/MNP2lnBKKh",20,9,5,1,2022-01-04,22,Tuesday,2,25,10
1478488521077932037,2022-01-04 22:08:27,"Celine Evangelista juga menganggap spirit doll miliknya sebagai anak. Akan tetapi, Celine memperlakukan boneka-boneka itu sewajarnya.  https://t.co/R0lzDr9Xva",7,2,1,3,2022-01-04,22,Tuesday,2,8,5
1478487254318391296,2022-01-04 22:03:25,"Dalam sidak tersebut ditemukan 59 CPMI yang akan diberangkatkan ke Arab Saudi, Qatar, dan Persatuan Emirat Arab (PEA) sebagai pekerja rumah tangga (domestic). https://t.co/0Vaqu940jp",3,0,0,0,2022-01-04,22,Tuesday,2,3,0
1478486355521019904,2022-01-04 21:59:50,"""Sepanjang dia tidak melanggar aturan, silakan saja,"" ujar Karo Penmas Divisi Humas Polri Brigjen Ahmad Ramadhan. https://t.co/l1iIDRS7Gv",2,0,0,0,2022-01-04,21,Tuesday,2,2,0
1478485358769852417,2022-01-04 21:55:53,Romelu Lukaku sudah meminta maaf ke Chelsea atas kekacauan yang dibuatnya. Tapi dia juga menyadari suporter tak akan langsung menyambutnya meriah. https://t.co/XWMBeFnvCu,12,0,1,0,2022-01-04,21,Tuesday,2,13,0
1478484353290317827,2022-01-04 21:51:53,Presiden Jokowi berharap RUU TPKS segera disahkan. RUU TPKS sudah melalui perjalanan panjang selama 9 tahun lebih. https://t.co/WBXNKtt3qz,5,0,2,1,2022-01-04,21,Tuesday,2,7,1
1478483311223791618,2022-01-04 21:47:44,"Seorang ibu muda asal Klaten, Jawa Tengah, bernama Efriyani (42) yang hilang hingga disayembarakan akhirnya pulang. Efriyani ternyata ditemukan di Solo. https://t.co/8ntgM2nTBH",13,2,2,0,2022-01-04,21,Tuesday,2,15,2
1478482317903601677,2022-01-04 21:43:48,Sejumlah tokoh dunia mencuri perhatian sepanjang 2021. Sebut saja Joe Biden yang resmi menjadi Presiden AS hingga Kim Jong-un yang dikabarkan menghilang. https://t.co/i80zWw6wIK,2,0,0,0,2022-01-04,21,Tuesday,2,2,0
1478481009188515841,2022-01-04 21:38:36,"Gempa berkekuatan magnitudo (M) 5,8 terjadi di Wakatobi, Sulawesi Tenggara. Gempa tersebut terjadi di kedalaman 568 kilometer. https://t.co/NimEPq8I5B",8,0,0,1,2022-01-04,21,Tuesday,2,8,1
1478479786427232256,2022-01-04 21:33:44,"Syahrini baru-baru ini merambah dunia metaverse dengan merilis Non-fungible Token (NFT) bernama 'Syahrini's Metaverse Tour', yang kemudian laris terjual. https://t.co/PxxYyqNlGg",5,0,2,0,2022-01-04,21,Tuesday,2,7,0
1478479009130426368,2022-01-04 21:30:39,Salah seorang dari trio oknum anggota TNI tersangka tewasnya Handi dan Salsa berasal dari Gunungkidul yakni Kopda Dwi Atmoko. Berikut ini empat fakta tentanya. https://t.co/KBMyNPOxoP,6,1,1,0,2022-01-04,21,Tuesday,2,7,1
1478477709114236930,2022-01-04 21:25:29,Bisnis kuliner dianggap sebagai bisnis yang menjanjikan. Ingin mencoba? Kira-kira segini modal yang harus disiapkan untuk 7 bisnis kuliner kekinian. https://t.co/uMu9F6foFT,9,0,4,0,2022-01-04,21,Tuesday,2,13,0
1478476712732147722,2022-01-04 21:21:31,"Seorang mantan finalis Masterchef Malaysia, Etiqah Siti Noorashikeen Mohd Sulong dan suaminya didakwa oleh Pengadilan Malaysia atas pembunuhan ART. https://t.co/mpi60xYd67",15,0,2,0,2022-01-04,21,Tuesday,2,17,0
1478475473080524800,2022-01-04 21:16:36,"Kemenkes RI buka suara soal penyebab PPKM DKI Jakarta naik lagi ke level 2, benar karena varian Omicron yang meningkat? https://t.co/aFx3WZOaBw",5,0,1,1,2022-01-04,21,Tuesday,2,6,1
1478474326143864834,2022-01-04 21:12:02,"Desain kawasan Istana Kepresidenan di ibu kota negara (IKN) baru, Kalimantan Timur (Kaltim) telah ditetapkan. Ini bocorannya: https://t.co/2pyQWPTFvY",13,2,2,0,2022-01-04,21,Tuesday,2,15,2
1478472193847791619,2022-01-04 21:03:34,Romelu Lukaku sempat diparkir manajer Thomas Tuchel. Striker Belgia itu diprediksi turun kembali pada laga Chelsea vs Tottenham Hotspur di Piala Liga Inggris. https://t.co/HC51ditMmt,2,0,0,0,2022-01-04,21,Tuesday,2,2,0
1478471428928323584,2022-01-04 21:00:31,"Seorang ibu muda asal Klaten yang hilang hingga disayembarakan akhirnya pulang. Namun karena sakit, warga Desa Bolopleret, tersebut kemudian dibawa ke RS. https://t.co/1ohjh1rVIk",4,0,0,0,2022-01-04,21,Tuesday,2,4,0
1478468705453494272,2022-01-04 20:49:42,"Para anggota keluarga Sutarno mengalami kelumpuhan. Meski begitu, putrinya yang lumpuh tetap tegar dan bernyanyi memperjuangkan hidup keluarga. Simak kisahnya: https://t.co/O9UdHQ6uHX",11,0,3,0,2022-01-04,20,Tuesday,2,14,0
1478467679522590720,2022-01-04 20:45:38,"Pada ajang CES 2022 mendatang Samsung dikabarkan akan memperkenalkan perangkat baru yang berkolaborasi dengan C-Lab, yakni sebuah gitar listrik. https://t.co/dzRljP7SuF",1,0,0,0,2022-01-04,20,Tuesday,2,1,0
1478466547022802946,2022-01-04 20:41:08,"Status PPKM Kota Tegal, Jawa Tengah naik dari level 1 menjadi level 2. Apa sebabnya? https://t.co/nDn40BzS9g",8,0,0,0,2022-01-04,20,Tuesday,2,8,0
1478465007549665280,2022-01-04 20:35:01,Dahak yang menyumbat saluran pernapasan memang mengganggu sekali. Apalagi jika disertai dengan batuk. Berikut 10 cara mengeluarkan dahak yang bisa dicoba. https://t.co/YAEPnBixzn,58,0,17,1,2022-01-04,20,Tuesday,2,75,1
1478463016987414530,2022-01-04 20:27:06,Insiden ini memicu perdebatan baru soal bagaimana para pembelot diperlakukan saat menjalani kehidupan baru di Korsel. https://t.co/glydUX0SBd,4,0,0,0,2022-01-04,20,Tuesday,2,4,0
1478461489711390720,2022-01-04 20:21:02,Flurona adalah sebutan untuk infeksi ganda virus influenza dan Corona. Flurona menjadi sorotan ketika dilaporkan terjadi pada seorang ibu hamil di Israel. https://t.co/nKu04P4WuP,3,0,2,3,2022-01-04,20,Tuesday,2,5,3
1478460521179459600,2022-01-04 20:17:11,Ini deretan musisi-musisi yang pernah dicekal lantaran karyanya dianggap dapat membahayakan pemerintah:  https://t.co/hu5QfluWbu,13,0,0,1,2022-01-04,20,Tuesday,2,13,1
1478456889818202115,2022-01-04 20:02:45,"Southampton resmi berpindah kepemilikan. Klub Premier League itu dibeli pengusaha media asal Serbia senilai 100 juta paun atau sekitar Rp 1,94 triliun. https://t.co/CV7djnSA7E",5,0,0,0,2022-01-04,20,Tuesday,2,5,0
1478455304010575878,2022-01-04 19:56:27,Liverpool membatalkan sesi latihan hari Selasa karena merebaknya COVID-19. Kini laga kontra Arsenal di Piala Liga Inggris pun jadi tanda tanya. https://t.co/QoZ7HEMxEH,5,0,0,0,2022-01-04,19,Tuesday,2,5,0
1478454315165810688,2022-01-04 19:52:31,"""Mahkamah Agung tidak memberikan permohonan fatwa yang pemohonnya bersifat perorangan,"" demikian bunyi surat panitera MA Ridwan Mansyur. https://t.co/JsWWrYNRXF",3,0,0,0,2022-01-04,19,Tuesday,2,3,0
1478452748886720521,2022-01-04 19:46:18,Momen Anies Baswedan saat makan di warteg sempat jadi meme. Hingga saat ini meme Anies itu masih ramai di media sosial. Simak lagi kilas baliknya: https://t.co/QFmR4VGqf6,6,1,0,1,2022-01-04,19,Tuesday,2,6,2
1478451759534252037,2022-01-04 19:42:22,"M Ramdan Dzuhri (10), siswa kelas 4 Madrasah Ibtidaiyah di Magetan, meninggal sehari usai divaksinasi. Keluarga menerima dan mengikhlaskan kepergian Ramdan. https://t.co/sKNEYpbHxk",8,2,3,0,2022-01-04,19,Tuesday,2,11,2
1478450447946027015,2022-01-04 19:37:09,Musyawarah Daerah (Musda) Partai Demokrat NTT diwarnai kericuhan. Sejumlah massa yang tak terima dengan hasil musda membakar atribut partai. https://t.co/rxWP3t5CnU,6,5,1,0,2022-01-04,19,Tuesday,2,7,5
1478448643371941894,2022-01-04 19:29:59,Ketum PBNU Yahya Cholil Staquf mengapresiasi tindakan tegas Polri yang telah menetapkan Bahar Smith sebagai tersangka terkait kasus penyebaran berita bohong. https://t.co/VMaTt4yKvb,340,111,46,14,2022-01-04,19,Tuesday,2,386,125
1478447635702890511,2022-01-04 19:25:59,"Aksi nekat Hendi membunuh sang istri, Risnawati (41), membuatnya kini berurusan dengan polisi. Usai mengakui perbuatannya, ia kini ditahan di Mapolres Garut. https://t.co/OzkViFjsoV",4,0,1,0,2022-01-04,19,Tuesday,2,5,0
1478446326232883205,2022-01-04 19:20:47,Narji PKS minta maaf karena pernah mendukung Jenderal Dudung soal pencopotan baliho di Jakarta. Begini retrospeksi (kilas balik) dukungan Narji. https://t.co/Aj9uyOxzaf,97,58,12,5,2022-01-04,19,Tuesday,2,109,63
1478444802303832064,2022-01-04 19:14:43,Sebuah video beredar di sosial media memperlihatkan seorang ibu di Sumut mengeluhkan biaya pemotongan dana bantuan sekolah anaknya. Seperti apa? https://t.co/cXVmucva6p,9,0,5,0,2022-01-04,19,Tuesday,2,14,0
1478444187024605186,2022-01-04 19:12:17,Hakim anggota Mulyono Dwi Purwanto memberikan dissenting opinion dalam putusan 4 terdakwa kasus korupsi di ASABRI. https://t.co/zGEMyIg4DF,2,0,0,0,2022-01-04,19,Tuesday,2,2,0
1478442938938150913,2022-01-04 19:07:19,"Satlantas Polres Tasikmalaya memanfaatkan knalpot bronk menjadi sebuah karya seni berupa patung robot Transformers. Wuih, keren! https://t.co/P0qfa9R0xf",5,0,0,1,2022-01-04,19,Tuesday,2,5,1
1478441629132460045,2022-01-04 19:02:07,"Polisi menangkap pemilik kapal yang mengangkut PMI secara ilegal dari Indonesia ke Johor Bahru, Malaysia. Pelaku ternyata juga mempunyai penampungan ilegal. https://t.co/DzVuCWsdbh",6,0,0,2,2022-01-04,19,Tuesday,2,6,2
1478439709084950531,2022-01-04 18:54:29,Komedian Narji menjelaskan alasannya memilih menjadi kader PKS. Narji juga menyampaikan permintaan maaf atas sikapnya terkait pencopotan baliho HRS. https://t.co/5SGBAo2WNz,14,21,2,0,2022-01-04,18,Tuesday,2,16,21
1478438664342495237,2022-01-04 18:50:20,Delapan unit mobil dinas pimpinan DPRD Klaten tiba-tiba ditarik Pemkab. Berikut alasan di balik penarikan mobdin ini. https://t.co/dZy6Px31PL,4,0,1,0,2022-01-04,18,Tuesday,2,5,0
1478437368654880775,2022-01-04 18:45:11,BPS beberapa hari lalu merilis indeks kebahagiaan di sejumlah provinsi di Indonesia. Indeks kebahagiaan itu disinggung bohong oleh epidemiolog Pandu Riono. https://t.co/x8ECXqtk8l,3,2,2,0,2022-01-04,18,Tuesday,2,5,2
1478436113912152065,2022-01-04 18:40:12,"""Dari hasil investigasi sementara ternyata terduga pelaku sudah bukan pengurus BEM, tetapi sudah demisioner,"" ujar Kepala Biro Humas dan Protokol UMY. https://t.co/a1uS5GsP9f",25,1,3,2,2022-01-04,18,Tuesday,2,28,3
1478434834339008522,2022-01-04 18:35:07,Bivitri menyatakan pemilu adalah untuk memilih wakil rakyat di parlemen. Namun tidak otomatis memberikan hak ke parlemen untuk membuat presidential threhold. https://t.co/rb6QJ1WL32,5,4,3,1,2022-01-04,18,Tuesday,2,8,5
1478433760089710606,2022-01-04 18:30:51,FIFA telah mengumumkan tiga finalis untuk Puskas Award. Salah satu dari tiga gol sepanjang 2021 bakal dinobatkan sebagai yang terindah. https://t.co/yNAyWT1NRT,3,0,0,0,2022-01-04,18,Tuesday,2,3,0
1478432501706248199,2022-01-04 18:25:51,"Galaxy S21 FE jadi penerus Galaxy S20 FE dengan membawa sejumlah peningkatan, namun perlukah upgrade? Ini perbandingan kedua ponsel tersebut:  https://t.co/TDKWkQvx5X",4,1,1,0,2022-01-04,18,Tuesday,2,5,1
1478429164885655553,2022-01-04 18:12:35,Pemerintah memangkas masa karantina untuk pelaku perjalanan luar negeri dari 14 menjadi 10 hari. Berikut daftar negara yang wajib karantina 10 hari. https://t.co/uzUUQ27uUm,2,0,1,0,2022-01-04,18,Tuesday,2,3,0
1478427859802808322,2022-01-04 18:07:24,Boneka arwah saat ini banyak dirawat seperti bayi atau anak-anak pada umumnya. Berikut fakta-fakta di baliknya: https://t.co/3m4JdhWZGi,10,8,2,1,2022-01-04,18,Tuesday,2,12,9
1478425970986172423,2022-01-04 17:59:53,Hendi tertunduk lesu. Dia kini terpaksa berurusan dengan polisi karena membunuh istrinya. https://t.co/8hCK9jVGGt,5,0,1,1,2022-01-04,17,Tuesday,2,6,1
1478424456414572544,2022-01-04 17:53:52,Dua anggota polisi yang berdinas di Polda Gorontalo bernama Brigadir Sumarlin Maksud dan Briptu Ratno Saputra dipecat. Mereka dipecat usai 'hilang' tanpa izin. https://t.co/vPFdzVdN6E,34,0,6,0,2022-01-04,17,Tuesday,2,40,0
1478422964458639365,2022-01-04 17:47:57,Seorang pengendara motor perempuan tewas terlindas truk di Bekasi. IP terjatuh diduga karena jalan licin. https://t.co/Fuqq7TkN2t,7,0,2,0,2022-01-04,17,Tuesday,2,9,0
1478422187531030540,2022-01-04 17:44:51,"Balita asal Kentucky, Amerika Serikat, Jalayne Sutherland menjadi sorotan setelah fotonya yang berdandan ala Ratu Elizabeth ditanggapi oleh pihak Istana. Ratu Elizabeth mengaku senang dengan foto Jalayne yang terlihat lucu. https://t.co/nvlnNtkumF",2,0,0,0,2022-01-04,17,Tuesday,2,2,0
1478420619935035398,2022-01-04 17:38:38,Sederet lagu K-pop yang rilis pada 2012 silam ini masih populer dan lekat diingatan para penggemar. Ini daftarnya:  https://t.co/ogGyu2AK8L,6,0,1,0,2022-01-04,17,Tuesday,2,7,0
1478419514954031108,2022-01-04 17:34:14,Kali ini lebih dari satu juta orang di sebuah kota di China tengah dikurung di rumah setelah mencatat tiga kasus virus corona tanpa gejala. https://t.co/p1jDOon4Ma,3,0,4,0,2022-01-04,17,Tuesday,2,7,0
1478418115943972867,2022-01-04 17:28:41,Jenderal Dudung memerintahkan jajarannya menghapus tradisi satuan yang menimbulkan korban jiwa. Dia meminta pengawasan diperketat. https://t.co/HZpPeNWzOn,11,0,2,0,2022-01-04,17,Tuesday,2,13,0
1478417118311993353,2022-01-04 17:24:43,Skotlandia berencana akan mengampuni 'penyihir' yang dieksekusi pada 400 tahun lalu. Ini kisahnya:  https://t.co/gH6OTMJ9pV,13,6,6,1,2022-01-04,17,Tuesday,2,19,7
1478416125092409349,2022-01-04 17:20:46,"Vaksin Merah Putih buatan Unair disebut bisa menetralisir COVID-19 varian Omicron. Memang, apa kelebihannya? https://t.co/QGP4SAg9F7",5,0,2,0,2022-01-04,17,Tuesday,2,7,0
1478415068232572937,2022-01-04 17:16:34,"Harjono menyatakan fungsi pemilu adalah membuat ambang batas di segala lini politik, seperti presidential threshold. Buat apa ada pemilu bila tak ada threshold? https://t.co/TRhvS228xU",42,7,14,2,2022-01-04,17,Tuesday,2,56,9
1478413870620454913,2022-01-04 17:11:49,Nurul sempat tak percaya saat tahu dirinya didapuk sebagai pemenang NMAX. Kok bisa sih? Gimana caranya? https://t.co/B0YTTW7cwO,6,0,1,0,2022-01-04,17,Tuesday,2,7,0
1478412941707853834,2022-01-04 17:08:07,Israel menyetujui pemberian vaksin dosis keempat untuk kelompok rentan terhadap COVID-19. Pemberian vaksin ini untuk mengantisipasi kasus yang dipicu Omicron. https://t.co/KYMVfwlEWu,8,2,2,2,2022-01-04,17,Tuesday,2,10,4
1478411644724293641,2022-01-04 17:02:58,Israel tengah dilanda kombinasi kasus Covid-19 dan influenza atau yang ramai disebut dengan Florona. Prof. Nadav Davidovitch menyebutkan sejumlah langkah yang dilakukan untuk mencegah sistem kesehatan mereka runtuh. https://t.co/dLhlfTaDZo,4,0,2,1,2022-01-04,17,Tuesday,2,6,1
1478411310085906435,2022-01-04 17:01:38,"Meskipun memiliki harta melimpah, orang-orang terkaya di dunia tetaplah seorang manusia. Mereka punya kebiasaan-kebiasaan aneh... yang berbeda dengan orang biasa. https://t.co/pzLobkzHgh",3,0,1,0,2022-01-04,17,Tuesday,2,4,0
1478411291198951427,2022-01-04 17:01:34,Banyak netizen kesal setelah Edric Tjandra mengunggah video TikTok. Pasalnya para netizen tidak rela ketika melihat Edric mmebuat kulit ayam goreng tepung. https://t.co/roM8BNIFo1,5,2,1,2,2022-01-04,17,Tuesday,2,6,4
1478410566876254216,2022-01-04 16:58:41,Mahasiswa di salah satu Perguruan Tinggi di Jakarta ditemukan tewas gantung diri di lantai dua sebuah warkop di Aceh Besar. Korban ngekos bersama ayahnya. https://t.co/gEtTuxM2NR,8,1,1,1,2022-01-04,16,Tuesday,2,9,2
1478409437689823254,2022-01-04 16:54:12,Keberadaan transportasi canggih bernama Mass Rapid Transit (MRT) telah merubah wajah ibu kota. Begini penampakannya. https://t.co/yyefRSo8He,6,3,2,0,2022-01-04,16,Tuesday,2,8,3
1478408651757047808,2022-01-04 16:51:04,Seorang pria tidak suka makan sayur sama sekali. Secara tidak sadar ia ditipu oleh sang kekasih agar makan sayuran tanpa ia ketahui. https://t.co/zOXxevY8k3,6,0,1,1,2022-01-04,16,Tuesday,2,7,1
1478407543407927296,2022-01-04 16:46:40,Kominfo mengumumkan persetujuan atas merger dan akuisisi PT Indosat Tbk dengan PT Hutchison 3 Indonesia. Kominfo mengungkapkan hak dan kewajibannya: https://t.co/LgtW8QMA23,8,2,4,1,2022-01-04,16,Tuesday,2,12,3
1478406766924898309,2022-01-04 16:43:35,"Banjir bandang yang terjadi di Padang Lawas (Palas), Sumatera Utara (Sumut), menyisakan kerugian yang mendalam bagi masyarakat. Banyaknya gelondongan kayu yang terbawa air membuat ratusan rumah warga rusak. https://t.co/Aek453WRfg",9,1,1,1,2022-01-04,16,Tuesday,2,10,2
1478405436919398403,2022-01-04 16:38:18,Publik dibuat bingung aturan masa karantina yang kerap berubah. Idealnya berapa lama sih aturan masa karantina di tengah temuan Omicron? https://t.co/2thsr9fvvF,7,1,2,1,2022-01-04,16,Tuesday,2,9,2
1478403614477590531,2022-01-04 16:31:03,"Fox Logger, startup GPS tracker pelacak kendaraan, menatap optimis tahun 2022. Startup ini berambisi untuk meraup omzet naik 100% dibandingkan tahun sebelumnya. https://t.co/hBSLS6uQJb",4,0,3,0,2022-01-04,16,Tuesday,2,7,0
1478403591102730247,2022-01-04 16:30:58,Presiden Jokowi meminta pembahasan RUU TPKS dipercepat dan segera disahkan. Menteri PPPA Bintang Puspayoga akan mengawal percepatan RUU TPKS tersebut. https://t.co/4SXIHUXfwL,24,0,2,2,2022-01-04,16,Tuesday,2,26,2
1478402749998014464,2022-01-04 16:27:37,"Banyak kisah viral seputar pecel lele yang bikin orang tertawa bahkan terhibur. Mulai dari binaragawan jualan pecel lele, hingga diputusin karena pecel lele. https://t.co/qv435R6WRL",2,0,1,0,2022-01-04,16,Tuesday,2,3,0
1478401622170607619,2022-01-04 16:23:08,"Memasuki tahun 2022, tren kuliner diprediksi berubah dan berkembang.Tak sepenuhnya meninggalkan tren kuliner 2021, pakar kuliner memiliki pandangan tambahan. https://t.co/q7xkzM7frt",2,0,3,0,2022-01-04,16,Tuesday,2,5,0
1478400726196015107,2022-01-04 16:19:35,Siswa MI di Magetan meninggal sehari usai vaksinasi. Orang tua mengaku kaget dan tidak mengira putranya akan meninggal dunia. https://t.co/ARn2VMbbxc,22,8,12,1,2022-01-04,16,Tuesday,2,34,9
1478399424074289168,2022-01-04 16:14:24,"Sumur resapan di Cipinang Indah dinilai tidak efektif. Meski sudah ada sumur resapan, warga mengaku masih ada genangan di jalan usai hujan. #detikcomdoyourmagic https://t.co/rIlxMw91Ki",3,3,1,1,2022-01-04,16,Tuesday,2,4,4
1478398185634734089,2022-01-04 16:09:29,Partai Ummat mendorong syarat ambang batas 20 persen dalam pencalonan presiden dan wakil presiden menjadi nol persen. https://t.co/Ws10kYyCll,28,31,2,1,2022-01-04,16,Tuesday,2,30,32
1478395973965647875,2022-01-04 16:00:42,"Seorang pria bernama Munas Mulyadi (64) ditemukan meninggal di Jl MT Haryono, Jakarta Selatan. Korban diketahui merupakan purnawirawan Polri. https://t.co/6ZH9ieQhwp",16,1,9,0,2022-01-04,16,Tuesday,2,25,1
1478395972329877514,2022-01-04 16:00:41,Kasus dugaan investasi bodong di Makassar bikin gempar. Belasan warga menjadi korban dan kerugian ditaksir mencapai Rp 10 miliar. https://t.co/y7WOfBjVWZ,5,1,3,0,2022-01-04,16,Tuesday,2,8,1
1478395182571732998,2022-01-04 15:57:33,Percayakah detikers jika ada seorang pria yang telah memiliki belasan istri hingga ratusan anak? Jika tidak maka yuk kenalan dengan sosok Misheck Nyandoro ini!  https://t.co/frE760cF52,7,1,2,0,2022-01-04,15,Tuesday,2,9,1
1478393299799101446,2022-01-04 15:50:04,19 Warga di Makassar tertipu investasi bodong tambang digital dengan total kerugian mencapai Rp 10 miliar. Bagaimana ceritanya? https://t.co/EmPqkr3PK8,15,4,3,1,2022-01-04,15,Tuesday,2,18,5
1478393275912540161,2022-01-04 15:49:58,Pelaku perjalanan luar negeri diwajibkan untuk karantina selama 7-10 hari. Kepala BNPB Suharyanto menemukan masih ada warga belum mengetahui aturan tersebut. https://t.co/GMsffxsUHD,6,1,1,1,2022-01-04,15,Tuesday,2,7,2
1478392215823175681,2022-01-04 15:45:46,Rela bagikan potongan makanan yang dinilai paling enak kepada kekasih bukan hal mudah. Tapi hal ini membuat seseorang masuk ke dalam kriteria pasangan teladan. https://t.co/auXwwwa5eP,288,80,72,79,2022-01-04,15,Tuesday,2,360,159
1478390760844279810,2022-01-04 15:39:59,Musyawarah Daerah (Musda) DPD Partai Demokrat kembali ricuh. Kericuhan terjadi di DPD Partai Demokrat NTT karena massa memprotes ketua DPD pilihan AHY. https://t.co/lJUc4V12VI,18,4,3,0,2022-01-04,15,Tuesday,2,21,4
1478390274569220104,2022-01-04 15:38:03,Salah seorang anggota TNI tersangka tabrak lari Handi-Salsa yakni Kopral Dua Dwi Atmoko berasal dari Gunungkidul. Seperti apa sosoknya di mata tetangga? https://t.co/GmYScYjYgT,1,1,0,1,2022-01-04,15,Tuesday,2,1,2
1478389145148002308,2022-01-04 15:33:34,Rumah milik tersangka kasus investasi bodong alkes di kawasan Tangerang Selatan jadi sasaran vandalisme. Berikut penampakannya! https://t.co/5Q6Ssou07J,6,1,6,0,2022-01-04,15,Tuesday,2,12,1
1478388610802110466,2022-01-04 15:31:26,Doddy Sudrajat membantah menerima uang asuransi Rp 500 juta. Ia bahkan mengancam akan melaporkan orang yang menuduhnya! https://t.co/umuCnkRGCA,16,7,2,3,2022-01-04,15,Tuesday,2,18,10
1478388028871786497,2022-01-04 15:29:07,Apa itu PayPal? Apakah kamu masih asing dengan aplikasi yang dulunya sahamnya juga dimiliki Elon Musk? Simak penjelasannya di sini:  https://t.co/T7xGx4eMvL,15,0,9,0,2022-01-04,15,Tuesday,2,24,0
1478387164522196993,2022-01-04 15:25:41,Tak cuma cerita klasik Winnie the Pooh karya AA Milne saja yang masuk domain publik namun juga novel Ernest Hemingway hingga buku puisi Kahlil Gibran. https://t.co/YQSzbDyeY6,5,0,1,0,2022-01-04,15,Tuesday,2,6,0
1478386152340131844,2022-01-04 15:21:40,Saat ini Indonesia heboh dengan boneka arwah yang diperlakukan sebagai anak. Di Jepang heboh boneka seks wanita yang dijadikan seperti layaknya kekasih. Mahalan mana? https://t.co/PlPrg9ze2j,13,8,9,2,2022-01-04,15,Tuesday,2,22,10
1478386133818089473,2022-01-04 15:21:36,Daftar orang terkaya dunia ditinggalkan sejumlah nama pada 2021. Beberapa orang terkaya dunia wafat dan meninggalkan harta ratusan triliun rupiah. https://t.co/bSghSE3UL2,5,0,2,0,2022-01-04,15,Tuesday,2,7,0
1478385108767985665,2022-01-04 15:17:31,Ini sinopsis drama Korea Ghost Doctor yang akan tayang perdana di tvN dan TVING pada 3 Januari 2022: #GhostDoctor  https://t.co/H4SIgBbhD7,12,0,6,0,2022-01-04,15,Tuesday,2,18,0
1478384803317796867,2022-01-04 15:16:18,"""Nggak akan ada yang bisa gantiin adik aku sih emang. Aku masih nggak tahu adilnya itu bagaimana,"" kata Greta Irene. https://t.co/hlsyclZpav",15,0,3,1,2022-01-04,15,Tuesday,2,18,1
1478384047713832973,2022-01-04 15:13:18,"""Awalnya saya pikir saya ditipu, tetapi perusahaan kartu kredit mengatakan ini semua adalah transaksi yang sah,"" https://t.co/KHFIcQqgum",36,5,10,15,2022-01-04,15,Tuesday,2,46,20
1478382990732447746,2022-01-04 15:09:06,Boneka arwah yang saat ini sedang digandrungi oleh para selebriti tanah air disebut bisa memberikan keberuntungan ke pemiliknya. Contohnya kayak mereka-mereka ini nih: https://t.co/bSweK6pHAy,15,28,2,7,2022-01-04,15,Tuesday,2,17,35
1478382244184182791,2022-01-04 15:06:08,"Ada museum interaktif bernama Robostation, di Moskow, Rusia. Melalui museum tersebut pengunjung akan diperkenalkan dengan berbagai jenis robot. Seperti apa? https://t.co/6RSV52t5Pz",1,0,2,4,2022-01-04,15,Tuesday,2,3,4
1478381629873741826,2022-01-04 15:03:42,Ketua Umum Pemuda Muhammadiyah Sunanto mengapresiasi gerak cepat Polri menangani kasus ini. https://t.co/a714rN8OYJ,222,23,45,6,2022-01-04,15,Tuesday,2,267,29
1478381079212003335,2022-01-04 15:01:30,"Setya Novanto mengajukan PK terkait putusan 15 tahun penjara karena korupsi proyek pengadaan e-KTP. Kini sudah dua tahun berlalu, MA belum juga mengetok palu. https://t.co/AXMEW9fRZc",21,2,5,1,2022-01-04,15,Tuesday,2,26,3
1478380028182290438,2022-01-04 14:57:20,Mau tahu peristiwa penting dan bersejarah apa saja tentang bitcoin yang terukir di sepanjang 2021? Cek yuk! https://t.co/hsFwNoi8Na,13,0,3,0,2022-01-04,14,Tuesday,2,16,0
1478377408373964806,2022-01-04 14:46:55,"Rudiantara memastikan peran barunya di Indosat Ooredoo Hutchison, tidak menimbulkan konflik kepentingan.  https://t.co/lyM5MxRVKl",10,4,1,1,2022-01-04,14,Tuesday,2,11,5
1478376860916531203,2022-01-04 14:44:45,Nasi yang direndam sop ayam ini teksturnya jadi lembut. Isiannya ayam dan wortel. Mudah dinikmati buat yang sedang flu atau sakit tenggorokan. https://t.co/Ldl9SpQVge,17,1,3,1,2022-01-04,14,Tuesday,2,20,2
1478375793575219201,2022-01-04 14:40:30,Kosta Eleftheriou memperingatkan pengguna iPhone dan iPad terhadap sejumlah aplikasi streaming penipu yang ada di App Store.  https://t.co/wkw8RY1rlq,6,0,2,0,2022-01-04,14,Tuesday,2,8,0
1478374888167596033,2022-01-04 14:36:54,Boneka Arwah populer di kalangan selebriti seperti Ivan Gunawan dan Ruben Onsu. Ini alat untuk mendeteksi boneka terisi arwah atau tidak:  https://t.co/adNUW51cy9,21,13,7,13,2022-01-04,14,Tuesday,2,28,26
1478374873185636352,2022-01-04 14:36:51,"Media sosial mendadak menampilkan trending girl band Kpop Kep1er. Menyebut namanya, mendadak jadi teringat seorang Johanes Kepler. Ini profilnya:  https://t.co/aiAw0ej3hl",5,2,1,1,2022-01-04,14,Tuesday,2,6,3
1478374267901419526,2022-01-04 14:34:26,"Abelle Senjaya dikenal usai jadi salah satu anggota girl group StarBe. Sebelum bergabung, ternyata ia seorang atlet.  https://t.co/PfOXVTywF5",20,0,4,0,2022-01-04,14,Tuesday,2,24,0
1478373683722915851,2022-01-04 14:32:07,KSP menyatakan pemberlakuan PTM dengan kapasitas 100 persen sudah mempertimbangkan kesiapan warga sekolah. Simak penjelasannya: https://t.co/rybxOWxQDB,6,0,1,0,2022-01-04,14,Tuesday,2,7,0
1478373125653946375,2022-01-04 14:29:54,"Samsung Galaxy S21 FE resmi diperkenalkan. Tidak hanya peningkatan spesifikasi, sejumlah pembaruan dihadirkan membuat berbagai sisi ponsel ini menggoda. https://t.co/vsQRPSjt6e",12,3,3,0,2022-01-04,14,Tuesday,2,15,3
1478372641035665413,2022-01-04 14:27:59,Tiga pelaku pembunuhan H dan S diduga berupaya menghilangkan jejak kejahatannya dengan mengganti warna cat mobil dan membuang identitas korban. Simak ceritanya: https://t.co/9j5NSgYuKa,19,1,10,2,2022-01-04,14,Tuesday,2,29,3
1478372288848441353,2022-01-04 14:26:35,Menkominfo Johnny G Plate menyambut beroperasinya PT Indosat Ooredoo Hutchison. Dia berharap industri telekomunikasi makin semarak di tahun 2022. https://t.co/R8O0MWp1AJ,10,1,6,0,2022-01-04,14,Tuesday,2,16,1
1478372035944407042,2022-01-04 14:25:34,Film Master yang dibintangi Vijay dan Vijay Sethupathi jadi film terlaris di India pada 2021. Mereka berhasil mencetak pendapatan hingga Rp 480 miliar.  https://t.co/75Cjgsztyu,6,0,1,0,2022-01-04,14,Tuesday,2,7,0
1478371453288525825,2022-01-04 14:23:15,Warga yang tengah berkunjung langsung panik dan kocar kacir. Hii! https://t.co/hblf7Wmg9N,7,1,1,0,2022-01-04,14,Tuesday,2,8,1
1478371068742152198,2022-01-04 14:21:44,"Prancis dihebohkan oleh temuan B.1.640.2, varian terbaru COVID-19 yang masuk daftar WHO setelah Omicron. WHO menggolongkannya sebagai Variant Under Monitoring. https://t.co/9UZWsJo8x8",8,3,10,12,2022-01-04,14,Tuesday,2,18,15
1478371067420889089,2022-01-04 14:21:43,Terdakwa kasus dugaan korupsi dana ASABRI Letjen TNI (Purn) Sonny Widjaja dan Mayjen TNI (Purn) Adam Damiri jalani sidang vonis. Mereka divonis 20 tahun penjara https://t.co/73B97vAHan,6,5,6,0,2022-01-04,14,Tuesday,2,12,5
1478370506017492992,2022-01-04 14:19:30,Raksasa teknologi Apple sempat berhasil mencapai kapitalisasi pasar senilai US$ 3 triliun atau sekitar Rp 42.600 triliun. https://t.co/y2MT0iU564,8,0,3,0,2022-01-04,14,Tuesday,2,11,0
1478369647800074246,2022-01-04 14:16:05,Seekor monyet ditangkap warga Tangerang Selatan. Monyet liar ini dianggap meresahkan karena sering mengejar warga. https://t.co/EnFNGsrQRR,11,6,1,3,2022-01-04,14,Tuesday,2,12,9
1478369062166093825,2022-01-04 14:13:45,Galaxy A03s adalah generasi selanjutnya dari Galaxy A02s yang jadi salah satu HP Rp 1 jutaan dan banyak diminati.  https://t.co/yJmhK51ZMT,6,0,1,0,2022-01-04,14,Tuesday,2,7,0
1478368759131824128,2022-01-04 14:12:33,"Sebagai seorang pembersih jasa trauma, Kim Sae Byoul punya makna kematian tersendiri baginya. #KimSaeByoul #Spotlight  https://t.co/V0cWp2MtXY",15,0,4,0,2022-01-04,14,Tuesday,2,19,0
1478367924922499077,2022-01-04 14:09:14,"Pesan kue pengantin secara online, pasangan ini justru kecewa. Kue pengantin pesanannya dalam keadaan miring dan dekorasinya disebut mirip urat. https://t.co/JzWYnGOD8H",6,0,1,0,2022-01-04,14,Tuesday,2,7,0
1478367425859047425,2022-01-04 14:07:15,"Kisah Layangan Putus yang diangkat dari novel karya Mommy ASF kini viral ditayangkan di layar kaca. Namanya ikut terseret, Lola Diara buka suara. #detikNetwork  https://t.co/RgrOAUPhS4",7,1,4,6,2022-01-04,14,Tuesday,2,11,7
1478366287827021827,2022-01-04 14:02:44,"Sementara di Indonesia heboh boneka arwah yang dianggap sebagai anak, Jepang heboh dengan boneka seks. Begini faktanya: https://t.co/dcrmSSbzvo",98,59,41,33,2022-01-04,14,Tuesday,2,139,92
1478366088303886336,2022-01-04 14:01:56,"Serial Layangan Putus yang viral belakangan ini diadaptasi dari novel karya Mommy ASF. Di sana, Kinan mengungkapkan hal yang diucapkan oleh si pelakor. #detikNetwork  https://t.co/0Lru8xdlJ9",7,0,1,1,2022-01-04,14,Tuesday,2,8,1
1478365765250256905,2022-01-04 14:00:39,Ferrari secara resmi meluncurkan logo khusus yang dibuat untuk menyambut perayaan ulang tahun ke-75.  https://t.co/EY80SKNNuh,5,0,1,0,2022-01-04,14,Tuesday,2,6,0
1478365741799952388,2022-01-04 14:00:34,"Secara tampilan, Aprilia SR GT memiliki tampang yang sporty, dengan gaya lampu depan mirip tampilan fascia sportbike mereka, RS 660.  https://t.co/izsHjYvAha",12,1,3,0,2022-01-04,14,Tuesday,2,15,1
1478365709604380674,2022-01-04 14:00:26,Otak pelaku penyerangan dan perusakan rumah karyawan berinisial AH di Riau akhirnya ditangkap. AH ditangkap usai jadi buron polisi sejak 24 November 2021. https://t.co/aBNaAAkOLj,4,0,1,0,2022-01-04,14,Tuesday,2,5,0
1478365219395092481,2022-01-04 13:58:29,"Kali ini, Denny Sumargo pun membongkar kedekatan Luna Maya dan Gading Marten. Gading Marten sebenarnya ada apa sih dengan Luna Maya? https://t.co/ETzjbjtWPo",1,1,0,1,2022-01-04,13,Tuesday,2,1,2
1478365202404061190,2022-01-04 13:58:25,"Keterbukaan informasi dan tingginya angka pengguna media sosial, menuntut para pedagang agar terjun ke internet untuk memasarkan produknya. Tak terkecuali bagi dealer mobil bekas.   https://t.co/7soB4mrMG3",2,0,0,0,2022-01-04,13,Tuesday,2,2,0
1478365189477224448,2022-01-04 13:58:22,Ahmad Sahroni merupakan Wakil Ketua Komisi III DPR RI sekaligus pengusaha yang dijuluki Crazy Rich Priok. Koleksi mobil mewahnya bikin ngiler!  https://t.co/iX6Un1hdL4,7,4,2,1,2022-01-04,13,Tuesday,2,9,5
1478364469080305675,2022-01-04 13:55:30,"PM Haiti, Ariel Henry, lolos dari percobaan pembunuhan yang dilakukan sekelompok pria bersenjata pada akhir pekan lalu. Bagaimana ceritanya? https://t.co/78f8pP1Eaj",0,0,1,0,2022-01-04,13,Tuesday,2,1,0
1478364446292594689,2022-01-04 13:55:25,"Awal 2022 akan ada platform gaming yang akan dirilis di Indonesia, namanya Venom. Ini yang menarik dari Venom:  https://t.co/P6UFRgGn7B",3,0,1,2,2022-01-04,13,Tuesday,2,4,2
1478363908192841746,2022-01-04 13:53:17,"Viral motor Volkspod kuning mentereng, bentuknya kecil seliweran di jalan!  https://t.co/5go5yaLFao",3,0,2,1,2022-01-04,13,Tuesday,2,5,1
1478363732241752066,2022-01-04 13:52:35,Sedang cari inspirasi untuk tampil kekinian sebagai salah satu resolusi tahun baru? Kamu bisa memulainya dari berpenampilan sesuai tren warna baju 2022. https://t.co/6ye9Rmh7fo,3,0,1,0,2022-01-04,13,Tuesday,2,4,0
1478363672615563275,2022-01-04 13:52:20,Simak harga motor matic Honda per Januari 2022. Termahal tembus Rp 86 jutaan.  https://t.co/PeW6jxbOta,3,2,0,0,2022-01-04,13,Tuesday,2,3,2
1478362901408792581,2022-01-04 13:49:17,Wakil Gubernur DKI Jakarta Ahmad Riza Patria disebut-sebut sebagai kandidat Gubernur Jakarta pengganti Anies. Intip koleksi mobil Ahmad Riza Patria.  https://t.co/dHsyc0qF0y,10,8,0,0,2022-01-04,13,Tuesday,2,10,8
1478362691974664196,2022-01-04 13:48:27,"Investasi kripto membuat banyak masyarakat ramai-ramai top up berharap raup keuntungan berlipat. Namun di balik itu, penipu pun bermunculan. #detiksAdvocate https://t.co/fPVYeIVNXS",6,2,1,1,2022-01-04,13,Tuesday,2,7,3
1478362672638967811,2022-01-04 13:48:22,"""Orang beli mobil apa saja, tidak masalah, selama punya uang yang cukup. Dalam konteks ini, tidak perlu dikaitkan dengan jabatan yang bersangkutan sebagai Sekdes,"" ujar Luqman. https://t.co/vPbqBlQ42i",25,4,8,1,2022-01-04,13,Tuesday,2,33,5
1478362107011907589,2022-01-04 13:46:07,Suzuki Indomobil Sales memastikan belum akan menaikan harga jual motor pada 2022. Artinya harga jual motor Suzuki di Indonesia masih sama seperti 2021 kemarin.  https://t.co/WEAKKRoFUe,11,1,1,0,2022-01-04,13,Tuesday,2,12,1
1478361631721771012,2022-01-04 13:44:14,Mitsubishi Motors Philippines Corporation (MMPC) meluncurkan SUV Pajero Sport yang lebih macho!  https://t.co/w7fRFlclyf,6,1,1,1,2022-01-04,13,Tuesday,2,7,2
1478361614604816387,2022-01-04 13:44:10,Pelat nomor atau disebut sebagai TNKB (Tanda Nomor Kendaraan Bermotor) menjadi bukti bahwa kendaraan tersebut sudah terdaftar di kepolisian. https://t.co/Zmr2nq7WYh,2,0,2,0,2022-01-04,13,Tuesday,2,4,0
1478361307569168386,2022-01-04 13:42:57,"Banjir merendam 14 kecamatan di Aceh Utara, Aceh. Sebanyak 32.854 jiwa jadi pengungsi. Curah hujan tinggi dan luapan air sungai menjadi penyebabnya. https://t.co/PRap5jLqmp",7,1,2,1,2022-01-04,13,Tuesday,2,9,2
1478361025762279424,2022-01-04 13:41:49,Heboh video pengemudi mobil menenteng benda mirip pistol setelah menabrak sepeda motor. Kejadian tersebut terekam CCTV dan viral di media sosial. https://t.co/LOe6EKwKoK,3,0,1,0,2022-01-04,13,Tuesday,2,4,0
1478361001217114115,2022-01-04 13:41:43,"Memasuki 2022, harga mobil mengalami kenaikan. Maklum, soalnya program relaksasi pajak penjualan atas barang mewah (PPnBM) untuk mobil baru telah berakhir.  https://t.co/MY2Ii8ncd6",1,0,1,0,2022-01-04,13,Tuesday,2,2,0
1478360982166589448,2022-01-04 13:41:39,Nasib pilu menimpa empat orang anak di Aceh. Mereka meninggal dunia usai menjadi korban banjir yang melanda empat kabupaten/kota di Serambi Mekah. https://t.co/VHojWiHFGA,3,0,0,0,2022-01-04,13,Tuesday,2,3,0
1478360393382776834,2022-01-04 13:39:19,"Menjelang detik-detik dimulainya gelaran MotoGP 2022, VR46 Racing mendapatkan sponsor dari Mooney, sebuah perusahaan perbankan asal Italia.  https://t.co/nW6IGksVCa",5,0,1,1,2022-01-04,13,Tuesday,2,6,1
1478360376332988417,2022-01-04 13:39:14,"#Foto Bikin speechless. Rumah yang satu ini bakal bikin pecinta mainan, khususnya Lego, mupeng. Seperti apa potret mewah rumah itu ya? https://t.co/PecE8OQYzp",0,0,0,1,2022-01-04,13,Tuesday,2,0,1
1478360129611485190,2022-01-04 13:38:16,Pada awal Desember 2021 NOAH resmi mengaransemen hingga rekaman ulang lagu-lagu dalam album Taman Langit milik Peterpan. https://t.co/jQy6JcWTF7,16,1,4,0,2022-01-04,13,Tuesday,2,20,1
1478359568346488836,2022-01-04 13:36:02,"Apple sudah menyiapkan aneka perangkat baru yang akan diluncurkan tahun ini. Mulai dari iPhone 14 sampai headset AR/VR, berikut ini daftar lengkapnya! https://t.co/3bWyYdU6So",16,2,2,3,2022-01-04,13,Tuesday,2,18,5
1478359552651403269,2022-01-04 13:35:58,Pengemudi Alphard ditangkap polisi setelah aksinya terekam dashcam tengah berkendara secara berbahaya!  https://t.co/w8zUIvYDwu,4,0,1,2,2022-01-04,13,Tuesday,2,5,2
1478358983710846977,2022-01-04 13:33:42,"Xiaomi dan OPPO terancam akan dikenakan dendan senilai Rp 1,9 triliun karena telah melanggar undang-undang yang berkaitan pajak. https://t.co/YX1IRvcIFP",11,0,1,1,2022-01-04,13,Tuesday,2,12,1
1478358966681972736,2022-01-04 13:33:38,DNA Bima Perkasa Jogja terus mematangkan persiapan menuju Indonesia Basketball League musim 2022. Mereka mematangkan strategi ke Jakarta.  https://t.co/FR3nvnsze9,8,0,0,0,2022-01-04,13,Tuesday,2,8,0
1478358722137268226,2022-01-04 13:32:40,"Booster vaksin COVID-19 ditargetkan mulai 12 Januari. Menkes menyebut terdapat rencana booster bakal diberikan setengah dosis (half dose) sekali suntik, kenapa? https://t.co/eM6Zlz2Nbd",2,0,0,1,2022-01-04,13,Tuesday,2,2,1
1478358700066750468,2022-01-04 13:32:35,"Deretan seleb Hollywood dari Emma Watson, Lady Gaga hingga Tom Cruise yang biasa tampil cantik sempurna diedit menjadi chubby menggemaskan. Seperti apa ya? https://t.co/BZ4U2EeWa1",4,0,0,0,2022-01-04,13,Tuesday,2,4,0
1478358372395196424,2022-01-04 13:31:17,"Barcelona sedang dikait-kaitkan dengan Alvaro Morata. Tapi, faktanya Los Cules mendatangkan Ferran Torres yang sesuai keinginan Xavi Hernandez.  https://t.co/gcO42QbnTX",2,1,0,0,2022-01-04,13,Tuesday,2,2,1
1478358370717470722,2022-01-04 13:31:16,"2021 jadi tahunnya kepopulerannya NFT, tak heran jika banyak perusahaan teknologi untuk mengadopsinya. Salah satunya Samsung. #NFT  https://t.co/n7dOvLhhcH",9,1,0,0,2022-01-04,13,Tuesday,2,9,1
1478358050167824388,2022-01-04 13:30:00,"Real Madrid bermimpi punya lini serang terbaik di dunia. Karim Benzema dan Vinicius lagi oke, nanti akan bersanding dengan Kylian Mbappe dan Erling Haaland.  https://t.co/wedcyx3tEN",5,1,1,1,2022-01-04,13,Tuesday,2,6,2
1478358048590684164,2022-01-04 13:30:00,Trent Alexander-Arnold meramalkan Manchester City akan tersandung di sisa musim ini. Tapi hal itu percuma jika Liverpool tidak bisa menang di saat bersamaan.  https://t.co/zuPU8tCfSK,2,1,0,2,2022-01-04,13,Tuesday,2,2,3
1478356493309255683,2022-01-04 13:23:49,Seorang emak-emak sengaja tiduran di tengah jalan di Banjarnegara agar dagangan makanan ringannya diborong. https://t.co/x3ShwPxkOT,31,11,5,2,2022-01-04,13,Tuesday,2,36,13
1478356161862803460,2022-01-04 13:22:30,Ralf Rangnick mengakui tugasnya di Manchester United tidak mudah. Kekalahan dari Wolverhampton bak jadi pengingat terjalnya jalan yang harus dihadapi Rangnick.  https://t.co/p4ran3GFCV,4,0,0,0,2022-01-04,13,Tuesday,2,4,0
1478356160063455233,2022-01-04 13:22:29,Cassandra Angelie menjadi tersangka kasus prostitusi online. Ia disebut menawarkan diri dalam kegiatan tersebut. https://t.co/bqVgRa3hWj,2,0,0,0,2022-01-04,13,Tuesday,2,2,0
1478355865937797124,2022-01-04 13:21:19,Saat pasir melapisi salju yang turun bentuknya sudah seperti kelapa. Ada juga yang bilang mirip kue coklat tiramisu! https://t.co/KkAL71r3my,3,0,0,0,2022-01-04,13,Tuesday,2,3,0
1478355847050899460,2022-01-04 13:21:15,"Kabar baik untuk Premier League yang lagi dihantam badai virus corona. Untuk pertama kalinya dalam dua bulan terakhir, angka kasus menurun di bawah 100. Top!  https://t.co/FtPXeBIstB",1,0,2,0,2022-01-04,13,Tuesday,2,3,0
1478355285379014657,2022-01-04 13:19:01,Jakarta PPKM level 2 berlaku selama dua pekan hingga 17 Januari 2022. Berikut aturan terbaru yang perlu diperhatikan warga DKI! https://t.co/uJCHPWZ4D9,5,0,0,1,2022-01-04,13,Tuesday,2,5,1
1478355035385962501,2022-01-04 13:18:01,Timnas Indonesia menjalani Piala AFF 2020 yang menerapkan ketentuan bubble selama di Singapura. Tetapi aturan di dalam negeri mewajibkan mereka untuk karantina.  https://t.co/VotSU4GYZH,10,0,0,0,2022-01-04,13,Tuesday,2,10,0
1478355029664931845,2022-01-04 13:18:00,Ousmane Dembele belum juga memberi jawaban kepada Barcelona soal perpanjangan kontrak. Barcelona berharap Dembele bisa memberi jawaban secepatnya.  https://t.co/ybL7qAiO2Y,0,0,0,0,2022-01-04,13,Tuesday,2,0,0
1478354369498259456,2022-01-04 13:15:22,Sukses Thailand menjuarai Piala AFF 2020 membuat kinerja Alexandre Polking diakui. Pelatih berdarah Jerman-Brasil itu akan diperpanjang kontraknya.  https://t.co/gJ7KJzUw95,8,1,0,0,2022-01-04,13,Tuesday,2,8,1
1478354075163017218,2022-01-04 13:14:12,"Tahun berganti, orang-orang pun memulai resolusi Tahun Baru mereka. Ini tipsnya menurut sains supaya resolusi kalian berhasil. https://t.co/WApVv1hx5S",5,0,0,0,2022-01-04,13,Tuesday,2,5,0
1478353583083081728,2022-01-04 13:12:15,"Banyak perusahaan teknologi asal China menjadi besar bisnisnya dan ekspansi ke berbagai wilayah, termasuk Asia Tenggara. Bagaimana rasanya bekerja di sana? https://t.co/YvA1SwleYs",4,1,0,1,2022-01-04,13,Tuesday,2,4,2
1478353577160675350,2022-01-04 13:12:13,"Timnas Indonesia, yang berisi pemain muda, meraih prestasi sip di Piala AFF 2020. Skuad Garuda diyakini akan lebih oke 2-3 tahun lagi.  https://t.co/HH2WfxVlhg",7,2,0,0,2022-01-04,13,Tuesday,2,7,2
1478353297002176519,2022-01-04 13:11:07,"Gelar juara Liga 2 yang diraih Persis Solo membuat suporter begitu bahagia. Mereka mau izin arak-arakan trofi, tapi wali kota Solo Gibran tidak menjanjikan, sih!  https://t.co/JTbkGYKKB6",1,1,0,1,2022-01-04,13,Tuesday,2,1,2
1478353295743848448,2022-01-04 13:11:06,Berikut adalah contoh-contoh kalimat resolusi 2022 yang bisa kamu update status di akun media sosial kamu! https://t.co/8ZWHIIuWXK,2,0,1,0,2022-01-04,13,Tuesday,2,3,0
1478352919955185674,2022-01-04 13:09:37,Sambutan suporter Timnas Indonesia di Jakarta meninggalkan kesan buat Shin Tae-yong. Pelatih asal Korea itu merasa dihargai setelah ajang Piala AFF 2020.  https://t.co/RqFtafHdaP,73,3,8,0,2022-01-04,13,Tuesday,2,81,3
1478352637548498946,2022-01-04 13:08:29,"Generasi milenial yang tumbuh di era booming internet, memiliki karakteristik menyukai yang serba instan dan cepat. Bagaimana dalam hal investasi? https://t.co/nPAT2slxue",9,0,3,0,2022-01-04,13,Tuesday,2,12,0
1478352615553515533,2022-01-04 13:08:24,Manchester United dinilai belum mempunyai identitas di bawah asuhan Ralf Rangnick. Penampilan Setan Merah masih belum konsisten.  https://t.co/hoZmKmGcaU,1,1,0,0,2022-01-04,13,Tuesday,2,1,1
1478352396472532992,2022-01-04 13:07:32,"Tenggat waktu PKPU Sementara Garuda Indonesia berlangsung hingga 5 Januari 2022, tepatnya hingga pukul 17.00 WIB. https://t.co/dEFwDQYBIh",3,1,0,0,2022-01-04,13,Tuesday,2,3,1
1478352377170305026,2022-01-04 13:07:27,"Shin Tae-yong berharap kualitas dan mutu BRI Liga 1 ditingkatkan. Menurutnya, Thailand masih jadi nomor 1 di ASEAN karena Thai League bagus pengelolaannya.  https://t.co/VHnVFdRl4j",30,0,7,0,2022-01-04,13,Tuesday,2,37,0
1478352129555324928,2022-01-04 13:06:28,"Informasi terkini, peneror kepala anjing ke ponpes Bahar berjumlah 3 orang. Siapa? https://t.co/Wzfpr6BYeY",6,4,1,3,2022-01-04,13,Tuesday,2,7,7
1478352106524393472,2022-01-04 13:06:23,"Bukan Mason Mount, bukan N'Golo Kante, atau Jorginho. Inilah Mateo Kovacic, dirigen Chelsea di lini tengah yang memimpin 'orkestra' The Blues!  https://t.co/yG3wUxjUWn",6,0,0,0,2022-01-04,13,Tuesday,2,6,0
1478350884685897730,2022-01-04 13:01:31,Klub-klub K-League diklaim berlomba-lomba untuk mengamankan tanda tangan Pratama Arhan. Hal itu ramai diberitakan media-media Korea.  https://t.co/cqcI4YFiOw,20,0,2,0,2022-01-04,13,Tuesday,2,22,0
1478350675520151555,2022-01-04 13:00:42,"Seorang remaja putri di Bekasi, Jawa Barat, dipersekusi diduga gegara persoalan asmara. Kejadian tersebut terekam dan sempat viral di media sosial. https://t.co/N4n63RHxW7",4,0,1,0,2022-01-04,13,Tuesday,2,5,0
1478350649083445252,2022-01-04 13:00:35,Kementerian ESDM melarang ekspor batu bara selama Januari 2022. Sikap berbeda ditunjukkan Partai Gerindra dan PDIP soal larangan eskpor batu bara. https://t.co/nUVsZ62SRX,3,1,0,2,2022-01-04,13,Tuesday,2,3,3
1478350328806326279,2022-01-04 12:59:19,Skotlandia berencana akan mengampuni 'penyihir' yang dieksekusi pada 400 tahun lalu. Seperti apa ceritanya? https://t.co/spAShlFQIF,12,2,1,1,2022-01-04,12,Tuesday,2,13,3
1478350309328134144,2022-01-04 12:59:14,"Para ilmuwan Prancis mengidentifikasi varian terbaru COVID-19, B.1.640.2. Disebut varian IHU, sudah masuk pantauan WHO. https://t.co/froxEuec69",27,14,6,17,2022-01-04,12,Tuesday,2,33,31
1478349270717771780,2022-01-04 12:55:07,Kabar baik bagi kamu yang kepincut dengan Xiaomi 12 dan 12 Pro! Kedua ponsel ini segera dirilis di Indonesia. https://t.co/SjnU1UQx6t,3,0,0,0,2022-01-04,12,Tuesday,2,3,0
1478349251835011074,2022-01-04 12:55:02,"Siswa madrasah dapat mengikuti seleksi masuk PTN melalui jalur SNMPTN maupun SBMPTN. Simak ketentuannya yuk: 
Via: detikedu https://t.co/dqWy5oxpTW",4,0,0,0,2022-01-04,12,Tuesday,2,4,0
1478349042027532289,2022-01-04 12:54:12,"Ketua Umum Partai Solidaritas Indonesia, Giring Ganesha, menyampaikan ucapan selamat Tahun Baru 2022. Di kesempatan yang sama, Giring turut menyinggung indeks kebahagiaan warga DKI Jakarta yang turun. https://t.co/8m3pEdrMpF https://t.co/lzfGPtY4Kh",12,23,3,1,2022-01-04,12,Tuesday,2,15,24
1478348718000779271,2022-01-04 12:52:55,"Prodi vokasi yang bisa dipilih untuk SNMPTN 2022 hanya program sarjana terapan atau D4. Dear para peserta, simak penjelasannya yuk! Via: detikedu https://t.co/UCM9VKXdhd",3,0,0,0,2022-01-04,12,Tuesday,2,3,0
1478348421920612352,2022-01-04 12:51:44,Pihak kampus saat ini tengah menelusuri kebenaran dari informasi tersebut. https://t.co/CYZem9HrlM,27,4,5,5,2022-01-04,12,Tuesday,2,32,9
1478347123703922688,2022-01-04 12:46:35,Suara tembakan di Tangsel yang viral di medsos ternyata berasal dari penggerebekan narkoba oleh Ditresnarkoa Polda Metro Jaya. Satu pelaku tewas ditembak. https://t.co/xcIx42mW5u,4,2,1,1,2022-01-04,12,Tuesday,2,5,3
1478346043360256008,2022-01-04 12:42:17,Suara tembakan di wilayah Tangsel yang viral di medsos ternyata berasal dari penggerebekan narkoba oleh Ditresnarkoa Polda Metro Jaya. 1 pelaku tewas ditembak. https://t.co/UMjl83FVbr,16,0,1,0,2022-01-04,12,Tuesday,2,17,0
1478345223294144517,2022-01-04 12:39:02,Ancilla Irish Gabriella (25) yang hilang saat ikut Meditation Camp di Tangsel belum ditemukan. Keluarga mengirim pesan menyentuh. https://t.co/SMUx8yxSAy,11,2,1,1,2022-01-04,12,Tuesday,2,12,3
1478344691728977921,2022-01-04 12:36:55,Celine Evangelista punya lebih dari satu spirit doll. Celine tegas membantah boneka miliknya berisi arwah!  https://t.co/VcJH2CqwZM,4,3,0,1,2022-01-04,12,Tuesday,2,4,4
1478343662656491521,2022-01-04 12:32:50,"Karier Ferran Torres di Manchester City terbilang singkat. Tapi, Torres berterima kasih kepada Pep Guardiola yang sudah membuatnya lebih baik.  https://t.co/o3WOfhAxon",5,0,0,0,2022-01-04,12,Tuesday,2,5,0
1478343417671438337,2022-01-04 12:31:51,"Pelatih Timnas Indonesia, Shin Tae-yong mengaku mendapat perintah khusus dari Presiden Jokowi. Perintah apakah itu?  https://t.co/qsPip5IQcJ",51,7,3,3,2022-01-04,12,Tuesday,2,54,10
1478343397060526085,2022-01-04 12:31:46,"Lapas Kelas II B Blitar kembali dilempar narkoba. Kali ini, sebanyak 1.000 pil koplo dilempar dari luar tembok pembatas lapas. https://t.co/3QNKJ3vlox",4,1,0,0,2022-01-04,12,Tuesday,2,4,1
1478343098027720705,2022-01-04 12:30:35,Tottenham Hotspur akan menghadapi Chelsea di semifinal Piala Liga Inggris. Manajer Tottenham Antonio Conte berharap bisa reuni dengan Romelu Lukaku di lapangan.  https://t.co/p8BGL5RRsj,4,0,1,0,2022-01-04,12,Tuesday,2,5,0
1478343096731582468,2022-01-04 12:30:35,"Meski jadi tersangka, Cassandra tak ditahan, berikut alasannya. https://t.co/zAZCYKZ48M",5,1,0,1,2022-01-04,12,Tuesday,2,5,2
1478342811267309575,2022-01-04 12:29:27,Hendra Setiawan/Mohammad Ahsan akan memulai turnamen pertamanya di tahun 2022. Di Di India Open mereka berharap bisa menang tiap babak.  https://t.co/h9VHk7RT9y,20,0,1,2,2022-01-04,12,Tuesday,2,21,2
1478342318927355909,2022-01-04 12:27:29,Pihak keluarga masih mencari Ancilla Irish Gabriella (25) peserta meditation camp yang hilang di area Tangsel. Berikut potret Ancilla. https://t.co/qp01MId5E4,9,3,5,0,2022-01-04,12,Tuesday,2,14,3
1478341820212035595,2022-01-04 12:25:30,NasDem tertarik mencalonkan pasangan Ahmad Sahroni-Airin Rachmy Diani di Pilgub DKI 2024. NasDem menilai Sahroni-Airin pasangan ganteng dan cantik. https://t.co/Jq7bIdTWB3,31,66,4,4,2022-01-04,12,Tuesday,2,35,70
1478341486513172490,2022-01-04 12:24:11,Zikri Daulay jadi sorotan karena terlihat ciuman dengan Ayu Aulia. Ini kata Zikri Daulay soal ciuman dengan Ayu Aulia:  https://t.co/YfG49gb9zR,4,2,1,0,2022-01-04,12,Tuesday,2,5,2
1478339689253937156,2022-01-04 12:17:02,Hujan deras di Sidoarjo membuat Jalan Brebek di Waru Sidoarjo tergenang. Ketinggian air mencapai 10 hingga 20 cm. Akibatnya banyak roda dua yang mogok. https://t.co/Ny6K0RnH7R,9,0,2,1,2022-01-04,12,Tuesday,2,11,1
1478339456314875919,2022-01-04 12:16:07,"Kementerian PUPR mencatat 10 ruas tol baru sepanjang 122,9 kilometer telah beroperasi. Ini daftar lengkapnya: https://t.co/xxge4920gv",13,0,0,0,2022-01-04,12,Tuesday,2,13,0
1478338979183448068,2022-01-04 12:14:13,"Aplikasi satu ini memang menyajikan beragam fitur menarik. Namun di sisi lain, bahaya WhatsApp Aero juga tak boleh dikesampingkan. https://t.co/z7w9CaJKjN",8,0,3,1,2022-01-04,12,Tuesday,2,11,1
1478338959524700161,2022-01-04 12:14:08,"Fasilitasnya? Tidur bersama anak arwah di apartemen mewah, wifi gratis, makanan mewah, biaya transportasi dan uang makan jika keluar bersama anak arwah. Mau? https://t.co/T0SAxJj0eA",123,112,36,53,2022-01-04,12,Tuesday,2,159,165
1478338229346750466,2022-01-04 12:11:14,Fenomena boneka arwah belakangan ramai diperbincangkan. Sejumlah selebriti mengaku mengasuh boneka arwah seperti anak sendiri. https://t.co/sSjfejcf9E,5,3,0,1,2022-01-04,12,Tuesday,2,5,4
1478337418088570880,2022-01-04 12:08:01,Kehidupan seabad lalu sangat berbeda dengan dunia yang kita tinggali sekarang ini. Apa yang terjadi tahun 1922 dan peristiwa apa yang mengubah sejarah dunia? https://t.co/UhyxPkqN1N,11,1,4,0,2022-01-04,12,Tuesday,2,15,1
1478336096861888515,2022-01-04 12:02:46,Komnas Perempuan mengapresiasi pernyataan Presiden Jokowi yang meminta agar RUU TPKS segera disahkan. Komnas Perempuan menyinggung parpol yang masih menolak. https://t.co/ps3E9e6Mrb,13,0,3,1,2022-01-04,12,Tuesday,2,16,1
1478335577024086017,2022-01-04 12:00:42,"Psikolog menyebut tak ada yang salah dengan memainkan dan merawat boneka arwah yang menyerupai seperti seorang bayi. Namun, ini bisa menjadi bahaya ketika sudah terjerembab dalam ruang halusinasi. #CNNIndonesia #detikNetwork https://t.co/TuPptAJCqY",6,3,4,0,2022-01-04,12,Tuesday,2,10,3
1478335077541101572,2022-01-04 11:58:43,RM dan Jin BTS dinyatakan sembuh dari COVID-19. Hal itu disampaikan melalui pernyataan di weverse. #BTS  https://t.co/DoOcj4bpD0,8,0,0,1,2022-01-04,11,Tuesday,2,8,1
1478334764658659330,2022-01-04 11:57:28,"MA (19), seorang kurir online shop (olshop) ditangkap polisi. MA ditangkap karena diduga sebagai provokator tawuran menggunakan senjata tajam (sajam) https://t.co/C1diZqFOT3",0,0,3,0,2022-01-04,11,Tuesday,2,3,0
1478334763454849028,2022-01-04 11:57:28,Atribut Partai Demokrat dibakar massa yang memprotes hasil Musda DPD PD NTT. Demokrat melaporkan peristiwa pembakaran atribut itu ke polisi. https://t.co/6PPRjKnT2b,4,6,3,2,2022-01-04,11,Tuesday,2,7,8
1478334027425800192,2022-01-04 11:54:32,Boneka arwah atau spirit doll saat ini sedang tren di kalangan artis-artis Indonesia. Tren awal mulanya dari mana sih? https://t.co/ayeBZyLjWp,10,5,1,4,2022-01-04,11,Tuesday,2,11,9
1478334026243100673,2022-01-04 11:54:32,Viral informasi di berbagai media sosial yang menyebutkan cuaca dingin di Indonesia belakangan ini terjadi karena aphelion 2022. Ini penjelasan BMKG:  https://t.co/hpCR0PRD57,5,0,1,0,2022-01-04,11,Tuesday,2,6,0
1478333534850981897,2022-01-04 11:52:35,Kabar gembira untuk penggemar game Battle Royale besutan Garena Indonesia. Mereka kembali membagikan kode redeem Free Fire secara cuma-cuma. #FreeFire  https://t.co/51pQoSyBgb,1,1,0,0,2022-01-04,11,Tuesday,2,1,1
1478332744937652224,2022-01-04 11:49:27,PLTS Atap membentuk kemandirian masyarakat karena mengoptimalkan penghematan tagihan listrik berdasarkan kapasitas terpasang. https://t.co/NV3DC8P3UH,9,1,3,0,2022-01-04,11,Tuesday,2,12,1
1478332724863811584,2022-01-04 11:49:22,Moammar Emka bicara soal prostitusi online yang kembali melibatkan artis. Sebenarnya apa sih alasan dibalik selebriti sampai terjerat kasus prostitusi online? https://t.co/qFfYcpPzL0,13,0,5,0,2022-01-04,11,Tuesday,2,18,0
1478332199090929666,2022-01-04 11:47:17,"Manchester United kembali menelan kekalahan, yang ironinya itu terjadi saat bersua dengan Wolves. Ini kekalahan pertama sejak ditangani Ralf Rangnick. https://t.co/5N3pWDa7tF",4,4,1,2,2022-01-04,11,Tuesday,2,5,6
1478332197694279683,2022-01-04 11:47:16,Ahli kedokteran Forensik dari RS Polri mengungkap hasil visum korban kasus penembakan laskar FPI. Ahli Forensik menemukan luka tembak di dada korban. https://t.co/Z75MAXFbAq,18,2,6,0,2022-01-04,11,Tuesday,2,24,2
1478331703504650242,2022-01-04 11:45:18,Spider-Man: No Way Home berhasil jadi film paling laris di 2021 meskipun dirilis di akhir tahun. Ini total pendapatannya:  https://t.co/c6uN2qbcIn,13,1,1,0,2022-01-04,11,Tuesday,2,14,1
1478329716302090242,2022-01-04 11:37:25,"Pria ini menang lotre Rp 14,31 miliar saat berniat membeli susu untuk anaknya. Bah, mantap kali! Kok bisa sih? https://t.co/0OTVB4nfPV",16,6,2,2,2022-01-04,11,Tuesday,2,18,8
1478329691530539013,2022-01-04 11:37:19,"Rumah pasangan suami istri yang terletak di Desa Tanjung Tiram, Kecamatan Moramo Utara, Kabupaten Konawe Selatan, Sulawesi Tenggara (Sultra) dibakar warga. Hal ini lantaran pasutri tersebut diduga memiliki ilmu hitam. https://t.co/7NPZPTuK4e",1,1,0,0,2022-01-04,11,Tuesday,2,1,1
1478329418917597186,2022-01-04 11:36:14,"Spotlight Culture kali ini membahas tentang penulis buku Things Left Behind sekaligus pembersih trauma di Korea, Kim Sae Byoul. Simak di sini: #Spotlight  https://t.co/5ifwrhTbM2",3,0,0,0,2022-01-04,11,Tuesday,2,3,0
1478328900153450497,2022-01-04 11:34:10,Aroma ayam goreng KFC disukai banyak orang. Kini tak harus makan ayam goreng kalau hanya ingin menikmati aromanya. Ada kayu bakar dengan aroma ayam goreng KFC. https://t.co/KMl5ybzXHx,42,3,5,11,2022-01-04,11,Tuesday,2,47,14
1478328266486423552,2022-01-04 11:31:39,Nagita Slavina kembali mencuri perhatian melalui gayanya saat memakai cincin yang terlihat seperti cincin mainan tapi berharga puluhan juta. Intip yuk gayanya.  https://t.co/xXwXZ12hT6,12,3,2,2,2022-01-04,11,Tuesday,2,14,5
1478328247142297604,2022-01-04 11:31:34,"AS melaporkan lebih dari 1 juta kasus virus Corona (COVID-19) dalam sehari, atau sepanjang Senin (3/1) waktu setempat, di tengah penyebaran varian Omicron. https://t.co/hISYK9gazn",8,1,3,3,2022-01-04,11,Tuesday,2,11,4
1478327921005768708,2022-01-04 11:30:17,"Juru bicara Satgas COVID-19, Prof Wiku Adisasmito, mengatakan waktu pelaksanaan ini telah sesuai target WHO. Lalu, apa syaratnya? https://t.co/kTzFbcdQAD",3,0,2,0,2022-01-04,11,Tuesday,2,5,0
1478327159534018564,2022-01-04 11:27:15,Apakah siswa dari kurikulum prototipe bisa daftar PTN? Ketua LTMPT jawab begini. Via: detikedu https://t.co/oUkdRqAklN,2,0,3,0,2022-01-04,11,Tuesday,2,5,0
1478326619840335875,2022-01-04 11:25:06,Presiden okowi berharap Rancangan Undang-Undang Tindak Pidana Kekerasan Seksual segera disahkan menjadi UU. Begini progres terakhir perumusan RUU TPKS di DPR. https://t.co/9DQxeNPXS3,7,9,2,5,2022-01-04,11,Tuesday,2,9,14
1478325607842856960,2022-01-04 11:21:05,Wiku Adisasmito mengungkapkan ada kenaikan kasus COVID-19 di Jakarta dan Kepri. Dia meminta Anies dan Ansar bertindak. https://t.co/8wWfDDJE0k,5,1,2,1,2022-01-04,11,Tuesday,2,7,2
1478325098033602567,2022-01-04 11:19:03,Banjir Malaysia melanda tujuh negara bagian pada Minggu (2/1/2022). Ini sederet informasinya. https://t.co/jYGv20eXr3,4,0,0,0,2022-01-04,11,Tuesday,2,4,0
1478324365724983297,2022-01-04 11:16:09,"Jadi anak pertama, rasanya berat ya? detikcom mau kasih kamu handphone baru sebagai hadiah atas perjuanganmu nih! Simak caranya: https://t.co/zvvXbsybrA",6,0,3,0,2022-01-04,11,Tuesday,2,9,0
1478324328991232020,2022-01-04 11:16:00,Suara tembakan terdengar di wilayah Tangerang Selatan (Tangsel). Kabar ini viral di media sosial. https://t.co/6d2VkalstP,5,0,2,0,2022-01-04,11,Tuesday,2,7,0
1478323768451862537,2022-01-04 11:13:46,"Kasus omicron di Indonesia terus bertambah. Berdasarkan data GISAID, kasus omicron di Indonesia sudah terdeteksi sebanyak 164 orang. https://t.co/7NCOLW7nEU",10,3,4,1,2022-01-04,11,Tuesday,2,14,4
1478323241215307777,2022-01-04 11:11:41,UMY memastikan terduga pelaku pemerkosaan yang viral di akun Instagram dear_umycatcallers adalah seorang anggota BEM. https://t.co/g0nf6rWjDr,86,6,26,12,2022-01-04,11,Tuesday,2,112,18
1478322949451128834,2022-01-04 11:10:31,Tommy Kurniawan apresiasi kinerja BUMN. Ia melihat kepeduliannya kepada masyarakat. https://t.co/FhZftLKpwk,4,0,1,0,2022-01-04,11,Tuesday,2,5,0
1478322458000306181,2022-01-04 11:08:34,Bursa Pilgub DKI Jakarta 2024 menggeliat seiring masa jabatan Gubernur Anies Baswedan yang segera habis. Sejumlah kandidat muncul ke permukaan. https://t.co/BwZdQEKz14,4,0,2,0,2022-01-04,11,Tuesday,2,6,0
1478321979677622273,2022-01-04 11:06:40,Heboh sejumlah remaja nekat terjun ke sungai berarus deras di Trenggalek. Jawa Timur. Mereka kemudian meminta maaf atas apa yang telah mereka lakukan. https://t.co/9cMccxLpnZ https://t.co/LQoI8oCNyY,27,21,4,2,2022-01-04,11,Tuesday,2,31,23
1478321494413479937,2022-01-04 11:04:44,"Biasanya ketika orang meninggal, nggak akan ada lagi hubungan dengan pekerjaan, apalagi pendapatan. Tapi, berbeda dengan artis-artis dunia ini. Mereka tetap 'gajian' meskipun sudah tiada. Siapa saja ya? https://t.co/WcEKyezS3G",15,2,5,1,2022-01-04,11,Tuesday,2,20,3
1478321451480588288,2022-01-04 11:04:34,Perayaan tahun baru 2022 tetap meriah meski di tengah pandemi corona. Ini potret kemeriahannya di berbagai penjuru dunia:  https://t.co/ruBlgVflGl,1,1,2,0,2022-01-04,11,Tuesday,2,3,1
1478320049207271428,2022-01-04 10:59:00,Nama-nama kandidat Gubernur DKI Jakarta mulai bermunculan mengingat masa jabatan Anies Baswedan segera habis. Siapa saja? https://t.co/qhpTdmfhqc,6,1,1,2,2022-01-04,10,Tuesday,2,7,3
1478319137508270081,2022-01-04 10:55:22,TransJakarta sampai jam berapa hari ini? Pertanyaan ini mulai dicari tahu masyarakat seiring dengan status PPKM DKI Jakarta yang kembali ke level 2. https://t.co/JDrwESdif3,2,0,1,0,2022-01-04,10,Tuesday,2,3,0
1478318643700195329,2022-01-04 10:53:25,"Viral di media sosial oknum anggota TNI AD di Tanimbar, Maluku bertelanjang dada memukul remaja dan mengajak seorang pemuda untuk duel satu lawan satu. https://t.co/6rUf9ys5G7",24,13,10,1,2022-01-04,10,Tuesday,2,34,14
1478317918538579968,2022-01-04 10:50:32,"Iseng berjualan jajanan di depan rumah agar bisa sambil menjaga anak, wanita ini justru dibuatkan warung. Warung sederhana tapi keren ini banjir pujian netizen. https://t.co/4rSQId8iy0",5,0,3,0,2022-01-04,10,Tuesday,2,8,0
1478317424160169991,2022-01-04 10:48:34,Samsung punya sederet smartphone yang memiliki sejumlah fitur dan keunggulan yang berbeda. Salah satunya adalah seri Galaxy A. Ini rekomendasinya:  https://t.co/yxtfdM7aFg,3,0,1,0,2022-01-04,10,Tuesday,2,4,0
1478316927407857665,2022-01-04 10:46:35,"LaporCovid-19 menerima 33 laporan penyelewengan stok vaksin COVID-19 untuk vaksinasi booster. Diberikan kepada non nakes, bahkan dijual! Ini laporannya: https://t.co/899RT1pRGR",5,3,4,1,2022-01-04,10,Tuesday,2,9,4
1478316694263287809,2022-01-04 10:45:40,Presenter yang merangkap jadi YouTuber Aurel Valen menceritakan soal kehidupannya. Ia ngaku terlahir dari keluarga yang biasa saja. https://t.co/RJdvzvnMJ9,12,1,3,0,2022-01-04,10,Tuesday,2,15,1
1478316672905879555,2022-01-04 10:45:35,"Gaga Muhammad dituntut Jaksa Penuntut Umum 4,5 tahun penjara. Alasannya karena Gaga Muhammad sopan selama menjalani sidang dan juga masih muda. https://t.co/TVyTrDEHyO",4694,1867,746,2687,2022-01-04,10,Tuesday,2,5440,4554
1478316204125208576,2022-01-04 10:43:43,Kim Yu Jin atau dikenal sebagai Uee kini mantap berkarier di jalur akting. Ini transformasi Uee:  https://t.co/xPQE398P8g,3,0,0,0,2022-01-04,10,Tuesday,2,3,0
1478316187364773892,2022-01-04 10:43:39,"Inspira Academy membangun pabrik printer 3D pertama di Indonesia. Tak sekadar merakit, mereka pun merancang printer beserta komponen-komponennya. https://t.co/p71yjskgGx",4,0,3,0,2022-01-04,10,Tuesday,2,7,0
1478314886291668995,2022-01-04 10:38:29,BMKG Stasiun Geofisika Nganjuk mencatat selama 2021 terjadi 878 gempa bumi di Jatim. Tiga di antaranya tergolong gempa berskala besar dan menimbulkan kerusakan. https://t.co/eEdmEmb48c,2,0,2,0,2022-01-04,10,Tuesday,2,4,0
1478314885092098048,2022-01-04 10:38:29,Anggota Komisi VII DPR RI Maman Abdurrahman mengatakan pihaknya mau tak mau harus mendukung kebijakan pemerintah yang menyetop sementara ekspor batu bara. https://t.co/H9X7SZxBbt,3,1,1,1,2022-01-04,10,Tuesday,2,4,2
1478313921962459138,2022-01-04 10:34:39,"Orang kaya raya memang bisa beli semua barang yang dimau. Tapi ya, ngapain beli barang yang nggak penting seperti orang-orang ini... https://t.co/UwgXcncVQ3",4,2,3,1,2022-01-04,10,Tuesday,2,7,3
1478313669217951750,2022-01-04 10:33:39,Demokrat NTT dilanda kisruh usai pengumuman Ketua DPD terpilih atas nama Leonardus Lelo. Leo bela AHY dan meminta AHY tak disalahkan. https://t.co/0MxDQj51lB,0,2,1,1,2022-01-04,10,Tuesday,2,1,3
1478313422156713985,2022-01-04 10:32:40,"Beberapa sekolah telah menerapkan PTM 100 persen. Namun di sekolah di Kulon Progo, belum semuanya bisa menggelar kegiatan itu. Apa ya alasannya? Via: detikedu https://t.co/WqY4mdvPdO",2,0,0,0,2022-01-04,10,Tuesday,2,2,0
1478312639491096578,2022-01-04 10:29:33,#FOTO Vaksinasi COVID-19 dilakukan untuk para siswa di SDN  Larangan 10 Kota Tangerang. Begini ekspresi mereka saat disuntik vaksin: https://t.co/13LQ86qgEP,6,1,1,1,2022-01-04,10,Tuesday,2,7,2
1478311772218171399,2022-01-04 10:26:06,Deretan seleb Hollywood yang biasa tampil cantik sempurna diedit menjadi chubby menggemaskan. Ini potretnya:  https://t.co/CglfBrWio3,3,0,2,1,2022-01-04,10,Tuesday,2,5,1
1478311292528209926,2022-01-04 10:24:12,"Selepas dari kisah Goku yang mencari tujuh bola naga, manga Dragon Ball Super tak kalah seru ketimbang sebelumnya. https://t.co/TwnKzRwuDp",10,0,2,0,2022-01-04,10,Tuesday,2,12,0
1478311260483690496,2022-01-04 10:24:04,Anggota Komisi VII DPR RI Maman Abdurrahman mengatakan pihaknya mau tak mau harus mendukung kebijakan pemerintah yang menyetop sementara ekspor batu bara. https://t.co/v3yg2Whh1B,4,0,2,1,2022-01-04,10,Tuesday,2,6,1
1478311044967809024,2022-01-04 10:23:13,"Pemkot Jakpus buka suara terkait Jalan Komplek Pendidikan Salemba, Senen, yang rusak akibat bekas proyek sumur resapan. Apa katanya? https://t.co/7v26AIGu0h",2,5,1,2,2022-01-04,10,Tuesday,2,3,7
1478311026575790084,2022-01-04 10:23:09,"Hidup mewah di dalam penjara, para narapidana ini justru pamer makanan mewah yang mereka punya di penjara. Sampai viral dan mengundang banyak pertanyaan. https://t.co/fnQWZuQLW0",9,3,6,0,2022-01-04,10,Tuesday,2,15,3
1478310769863311360,2022-01-04 10:22:07,Seorang bule cantik asal Eropa yang tinggal di Lombok ini mencicipi jajanan SD khas Lombok untuk pertama kalinya. Seperti ini reaksinya! https://t.co/zOgqo00t7z,3,0,1,0,2022-01-04,10,Tuesday,2,4,0
1478310514384068612,2022-01-04 10:21:06,"Pemerintah telah mengevaluasi libur Natal dan tahun baru 2022 khusus di Pulau Dewata. Dalam momen ini, kunjungan turis asing masih sangat sedikit. https://t.co/SyW1CLYhed",3,0,0,0,2022-01-04,10,Tuesday,2,3,0
1478310489163710464,2022-01-04 10:21:00,Herry mengaku khilaf berbuat aksi biadab terhadap santriwatinya. https://t.co/OZAmwK2GRS,833,1138,159,694,2022-01-04,10,Tuesday,2,992,1832
1478308973627547648,2022-01-04 10:14:59,"Seorang pria di Asahan, Sumatra Utara bernama Irsyad (47) menjadi korban penyiraman air keras. Pelaku penyiraman merupakan orang suruhan istrinya sendiri. https://t.co/R4MTXoYQIx",3,0,1,0,2022-01-04,10,Tuesday,2,4,0
1478308020627066883,2022-01-04 10:11:12,Massa memprotes hasil Musda PD NTT yang menetapkan Leonardus Lelo sebagai ketua. https://t.co/AG7GSsmXat,4,1,1,0,2022-01-04,10,Tuesday,2,5,1
1478308009071763457,2022-01-04 10:11:09,Jokowi ingin ada perlindungan maksimal terhadap korban kekerasan seksual. https://t.co/JWJqPKZaNQ,20,1,2,1,2022-01-04,10,Tuesday,2,22,2
1478307491662413826,2022-01-04 10:09:06,Wakil Ketua DPR RI Sufmi Dasco Ahmad menanggapi atensi Presiden Joko Widodo yang meminta agar RUU Tindak Pidana Kekerasan Seksual (RUU TPKS) segera disahkan. https://t.co/Dofy7ZrUM7,8,1,2,3,2022-01-04,10,Tuesday,2,10,4
1478306970142756866,2022-01-04 10:07:01,Jokowi berharap ada langkah-langkah percepatan terkait pembahasan RUU TPKS. https://t.co/1ZNy6bS9mA,11,1,3,0,2022-01-04,10,Tuesday,2,14,1
1478306760045871106,2022-01-04 10:06:11,Presiden Jokowi berharap RUU TPKS segera disahkan. Jokowi meminta substansi dalam UU tersebut fokus pada perlindungan korban kekerasan seksual. https://t.co/aA3bzA43b1,4,1,1,0,2022-01-04,10,Tuesday,2,5,1
1478306743448911873,2022-01-04 10:06:07,"Setelah dugaaan kasus pemerkosaan oleh seorang mahasiswa aktivis UMY viral, ada pengakuan korban lain yang muncul. https://t.co/MqnEhmdJF0",28,7,4,0,2022-01-04,10,Tuesday,2,32,7
1478305384976814080,2022-01-04 10:00:44,"Dalam pemeriksaan, Herry mengakui perbuatannya memperkosa 13 santriwati hingga hamil dan melahirkan anak. https://t.co/L74bqgu6bA",8,9,1,0,2022-01-04,10,Tuesday,2,9,9
1478305204479029254,2022-01-04 10:00:00,"Yuk! Ulas Kilas Balik Peristiwa Penting Sepanjang 2021 Bareng detikcom
https://t.co/TfZyprgmiQ",3,0,1,0,2022-01-04,10,Tuesday,2,4,0
1478305122711183364,2022-01-04 09:59:41,Surat izin tidak masuk sekolah adalah surat diajukan oleh seorang murid atau wali ketika berhalangan hadir. Banyak lho contoh surat yang kerap disalahgunakan. https://t.co/JXK2TouLId,2,0,1,1,2022-01-04,9,Tuesday,2,3,1
1478304376750018563,2022-01-04 09:56:43,"Trio TNI AD membuang tubuh Handi-Salsa ke Sungai Serayu usai terlibat kecelakaan di Nagreg. Berupaya menghilangkan jejak, pelaku sempat ganti warna cat mobil. https://t.co/r63pTLzGOw",9,6,6,1,2022-01-04,9,Tuesday,2,15,7
1478304122562621440,2022-01-04 09:55:43,Pemprov DKI Jakarta bakal menutup sekolah jika ditemukan kasus Omicron selama pembelajaran tatap muka 100 persen. Penutupan akan dilakukan selama 5 hari. https://t.co/TKafzKIrXX,7,0,2,1,2022-01-04,9,Tuesday,2,9,1
1478303879557177346,2022-01-04 09:54:45,"Nongkrong di kafe bareng teman, wanita ini pesan menu pop chicken agar bisa dimakan bersama. Disajikan satu ember tapi ternyata isinya bikin emosi. https://t.co/5mOw6Gd2c2",6,0,1,1,2022-01-04,9,Tuesday,2,7,1
1478302841395630082,2022-01-04 09:50:37,Terdapat 125 perguruan tinggi negeri yang membuka penerimaan mahasiswa baru jalur SNMPTN 2022. Mana saja ya? Ada pilihan kamu? Via: detikedu https://t.co/D123T5FLch,7,0,3,0,2022-01-04,9,Tuesday,2,10,0
1478302565444071424,2022-01-04 09:49:31,"Putri pedangdut Ayu Ting Ting, Bilqis Khumairah ngaku ketagihan berlibur di Amerika Serikat. Ini respons Ayu Ting Ting:  https://t.co/lROpwBcu4J",7,0,2,0,2022-01-04,9,Tuesday,2,9,0
1478302052421971968,2022-01-04 09:47:29,"Wagyu salah satu jenis daging sapi premium paling mahal di dunia. Di peternakan yang ada di kota Kobe, Jepang. Daging wagyu berharga tinggi ini diproduksi. https://t.co/TPFabM7D2A",6,1,2,0,2022-01-04,9,Tuesday,2,8,1
1478301545183817729,2022-01-04 09:45:28,"Manusia tertua di dunia, Kane Tanaka, telah mencapai usia 119 tahun pada Minggu (2/1). Momen perayaan ulang tahun Kane Tanaka diabadikan oleh cicitnya, Junko Tanaka. Begini potret kebahagiaan: https://t.co/XVBBXYpumh",7,1,4,0,2022-01-04,9,Tuesday,2,11,1
1478301521116909570,2022-01-04 09:45:22,Maskapai Pelita Air Service (PAS) sejak tahun 2021 kemarin melakukan persiapan untuk membuka layanan penerbangan berjadwal reguler. https://t.co/WRAOTl7fqO,10,0,2,0,2022-01-04,9,Tuesday,2,12,0
1478300983319052288,2022-01-04 09:43:14,"Bagi Reino Barack, mimpinya itu berangkat dari kepercayaan bahwa hidup harus lebih dari sekadar dinikmati tanpa memberikan arti. #ReinoBarack  https://t.co/lkHv5bE459",9,0,1,2,2022-01-04,9,Tuesday,2,10,2
1478300759334793220,2022-01-04 09:42:21,Reino Barack dan keluarganya adalah pemilik kerajaan bisnis besar di Indonesia. Kali ini Reino bicara soal bisnis di tahun baru: #HotQuestions  https://t.co/48SySIfQle,8,0,1,0,2022-01-04,9,Tuesday,2,9,0
1478300228830781440,2022-01-04 09:40:14,"Dunia dihebohkan dengan Flurona, infeksi ganda flu dan Corona. Gejalanya mirip-mirip, bagaimana cara membedakan flu, Corona, dan Flurona? https://t.co/8hM3ixSpY1",6,2,3,8,2022-01-04,9,Tuesday,2,9,10
1478299975629123584,2022-01-04 09:39:14,"Teka-teki matematika ini sekilas tampak rumit. Namun, sebetulnya mudah bila tahu triknya. Yuk coba latih ketajaman otak dengan menjawab teka-teki berikut. https://t.co/bUoqnb5Qnf",36,55,8,2,2022-01-04,9,Tuesday,2,44,57
1478299184583294977,2022-01-04 09:36:05,"Selain untuk bermain game, ponsel Samsung Galaxy A52s 5G juga nyaman digunakan untuk kegiatan multitasking hingga menonton film nih detikers! https://t.co/TnpUKjfocS",6,0,3,1,2022-01-04,9,Tuesday,2,9,1
1478298440463523842,2022-01-04 09:33:08,Elon Musk membagikan lima nasihat untuk anak muda yang ingin sukses di kehidupan. Ini nasehat dari orang terkaya di dunia:  https://t.co/iBQktX8j88,17,1,5,4,2022-01-04,9,Tuesday,2,22,5
1478298417017368583,2022-01-04 09:33:02,Irwansyah dan Hafiz Fatur adalah kakak beradik yang terlihat kompak. Ternyata Hafiz Fatur tega berkhianat dan menipu Irwansyah. Ini momen kebersamaan mereka:  https://t.co/UVXxizm9b4,4,0,1,0,2022-01-04,9,Tuesday,2,5,0
1478298163077386240,2022-01-04 09:32:02,"Bicara soal Air Purifier, secara umum ada 3 fitur pokok yang dapat dipilih sesuai dengan kebutuhan pengguna. Ini tips memilihnya:  https://t.co/X304oRhLHD",9,0,3,1,2022-01-04,9,Tuesday,2,12,1
1478296576762126336,2022-01-04 09:25:43,"Terhitung per 3 Januari, terdapat 162 orang terkonfirmasi positif Omicron! Simak data lengkapnya disini. https://t.co/vesP3o8Z8B",13,1,7,1,2022-01-04,9,Tuesday,2,20,2
1478296565169233921,2022-01-04 09:25:41,"DPO teroris MIT Poso, Sulteng Ahmad Panjang tewas ditembak Satgas Madago Raya. Jenazahnya akan dimakamkan di area pemakaman yang sama dengan makam Ali Kalora. https://t.co/10hwrr9VMa",6,2,2,2,2022-01-04,9,Tuesday,2,8,4
1478295206629941250,2022-01-04 09:20:17,"Indonesia mencatat sebanyak 299 kasus baru COVID-19, Selasa (4/1/2022). DKI menyumbang kasus terbanyak dengan jumlah 115. https://t.co/xYvhZbDhYW",3,0,1,0,2022-01-04,9,Tuesday,2,4,0
1478294740827353089,2022-01-04 09:18:26,"Indonesia melaporkan 299 kasus COVID-19 pada Selasa (4/1/2022). Total kasus positif menjadi 4.263.732, sembuh 4.114.969, dan meninggal 144.105. https://t.co/8GtElwWHjE",3,0,1,0,2022-01-04,9,Tuesday,2,4,0
1478294278677929986,2022-01-04 09:16:36,"Israel melaporkan temuan kasus infeksi gabungan virus influenza dengan virus Corona 'Flurona'. Disorot Kementerian Kesehatan Israel, ini yang dikhawatirkan. https://t.co/ao55XVg9mH",10,2,1,0,2022-01-04,9,Tuesday,2,11,2
1478294023794212867,2022-01-04 09:15:35,Warung mangut lele Pak Gianto yang kondang di Yogyakarta buka cabang di Bekasi. Mangut lele beraroma asap dengan kuah pedas ini bikin nagih. https://t.co/yQLbABNNPT,2,0,3,0,2022-01-04,9,Tuesday,2,5,0
1478293781170556929,2022-01-04 09:14:37,Keberadaan Hafiz Fatur masih dalam pencarian. Bahkan keluarga Irwansyah juga tak bisa menghubunginya. #HafizFatur  https://t.co/za22xLzRkI,6,3,1,1,2022-01-04,9,Tuesday,2,7,4
1478293240273068032,2022-01-04 09:12:28,Preeklampsia memang menjadi salah satu kondisi yang harus diwaspadai saat hamil. Sebab kondisi ini dapat membahayakan ibu hamil maupun janinnya. https://t.co/zaFECZKsZ7,44,0,8,1,2022-01-04,9,Tuesday,2,52,1
1478292491677937664,2022-01-04 09:09:30,"Amel, wanita asal Depok, Jawa Barat, sudah enam hari mencari ayahnya, Budiono (61) yang hilang. Ayahnya meninggalkan rumah sejak Kamis (30/12/2021) lalu. https://t.co/tufAvJ3JJ6",18,0,3,0,2022-01-04,9,Tuesday,2,21,0
1478291468083208197,2022-01-04 09:05:25,Penyanyi muda Kaleb J berhasil memikat hati penikmat musik Tanah Air lewat It's Only Me. Kini ia merilis album bertajuk Melancholy:  https://t.co/HntEeioWOV,7,1,2,0,2022-01-04,9,Tuesday,2,9,1
1478291449909284865,2022-01-04 09:05:21,"Manhwa Solo Leveling viral di luar Korea Selatan dan menjadi pembicaraan sampai ke Indonesia, benarkan serial ini bakal diadaptasi ke anime? https://t.co/Gugv62gK6P",11,2,2,1,2022-01-04,9,Tuesday,2,13,3
1478290946005557254,2022-01-04 09:03:21,"Gaga Muhammad dituntut 4,5 tahun penjara. Sahabat Laura Anna merasa tuntutan itu tidak sebanding dengan apa yang telah dilakukan oleh Gaga Muhammad! https://t.co/Bs6xWHfmIA",4,2,1,0,2022-01-04,9,Tuesday,2,5,2
1478290658548985859,2022-01-04 09:02:12,Warga di Depok protes gara-gara ada warga yang membangun tembok di jalan hingga menghalangi saluran air. Warga khawatir hal itu memicu banjir. https://t.co/aBLhiRHUna,3,0,0,1,2022-01-04,9,Tuesday,2,3,1
1478289772732891136,2022-01-04 08:58:41,Apakah kamu punya resolusi menurunkan berat badan di 2022 ini? Simak yuk cerita pengalaman diet turun berat badan 20 kg lebih yang bisa dicoba pemula. https://t.co/WFNNZFeLjn,2,0,2,0,2022-01-04,8,Tuesday,2,4,0
1478289525701025795,2022-01-04 08:57:42,Dinas Kesehatan DKI Jakarta menjelaskan perbedaan data kasus Corona varian Omicron di DKI dan pusat. Berikut penjelasannya. https://t.co/nGgKsB8hzm,2,0,0,1,2022-01-04,8,Tuesday,2,2,1
1478289022749495297,2022-01-04 08:55:42,"Persalinan langka terjadi di California. Seorang wanita melahirkan bayi kembar di tanggal, bulan dan tahun yang berbeda. https://t.co/tMFCn53QQU",10,1,4,0,2022-01-04,8,Tuesday,2,14,1
1478288283557842944,2022-01-04 08:52:46,Partai Ummat mengajukan judicial review materi UU Nomor 7 Tahun 2017 tentang Pemilihan Umum ke Mahkamah Konstitusi (MK). Partai Ummat mendorong syarat ambang batas 20 persen dalam pencalonan presiden dan wakil presiden dihapus. https://t.co/ruiHJzCjpF,12,7,3,0,2022-01-04,8,Tuesday,2,15,7
1478288270157135877,2022-01-04 08:52:43,"Ketua Umum Partai Solidaritas Indonesia, Giring Ganesha, menyampaikan ucapan selamat Tahun Baru 2022. Di kesempatan yang sama, Giring turut menyinggung indeks kebahagiaan warga DKI Jakarta yang turun. https://t.co/piqD9Tm8zu",3,4,3,1,2022-01-04,8,Tuesday,2,6,5
1478287744275206150,2022-01-04 08:50:38,"""Saat ini harga telur ayam sudah berangsur turun dari Rp 32.000/kg dan saya targetkan menjadi Rp 27.000/kg di wilayah Jakarta karena barometernya Jabodetabek"" https://t.co/JLsXDSv4hd",4,1,3,1,2022-01-04,8,Tuesday,2,7,2
1478287494990995457,2022-01-04 08:49:38,"Dinas Kesehatan DKI Jakarta menuturkan, dari 162 yang kasus, 6 orang di antaranya merupakan transmisi lokal. https://t.co/CX2CZc0ch4",5,0,3,0,2022-01-04,8,Tuesday,2,8,0
1478286747834490884,2022-01-04 08:46:40,"Sedang menjalani long distance relationship (LDR)? Jika sedang berjauhan, yuk kirim puisi rindu untuk pasangan. https://t.co/MwuuxRZvH5",6,1,3,1,2022-01-04,8,Tuesday,2,9,2
1478286464903483393,2022-01-04 08:45:33,"Musisi Tri Suaka kembali merilis single keduanya yang bertajuk Ku Tunggu Engkau di Surga. Sebelumnya, ia sukses pada single Aku Bukan Jodohnya.  https://t.co/rPE6wFZ1FH",2,1,1,0,2022-01-04,8,Tuesday,2,3,1
1478286223697448962,2022-01-04 08:44:35,Jae melontarkan pernyataan yang berbeda soal statusnya di DAY6. Ini sederet fakta seputar Jae yang hengkang dari DAY6:  https://t.co/WvfolLbVum,8,0,0,0,2022-01-04,8,Tuesday,2,8,0
1478285715989532672,2022-01-04 08:42:34,"Rekonstruksi kasus kecelakaan Handi Saputra (18) dan Salsabila (14) yang melibatkan tiga oknum prajurit TNI juga digelar di Kabupaten Banyumas, Jawa Tengah. https://t.co/a1ggNLvF6S https://t.co/nKfEFRrRqD",3,0,1,2,2022-01-04,8,Tuesday,2,4,2
1478285180724985858,2022-01-04 08:40:26,Jakarta dinyatakan sebagai wilayah PPKM level 2. Apakah ini gara-gara Omicron? https://t.co/y4QBC769Da,8,1,5,1,2022-01-04,8,Tuesday,2,13,2
1478284932824932353,2022-01-04 08:39:27,Peserta SNMPTN 2022 boleh memilih maksimal dua program studi dari satu atau dua PTN. Jangan sampai nyesel! Begini tips dan cara pemilihannya: Via: detikedu https://t.co/iio0WbptRf,4,0,1,0,2022-01-04,8,Tuesday,2,5,0
1478284413406523394,2022-01-04 08:37:24,DKI Jakarta kembali masuk PPKM level 2 berdasarkan Inmendagri nomor 1 tahun 2022. Berikut sederet aturan yang harus diketahui: https://t.co/F5tkZvfRQH,9,0,5,1,2022-01-04,8,Tuesday,2,14,1
1478283912757624833,2022-01-04 08:35:24,"Gaga Muhammad membela dituntut 4,5 tahun penjara. Ia tidak terima dengan tuntutan yang dilayangkan oleh Jaksa Penuntut Umum. #GagaMuhammad  https://t.co/yNxEpwYvbw",28,10,4,12,2022-01-04,8,Tuesday,2,32,22
1478283419977142277,2022-01-04 08:33:27,Cara cek sertifikat vaksin orang lain terbilang cukup mudah. Kita pun bisa membantu mengecek sertifikat untuk orang tua dan kerabat lainnya. Ini caranya:  https://t.co/zf2v4OOmRH,7,0,4,0,2022-01-04,8,Tuesday,2,11,0
1478282528087810049,2022-01-04 08:29:54,Adopsi boneka arwah sedang menjadi tren di kalangan selebriti. Muhammadiyah buka suara terkait hal ini. https://t.co/9obC6c2USl,3,0,0,0,2022-01-04,8,Tuesday,2,3,0
1478282068157206530,2022-01-04 08:28:04,Heboh video pengemudi mobil menenteng benda mirip pistol setelah menabrak sepeda motor. Kejadian tersebut terekam CCTV dan viral di media sosial. https://t.co/pZjxthxX70 https://t.co/BEblj68KK7,25,10,3,1,2022-01-04,8,Tuesday,2,28,11
1478281789294710786,2022-01-04 08:26:58,Chrissy Teigen unggah foto terbaru di Instagram dengan penampilan yang tampak berbeda dari biasanya. Perubahan wajahnya dinilai mirip Khloe Kardashian. Hmm... https://t.co/EJwFkrMD2D,1,0,0,0,2022-01-04,8,Tuesday,2,1,0
1478281262288801794,2022-01-04 08:24:52,"Banyak perusahaan teknologi asal China jadi besar bisnisnya dan ekspansi ke berbagai wilayah, termasuk Asia Tenggara. Ternyata begini rasanya bekerja di sana:  https://t.co/5vuroCSqE7",1,0,1,0,2022-01-04,8,Tuesday,2,2,0
1478280998165094400,2022-01-04 08:23:49,"Tak lengkap rasanya jika mengunjungi Kota Magelang, Jawa Tengah, tanpa mencicipi kuliner yang ada. Salah satu kuliner legendarisnya yakni Es Semanggi. https://t.co/H0bf8sUvfb",5,2,0,0,2022-01-04,8,Tuesday,2,5,2
1478280533121642496,2022-01-04 08:21:58,"PPKM Level 1, 2, dan 3 diperpanjang hingga 17 Januari 2022. Ingin 'nge-mall' di tengah pandemi COVID-19? Simak dulu aturan masing-masing level wilayah. https://t.co/o678rGESia",4,0,3,0,2022-01-04,8,Tuesday,2,7,0
1478279921428537347,2022-01-04 08:19:33,Keluarga Laura Anna merasa selama apa pun Gaga Muhammad dipenjara tak akan pernah bisa menggantikan keberadaan Laura. https://t.co/SDLxB1pjjB,279,15,28,6,2022-01-04,8,Tuesday,2,307,21
1478279905393745922,2022-01-04 08:19:29,"Penggunaan do dan does sering ditemui dalam Bahasa Inggris. Lalu, gimana cara menggunakannya yang benar? Simak penjelasan berikut yuk! Via: detikedu https://t.co/PqqLapxduE",6,0,5,1,2022-01-04,8,Tuesday,2,11,1
1478279337468211200,2022-01-04 08:17:13,"Penipuan WhatsApp terus berkembang, dan kini modus baru kembali muncul. Penipuan itu dinamakan Rediroff. Hati-hati ya detikers!  https://t.co/VKCOKy7bNm",45,1,22,1,2022-01-04,8,Tuesday,2,67,2
1478279089861632002,2022-01-04 08:16:14,"Di video itu, Gaga Muhammad menceritakan kegiatan yang dilakukannya, mulai dari olahraga hingga pamer sepatu baru. #GagaMuhammad  https://t.co/CFEJvppojB",4,0,1,0,2022-01-04,8,Tuesday,2,5,0
1478278308538331138,2022-01-04 08:13:08,"AirPods Pro generasi ke-2 kabarnya bakal punya dukungan terhadap Apple Lossless Audio Codec, format yang dipakai di banyak lagu di Apple Music Lossless. https://t.co/XBPmMxvsQG",1,0,2,3,2022-01-04,8,Tuesday,2,3,3
1478277787140206598,2022-01-04 08:11:04,"Adik Ayu Ting Ting, Assyifa Nuraini, tak lama lagi akan menikah. Ayu ngaku sedih karena akan ditinggal menikah oleh sang adik tercinta...  https://t.co/obdprU0JPs",4,1,2,0,2022-01-04,8,Tuesday,2,6,1
1478277199618842625,2022-01-04 08:08:44,"Jutaan kendaraan hilir-mudik dari Jabotabek pada periode Natal 2021 dan Tahun Baru 2022. Totalnya ada lebih dari 2,5 juta kendaraan yang melakukan perjalanan.  https://t.co/7aYHnDrsLZ",5,0,1,1,2022-01-04,8,Tuesday,2,6,1
1478276446607007748,2022-01-04 08:05:44,Wah! Rayyanza bakal disunat hari ini. Tapi sebelumnya anak kedua Raffi Ahmad dan Nagita Slavina itu mendapatkan kunjungan dari Retno Marsudi. https://t.co/vOKqiqKD8N,12,2,2,2,2022-01-04,8,Tuesday,2,14,4
1478276431612461056,2022-01-04 08:05:41,Kementerian PPN/Bappenas membuka lowongan kerja. Kesempatan ini terbuka sampai 6 Januari 2022. Buruan daftar! https://t.co/7ogACAJVvy,4,0,4,1,2022-01-04,8,Tuesday,2,8,1
1478275873480617990,2022-01-04 08:03:27,Tahun 2022 sudah dimulai. Inilah saat yang tepat membeli handphone untuk anak pertama. detikcom mau bagi handphone senilai Rp 13 jutaan. Simak caranya di sini:  https://t.co/dmdSVj60Hl,0,0,1,1,2022-01-04,8,Tuesday,2,1,1
1478275294259785733,2022-01-04 08:01:09,"Satgas Operasi Madago Raya menangkap DPO teroris MIT Poso, Sulteng. DPO atas nama Ahmad Panjang alias Basir asal Poso ditembak mati oleh petugas. https://t.co/a1vQgWZbpk",14,3,3,0,2022-01-04,8,Tuesday,2,17,3
1478274992479551489,2022-01-04 07:59:57,"Sebuah perusahaan di Helsinki, Finlandia, Rens, membuat sepatu dari ampas kopi dan botol plastik daur ulang. Sepatu kets mereka diklaim tahan air. Inovasi ini sebagai upaya mengurangi dampak lingkungan dari ampas kopi bekas. https://t.co/JmmxUj5e22",11,0,5,1,2022-01-04,7,Tuesday,2,16,1
1478274480178876419,2022-01-04 07:57:55,"Apple jadi perusahaan pertama di dunia dengan valuasi USD 3 triliun, sekitar Rp 42.850,9 triliun. Pencapaian tersebut terjadi setelah harga saham Apple naik. https://t.co/2jB276H9ts",21,1,5,0,2022-01-04,7,Tuesday,2,26,1
1478273920675598338,2022-01-04 07:55:42,"Mendagri Tito Karnavian menerbitkan Inmendagri nomor 1 tahun 2022 tentang PPKM Level 2,2, dan 1 di Jawa-Bali. Jakarta menjadi salah satu wilayah yang menerapkan PPKM Level 2. https://t.co/jCeWtdvqEq",8,1,3,1,2022-01-04,7,Tuesday,2,11,2
1478272890869096451,2022-01-04 07:51:36,NFT alias non-fungible token sedang naik daun. Berikut deretan artis yang mulai melek NFT. Ada Raffi Ahmad? https://t.co/9HQP4zt2hq,8,1,0,0,2022-01-04,7,Tuesday,2,8,1
1478272611071180800,2022-01-04 07:50:30,Kasus varian Omicron kini semakin meluas di dunia. Indonesia pun kini berada pada ranking ke-27 negara dengan kasus Omicron di dunia. https://t.co/CpFpONjQSo,15,1,4,1,2022-01-04,7,Tuesday,2,19,2
1478272267628986370,2022-01-04 07:49:08,"Digemari berjuta umat di Indonesia, bakwan goreng ternyata memiliki banyak nama sebutan yang berbeda di setiap daerah. Apa saja? https://t.co/3E3MJSXFDk",28,3,4,2,2022-01-04,7,Tuesday,2,32,5
1478271764232818694,2022-01-04 07:47:08,"Gaga Muhammad menjalani sidang tuntutan atas kasus kecelakaan lalu lintas. Ia dituntut 4,5 tahun penjara. Begini respons Gaga:  https://t.co/jMNECe04F2",29,6,3,7,2022-01-04,7,Tuesday,2,32,13
1478271276758228996,2022-01-04 07:45:11,"Masalah yang dialami Snapdragon 888 adalah panas yang dihasilkannya tinggi, dan Snapdragon 8 Gen 1 juga tampaknya akan mengalami masalah sama, bahkan lebih. https://t.co/vSt1QKFACU",0,0,2,0,2022-01-04,7,Tuesday,2,2,0
1478271027201331204,2022-01-04 07:44:12,Indonesia memiliki api abadi alias api yang terus menyala tak pernah padam. Ini lokasinya:  https://t.co/rhQcqtC2Uo,5,0,1,0,2022-01-04,7,Tuesday,2,6,0
1478270782761578497,2022-01-04 07:43:14,"Gaga Muhammad dituntut 4,5 tahun penjara. Orang tuanya bergeming saat mendengar tuntutan itu. #GagaMuhammad  https://t.co/ucDJmSqDl5",2,3,3,2,2022-01-04,7,Tuesday,2,5,5
1478269487443025923,2022-01-04 07:38:05,"Pemkot Bekasi menganggarkan Rp 1,1 miliar untuk pengadaan karangan bunga. Wali Kota Bekasi Rahmat Effendi atau Pepen menjelaskan. https://t.co/Nv3ZBjSa9T",16,4,3,2,2022-01-04,7,Tuesday,2,19,6
1478268722087444480,2022-01-04 07:35:02,"Mengawali 2022, AnTuTu merilis daftar HP Android terkencang di hingga Desember 2021. Ini daftarnya:  https://t.co/LvEOlAmH4F",8,0,2,1,2022-01-04,7,Tuesday,2,10,1
1478268181408100352,2022-01-04 07:32:53,"Jalan Komplek Pendidikan Salemba, Senen, viral di media sosial lantaran rusak dan susah dilewati akibat adanya bekas proyek sumur resapan. Begini kondisinya: https://t.co/nCTBZXnEGU",27,14,6,3,2022-01-04,7,Tuesday,2,33,17
1478267682315247617,2022-01-04 07:30:55,"Huawei MateBook 14s menawarkan tampilan memikat, performa handal untuk produktivias dan fitur menarik. Ini review lengkap laptop harga Rp 17 juta ini:  https://t.co/OcYXcRMMe2",3,0,2,1,2022-01-04,7,Tuesday,2,5,1
1478266922244493312,2022-01-04 07:27:53,Dampak dari mahalnya harga minyak goreng sangat dirasakan oleh penjual gorengan. Mereka terpaksa memperkecil ukuran demi mendapatkan keuntungan. https://t.co/SkUWUgNlLh,8,3,4,0,2022-01-04,7,Tuesday,2,12,3
1478266359654014978,2022-01-04 07:25:39,"#Foto Cinta memang tak kenal usia, seperti kisah pasangan yang punya jarak usia cukup jauh ini. Pada 2004 istri masih TK dan suami sudah jadi polisi. Ini potret mereka... https://t.co/yjg00QFFEw",8,5,3,1,2022-01-04,7,Tuesday,2,11,6
1478266341090021376,2022-01-04 07:25:35,"Jaksa penuntut umum membacakan tuntutan untuk Gaga Muhammad. Ia dituntut 4,5 tahun penjara. https://t.co/jBj5kkL4Ax",93,24,20,11,2022-01-04,7,Tuesday,2,113,35
1478266101213585408,2022-01-04 07:24:38,Habib Bahar bin Smith ditahan sebagai tersangka usai diperiksa selama berjam-jam oleh penyidik Polda Jawa Barat. Bagaimana reaksi pengacara? https://t.co/kYUoaasarP,12,9,3,0,2022-01-04,7,Tuesday,2,15,9
1478265631975915521,2022-01-04 07:22:46,"Intel diperkirakan akan merilis GPU diskrit untuk gamingnya pada Maret mendatang, yang bernama Arc Alchemist.  https://t.co/dR1PfT6x6U",3,0,3,0,2022-01-04,7,Tuesday,2,6,0
1478265609494450176,2022-01-04 07:22:40,"Beberapa perusahaan menyediakan menu makan siang untuk para pegawainya. Termasuk perusahaan global seperti Google, Apple hingga Facebook. Apa saja menunya? https://t.co/dz6nAyDbcJ",5,1,4,2,2022-01-04,7,Tuesday,2,9,3
1478264971972780039,2022-01-04 07:20:08,"Bagi calon orangtua, bisa mempertimbangkan nama bayi laki-laki modern 3 kata ini yang bermakna baik.  https://t.co/clc3vzsag7",31,0,10,1,2022-01-04,7,Tuesday,2,41,1
1478264219497869313,2022-01-04 07:17:09,"Tahun baru, semangat baru! Suami ingin alih profesi jadi pengusaha, tapi dananya belum ada? Jangan khawatir, detikcom bantu modalin! https://t.co/YgTvUQb52X",13,3,4,0,2022-01-04,7,Tuesday,2,17,3
1478263943474913280,2022-01-04 07:16:03,Fenomena Aphelion ramai disebut sebabkan cuaca dingin. BMKG meluruskan informasi yang beredar. Ini penjelasannya: https://t.co/6msB43m71F,8,0,6,0,2022-01-04,7,Tuesday,2,14,0
1478263675156762630,2022-01-04 07:14:59,"Peluang Cuan! Ajak Teman Langganan Internet Bisa Dapat Penghasilan
https://t.co/xcKxh3rQrk",1,1,3,0,2022-01-04,7,Tuesday,2,4,1
1478263152387112960,2022-01-04 07:12:54,"Polisi menetapkan Habib Bahar bin Smith sebagai tersangka dugaan kasus penyebaran berita bohong. Pengacara Habib Bahar bin Smith, Ichwan Tuankotta merasa proses penetapan tersangka kliennya sangat cepat. https://t.co/nG5SzggjPw",2,1,2,2,2022-01-04,7,Tuesday,2,4,3
1478262400872820740,2022-01-04 07:09:55,Shell Indonesia telah menghapus BBM Shell Regular dalam daftar jualannya. Apa alasannya? https://t.co/PkSX7KkD0z,4,0,4,0,2022-01-04,7,Tuesday,2,8,0
1478262150368051207,2022-01-04 07:08:56,"Di Indonesia, buah-buahan seperti durian dan rambutan sangat mudah ditemui. Namun di Korea buah-buahan tersebut terbilang langka. Cek harganya berikut ini! https://t.co/a9OC3ybONr",14,3,4,0,2022-01-04,7,Tuesday,2,18,3
1478261598347218946,2022-01-04 07:06:44,Beberapa waktu terakhir spirit doll ramai diperbincangkan. Harga adopsi boneka tersebut lumayan juga lho... Sampai jutaan! 😱 Berapa paling mahal? https://t.co/1QMO032hez,11,4,1,4,2022-01-04,7,Tuesday,2,12,8
1478261102509236225,2022-01-04 07:04:46,Jakarta kini kembali ke PPKM level 2 setelah sebelumnya sempat berada di level 1. Apa penyebab Jakarta kembali ke level 2? https://t.co/kV5kzbRWjB,7,1,8,0,2022-01-04,7,Tuesday,2,15,1
1478260801366630401,2022-01-04 07:03:34,Kepolisian di Malaysia menutup sebuah penambangan Bitcoin besar di negara itu. Sebanyak 1.720 mesin penambangan Bitcoin disita. #Bitcoin  https://t.co/9v0gj0Cu8k,12,5,8,2,2022-01-04,7,Tuesday,2,20,7
1478260141795467266,2022-01-04 07:00:57,Pemerintah harus menindak tegas perusahaan batu baru yang melanggar kewajiban pemenuhan kebutuhan dalam negeri khususnya untuk sektor ketenagalistrikan. #CNNIndonesia #detiknetwork  https://t.co/9tr1blo7LL,10,0,4,1,2022-01-04,7,Tuesday,2,14,1
1478259399206576131,2022-01-04 06:58:00,Asosiasi Haji dan Umroh AMPHURI telah memberangkatkan tim untuk melaksanakan ibadah umroh di akhir Desember. Berapa biayanya? https://t.co/mUrk9RriOO,9,0,1,0,2022-01-04,6,Tuesday,2,10,0
1478259157102960640,2022-01-04 06:57:02,"Habib Bahar tersangka atas penyebaran berita bohong dalam ceramahnya di Bandung, Jawa Barat. Bagaimana kronologi hingga penjelasan polisi? https://t.co/2llMimTKRX",17,5,2,2,2022-01-04,6,Tuesday,2,19,7
1478258659805253633,2022-01-04 06:55:03,Jaringan 3G sedang menuju akhir hayat di berbagai belahan dunia. Kebutuhan akan koneksi internet yang lebih cepat membuat 3G kian terpinggirkan. #3G  https://t.co/sCwq0ORyMr,11,0,3,0,2022-01-04,6,Tuesday,2,14,0
1478257671723757574,2022-01-04 06:51:08,"Musisi Danilla Riyadi merilis lagu barunya yang bertajuk MPV. Lagu ini menjadi awal mula dari album selanjutnya Danilla, Pop Seblay. https://t.co/KtSFyR6K71",14,0,1,0,2022-01-04,6,Tuesday,2,15,0
1478257153043582981,2022-01-04 06:49:04,"DKI Jakarta kembali naik level menjadi PPKM level 2 per hari ini hingga 17 Januari 2022. Lalu, apakah bakal ada perubahan terkait PTM? Via: detikedu https://t.co/3KiLeW47c9",14,3,5,1,2022-01-04,6,Tuesday,2,19,4
1478256636976414720,2022-01-04 06:47:01,Ryan Reynolds debut jadi penulis cerita dan narator Winnie the Screwed yang diadaptasi dari cerita klasik Winnie the Pooh karya AA Milne. https://t.co/A3VVMUvkM6,7,0,2,0,2022-01-04,6,Tuesday,2,9,0
1478256391785746433,2022-01-04 06:46:03,"Anies Baswedan bernostalgia dengan makan di sebuah warteg di kawasan Ancol, Jakarta Utara. Anies makan di warteg yang fotonya sempat jadi meme. https://t.co/0ELbwLhlmJ",88,28,13,6,2022-01-04,6,Tuesday,2,101,34
1478256094585761793,2022-01-04 06:44:52,#Foto SD Negeri Kebon Jeruk 08 Jakarta Barat sekolah tatap muka 100 persen. Siswa kelas 3-6 istirahat 15 menit di sela kelas. Begini suasananya. Via: detikedu https://t.co/8vXpHmISuB,5,0,2,0,2022-01-04,6,Tuesday,2,7,0
1478255842512326661,2022-01-04 06:43:52,Satu unit helikopter militer Israel jatuh di perairan Mediterania saat misi latihan. Dua pilot di helikopter dinyatakan tewas dan satu awak lainnya luka-luka. https://t.co/IEiIGLWe5j,3,1,2,0,2022-01-04,6,Tuesday,2,5,1
1478254692878766080,2022-01-04 06:39:18,Uji klinis Vaksin Merah Putih Unair pada manusia rencananya dilakukan awal Februari 2022. 500 Relawan akan dikumpulkan. https://t.co/YMo7lecSw8,5,0,0,2,2022-01-04,6,Tuesday,2,5,2
1478253674992488450,2022-01-04 06:35:15,"Jika ingin memasak sayur sederhana yang sedap, bisa membuat kotokan. Sayur santan ini isinya tahu, tempe dan telur. Gurih pedas rasanya, beuh! https://t.co/aYJ3jl1J2E",5,1,0,0,2022-01-04,6,Tuesday,2,5,1
1478253178827247616,2022-01-04 06:33:17,SMTOWN Live 2022: SMCU Express at Kwangya digelar pada 1 Januari 2022. Konser itu mencuri banyak perhatian publik dari seluruh dunia hingga pecahkan rekor. Daebak!  https://t.co/oiJd64Fp2y,13,0,2,0,2022-01-04,6,Tuesday,2,15,0
1478252580505587714,2022-01-04 06:30:54,"Suhu udara yang turun hingga 3 derajat celcius sehingga di sekitar komplek Candi Arjuna. Biasanya, fenomena embun es di Dieng terjadi pada Mei hingga September. https://t.co/K5MfmMeAEd",21,1,4,1,2022-01-04,6,Tuesday,2,25,2
1478252049569619975,2022-01-04 06:28:47,Penundaan umrah akibat pandemi membuat jemaah Indonesia tak bisa berangkat ke tanah suci. Jumlahnya ternyata capai lebih dari 60 ribu. https://t.co/enPkxVAYWB,13,1,4,0,2022-01-04,6,Tuesday,2,17,1
1478251798968377346,2022-01-04 06:27:48,"Lola Diara ikut terseret saat kisah Layangan Putus Mommy ASF viral pada 2019. Kini web series itu pun jadi perbincangan, Lola berikan klarifikasi. https://t.co/5rZNHCdx3h",8,0,1,1,2022-01-04,6,Tuesday,2,9,1
1478251342036713478,2022-01-04 06:25:59,"Evergrande menangguhkan sementara (suspensi) perdagangan sahamnya di Hong Kong. Sebab, investor tengah menunggu berita tentang rencana restrukturisasi. https://t.co/asEvsWzITP",4,0,3,0,2022-01-04,6,Tuesday,2,7,0
1478251316652785664,2022-01-04 06:25:53,Satgas transisi penanganan bencana erupsi gunung Semeru kembali menemukan dua jenazah korban erupsi gunung Semeru. Korban berjenis kelamin perempuan dan laki laki. https://t.co/kSOIenrhRy https://t.co/6Fi9gcmVuv,9,0,2,0,2022-01-04,6,Tuesday,2,11,0
1478250509387583492,2022-01-04 06:22:40,Jokowi memberi kewenangan kepada Menteri ESDM Arifin Tasrif untuk menghapus Premium dari BBM khusus penugasan. Ini daftar harga BBM se-RI: https://t.co/NlNrdpXoC2,13,3,1,2,2022-01-04,6,Tuesday,2,14,5
1478249983363194884,2022-01-04 06:20:35,Kaka Slank menjelaskan bagaimana album Virus semakin hari kian disenangi banyak orang. Layaknya wine yang semakin lama disimpan makin disukai...  https://t.co/OwqAZsbHHt,6,0,2,0,2022-01-04,6,Tuesday,2,8,0
1478249433020215300,2022-01-04 06:18:24,"Jakarta kini menerapkan PPKM Level 2 usai ditemukan 162 kasus Omicron. Lantas, bagaimana nasib pembelajaran tatap muka 100% di DKI Jakarta? https://t.co/Nk52xh9u7J",42,16,8,7,2022-01-04,6,Tuesday,2,50,23
1478248656457416704,2022-01-04 06:15:18,"Per Januari 2022, harga mobil banyak yang mengalami penyesuaian. Salah satunya Xpander dan Xpander Cross.  https://t.co/tQp3J8y0KZ",2,0,1,0,2022-01-04,6,Tuesday,2,3,0
1478248638442782720,2022-01-04 06:15:14,Apakah aturan ini akan berpengaruh ke China? Mengingat China adalah salah satu importir batu bara terbesar dari Indonesia. https://t.co/xtxyCN3UPi,8,5,1,0,2022-01-04,6,Tuesday,2,9,5
1478248369105649666,2022-01-04 06:14:10,Tahun berganti dan para idola K-Pop ini juga bertambah usia. Mereka yang lahir di tahun 2000 kini bakal memasuki usia internasional 22 tahun. Ini daftarnya:  https://t.co/UbUvJorFpa,3,0,1,0,2022-01-04,6,Tuesday,2,4,0
1478248099948683265,2022-01-04 06:13:06,"Menteri Perindustrian Agus Gumiwang Kartasasmita menyebut soal usulan mobil rakyat yang dibebaskan dari Pajak Penjualan atas Barang Mewah. Berdasarkan syaratnya, ada 10 mobil yang berpotensi dapat gelar mobil rakyat!  https://t.co/ZSsDQjHWJZ",2,0,0,0,2022-01-04,6,Tuesday,2,2,0
1478248082970140673,2022-01-04 06:13:02,PPKM diperpanjang hingga 17 Januari 2022. Simak aturan berkendara menggunakan tranportasi darat dan kendaraan pribadi.  https://t.co/qO39yTXWE7,2,1,0,0,2022-01-04,6,Tuesday,2,2,1
1478247587023134722,2022-01-04 06:11:03,#FOTO SM Entertainment menggelar konser SMTOWN Live 2022: SMCU Express at Kwangya untuk menyambut pergantian tahun. Ini potret keseruannya: https://t.co/AuwZldDAXP,4,0,0,0,2022-01-04,6,Tuesday,2,4,0
1478247310161321987,2022-01-04 06:09:57,"Selepas Rossi pensiun muncul pertanyaan siapa yang bakal jadi ikon baru MotoGP. Karena setiap era memiliki bintangnya sendiri, Dorna pun membuat prediksinya.  https://t.co/C56JpoGH5g",10,1,2,0,2022-01-04,6,Tuesday,2,12,1
1478246300609089538,2022-01-04 06:05:57,Barcelona boleh dibilang lagi terpuruk saat ini. Maka tugas Ferran Torres sebagai pemain baru membantu Los Cules balik ke habitatnya di papan atas.  https://t.co/uWZDoGrUFV,5,0,0,0,2022-01-04,6,Tuesday,2,5,0
1478245818507407361,2022-01-04 06:04:02,"Belakangan, spirit doll atau boneka arwah sedang tren di kalangan selebriti. Lalu, apa kata psikolog? Apakah ini hanya tren atau bisa terjerumus halusinasi? https://t.co/6k7xrPq9w3",23,13,5,4,2022-01-04,6,Tuesday,2,28,17
1478245801939935232,2022-01-04 06:03:58,Manchester United menelan kekalahan lagi di Liga Inggris. Setan Merah mempunyai masalah yang sangat-sangat besar!  https://t.co/AONU7WoF9r,2,0,0,0,2022-01-04,6,Tuesday,2,2,0
1478245522515369985,2022-01-04 06:02:51,"Varian Omicron menular lebih cepat dibanding varian Delta, varian Corona biang kerok lonjakan kasus COVID-19. Peneliti menguak penyebabnya, masih bisa diatasi? https://t.co/sWjTkf5acD",3,3,2,0,2022-01-04,6,Tuesday,2,5,3
1478245503905284098,2022-01-04 06:02:47,Trigol ke gawang Vannes di ajang Piala Prancis membuat Kylian Mbappe sudah bikin 150 gol di Paris Saint-Germain. Ia mengancam rekor Zlatan Ibrahimovic.  https://t.co/tcEjGsjdjT,3,0,1,0,2022-01-04,6,Tuesday,2,4,0
1478244684967329796,2022-01-04 05:59:32,"Menyambut awal 2022, untuk penikmat seni ada rekomendasi agenda budaya yang bisa kamu kunjungi untuk mengisi waktu luang. Ini daftarnya:  https://t.co/xjMbzBSROk",1,0,1,0,2022-01-04,5,Tuesday,2,2,0
1478244179406995458,2022-01-04 05:57:31,Pesepakbola Hwang Ui Jo mencuri perhatian awal pekan ini karena hubungannya dengan Hyomin T-Ara. Ini pesona Hwang Ui Jo:  https://t.co/8vW4Jzg9Rr,3,0,1,0,2022-01-04,5,Tuesday,2,4,0
1478243975203115008,2022-01-04 05:56:42,Pengelola Teras Kaca Pantai Nguluran memastikan wahana barunya yakni 'Ngopi in The Sky' aman meski menggunakan crane untuk mengangkat tempat ngopi. https://t.co/AhorzoHUsZ,33,28,6,11,2022-01-04,5,Tuesday,2,39,39
1478243277790920704,2022-01-04 05:53:56,DJPPR Kementerian Keuangan akan melakukan lelang Surat Utang Negara (SUN) perdana di 2022. Hal ini dilakukan sebagian dari target pembiayaan dalam APBN 2022. https://t.co/Kqv2d9j2TH,3,0,1,0,2022-01-04,5,Tuesday,2,4,0
1478242507829952517,2022-01-04 05:50:52,"Irwansyah tak pernah sekalipun menaruh curiga pada Hafiz Fatur. Sayang, Hafiz mengkhianati kepercayaan Irwansyah dan Zaskia Sungkar...  https://t.co/0C9fYno7U0",6,0,2,0,2022-01-04,5,Tuesday,2,8,0
1478242016765136896,2022-01-04 05:48:55,Goks! Ada lima saham IPO yang mengalami kenaikan berpuluh-puluh kali lipat. Apa penyebabnya? https://t.co/pEqJWM2sgt,5,1,1,0,2022-01-04,5,Tuesday,2,6,1
1478241517324144642,2022-01-04 05:46:56,"Pakar epidemiologi menyebut naiknya PPKM DKI ke level 2 adalah kecemasan berlebihan. Menurutnya, kebijakan ini didasari pertimbangan psikologis. https://t.co/uQqGPVB88W",7,1,1,2,2022-01-04,5,Tuesday,2,8,3
1478240665666523140,2022-01-04 05:43:33,Eka Gustiwana dan Sara Fajira kembali jalani kolaborasi. Kali ini mereka tergabung dalam project lagunya yang bertajuk Push It Down. https://t.co/04aDh1WuQF,5,0,3,0,2022-01-04,5,Tuesday,2,8,0
1478240110458155009,2022-01-04 05:41:21,Gaga Muhammad menjalani sidang tuntutan. Sahabat Laura Anna mengunggah video bukti Gaga Muhammad tak pernah menyesal buat Laura celaka dan lumpuh. https://t.co/NqOtR14ul8,39,0,5,2,2022-01-04,5,Tuesday,2,44,2
1478239628423487490,2022-01-04 05:39:26,"Rekonstruksi kasus kecelakaan Handi Saputra (18) dan Salsabila (14) yang melibatkan tiga oknum prajurit TNI juga digelar di Kabupaten Banyumas, Jawa Tengah.  https://t.co/Pe6WGbXEv0",8,1,4,0,2022-01-04,5,Tuesday,2,12,1
1478239104311742465,2022-01-04 05:37:21,"Catat ratusan kasus Omicron, PPKM DKI Jakarta naik ke level 2, ini aturan lengkapnya termasuk ketentuan masuk mal hingga bioskop. https://t.co/bui7FCH0oV",8,0,8,2,2022-01-04,5,Tuesday,2,16,2
1478238609778135046,2022-01-04 05:35:23,"Pada hari ini, 4 Januari 2022, Bumi berada di titik perihelion atau jarak terdekatnya dari Matahari. Apa itu perihelion dan apa dampaknya? Simak di sini:  https://t.co/5DlCIb2Oce",31,3,10,2,2022-01-04,5,Tuesday,2,41,5
1478238120713850883,2022-01-04 05:33:26,"Yuk, intip sederet fakta album debut Kep1er berjudul First Impact yang rilis pada 3 Januari 2022. Ini faktanya:  https://t.co/5WY9Fs3gpm",1,0,1,0,2022-01-04,5,Tuesday,2,2,0
1478236466887155712,2022-01-04 05:26:52,Titi Kamal bahagia bukan main saat mengetahui film Makmum 2 nyaris tembus 50 ribu penonton. #Makmum2   https://t.co/MPBOqCIiuD,4,1,1,0,2022-01-04,5,Tuesday,2,5,1
1478236214792761346,2022-01-04 05:25:52,"Punya trik menarik pelanggan, penjual makanan ini kenakan kostum tak biasa. Ada SpiderMan jualan sate hingga Kakashi jual kerak telor! https://t.co/WuLRahG0GP",4,0,0,0,2022-01-04,5,Tuesday,2,4,0
1478235166854287360,2022-01-04 05:21:42,"Tradisi bungkus-bungkus makanan saat ada acara atau pesta, ternyata memiliki makna sendiri. Kebiasaan ini sudah menjadi budaya di Manado. https://t.co/jxXkaifX3A",9,0,3,2,2022-01-04,5,Tuesday,2,12,2
1478234672656179202,2022-01-04 05:19:44,"Tahu pada umumnya diolah dengan cara digoreng atau dijadikan bakso. Namun, pernah kah kamu mencicipi wedang tahu? https://t.co/SWR9oYT9Ps",3,3,0,1,2022-01-04,5,Tuesday,2,3,4
1478234427268419591,2022-01-04 05:18:46,"Gugatan presidential threshold agar menjadi 0 persen terus berdatangan ke MK. Kali ini diajukan oleh seorang ASN dari Jakarta, Ikhwan Mansyur. https://t.co/97Pwu5PXwN",11,0,4,2,2022-01-04,5,Tuesday,2,15,2
1478233447369949185,2022-01-04 05:14:52,"Tak disangka, pentol buatan Mika mendapat respons positif. Lama kelamaan, Mika kebanjiran pesanan dari teman-temannya. Begini kisahnya: https://t.co/6T9V8KxNN6",29,5,5,0,2022-01-04,5,Tuesday,2,34,5
1478232686309294090,2022-01-04 05:11:51,"Mantan personel Slank, Pay Burman cerita pengalamannya sembuh dari narkoba. Hal itu terjadi setelah Pay Burman meninggalkan Slank. Ini kisahnya:  https://t.co/Zt38rQwJh5",8,0,3,0,2022-01-04,5,Tuesday,2,11,0
1478232385183526921,2022-01-04 05:10:39,Perbankan saat ini mulai bertransformasi ke digital sebagai bentuk pertahanan agar tidak ditinggal nasabah. Berabgai inovasi pun dilakukan perbankan. https://t.co/hPZ3DvCcbz,3,0,1,0,2022-01-04,5,Tuesday,2,4,0
1478231896270196742,2022-01-04 05:08:42,"Di sela aktivitasnya yang padat, Teuku Wisnu harus terganggu dengan asam lambung. Sakit itu membuatnya tidak nyaman karena merasakan nyeri dan sesak....  https://t.co/BeCzc9ulxi",8,0,3,2,2022-01-04,5,Tuesday,2,11,2
1478231147914088451,2022-01-04 05:05:44,Ada banyak tontonan seru yang bisa kamu saksikan di awal 2022 ini. Catat ini daftarnya:  https://t.co/27tbSTcEvv,5,0,1,0,2022-01-04,5,Tuesday,2,6,0
1478230615128424450,2022-01-04 05:03:37,Gas LPG 12 kg kini dijual Rp 175.000 oleh warung kepada konsumen. Pelanggan pun berniat beralih ke gas subsidi 3 kg. https://t.co/0rUsJ8O2jZ,6,3,2,1,2022-01-04,5,Tuesday,2,8,4
1478230098323161092,2022-01-04 05:01:34,"Havid Alfriandra, pemuda asal Klaten viral dikabarkan menjadi korban penipuan calo tenaga kerja di Jawa Barat. Kini dia disebut menggelandang di perantauan... https://t.co/vjVLSohYz4",5,2,2,1,2022-01-04,5,Tuesday,2,7,3
1478229096631087108,2022-01-04 04:57:35,WhatsApp sudah menguji coba beberapa fitur baru yang diprediksi akan digulirkan tahun ini. Ini deretan calon fitur baru WhatsApp:  https://t.co/MET4XrukX4,6,2,0,1,2022-01-04,4,Tuesday,2,6,3
1478229078163529729,2022-01-04 04:57:31,Video TikTok Nadya Mustika jadi sorotan karena diduga menyindir Rizki DA punya pacar baru. Tak bicara di belakang keduanya langsung bertemu! https://t.co/TqMkcK3zSD,2,0,1,1,2022-01-04,4,Tuesday,2,3,1
1478228828631752710,2022-01-04 04:56:31,Para pengusaha memastikan tetap akan menggugat Gubernur DKI Jakarta Anies Baswedan soal kenaikan UMP untuk 2022. https://t.co/RWybLwmurr,18,3,4,2,2022-01-04,4,Tuesday,2,22,5
1478228249616523264,2022-01-04 04:54:13,Habib Bahar dijadikan tersangka atas kasus dugaan penyebaran berita bohong. Hal itu diduga terkait ucapan tentang penembakan di kilometer 50. Seperti apa? https://t.co/cua4vwAPx8,10,1,1,1,2022-01-04,4,Tuesday,2,11,2
1478227502447398913,2022-01-04 04:51:15,"Sempat heboh temuan kasus Florona, infeksi gabungan dari flu dan Corona. Apakah itu hal yang baru? Ini penjelasan dokter. https://t.co/OLVtbOuIWG",1,2,2,0,2022-01-04,4,Tuesday,2,3,2
1478226744821878788,2022-01-04 04:48:14,Penyanyi senior Nindy Ellesse meninggal dunia setelah berjuang melawan kanker payudara. Ini perjuangan Nindy Ellesse diserang kanker tiga kali:  https://t.co/woKjf1XaHq,5,0,2,1,2022-01-04,4,Tuesday,2,7,1
1478226519382237188,2022-01-04 04:47:20,Tottenham Hotspur akan menghadapi Chelsea di semifinal Piala Liga Inggris. Antonio Conte menilai Chelsea saat ini lebih siap untuk menjuarai kompetisi  https://t.co/pLXQkPeBef,2,0,1,0,2022-01-04,4,Tuesday,2,3,0
1478226496414179329,2022-01-04 04:47:15,"Ivan Gunawan menanggapi pro kontra soal spirit doll. Sebagai orang yang mengadopsi dua spirit doll, Igun menegaskan 'anak-anaknya' bukan anak setan. https://t.co/WtWAeiTUYl",45,66,5,6,2022-01-04,4,Tuesday,2,50,72
1478225930673917954,2022-01-04 04:45:00,"Jika ingin membakar kalori, asupan makanan dan olahraga harus seimbang. Enam makanan ini disebut baik untuk maksimalkan pembakaran kalori setelah olahraga. https://t.co/cuhSi67gp3",5,1,0,0,2022-01-04,4,Tuesday,2,5,1
1478225136243335171,2022-01-04 04:41:51,Seorang penyanyi Malaysia dilarang masuk Singapura meskipun sudah divaksin dua kali. Kok bisa? https://t.co/ALqWgsicRF,2,1,2,0,2022-01-04,4,Tuesday,2,4,1
1478224392459104260,2022-01-04 04:38:53,Aura Kasih sempat menyinggung soal penyakit ain yang buat dirinya hapus foto seksi di media sosial. Ini kata Ustaz Maulana soal wanti-wanti penyakit ain:  https://t.co/4MgxOu9gWX,4,0,0,0,2022-01-04,4,Tuesday,2,4,0
1478223648922214404,2022-01-04 04:35:56,Rumor transfer Alvaro Morata membuat pelatih Juventus Massimiliano Allegri gerah. Ia pun bertekad mempertahankan penyerang Spanyol tersebut.  https://t.co/gy8WdKQRjE,4,0,0,1,2022-01-04,4,Tuesday,2,4,1
1478223385251524612,2022-01-04 04:34:53,"Jadi anak pertama, rasanya berat ya? detikcom mau kasih kamu handphone baru sebagai hadiah atas perjuanganmu nih! Simak caranya: https://t.co/yjD1T6X7On",12,3,1,3,2022-01-04,4,Tuesday,2,13,6
1478223126546853888,2022-01-04 04:33:52,#Foto Chanathip Songkrasin pernah berpacaran dengan aktris Pitchanart Shakhakorn. Intip yuk potret wanita cantik yang lebih tua 12 tahun dari Chanathip. https://t.co/KqzhdzEsUW,3,1,1,0,2022-01-04,4,Tuesday,2,4,1
1478222296775016459,2022-01-04 04:30:34,Manchester United tumbang di kandang kala menjamu Wolverhampton Wanderers. Berikut delapan fakta kekalahan Setan Merah di tangan The Wolves.   https://t.co/IeywsZTTgQ,7,0,2,0,2022-01-04,4,Tuesday,2,9,0
1478222295672008704,2022-01-04 04:30:33,"Pemerintah memutuskan menyetop sementara ekspor batu bara. Lantas, siapa saja pengusaha yang memperoleh pundi-pundi uang dari emas hitam ini? https://t.co/nJt5sUpw4K",21,0,8,1,2022-01-04,4,Tuesday,2,29,1
1478222013340819460,2022-01-04 04:29:26,"Ferran Torres sial betul. Baru diperkenalkan sebagai pemain Barcelona, Torres harus absen dulu karena positif COVID-19. Duh!  https://t.co/fKY51bXPzE",8,0,1,0,2022-01-04,4,Tuesday,2,9,0
1478221562511826944,2022-01-04 04:27:39,"Manga Hunter x Hunter sudah hiatus selama tiga tahun lamanya, apakah komik ciptaan Yoshihiro Togashi bakal kembali terbit? https://t.co/VRDqxqKCRg",127,52,41,29,2022-01-04,4,Tuesday,2,168,81
1478221538444951555,2022-01-04 04:27:33,UMY digegerkan dengan kasus dugaan kekerasan seksual yang dilakukan salah seorang aktivis mahasiswanya. Pihak kampus kini memberikan pendampingan bagi korban. https://t.co/nYimmjWcqG,30,3,10,0,2022-01-04,4,Tuesday,2,40,3
1478221053268799490,2022-01-04 04:25:37,Komik Superman: Son of Kal-El jadi pembicaraan setelah anak Lois Lane dan Clark Kent menjadi Superman terbaru. #Superman   https://t.co/umgWC9zUtJ,2,1,1,0,2022-01-04,4,Tuesday,2,3,1
1478220572396072965,2022-01-04 04:23:43,"#Terpopuler Humas Polda Metro Jaya, Endra Zulpan, mengatakan artis Cassandra Angelie saat ini diberlakukan wajib lapor. Ini alasannya: https://t.co/aTzUsxDs0k",5,1,1,0,2022-01-04,4,Tuesday,2,6,1
1478220552963862532,2022-01-04 04:23:38,"Harga cabai rawit merah, minyak goreng hingga telur ayam naik. Pemprov DKI memprediksi harga bakal turun mulai bulan depan. https://t.co/AylhyrzXlY",3,1,2,0,2022-01-04,4,Tuesday,2,5,1
1478219767408435200,2022-01-04 04:20:31,Liu Haocun jadi target bully dari warganet gegara masa lalu kedua orangtuanya yang sempat membuat gadis 6 tahun lumpuh. Ini kisahnya:  https://t.co/7W7eTwD5IC,4,0,1,0,2022-01-04,4,Tuesday,2,5,0
1478218737861939200,2022-01-04 04:16:25,"Habib Bahar bin Smith kembali menjadi tersangka dan ditahan di Polda Jawa Barat karena diduga menyebarkan berita bohong dalam sebuah ceramah. Tak hanya Bahar Smith, pengunggah video ceramahnya juga ditetapkan sebagai tersangka. https://t.co/KskpvoYqYo",3,0,1,1,2022-01-04,4,Tuesday,2,4,1
1478218736754728962,2022-01-04 04:16:25,Polda Jabar menetapkan habib Bahar bin Smith sebagai tersangka kasus penyebaran berita bohong saat ceramah di Bandung. Bahar kini ditahan. https://t.co/YtakWsSGUz,19,12,3,1,2022-01-04,4,Tuesday,2,22,13
1478217663721746433,2022-01-04 04:12:09,"Britney Spears memutuskan untuk meng-unfollow adiknya, Jamie Lynn Spears, di instagram. Hal ini imbas perseteruannya dengan pihak keluarga. Waduh...  https://t.co/owyHQvBMLn",3,0,0,0,2022-01-04,4,Tuesday,2,3,0
1478216905131442177,2022-01-04 04:09:08,Satgas transisi penanganan bencana erupsi gunung Semeru kembali menemukan dua jenazah korban erupsi gunung Semeru. Korban berjenis kelamin perempuan dan laki laki. https://t.co/8Z5qLvNv2G,6,0,0,0,2022-01-04,4,Tuesday,2,6,0
1478216174827679748,2022-01-04 04:06:14,Amphuri memastikan ada manfaat yang didapatkan setelah melakukan dua kali umrah uji coba untuk para jemaah. Apa saja? https://t.co/ew9fKqrJG3,1,1,0,0,2022-01-04,4,Tuesday,2,1,1
1478215924679430147,2022-01-04 04:05:15,Seafood ini bikin orang ngeri karena seperti jari kehitaman dengan cakar tajam. Gooseneck barnacles dibanderol hingga Rp 3 juta per kg! Apa istimewanya? https://t.co/y18Qq9vk6r,6,2,1,0,2022-01-04,4,Tuesday,2,7,2
1478215436466630662,2022-01-04 04:03:18,"Polisi menyebut pria hidung belang pelanggan prostitusi Cassandra Angelie bisa dijerat pidana, tapi ada syaratnya. https://t.co/JRZmEzedHo",4,0,0,0,2022-01-04,4,Tuesday,2,4,0
1478215420448591872,2022-01-04 04:03:14,Tim Damkar Makassar masih mencari ular piton 5 meter yang muncul di RS Dr Wahidin Sudirohusodo dan kini lari ruang isolasi pasien COVID-19. Waduh! https://t.co/i4AslAb9RA,2,1,0,2,2022-01-04,4,Tuesday,2,2,3
1478214906356940819,2022-01-04 04:01:12,"Komnas KIPI pun menjelaskan belum ada kasus meninggal yang disebabkan vaksinasi COVID-19, termasuk kematian dua bocah di Jombang dan dua warga Bone. #detiknetwork  https://t.co/sLWZD1MXF7",3,10,1,7,2022-01-04,4,Tuesday,2,4,17
1478213924071817218,2022-01-04 03:57:18,Eks Menkominfo Rudiantara kembali terjun ke industri telekomunikasi setelah kembali dipinang Indosat Ooredoo Hutchison. Apa alasan Rudiantara mau bergabung? https://t.co/cY89whIbVb,4,0,1,1,2022-01-04,3,Tuesday,2,5,1
1478213389474275328,2022-01-04 03:55:10,"Suga BTS dinyatakan sembuh dari COVID-19. Saat ini, ia sudah diperbolehkan keluar dari karantina. #Suga #BTS  https://t.co/LFKqGQldbv",7,0,3,0,2022-01-04,3,Tuesday,2,10,0
1478213375922421764,2022-01-04 03:55:07,"Zaskia Sungkar sempat dipanggil oleh Kejaksaan atas kasus korupsi yang dilakukan adik Irwansyah, Hafiz Fatur. Ini alasan Zaskia dipanggil Kejaksaan:  https://t.co/CMs2VAVmln",1,0,0,0,2022-01-04,3,Tuesday,2,1,0
1478212648550514690,2022-01-04 03:52:13,Dirjen PAUD Dikdasmen Jumeri menyatakan guru yang menolak divaksin akan dapat sanksi menurut Perpres 14/2021. Berikut sanksi yang dimaksud: Via: detikedu https://t.co/LambS0UKvV,5,1,1,0,2022-01-04,3,Tuesday,2,6,1
1478212629344702466,2022-01-04 03:52:09,Balita asal Amerika ini berdandan seperti Ratu Elizabeth untuk menyambut Halloween. Penampilan bocah bernama Jalayne Sutherland itu jadi sorotan. Gemas! https://t.co/UWVa4BL5jo,8,0,2,0,2022-01-04,3,Tuesday,2,10,0
1478212382732214274,2022-01-04 03:51:10,Sebanyak 32 ribu warga di Aceh Utara terpaksa mengungsi setelah daerah tersebut terendam banjir luapan. Banjir juga menyebabkan dua anak tewas tenggelam. #Aceh https://t.co/CDAuKmVmoq,4,1,1,0,2022-01-04,3,Tuesday,2,5,1
1478211591686529030,2022-01-04 03:48:01,"#Terpopuler Amalia Fujiawati laporkan Bambang Pamungkas soal penelantaran anak. Putri sulung Bepe, Jane Abel jadi saksi untuk laporan Amalia Fujiawati. https://t.co/12MfrQAQlR",2,0,0,0,2022-01-04,3,Tuesday,2,2,0
1478211350782488580,2022-01-04 03:47:04,Irwansyah sakit hati dan kecewa atas tindakan adiknya yang tega menipu dirinya dan orang lain. Ia memilih untuk memperkarakan kasus tersebut. #Irwansyah  https://t.co/xwGM8cxPCE,5,1,1,0,2022-01-04,3,Tuesday,2,6,1
1478211041184079872,2022-01-04 03:45:50,"Orang tua atau wali diminta mendorong anaknya yang sudah memenuhi syarat agar mendapat vaksinasi. Namun, vaksinasi tidak menjadi syarat untuk bisa ikut PTM terbatas. Via: detikedu https://t.co/lFI6MoILQL",2,0,1,0,2022-01-04,3,Tuesday,2,3,0
1478210034433679362,2022-01-04 03:41:50,"Menu ayam utuh yang viral membuat banyak gerai menyajikan yang serupa. detikfood mencicipi tiga hidangan ayam utuh, mana yang paling lezat rasanya? https://t.co/PFN8Ky75UY",3,0,3,0,2022-01-04,3,Tuesday,2,6,0
1478209318059233283,2022-01-04 03:38:59,Kasus prostitusi yang melibatkan Cassandra Angelie banyak yang bertanya ataupun meminta pelanggan Cassandra dikenakan pidana. Ini jawaban polisi:  https://t.co/T273CNJmWI,10,11,3,2,2022-01-04,3,Tuesday,2,13,13
1478209050588422150,2022-01-04 03:37:56,Bek Manchester United Luke Shaw mengakui performa timnya tidak cukup bagus saat dikalahkan Wolverhampton Wanderers. Shaw menyoroti komitmen para pemain MU.  https://t.co/ejPCSLyxlD,1,1,0,0,2022-01-04,3,Tuesday,2,1,1
1478208536811384835,2022-01-04 03:35:53,Wang Leehom terancam diboikot dari dunia hiburan akibat kasus perceraian serta kehebohan yang terjadi akhir-akhir ini. #WangLeehom  https://t.co/L93x3emwpF,3,1,2,0,2022-01-04,3,Tuesday,2,5,1
1478207987764367366,2022-01-04 03:33:42,"Apa yang terjadi di kelas MotoGP setelah perpisahan dari legenda MotoGP, Valentino Rossi? Dorna coba membuat prediksi.  https://t.co/Znnow5E1Ma",4,0,0,0,2022-01-04,3,Tuesday,2,4,0
1478207972438417411,2022-01-04 03:33:39,Kementerian ESDM melarang sementara ekspor batu bara mulai 1 Januari hingga 31 Januari 2022. Begini kata Menteri BUMN Erick Thohir. https://t.co/EzrPjKseHH,4,0,2,0,2022-01-04,3,Tuesday,2,6,0
1478207688173572096,2022-01-04 03:32:31,"Sepanjang 2021, Tesla hampir menjual satu juta unit kendaraan. Angka itu hampir naik dua kali lipat dibandingkan penjualan tahun 2020.  https://t.co/XPkgiMiv5r",5,0,0,0,2022-01-04,3,Tuesday,2,5,0
1478207432581124096,2022-01-04 03:31:30,Penyesuaian tarif Tol Surabaya-Gresik resmi diberlakukan mulai Senin (3/1) pukul 00.00 WIB kemarin. Ini daftarnya: https://t.co/ibrBIqEF4I,1,0,2,2,2022-01-04,3,Tuesday,2,3,2
1478207416345018369,2022-01-04 03:31:26,"Sebuah mobil menarik perhatian saat ditemui di bilangan Depok, Jawa Barat. Ini penampakannya!   https://t.co/01cejOtYUR",21,0,5,2,2022-01-04,3,Tuesday,2,26,2
1478207126799536131,2022-01-04 03:30:17,"Hadooh, Rupiah kebakaran! Nilai tukar dolar Amerika Serikat (AS) terhadap rupiah pagi ini menguat. Begini pergerakannya: https://t.co/Vae206TBLN",8,0,1,0,2022-01-04,3,Tuesday,2,9,0
1478207106348163073,2022-01-04 03:30:12,Manchester United tampil buruk saat dikalahkan Wolverhampton Wanderers 0-1 di Liga Inggris. Joao Moutinho mengatakan timnya memang layak menang.  https://t.co/2STyT78Tuh,3,0,0,0,2022-01-04,3,Tuesday,2,3,0
1478206343932743684,2022-01-04 03:27:10,Manchester United tumbang di kandang kala menjamu Wolverhampton Wanderers. Berikut delapan fakta kekalahan Setan Merah di tangan The Wolves.  https://t.co/UDOyasFWvg,3,1,1,0,2022-01-04,3,Tuesday,2,4,1
1478205809758810116,2022-01-04 03:25:03,"Presiden Barcelona, Joan Laporta, angkat bicara soal isu klubnya mau mendatangkan Erling Haaland. Dia menyebut transfer tersebut bisa saja terjadi kelak.  https://t.co/5mvja5fmpH",3,0,0,0,2022-01-04,3,Tuesday,2,3,0
1478205721367953409,2022-01-04 03:24:42,"Sebanyak 4 kios di Kendari, Sulawesi Tenggara (Sultra) kebakaran. Dua unit mobil pemadam kebakaran (damkar) dikerahkan. Beruntung tidak ada korban jiwa. https://t.co/vpvV8qv2BK",5,0,0,0,2022-01-04,3,Tuesday,2,5,0
1478205531135393793,2022-01-04 03:23:57,Bek Arsenal Ben White kedapatan menampar tangan asisten wasit dua saat bersalaman usai laga Arsenal vs Manchester City bubar.  https://t.co/rTctjFNLog,2,0,0,0,2022-01-04,3,Tuesday,2,2,0
1478205281003835396,2022-01-04 03:22:57,Phil Jones kembali memperkuat Manchester United setelah hampir dua tahun absen. Performa bek 29 tahun itu di lapangan mendapat pujian.  https://t.co/dnhhMRz6Tl,2,0,0,1,2022-01-04,3,Tuesday,2,2,1
1478205275429605378,2022-01-04 03:22:56,Sebuah video aksi sepasang WNA diduga tengah menerobos kawasan Candi Prambanan viral. Dalam video itu keduanya terlihat memanjat pagar area terluar kompleks Candi Prambanan dan menerobos masuk. https://t.co/isEsvcCev5,4,1,1,0,2022-01-04,3,Tuesday,2,5,1
1478204453698383873,2022-01-04 03:19:40,"Sebanyak 4 kios di Kendari, Sulawesi Tenggara (Sultra) kebakaran. Dua unit mobil pemadam kebakaran (damkar) dikerahkan. Beruntung tidak ada korban jiwa. https://t.co/Kllr06QtGm",5,0,0,0,2022-01-04,3,Tuesday,2,5,0
1478203723142860801,2022-01-04 03:16:45,"Syariah Mobilindo tak hanya fokus kepada penjualan mobil bekas, namun juga menawarkan sistem pembayaran yang lebih aman dibanding dealer konvensional.  https://t.co/gJ8BhSs1ky",11,10,2,1,2022-01-04,3,Tuesday,2,13,11
1478202977160769538,2022-01-04 03:13:48,Ivan Gunawan ngaku tidak kesulitan dalam mengurus kedua 'anaknya'. Sebab masing-masing sudah memiliki pengasuh alias baby sitter.  https://t.co/S4gWCSG0bm,79,101,1,20,2022-01-04,3,Tuesday,2,80,121
1478201919004889090,2022-01-04 03:09:35,Hafiz Fatur ternyata tega mencuri surat-surat aset milik Irwansyah yang dipegang almarhum orang tuanya. Waduh! https://t.co/b4vckfvANr,15,2,1,1,2022-01-04,3,Tuesday,2,16,3
1478201422537711619,2022-01-04 03:07:37,"Program diskon pajak penjualan atas barang mewah (PPnBM) 100% untuk mobil baru telah berakhir pada 31 Desember 2021 lalu. Per Januari 2022, harga mobil pun mengalami kenaikan. https://t.co/nQ9H4Y2DTS",1,0,0,0,2022-01-04,3,Tuesday,2,1,0
1478200932928212998,2022-01-04 03:05:40,Seorang pria putus asa berpikir bahwa dia tidak akan bisa menemukan cinta sejatinya. Pria itu kemudian berencana untuk menikahi seorang wanita robot. https://t.co/fvJwtK85kU,9,1,1,8,2022-01-04,3,Tuesday,2,10,9
1478200193271144453,2022-01-04 03:02:44,"Saat jam istirahat PTM Terbatas, Kemenkes menyampaikan agar siswa memperhatikan beberapa hal untuk keamanan kesehatan. Ini 5 tips amannya. Via: detikedu https://t.co/dBgoID7Tbv",2,0,0,1,2022-01-04,3,Tuesday,2,2,1
1478199041217503241,2022-01-04 02:58:09,"Kini, Rachmat telah resmi menjadi bagian dari Kemenko Kemaritiman dan Investasi yang dipimpin Luhut Binsar Pandjaitan. Ini posisinya: https://t.co/7tP0KU7aXo",13,2,1,1,2022-01-04,2,Tuesday,2,14,3
1478197798034194434,2022-01-04 02:53:13,Irwansyah merasa kecewa dan sakit hati atas tindakan sang adik yang tega menipunya. Ini kisah lengkap dari kasus Irwansyah:  https://t.co/y8Gs0elG2J,2,0,1,0,2022-01-04,2,Tuesday,2,3,0
1478197056464371712,2022-01-04 02:50:16,"Penyanyi senior Nindy Ellesse meninggal dunia setelah 3 tahun berjuang melawan kanker payudara stadium 4. Hal itu diungkapkan suaminya, Willem Frederik Laoh. https://t.co/U59sGVUHaI",3,0,1,0,2022-01-04,2,Tuesday,2,4,0
1478195232084832256,2022-01-04 02:43:01,"Mumpung masih pagi, pikiran biasanya masih fresh yakan~ Ada yang bisa jawab nggak ni? https://t.co/m45JSJuLqS",846,633,123,47,2022-01-04,2,Tuesday,2,969,680
1478193728959524867,2022-01-04 02:37:03,Samsung Galaxy S21 FE akhirnya resmi dirilis setelah bocorannya ramai bermunculan. Ini spesifikasi lengkapnya: #Samsung #GalaxyFE21  https://t.co/4OeBK1CzBo,12,1,2,0,2022-01-04,2,Tuesday,2,14,1
1478192738181038080,2022-01-04 02:33:06,Heboh sejumlah remaja nekat terjun ke sungai berarus deras di Trenggalek. Jawa Timur. Mereka kemudian meminta maaf atas apa yang telah mereka lakukan. https://t.co/3a8HJjTiBP,4,2,0,1,2022-01-04,2,Tuesday,2,4,3
1478192232205279233,2022-01-04 02:31:06,"Harga emas Antam hari ini turun Rp 10.000! Buat yang mau beli, berikut rincian harganya: https://t.co/Qjo6SOQMqx",16,0,2,0,2022-01-04,2,Tuesday,2,18,0
1478192230917722115,2022-01-04 02:31:05,"Sosok Nur Chamin, menjadi viral usai beredar video ketika ia menghadiahi anak dan keluarganya 3 unit mobil mewah. Duitnya dari mana? https://t.co/8kGAnGVRUS",44,13,4,4,2022-01-04,2,Tuesday,2,48,17
1478191425837797380,2022-01-04 02:27:54,Inflasi Turki secara tahunan berada di level tertinggi dalam 19 tahun. Hal ini menjadi peringatan atas kebijakan presidennya Recep Tayyip Erdogan. https://t.co/llwKo9Yyvq,17,11,6,4,2022-01-04,2,Tuesday,2,23,15
1478190182784712707,2022-01-04 02:22:57,"Sejumlah area di Kanada melaporkan lonjakan kasus COVID-19 imbas varian Omicron. Guna menekan laju kasus, toko di pusat perbelanjaan hingga bioskop pun ditutup. https://t.co/oTvRXoyxaM",6,1,1,0,2022-01-04,2,Tuesday,2,7,1
1478189198150676486,2022-01-04 02:19:02,Polisi mendapat list nama dari muncikari yang menjajakan Cassandra Angelie. Dari daftar nama itu rata-rata pesinetron muda dan tinggal di Jakarta. https://t.co/HxzwDzWVnD,18,3,2,0,2022-01-04,2,Tuesday,2,20,3
1478187869256798213,2022-01-04 02:13:46,Cassandra Angelie dinyatakan sebagai tersangka atas kasus prostitusi. Selain itu polisi juga telah mengantongi nama artis lainnya yang terlibat. #CassandraAngelie  https://t.co/QRF9p89Ace,8,2,1,0,2022-01-04,2,Tuesday,2,9,2
1478186630401957893,2022-01-04 02:08:50,Polisi menetapkan habib Bahar bin Smith sebagai tersangka atas kasus penyebaran berita bohong dalam ceramah di Bandung. Bagaimana kronologinya? https://t.co/WJqfstsNg8,5,2,3,2,2022-01-04,2,Tuesday,2,8,4
1478185645243777031,2022-01-04 02:04:55,Siapa yang zodiaknya Taurus? Jangan merasa yakin dulu dengan apa yang telah ditawarkan mereka sebelum jelas bukti riil nya. Lihat yuk kata zodiak lainnya: https://t.co/ALBUyaMgrj,2,0,1,0,2022-01-04,2,Tuesday,2,3,0
1478184644575051776,2022-01-04 02:00:57,Persiapan ini penting agar anak tetap aman dan waspada saat sekolah tatap muka berlangsung. Berikut 5 hal yang perlu dipersiapkan saat anak masuk sekolah. #CNNIndonesia #detikNetwork  https://t.co/rnAwshlzvP,2,0,0,0,2022-01-04,2,Tuesday,2,2,0
1478183409096826885,2022-01-04 01:56:02,Beberapa gambar ini memiliki teka-teki yang perlu dipecahkan. Kamu bisa menjawabnya bila memiliki logika dan ketajaman mata yang bagus. #TesAsahOtak https://t.co/13r5pioPJo,5,1,2,0,2022-01-04,1,Tuesday,2,7,1
1478182186700488708,2022-01-04 01:51:11,"Taman nasional di Sidney, Australia, memiliki api yang menyala kurang lebih selama 6.000 tahun. Apa yang menyebabkannya menyala? https://t.co/GX4nuAqHeW",22,0,5,1,2022-01-04,1,Tuesday,2,27,1
1478179451968135170,2022-01-04 01:40:19,"Keberadaan varian Omicron berdampak pada pembatalan ribuan penerbangan di dunia. Terakhir, lebih dari 4.000 penerbangan di dunia batal mengudara. https://t.co/dbvLGUPjOS",14,0,7,1,2022-01-04,1,Tuesday,2,21,1
1478178465849430018,2022-01-04 01:36:24,"Dari CEO Bukalapak, Rachmat Kaimuddin dipastikan bergabung dengan Kemenko Kemaritiman dan Investasi pimpinan Luhut. Ini dia rekam jejaknya. https://t.co/OGEE8nN0D4",13,2,1,0,2022-01-04,1,Tuesday,2,14,2
1478177254282862593,2022-01-04 01:31:35,Ada apa di balik tren memiliki boneka yang konon dimasukkan arwah itu? Ini penjelasan dari psikolog. https://t.co/Vde9DKY3Wx,5,2,0,1,2022-01-04,1,Tuesday,2,5,3
1478176208860983298,2022-01-04 01:27:26,Habib Bahar jadi tersangka kasus dugaan penyebaran berita bohong. Pengacara Habib Bahar mengajukan penangguhan penahanan. https://t.co/KyG94yH9Ay,16,21,1,3,2022-01-04,1,Tuesday,2,17,24
1478175350999982080,2022-01-04 01:24:01,"Relaksasi PPnBM untuk mobil sudah berakhir. Honda belum merilis harga baru mobil-mobilnya. Dikutip dari situs resminya, belum ada kenaikan harga mobil Honda.  https://t.co/01G4Kp1w8b",3,0,0,0,2022-01-04,1,Tuesday,2,3,0
1478175098892959748,2022-01-04 01:23:01,"Omicron di Indonesia terus bertambah, totalnya menjadi 152 kasus per hari ini. Kemenkes mengungkap jenis masker yang tak lagi efektif tangkal Omicron. https://t.co/UsS0444Kts",65,38,26,12,2022-01-04,1,Tuesday,2,91,50
1478175083206262789,2022-01-04 01:22:57,"Program diskon PPnBM 100% untuk mobil baru telah berakhir pada 31 Desember 2021 lalu. Per Januari 2022, harga mobil pun mengalami kenaikan.  https://t.co/OINJlzDeaL",0,0,1,0,2022-01-04,1,Tuesday,2,1,0
1478174093220675586,2022-01-04 01:19:01,Kemenag tegur Asosiasi Muslim Penyelenggara Haji dan Amphuri yang memberangkatkan rombongan jemaah umrah di akhir tahun. Amphuri akan meminta maaf. https://t.co/xloYj6urRq,2,0,1,0,2022-01-04,1,Tuesday,2,3,0
1478174073066827777,2022-01-04 01:18:56,"Dongfeng FengGuang Mini EV baru akan diluncurkan pada kuartal pertama 2022. Soal harga, diprediksi mobil ini punya banderol sekitar USD 5.000 atau Rp 71 jutaan.  https://t.co/16Q4zi7Hrl",13,1,2,1,2022-01-04,1,Tuesday,2,15,2
1478173798616686592,2022-01-04 01:17:51,"Sesuai peraturan yang ada, program PPnBM 0% untuk mobil baru telah berakhir pada 31 Desember 2021 lalu. Per Januari 2022, harga mobil naik.  https://t.co/fDH9a6jLX7",5,0,0,0,2022-01-04,1,Tuesday,2,5,0
1478173542290239490,2022-01-04 01:16:50,"Honda Winner X 2022 tampil semakin gagah, dengan lekukan bodi yang semakin kekar.  https://t.co/pWMcD1D5Kh",3,0,0,0,2022-01-04,1,Tuesday,2,3,0
1478173283308744706,2022-01-04 01:15:48,Toyota telah merilis daftar harga mobil Januari 2022. Berapa kenaikan harga mobil yang kini tak lagi mendapat PPnBM 0%?  https://t.co/rbgmANbZYF,6,0,0,0,2022-01-04,1,Tuesday,2,6,0
1478173037744766983,2022-01-04 01:14:49,"Menparekraf Sandiaga Uno memonitor penelantaran 60 pendaki di Gunung Rinjani. Lalu, apakah akan ada penertiban terkait aktivitas ini? Ini katanya.  https://t.co/DoPBGwjQdu",10,3,2,0,2022-01-04,1,Tuesday,2,12,3
1478172496738271234,2022-01-04 01:12:40,Manchester United gagal memperbaiki posisinya usai dipermalukan Wolverhampton. Manajer interim MU Ralf Rangnick enggan menjamin timnya bisa finis empat besar.  https://t.co/zWe6LHeGXu,3,1,1,2,2022-01-04,1,Tuesday,2,4,3
1478172016318595073,2022-01-04 01:10:46,"Hafiz Fatur ternyata mencuri sertifikat aset Irwansyah. Tidak hanya itu, dia juga memalsukan tanda tangan Irwansyah. https://t.co/ZPeTSVx3el",6,0,1,0,2022-01-04,1,Tuesday,2,7,0
1478172000111808516,2022-01-04 01:10:42,"Rider Ducati Jack Miller masih mendaki jalan menuju status pebalap top MotoGP. Miller tak mau dibandingkan dengan pendahulunya, Casey Stoner.  https://t.co/lmkzHmjwHC",2,0,0,0,2022-01-04,1,Tuesday,2,2,0
1478171754119979010,2022-01-04 01:09:43,Cristiano Ronaldo menjadi kapten Manchester United saat bersua Wolverhampton Wanderers. CR7 langsung kena kritik dan dianggap bukan sosok pemimpin lapangan.  https://t.co/74IzIMTeam,48,1,7,2,2022-01-04,1,Tuesday,2,55,3
1478171493355999232,2022-01-04 01:08:41,Mason Greenwood tampil cukup oke tapi malah digantikan oleh Bruno Fernandes saat Manchester United dipermalukan Wolverhampton 0-1. Ralf Rangnick menjelaskan.  https://t.co/D7AknoyKsd,3,1,2,0,2022-01-04,1,Tuesday,2,5,1
1478171249000034304,2022-01-04 01:07:43,"Antonio Conte tak dendam dengan Chelsea. Meski sempat berseteru di masa lalu, ia tetap berterima kasih kepada The Blues yang membuka jalan berkarier di Inggris.  https://t.co/snlliBUfoG",5,0,0,0,2022-01-04,1,Tuesday,2,5,0
1478170529412624387,2022-01-04 01:04:51,"Pemerintah terus memperbaharui syarat penerbangan domestik di awal Tahun Baru 2022. Walau tak banyak berubah, ini syarat naik pesawat terbaru. Catat ya! https://t.co/lvtOC2P0CN",11,0,3,0,2022-01-04,1,Tuesday,2,14,0
1478170504536150017,2022-01-04 01:04:46,"Bintang AS Roma, Tammy Abraham, mengalami kecelakaan dalam perjalanan menuju latihan AS Roma. Mobilnya tabrakan dengan kendaraan lain.  https://t.co/Z66QykUUeL",2,0,0,0,2022-01-04,1,Tuesday,2,2,0
1478170013429383171,2022-01-04 01:02:48,Masa bulan madu Ralf Rangnick dengan Manchester United selesai sudah. MU menderita kekalahan pertamanya di era Rangnick dengan penampilan yang buruk.  https://t.co/A4FY7oO11q,5,2,1,0,2022-01-04,1,Tuesday,2,6,2
1478169764916871172,2022-01-04 01:01:49,"Paris Saint-Germain meraih hasil sempurna menghadapi tim divisi empat, Vannes, dalam Piala Prancis. Les Parisiens menang 4-0 via hat-trick Kylian Mbappe.  https://t.co/wMdb4OMybH",3,0,0,0,2022-01-04,1,Tuesday,2,3,0
1478169448393711619,2022-01-04 01:00:34,Phil Jones kembali bermain untuk Manchester United. Bek tengah 29 tahun itu merumput lagi setelah hampir dua tahun lamanya.  https://t.co/jDcXC9BfKn,2,0,1,0,2022-01-04,1,Tuesday,2,3,0
1478169196622135303,2022-01-04 00:59:34,Arsenal menderita kekalahan dramatis di tangan Manchester City 1-2. Usai laga bek tengah Arsenal Ben White tak kuasa membendung rasa geramnya pada ofisial laga.  https://t.co/vjxPzCZek6,4,0,1,0,2022-01-04,0,Tuesday,2,5,0
1478168927968677892,2022-01-04 00:58:30,"Manchester United menelan kekalahan di laga perdana mereka di tahun 2022. Menjamu Wolverhampton Wanderers dalam lanjutan Liga Inggris, Setan Merah tumbang 0-1.  https://t.co/nBm3CSFBXh",3,0,0,1,2022-01-04,0,Tuesday,2,3,1
1478168926433550341,2022-01-04 00:58:29,Polda Sumut mengambil alih penyidikan kasus pria ngaku bela diri lalu tikam begal di Medan. Langkah ini diambil untuk menghindari polemik di masyarakat. https://t.co/LSBkvR4QzV,10,5,1,0,2022-01-04,0,Tuesday,2,11,5
1478168326065070082,2022-01-04 00:56:06,"Kasus Corona di India melonjak nyaris lima kali lipat. Menkes India, Mansukh Mandaviya mewanti-wanti soal varian Omicron yang sangat menular. https://t.co/9s6Ksto92h",3,1,0,0,2022-01-04,0,Tuesday,2,3,1
1478168073886744582,2022-01-04 00:55:06,Alvaro Morata semakin dekat dengan pintu keluar Juventus untuk bergabung dengan Barcelona. Namun masih ada dua hal yang mengganjal kepindahannya ke Camp Nou.  https://t.co/IBQGEj9GGI,6,1,0,0,2022-01-04,0,Tuesday,2,6,1
1478168057252089856,2022-01-04 00:55:02,Wagub DKI Jakarta Ahmad Riza Patria mengumumkan kini ada 162 kasus varian Omicron. PAN menyorot ketersediaan alat kesehatan hingga oksigen https://t.co/DPBy1eg6h2,5,0,0,1,2022-01-04,0,Tuesday,2,5,1
1478168055578513410,2022-01-04 00:55:02,"Longsoran tanah menutup lahan pertanian di Pranten, Kecamatan Bawang, Kabupaten Batang, Jawa Tengah, Senin (3/1/2022). Akses di dua desa itu pun ikut terputus. https://t.co/OzLNrJ1AqY",5,0,0,0,2022-01-04,0,Tuesday,2,5,0
1478167819191738368,2022-01-04 00:54:05,Situasi Romelu Lukaku memunculkan spekulasi tentang kelanjutan kariernya di Chelsea. Lukaku diklaim berminat bereuni dengan Antonio Conte di Tottenham Hotspur.  https://t.co/YYHdDqbylv,4,0,0,0,2022-01-04,0,Tuesday,2,4,0
1478167799159742471,2022-01-04 00:54:01,Negara tetangga Indonesia terancam diterjang gelombang varian Omicron. Hal itu juga akan mengancam sistem kesehatan masyarakat di sana. https://t.co/YJ96pp7f8Q,2,3,0,0,2022-01-04,0,Tuesday,2,2,3
1478167560453558281,2022-01-04 00:53:04,"Manchester United menelan kekalahan di laga perdana mereka di tahun 2022. Menjamu Wolverhampton Wanderers dalam lanjutan Liga Inggris, Setan Merah tumbang 0-1.  https://t.co/CDUMg8s6y4",3,0,0,0,2022-01-04,0,Tuesday,2,3,0
1478167542590066691,2022-01-04 00:52:59,Menkes Budi Gunadi Sadikin mengatakan vaksinasi booster COVID-19 bakal dimulai 12 Januari 2022. Bagaimana teknis pemberian dan kriteria orang yang menerimanya? https://t.co/mJXYstAV7E,3,0,3,0,2022-01-04,0,Tuesday,2,6,0
1478167298162798595,2022-01-04 00:52:01,Pemerintah akan segera menggelar vaksinasi booster di Indonesia. Gerindra mengusulkan vaksin booster dapat diberikan ke masyarakat secara gratis. https://t.co/Nvf7vTQYfY,2,0,0,2,2022-01-04,0,Tuesday,2,2,2
1478166897329938432,2022-01-04 00:50:25,"Presiden Barcelona Joan Laporta memperingatkan klub-klub rival bahwa Barca sudah kembali. Laporta juga yakin, Barca masih sanggup menarik minat pemain top.  https://t.co/Usx4moy5Qr",1,0,0,0,2022-01-04,0,Tuesday,2,1,0
1478166802236846080,2022-01-04 00:50:03,Masa karantina pelaku perjalanan luar negeri di Indonesia berganti. Keputusan ini disampaikan menteri setelah rapat terbatas. https://t.co/eA3pEMVdLo,2,0,2,1,2022-01-04,0,Tuesday,2,4,1
1478166305656262659,2022-01-04 00:48:04,Bupati Bogor Ade Yasin tak membubarkan milad Front Persaudaraan Islam (FPI) di pelataran Masjid At-Ta'awun Puncak yang tak memiliki izin. Apa alasannya? https://t.co/vUYHPt17NO,57,59,17,11,2022-01-04,0,Tuesday,2,74,70
1478165816818475008,2022-01-04 00:46:08,#terpopuler Ketua Umum PSSI Mochamad Iriawan angkat bicara terkait penyambutan Timnas Indonesia. Ia dikritik karena Garuda mestinya menjalani karantina tanpa bertemu orang.  https://t.co/0sWxdDiRzV https://t.co/Z3AVZN3YKO,20,4,1,2,2022-01-04,0,Tuesday,2,21,6
1478164749422583808,2022-01-04 00:41:53,"#terpopuler 3 unit mobil mewah hadiah ulang tahun seorang sekretaris Desa Gajihan Kecamatan Gunungwungkal, Pati, viral di medsos. Ini dia penampakan ketiga mobilnya.  https://t.co/JX9ZdPUvhw https://t.co/L9ry1g3muP",26,13,6,1,2022-01-04,0,Tuesday,2,32,14
1478164580509667329,2022-01-04 00:41:13,LBM Eijkman disorot usai melebur dengan BRIN. Kehebohan pun mengemuka lantaran dikabarkan banyak peneliti eks Eijkman yang kehilangan pekerjaan. https://t.co/zvbOIj6cfg,5,0,1,1,2022-01-04,0,Tuesday,2,6,1
1478164052169867266,2022-01-04 00:39:07,"Salah satu cara mendapatkan tubuh yang langsing yaitu dengan mengonsumsi obat diet. Namun, sudah tahukah Anda dampak negatif obat diet? https://t.co/4N8BOH7H9f",6,0,2,0,2022-01-04,0,Tuesday,2,8,0
1478162527158689794,2022-01-04 00:33:04,PPKM Jawa-Bali diperpanjang hingga 17 Januari 2022. Berikut pembagian level PPKM di masing-masing kota dan kabupaten. https://t.co/1CUjVP11Vg,8,7,4,0,2022-01-04,0,Tuesday,2,12,7
1478162390835679233,2022-01-04 00:32:31,Ketum PSSI Mochamad Iriawan disorot netizen karena menemui pemain timnas Indonesia yang baru kembali dari Singapura. https://t.co/7vqAxneOGV,47,27,10,21,2022-01-04,0,Tuesday,2,57,48
1478162375643701252,2022-01-04 00:32:27,Fenomena mengadopsi boneka arwah sebagai 'anak' menjadi tren di kalangan selebriti. Apa kata psikolog? https://t.co/TogvjMO0Jb,4,5,1,1,2022-01-04,0,Tuesday,2,5,6
1478161765250875399,2022-01-04 00:30:02,"Kane Tanaka, orang tertua di dunia telah mencapai usia ke 119 tahun pada Minggu. Hal itu diketahui dari sebuah unggahan di akun Twitter cicitnya, Junko Tanaka. https://t.co/8OeuyEGuhj",38,4,8,2,2022-01-04,0,Tuesday,2,46,6
1478161271900053506,2022-01-04 00:28:04,"Pada kunjungan ini Ida juga meresmikan gedung asrama, Kios 3in1, dan workshop kejuruan pengelasan bawah air (underwater wet welding). https://t.co/LgbDIzjNGY",1,0,1,0,2022-01-04,0,Tuesday,2,2,0
1478160778964439044,2022-01-04 00:26:07,"Polri telah selesai melakukan operasi lilin 2021 yang digelar dari 23 Desember 2021 hingga 2 Januari 2022. Hasilnya, gangguan kamtibmas menurun. https://t.co/tw3uPcCGkA",5,0,1,0,2022-01-04,0,Tuesday,2,6,0
1478160276755263490,2022-01-04 00:24:07,"Cuitan netizen mengaku tak suka anak kecil karena berisik berakhir viral. Menjadi pro-kontra, sebenarnya apa yang terjadi saat seseorang tak suka anak kecil? https://t.co/cTl8vtH6IV",8,1,2,1,2022-01-04,0,Tuesday,2,10,2
1478159038844215296,2022-01-04 00:19:12,Situs Ditjen Imigrasi Kementerian Hukum dan HAM sempat diretas. Ditjen Imigrasi menjamin data para pemohon layanan keimigrasian tetap aman. https://t.co/cEnXtBSTh4,8,0,4,0,2022-01-04,0,Tuesday,2,12,0
1478158552611106824,2022-01-04 00:17:16,"Antonio Conte tak dendam dengan Chelsea. Meski sempat berseteru di masa lalu, ia tetap berterima kasih kepada The Blues yang membuka jalan berkarier di Inggris. https://t.co/apAJwlz2Rg",7,0,0,0,2022-01-04,0,Tuesday,2,7,0
1478157804997337094,2022-01-04 00:14:18,"Sebanyak 14 kepala puskesmas di Kabupaten Bintan, Kepri, mengembalikan uang dugaan korupsi dana insentif nakes senilai Rp 504 juta ke Kejari Bintan. https://t.co/gZMmtqxVpB",37,22,16,11,2022-01-04,0,Tuesday,2,53,33
1478157307334774785,2022-01-04 00:12:19,"Mantan Menteri Kehakiman Tunisia Noureddine Bhiri ditangkap polisi. Bhiri diduga terlibat dalam kegiatan terorisme, kata Menteri Dalam Negeri. https://t.co/IU3XwLrLpE",10,3,2,1,2022-01-04,0,Tuesday,2,12,4
1478156959400480779,2022-01-04 00:10:56,"Pengacara Bahar, Ichwan Tuankotta heran atas penetapan tersangka Habib Bahar. Dia menilai proses penetapan tersangka itu sangat cepat. https://t.co/3chx5EE3jY",67,54,11,6,2022-01-04,0,Tuesday,2,78,60
1478156217650495488,2022-01-04 00:07:59,Pejabat tinggi kesehatan Israel menyatakan bahwa Israel bisa mencapai herd immunity di tengah lonjakan kasus Corona (COVID-19) yang dipicu varian Omicron. https://t.co/FuIJ10v7Li,9,0,1,0,2022-01-04,0,Tuesday,2,10,0
1478155428655738880,2022-01-04 00:04:51,Puan meminta penerapan pembelajaran tatap muka 100% dievaluasi hingga pelaksanaan vaksinasi anak telah merata. Apalagi saat ini ada ancaman varian Omicron. https://t.co/bVnoATHmpc,20,5,6,8,2022-01-04,0,Tuesday,2,26,13
1478154649198907396,2022-01-04 00:01:45,Negara tetangga Indonesia terancam diterjang gelombang varian Omicron. Hal itu juga akan mengancam sistem kesehatan masyarakat di sana. https://t.co/cROVTmY5AG,7,1,2,1,2022-01-04,0,Tuesday,2,9,2
1478153587884756996,2022-01-03 23:57:32,Seorang pedagang di Bojonegoro diamankan karena menjual seprai. Seprai yang dijualnya memalsukan merek seprai lain. https://t.co/FeUr9pnCnQ,5,0,1,1,2022-01-03,23,Monday,1,6,1
1478152841286062093,2022-01-03 23:54:34,Dua siswa SD di Jombang dirawat di RSUD Jombang setelah vaksinasi. Komda KIPI menyimpulkan kedua siswa SD tersebut menderita sakit bukan karena efek vaksinasi. https://t.co/AjQrZyRvzM,5,6,0,4,2022-01-03,23,Monday,1,5,10
1478151853498064896,2022-01-03 23:50:39,2 Orang teridentifikasi positif COVID-19 varian omicron teridentifikasi di Surabaya. Vaksin Merah Putih buatan Unair disebut bisa menetralisir varian Omicron. https://t.co/6ZlXLhQ3EU,6,0,1,2,2022-01-03,23,Monday,1,7,2
1478151095977447431,2022-01-03 23:47:38,"Pemerintah menetapkan harga rokok 2022 naik sekitar 12 persen. Bagi yang ingin menjadikan ini sebagai momen untuk berhenti, simak tips dari ahli berikut.] https://t.co/NFRuavZ540",3,1,3,1,2022-01-03,23,Monday,1,6,2
1478150356706238464,2022-01-03 23:44:42,"Ponpes As-Sunnah, Kecamatan Aikmal, Lombok Timur, dirusak orang tak dikenal karena pendiskreditan sejumlah makam leluhur. Menag Yaqut minta polisi mengusut. https://t.co/A6svOOEwgd",17,8,0,0,2022-01-03,23,Monday,1,17,8
1478149366410092544,2022-01-03 23:40:46,"India melaporkan lebih dari 27.000 kasus harian COVID-19 yang dipicu penyebaran varian Omicron. Namun, warga India seakan tidak perduli dan nekat berkerumun. https://t.co/yzAH3gbvB6",15,4,3,6,2022-01-03,23,Monday,1,18,10
1478148373270171649,2022-01-03 23:36:49,Peristiwa langka terjadi ketika ada sosok misterius yang melintas dari Korea Selatan ke Korea Utara. Sosok tersebut diduga sebagai pembelot Korut yang pulang. https://t.co/fq01B8RTK0,5,1,0,0,2022-01-03,23,Monday,1,5,1
1478147628596666369,2022-01-03 23:33:51,Sebanyak 20 warga Jawa Barat positif terpapar virus Corona varian Omicron. Saat ini 20 orang tersebut tengah menjalani karantina di Jakarta. https://t.co/V0OeAieTkO,5,33,7,2,2022-01-03,23,Monday,1,12,35
1478146885319905284,2022-01-03 23:30:54,"Bintang AS Roma, Tammy Abraham, mengalami kecelakaan dalam perjalanan menuju latihan AS Roma. Mobilnya tabrakan dengan kendaraan lain. https://t.co/6szmGwpaVs",9,0,0,0,2022-01-03,23,Monday,1,9,0
1478146388923985921,2022-01-03 23:28:56,"Seorang pria babak belur dihajar massa karena ketahuan mencuri sepeda motor di Lasem, Rembang, sore tadi. https://t.co/34fPtHgPbp",2,0,0,1,2022-01-03,23,Monday,1,2,1
1478145647626891266,2022-01-03 23:25:59,Masa bulan madu Ralf Rangnick dengan Manchester United selesai sudah. MU menderita kekalahan pertamanya di era Rangnick dengan penampilan yang buruk. https://t.co/R0YRda21sr,3,0,0,1,2022-01-03,23,Monday,1,3,1
1478145153634344965,2022-01-03 23:24:01,"Seorang polisi bernama Bripda Rio Novemberyanto dikeroyok di Tanjung Priok, Jakarta Utara. Ia dikeroyok ketika hendak melerai sebuah keributan. https://t.co/BYGhxmZY7k",4,0,2,2,2022-01-03,23,Monday,1,6,2
1478143808864931840,2022-01-03 23:18:41,"Kini penyebaran varian Omicron semakin meluas, termasuk di Indonesia. Namun, Menkes Budi mengatakan penyebarannya di RI masih tergolong lebih lambat. https://t.co/yGe4UFI1t9",9,0,1,0,2022-01-03,23,Monday,1,10,0
1478142819311226885,2022-01-03 23:14:45,Fenomena Aphelion 2022 menarik untuk diketahui. Aphelion merupakan fenomena di mana bumi berada di posisi terjauh dengan matahari. Berikut fakta-faktanya. https://t.co/XF3V87WSvm,14,0,1,1,2022-01-03,23,Monday,1,15,1
1478141584688521218,2022-01-03 23:09:50,Bhabinkamtibmas Polsek Teupah Barat Brigadir Miswandi dipuji gegara menjaga penjemuran gabah warga agar mau vaksinasi. Dia bakal diberi penghargaan. https://t.co/wVumKVsRH0,178,16,11,4,2022-01-03,23,Monday,1,189,20
1478140669600354313,2022-01-03 23:06:12,"Remaja pria berinisial YRH (19) di Depok, Jawa Barat, menjadi korban begal. Pelaku membacok dan menyiramkan air keras kepada korban. https://t.co/VSzfutNxaO",17,10,5,4,2022-01-03,23,Monday,1,22,14
1478138855488299009,2022-01-03 22:59:00,"Ketum PAN Zulkifli Hasan melakukan konsolidasi ke Kota Cirebon. Dalam konsolidasi itu, Zulhas memperkenalkan musisi Charly Van Houten sebagai kader PAN. https://t.co/Wk20kTFyxW",4,6,2,0,2022-01-03,22,Monday,1,6,6
1478137855847321608,2022-01-03 22:55:01,"Office boy (OB) kantor desa di Kecamatan Ngoro, Jombang, KTJ (51) memerkosa siswi SD. Aksi bejat pelaku berlangsung sejak korban berusia 4 tahun. https://t.co/kzsA3AaEGt",8,7,3,0,2022-01-03,22,Monday,1,11,7
1478136606284517382,2022-01-03 22:50:04,Pemerintah melaporkan pada hari ini kasus baru Corona (COVID-19) di Indonesia bertambah 265 kasus. DKI Jakarta melaporkan kasus terbanyak dengan 172 kasus. https://t.co/7aWYHrb4Rc,5,0,1,1,2022-01-03,22,Monday,1,6,1
1478135041100234759,2022-01-03 22:43:50,Sebuah video aksi sepasang warga negara asing (WNA) diduga tengah menerobos kawasan Candi Prambanan viral di media sosial. https://t.co/1kR7WqDOpV,10,3,0,2,2022-01-03,22,Monday,1,10,5
1478135039787520000,2022-01-03 22:43:50,Video rombongan moge ditilang hingga bensin dikuras polisi saat sunmori viral di medsos. Begini penjelasan polisi. https://t.co/LYYQYfHWDa,11,3,0,1,2022-01-03,22,Monday,1,11,4
1478134568205045765,2022-01-03 22:41:58,"Annisa Naraya (16), warga Desa Lembuh Sawah, Kecamatan Cicantayan, Kabupaten Sukabumi, sudah 17 hari hilang. Keluarga diliputi rasa khawatir dan waswas. https://t.co/gxgP6Fb30n",51,4,13,3,2022-01-03,22,Monday,1,64,7
1478133043344941058,2022-01-03 22:35:54,Phil Jones kembali bermain untuk Manchester United. Bek tengah 29 tahun itu merumput lagi setelah hampir dua tahun lamanya. https://t.co/bEmhjvbFn5,49,0,3,0,2022-01-03,22,Monday,1,52,0
1478131507160043535,2022-01-03 22:29:48,"Paris Saint-Germain meraih hasil sempurna menghadapi tim divisi empat, Vannes, dalam Piala Prancis. Les Parisiens menang 4-0 via hat-trick Kylian Mbappe. https://t.co/BoJas3k476",6,0,1,0,2022-01-03,22,Monday,1,7,0
1478130767301595146,2022-01-03 22:26:51,"Universitas Hasanuddin (Unhas) membantu mengembangkan pesawat ultralight Haerul, montir lulusan SD asal Kabupaten Pinrang, Sulawesi Selatan. https://t.co/PdJNQN35zZ",23,1,5,0,2022-01-03,22,Monday,1,28,1
1478129228063330306,2022-01-03 22:20:44,"DKI Jakarta mencatat jumlah kasus aktif hari ini, Senin (3/1/2022), sebanyak 694 orang Padahal, kasus aktif pada hari Senin (20/12/2021) lalu hanya 281 orang. https://t.co/1ZWl6QWagH",10,7,6,2,2022-01-03,22,Monday,1,16,9
1478127748136722434,2022-01-03 22:14:52,"Dishub Kota Bekasi memberi sanksi kepada anggotanya yang melawan arus di Gadog, Bogor. Oknum tersebut melakukan pengawalan secara ilegal. https://t.co/NKZf9u2E4Q",10,7,1,0,2022-01-03,22,Monday,1,11,7
1478126742296535042,2022-01-03 22:10:52,"Setiap makhluk hidup, pasti akan mengalami kematian. Berikut ini beberapa tanda-tanda kematian yang menandakan ajal sudah dekat. https://t.co/R3RcXjPEnF",33,6,16,1,2022-01-03,22,Monday,1,49,7
1478124427103592453,2022-01-03 22:01:40,"Polisi masih menyelidiki hilangnya Annisa Naraya (16), gadis asal Kabupaten Sukabumi yang pergi dari rumah sejak Sabtu, 18 Desember 2021. https://t.co/4yWpe0wKQj",16,0,1,0,2022-01-03,22,Monday,1,17,0
1478123321808064512,2022-01-03 21:57:16,Alvaro Morata semakin dekat dengan pintu keluar Juventus untuk bergabung dengan Barcelona. Namun masih ada dua hal yang mengganjal kepindahannya ke Camp Nou. https://t.co/1O7s011Nri,4,1,2,0,2022-01-03,21,Monday,1,6,1
1478122561321979909,2022-01-03 21:54:15,Arsenal menderita kekalahan dramatis di tangan Manchester City 1-2. Usai laga bek tengah Arsenal Ben White tak kuasa membendung rasa geramnya pada ofisial laga. https://t.co/J6PCVx0DKB,6,0,2,0,2022-01-03,21,Monday,1,8,0
1478122336452763648,2022-01-03 21:53:21,Heboh video pengemudi mobil menenteng benda mirip pistol setelah menabrak sepeda motor. Kejadian tersebut terekam CCTV dan viral di media sosial. https://t.co/BkCnVeLizN,16,6,2,1,2022-01-03,21,Monday,1,18,7
1478121337700945927,2022-01-03 21:49:23,"Vaksinasi booster rencananya bakal dimulai 12 Januari mendatang. Vaksin Nusantara sempat disebut jadi salah satu jenis vaksin booster, benarkah? https://t.co/9u0iUPfwHs",5,2,2,0,2022-01-03,21,Monday,1,7,2
1478120097130725384,2022-01-03 21:44:27,Beberapa gambar ini memiliki teka-teki yang perlu dipecahkan. Kamu bisa menjawabnya bila memiliki logika dan ketajaman mata yang bagus.] https://t.co/sRTmDXojZp,2,0,1,0,2022-01-03,21,Monday,1,3,0
1478117574701367304,2022-01-03 21:34:26,"Ida mengatakan untuk mengantisipasi berbagai tantangan yang ada, maka mau tidak mau, suka tidak suka, pihaknya memerlukan resolusi baru. https://t.co/SpSjpDYUCS",7,0,0,0,2022-01-03,21,Monday,1,7,0
1478115777777709059,2022-01-03 21:27:18,"Pangdam IM Mayjen TNI Mohamad Hasan meninjau lokasi banjir yang merendam 14 kecamatan di Aceh Utara, Aceh. Mohamad sekaligus menyerahkan bantuan ke pengungsi. https://t.co/lIxCJHOA5D",6,0,1,0,2022-01-03,21,Monday,1,7,0
1478113738834206721,2022-01-03 21:19:12,BPIP bersama KPU berencana melakukan sosialisasi nilai-nilai Pancasila kepada masyarakat dan pemimpin. Rencanannya sosialisasi akan dilakukan selama pemilu. https://t.co/2GssPpbedW,10,12,2,0,2022-01-03,21,Monday,1,12,12
1478112222975082496,2022-01-03 21:13:10,"Tugu Pamulang yang sempat disorot banyak pihak karena berbeda dengan desain awal sudah selesai direnovasi. Rencananya, pekan depan tugu tersebut akan diresmikan https://t.co/y0vd9Mav10",9,1,2,2,2022-01-03,21,Monday,1,11,3
1478110958249779207,2022-01-03 21:08:09,"PT KAI melaporkan 13 ribu penumpang tiba di Stasiun Gambir dan Stasiun Pasar Senen pada Senin, 3 Januari 2022. https://t.co/md9FGyVdja",18,3,4,1,2022-01-03,21,Monday,1,22,4
1478109869869834247,2022-01-03 21:03:49,Momen bersejarah tercipta di laga Chelsea vs Liverpool. Untuk pertama kalinya tribune berdiri diberlakukan lagi di kompetisi Liga Inggris. https://t.co/bI91RAHMmo,4,0,1,0,2022-01-03,21,Monday,1,5,0
1478107446371622922,2022-01-03 20:54:11,"Sebanyak 18 ekor anak ular kobra ditemukan di rumah warga di Citeureup, Bogor. Induk ular kobranya masih dicari. https://t.co/tGZz6rrtnD",5,1,2,2,2022-01-03,20,Monday,1,7,3
1478105217518428161,2022-01-03 20:45:20,"Pasien Omicron transmisi lokal Surabaya mengeluhkan gejala COVID-19 pada tenggorokan, seperti ada lendir. Inikah alasannya? https://t.co/Y4RNewotPc",7,1,0,0,2022-01-03,20,Monday,1,7,1
1478102176178257920,2022-01-03 20:33:15,Kalau kangen gorengan sayur bisa bikin sendiri kakiage tempura. Bakwan sayuran Jepang ini rasanya renyah gurih. Dicelup saus shoyu rasanya semakin enak. https://t.co/MdsLpHmjbV,10,0,3,0,2022-01-03,20,Monday,1,13,0
1478100624503971846,2022-01-03 20:27:05,"Indonesia mencatat sebanyak 265 kasus baru COVID-19, Senin (3/1/2022). DKI menyumbang kasus terbanyak dengan jumlah 172. https://t.co/6xRMXjil87",8,3,2,2,2022-01-03,20,Monday,1,10,5
1478099138843664393,2022-01-03 20:21:11,Timnas Putri Indonesia saat ini fokus pada pemusatan latihan sebagai persiapan untuk Piala Asia Wanita 2022 yang akan digelar di India. https://t.co/ftcy43t6fk,9,0,1,0,2022-01-03,20,Monday,1,10,0
1478097259363553281,2022-01-03 20:13:43,Situasi Romelu Lukaku memunculkan spekulasi tentang kelanjutan kariernya di Chelsea. Lukaku diklaim berminat bereuni dengan Antonio Conte di Tottenham Hotspur. https://t.co/6R2dEsC21x,4,0,2,2,2022-01-03,20,Monday,1,6,2
1478096776783613957,2022-01-03 20:11:47,"Manchester United menelan kekalahan di laga perdana mereka di tahun 2022. Menjamu Wolverhampton Wanderers dalam lanjutan Liga Inggris, Setan Merah tumbang 0-1. https://t.co/nj1kxcwqra",6,0,1,1,2022-01-03,20,Monday,1,7,1
1478095033979056128,2022-01-03 20:04:52,"Adeeva Myesha Haura Amanda Sitorus, bocah 8 tahun ini jadi sorotan. Pasalnya dia hafal nama-nama menteri hingga Bupati Karawang. Wuih! https://t.co/mbKLJvub80",8,6,0,0,2022-01-03,20,Monday,1,8,6
1478093006733467651,2022-01-03 19:56:49,Baliho iklan wisata aman Kota Solo yang dipasang di Yogyakarta viral. Warganet mengaitkan dengan klithih yang marak di Yogyakarta belakangan ini. https://t.co/dsQx8XT16Z,4,1,0,0,2022-01-03,19,Monday,1,4,1
1478092045445181440,2022-01-03 19:52:59,Polisi menangkap dua pria di Medan karena diduga memalak pemilik laundry. Keduanya melempari usaha laundry dengan telur dan menyiram oli kotor. https://t.co/Z77s0RTkI9,16,2,2,1,2022-01-03,19,Monday,1,18,3
1478090175800647682,2022-01-03 19:45:34,Berlliana Lovell bicara kedekatan dengan sepupu Raffi Ahmad. Ia ngaku masih berteman. https://t.co/zd5PnmPNKZ,0,0,0,0,2022-01-03,19,Monday,1,0,0
1478088934970298368,2022-01-03 19:40:38,Federico Bernardeschi berhasrat bertahan di Juventus. Ia mengungkap ada tradisi unik di Bianconeri setiap ada pemain yang memperpanjang kontrak. https://t.co/OvXMpLEnxt,2,0,0,0,2022-01-03,19,Monday,1,2,0
1478087714637553667,2022-01-03 19:35:47,Polisi melakukan penahanan terhadap Habib Bahar bin Smith usai ditetapkan tersangka kasus penyebaran berita bohong saat ceramah di Bandung. https://t.co/e9pib1wSUH,137,45,18,13,2022-01-03,19,Monday,1,155,58
1478086702543560707,2022-01-03 19:31:46,Duel Liga Inggris antara MU vs Wolverhampton berakhir 0-0 di babak pertama. Setan Merah yang bermain di kandang sendiri justru lebih banyak ditekan. https://t.co/IWlWQdIDb9,2,1,0,1,2022-01-03,19,Monday,1,2,2
1478085688033693703,2022-01-03 19:27:44,Warga yang tersulut emosinya yakin kematian warga atas nama Waode Handayani yang meninggal ada 30 Desember lalu terkait dengan ilmu hitam parakang pasutri itu. https://t.co/jg5FTsxWap,2,0,2,0,2022-01-03,19,Monday,1,4,0
1478084319059062786,2022-01-03 19:22:17,"Terlihat korban pertama dibuang ke Sungai dengan posisi kepala berada di bawah, sedangkan korban kedua dibuang dengan posisi kaki terlebih dahulu. https://t.co/uBnU3iiYaL",4,2,2,1,2022-01-03,19,Monday,1,6,3
1478083056053501957,2022-01-03 19:17:16,Puluhan ribu dosis vaksin COVID-19 di Jawa Tengah nyaris kedaluwarsa. Ganjar Pranowo mewanti-wanti kepala daerahnya untuk mempercepat vaksinasi. https://t.co/nTvUhrHEg3,5,0,1,1,2022-01-03,19,Monday,1,6,1
1478081785934368772,2022-01-03 19:12:13,"Pembatalan penerbangan disebabkan oleh berbagai gangguan, mulai dari cuaca buruk hingga lonjakan kasus Corona (COVID-19) yang dipicu varian Omicron. https://t.co/XnmN3uRovj",4,0,2,0,2022-01-03,19,Monday,1,6,0
1478080782455480323,2022-01-03 19:08:14,Ancaman perubahan iklim kian nyata sepanjang 2021. Hal ini dibuktikan dengan sebagian bumi yang sudah mulai berubah. Begini potretnya. https://t.co/zdKZMNf9T9,6,0,2,0,2022-01-03,19,Monday,1,8,0
1478079476533800969,2022-01-03 19:03:03,Bek tengah berpengalaman Thiago Silva masih akan berseragam Chelsea sampai tahun depan. Thiago Silva telah resmi memperpanjang kontrak dengan klubnya. https://t.co/0IkdZSLeLm,7,0,0,0,2022-01-03,19,Monday,1,7,0
1478079263081390082,2022-01-03 19:02:12,Dino Patti Djalal mengaku diancam oleh tersangka mafia tanah yang dilaporkannya. Dino mengadu ke Kapolda Metro Jaya. https://t.co/4iCjAE1Ha0,12,0,5,0,2022-01-03,19,Monday,1,17,0
1478077878571085830,2022-01-03 18:56:42,"Kasus COVID-19 varian Omicron di Jakarta bertambah. Wakil Gubernur DKI Jakarta Ahmad Riza Patria mengungkap, sebanyak 162 orang di Jakarta positif Omicron. https://t.co/hQFEq78Jqt",13,7,12,5,2022-01-03,18,Monday,1,25,12
1478076893257687040,2022-01-03 18:52:47,Tiga pucuk pimpinan Partai Gerindra bertemu di hotel sore ini. Ada apa? https://t.co/n9A37erjdo,2,1,0,0,2022-01-03,18,Monday,1,2,1
1478075636233252864,2022-01-03 18:47:47,"Selama berdiri, Lembaga Eijkman telah memberikan deretan sumbangsih penelitian di bidang biologi dan kedokteran. Simak pembahasannya: https://t.co/on9EuingA0",11,0,2,0,2022-01-03,18,Monday,1,13,0
1478074353317257216,2022-01-03 18:42:41,"""Pak Gubernur, untuk kedua kali jangan gitu lagi lah. Orang kan punya harga diri. Kalau harga diri ini kan nggak bisa diukur dari segi apapun."" https://t.co/4gm1vpitx9",21,4,1,2,2022-01-03,18,Monday,1,22,6
1478073261942575117,2022-01-03 18:38:21,"""Harapan besar tahun 2022 adalah KPK akan semakin dipercaya dan kita semua pegawai KPK ada dalam satu suara,"" kata Firli Bahuri. https://t.co/iKZ482Ob94",14,35,0,1,2022-01-03,18,Monday,1,14,36
1478072110744543242,2022-01-03 18:33:47,"Sama seperti Bahar Smith, polisi juga memutuskan untuk menahan TR. https://t.co/FA5SMuPNZ5",21,2,4,1,2022-01-03,18,Monday,1,25,3
1478070859252314112,2022-01-03 18:28:48,Video polisi menilang dan menguras bensin rombongan pengemudi moge saat sunmori viral di medsos. Polisi mengungkap alasannya. https://t.co/Bo223UXaU1,12,3,1,0,2022-01-03,18,Monday,1,13,3
1478069459197771783,2022-01-03 18:23:14,"Polisi mengamankan seorang Ibu Rumah Tangga (IRT), YS (45) di Medan. IRT itu diamankan karena kedapatan memiliki 9 kg sabu dan 2.800 butir ekstasi. https://t.co/1qcXWJcehh",13,0,3,1,2022-01-03,18,Monday,1,16,1
1478068463243563012,2022-01-03 18:19:17,Dia menyebut pembentukan BRIN yang memerlukan transisi dengan melebur Eijkman tetap harus merangkul para ilmuwan dari Eijkman. https://t.co/QkaHjwWAYm,19,5,3,0,2022-01-03,18,Monday,1,22,5
1478067124757319681,2022-01-03 18:13:58,Sosok misterius yang menyeberangi perbatasan yang dijaga ketat dari Korsel menuju Korut diduga merupakan seorang warga Korut yang sebelumnya membelot ke Korsel. https://t.co/4DYNYTIn8m,6,0,2,0,2022-01-03,18,Monday,1,8,0
1478066123471994880,2022-01-03 18:09:59,PTM terbatas dengan kapasitas 100% siswa di sekolah di Jakarta mulai digelar hari ini. Kebijakan tersebut mendatangkan respons beragam dari orang tua siswa. https://t.co/BcnP4a1QEV,8,0,1,1,2022-01-03,18,Monday,1,9,1
1478064570719776772,2022-01-03 18:03:49,Presiden Jokowi memberi kewenangan kepada Menteri Energi dan Sumber Daya Mineral (ESDM) Arifin Tasrif untuk menghapus Premium. Kapan? https://t.co/KEnr0KbsvW,15,8,0,0,2022-01-03,18,Monday,1,15,8
1478063486215278594,2022-01-03 17:59:30,Vaksinasi booster di Indonesia bakal dimulai pada 12 Januari 2022. Berikut ini sejumlah kriterianya. https://t.co/UaTavtrFHO,10,0,7,2,2022-01-03,17,Monday,1,17,2
1478062155006156800,2022-01-03 17:54:13,Total pelanggan yang ditolak berangkat pada periode 31 Desember 2021 s.d 2 Januari 2022 ada sebanyak 8.554 pelanggan. Kenapa nih? https://t.co/AOhJlIiGHT,3,1,0,0,2022-01-03,17,Monday,1,3,1
1478060571010469888,2022-01-03 17:47:55,Tim DVI Polda Jatim kembali mengungkap 3 identitas korban erupsi Semeru. Dan tim DVI telah resmi mengakhiri masa tugasnya. https://t.co/UE6X5By6lk,8,0,1,0,2022-01-03,17,Monday,1,9,0
1478059802727116802,2022-01-03 17:44:52,Polda Jawa Barat (Jabar) menetapkan Habib Bahar bin Smith sebagai tersangka kasus penyebaran berita bohong. Bahar jadi tersangka usai diperiksa penyidik. https://t.co/DYs5AQTZ6N,308,105,41,17,2022-01-03,17,Monday,1,349,122
1478058718428286983,2022-01-03 17:40:34,Reino Barack dikenal sebagai pengusaha dan juga suami dari Syahrini. Kira-kira apa sih rahasia Reino bisa menjalani keduanya dengan baik? https://t.co/7PXGwFlHwA,1,0,0,1,2022-01-03,17,Monday,1,1,1
1478056951875526656,2022-01-03 17:33:32,Luhut Binsar Pandjaitan mengungkap kunci Indonesia bisa mencegah lonjakan kasus Corona varian Omicron. Apa itu? https://t.co/Js0QpCYAfZ,33,27,6,8,2022-01-03,17,Monday,1,39,35
1478055408182910981,2022-01-03 17:27:24,Awal tahun 2022 Pemkab Banyuwangi resmi memiliki Dinas Damkar. Sebelumnya pemadam kebakaran menjadi salah satu bidang di Satuan Polisi Pamong Praja (Satpol PP). https://t.co/CzlokFt9VK,7,0,0,0,2022-01-03,17,Monday,1,7,0
1478054930472656896,2022-01-03 17:25:31,Infrastruktur tersebut akan dibongkar dengan alasan menjadi area berdagang. #detikcomdoyourmagic https://t.co/ee32THQ3nb,4,0,1,0,2022-01-03,17,Monday,1,5,0
1478053610563018752,2022-01-03 17:20:16,Reka ulang adegan berlangsung singkat dengan lima adegan. https://t.co/M6QzilUVQL,8,1,2,0,2022-01-03,17,Monday,1,10,1
1478052610762547202,2022-01-03 17:16:17,Bill Gates dan mantan istrinya Melinda French Gates memuncaki daftar donatur terbesar tahun 2021 dengan donasi sebesar Rp 214 triliun. https://t.co/VDj2T3Q9kV,32,2,2,0,2022-01-03,17,Monday,1,34,2
1478051608294563842,2022-01-03 17:12:18,Presiden Jokowi menyatakan masih ada sederet tantangan di sektor ekonomi yang harus dihadapi Indonesia. Apa saja? https://t.co/h5LFYkPqsY,24,8,4,1,2022-01-03,17,Monday,1,28,9
1478050596036952065,2022-01-03 17:08:17,Robby Purba kabarkan kondisi kesehatannya usai menjalani operasi tumor payudara. https://t.co/BAJaCUBx93,2,0,1,0,2022-01-03,17,Monday,1,3,0
1478049614091759620,2022-01-03 17:04:23,"Akhirnya pihak Irwansyah bicara soal dirinya yang ditipu adik sendiri, Hafiz Fatur. Irwansyah kena tipu hingga merugi Rp 5 miliar. https://t.co/o9c78DYEQm",22,1,0,1,2022-01-03,17,Monday,1,22,2
1478049336890204161,2022-01-03 17:03:17,"Per Januari 2022, sekolah tatap muka bisa diberlakukan 100 persen. Bagaimana protokol terbarunya termasuk kegiatan di kantin dan ekstrakurikuler? https://t.co/xyw1OFADWZ",11,1,3,0,2022-01-03,17,Monday,1,14,1
1478048773511303177,2022-01-03 17:01:03,"Dia menyebut penataan Kampung Bayam tak hanya menjadi atensi Pemprov DKI, tapi juga pemerintah pusat, yaitu Kementerian PUPR. https://t.co/pD4fKMEvCF",1,0,0,0,2022-01-03,17,Monday,1,1,0
1478048202725150728,2022-01-03 16:58:46,Romelu Lukaku dianggap tak tahu tempat dan waktu ketika mengeluhkan tak bahagia di Chelsea. Ia menambah masalah buat Thomas Tuchel dan The Blues. https://t.co/8cHpE35unx,4,0,0,0,2022-01-03,16,Monday,1,4,0
1478047636758446082,2022-01-03 16:56:32,"Ketum PSSI Mochamad Iriawan menjadi sorotan lantaran menemui timnas Indonesia, yang baru menjalani laga Final AFF 2020 di Singapura. Ini respons Kemenkes. https://t.co/4TSKEjzT8e",7,1,0,0,2022-01-03,16,Monday,1,7,1
1478047309581721610,2022-01-03 16:55:14,Ketua Umum PSSI Mochamad Iriawan angkat bicara terkait penyambutan Timnas Indonesia. Ia dikritik karena Garuda mestinya menjalani karantina tanpa bertemu orang. https://t.co/LRa2rQnRZG,22,9,3,4,2022-01-03,16,Monday,1,25,13
1478046744617365511,2022-01-03 16:52:59,"PSSI buka suara soal sorotan terhadap Ketua Umum PSSI, Mochamad Iriawan gegara menyambut timnas Indonesia yang baru pulang dari Singapura. Ini responsnya. https://t.co/6dz7xPM60Q",5,0,1,0,2022-01-03,16,Monday,1,6,0
1478045813947441152,2022-01-03 16:49:17,Polda Metro Jaya berbicara soal desakan yang salah satunya datang dari Komnas Perempuan untuk mengungkap dan menjerat konsumen dari artis Cassandra Angelie. https://t.co/gcJoarl9OT,6,0,1,2,2022-01-03,16,Monday,1,7,2
1478044647146639366,2022-01-03 16:44:39,"Jae melontarkan pernyataan yang berbeda terkait statusnya di DAY6. Berikut sederet fakta seputar Jae yang hengkang dari DAY6. Yuk, simak!
 https://t.co/5cspIEokIK",6,0,0,0,2022-01-03,16,Monday,1,6,0
1478043887428059136,2022-01-03 16:41:38,Satgas transisi penanganan bencana erupsi Semeru kembali menemukan dua jenazah korban erupsi. Korban berjenis kelamin perempuan dan laki laki. https://t.co/AtJMuwsGlH,4,0,0,0,2022-01-03,16,Monday,1,4,0
1478043301060268035,2022-01-03 16:39:18,Khoirudin Aritonang (Choki) akhirnya menempuh langkah hukum atas apa yang dilakukan Gubernur Sumut (Gubsu) Edy Rahmayadi kepadanya. https://t.co/1A40hVU3TY,25,12,6,0,2022-01-03,16,Monday,1,31,12
1478042477508583424,2022-01-03 16:36:01,"Ayu Aulia sengaja ke Bali untuk healing sebelum terbang ke Amerika Serikat. Usai heboh video ciuman, keduanya langsung pemotretan bareng. https://t.co/vM20d81Lfd",7,0,0,0,2022-01-03,16,Monday,1,7,0
1478041958161518594,2022-01-03 16:33:58,"Sebuah rumah mewah di Perumahan Vila Pamulang, Kota Tangsel, menjadi tempat vandalisme. Polisi mengungkapkan rumah itu miliki tersangka investasi bodong alkes. https://t.co/55mfXiTImY",45,4,17,5,2022-01-03,16,Monday,1,62,9
1478041049763401728,2022-01-03 16:30:21,"Di Kampoeng Seafood, Kelapa Gading ada banyak restoran seafood yang terkenal enak. Salah satunya restoran ini nih, yang menunya tak pelit bumbu.  https://t.co/aj0JCxcm7m",14,0,3,0,2022-01-03,16,Monday,1,17,0
1478039539298058240,2022-01-03 16:24:21,Dinkes Magetan belum bisa menyimpulkan soal meninggalnya siswa MI apakah karena vaksinasi atau tidak. Temuan atau kasus ini akan dilaporkan ke Komda KIPI. https://t.co/eaNOtwZiRU,5,0,2,1,2022-01-03,16,Monday,1,7,1
1478039257772179459,2022-01-03 16:23:14,Salernitana bisa bernapas lega karena mereka tidak jadi dicoret dari Serie A 2021/2022. Sebab klub itu baru saja punya pemilk baru. https://t.co/zTNjiZjwWo,13,0,0,0,2022-01-03,16,Monday,1,13,0
1478036672730308610,2022-01-03 16:12:58,Sejumlah remaja di Trenggalek viral terjun ke sungai berarus deras saat terjadi banjir. Mereka kemudian meminta maaf atas apa yang telah mereka lakukan. https://t.co/Ngc7o7lmSS,18,5,0,1,2022-01-03,16,Monday,1,18,6
1478035966766030858,2022-01-03 16:10:09,"Suami kerjanya hanya tiduran, habis makan tidur, diminta jaga anak juga tidur, ujung-ujungnya dia menjadi overweight dan membuat kehidupan romansa kami pudar. #detikNetwork  https://t.co/2yNnIFDbNp",11,0,3,0,2022-01-03,16,Monday,1,14,0
1478035952669011970,2022-01-03 16:10:06,Proyek jalan tembusan Pasar Minggu mangkrak sekitar 2 tahun. Pemprov DKI Jakarta menjelaskan. https://t.co/9aQM4x5txu,14,0,4,1,2022-01-03,16,Monday,1,18,1
1478035435045670912,2022-01-03 16:08:02,"Kebakaran terjadi di di Jalan Budi Utomo, Kecamatan Kadia, Kota Kendari, Sulawesi Tenggara (Sultra). Akibatnya empat bangunan kios ludes terbakar. https://t.co/HgiOZKuZlw",5,0,3,0,2022-01-03,16,Monday,1,8,0
1478034917313466374,2022-01-03 16:05:59,Tim Basarnas menempuh jarak 30 Km untuk bisa menuju rumah ibu tersebut saat melakukan evakuasi. https://t.co/DI6GUQ6qa8,3,0,1,0,2022-01-03,16,Monday,1,4,0
1478034295277211653,2022-01-03 16:03:31,Seorang siswa MI di Magetan meninggal sehari usai divaksinasi Sinovac. Bagaimana siswa tersebut meninggal sehari usai divaksinasi? Begini kronologinya. https://t.co/D26kRxZDIr,9,1,4,1,2022-01-03,16,Monday,1,13,2
1478033240183169025,2022-01-03 15:59:19,"Banjir bandang menerjang jembatan di Kecamatan Mojo, Kabupaten Kediri, sehingga 42 KK sempat terisolasi. Material banjir berupa lumpur, batu dan batang pohon. https://t.co/Oxkr1OpeyW",16,0,4,0,2022-01-03,15,Monday,1,20,0
1478032973358415873,2022-01-03 15:58:16,Propam Polda Sulut memeriksa oknum polisi inisial RT yang diduga menyalakan petasan hingga membuat gudang mebel milik warga di Manado kebakaran. https://t.co/1fpn9BhZLF,9,0,4,0,2022-01-03,15,Monday,1,13,0
1478032794366492673,2022-01-03 15:57:33,"Omicron di Indonesia terus bertambah, totalnya menjadi 152 kasus per hari ini. Kemenkes mengungkap jenis masker yang tak lagi efektif tangkal Omicron. https://t.co/QelzA7ErD8",83,51,50,20,2022-01-03,15,Monday,1,133,71
1478031614550675459,2022-01-03 15:52:52,Mengonsumsi obat kuat kerap menjadi solusi dalam mengatasi disfungsi ereksi. Simak 9 di antaranya termasuk obat kuat berbahan alami. https://t.co/yDtQJG0wFR,23,1,3,1,2022-01-03,15,Monday,1,26,2
1478030831314776068,2022-01-03 15:49:45,"Gugatan presidential threhold 20 persen terus berdatangan ke MK. Tidak hanya dari dalam negeri, tetapi juga datang dari WNI di berbagai penjuru dunia. https://t.co/DQYvby6p8K",31,6,10,2,2022-01-03,15,Monday,1,41,8
1478029230239801352,2022-01-03 15:43:23,Video sejumlah remaja terjun ke sungai yang sedang banjir besar viral. Tanpa rasa takut mereka menceburkan diri dan berenang mengikuti arus yang sangat deras. https://t.co/8nFlUxfRhY,10,2,2,0,2022-01-03,15,Monday,1,12,2
1478028442885050372,2022-01-03 15:40:15,"Bumi kita menyimpan banyak misteri. Beberapa tempat bahkan ada yang menyimpan keanehan, termasuk tempat-tempat teraneh berikut ini! https://t.co/TJrPPRdP71",10,0,2,1,2022-01-03,15,Monday,1,12,1
1478026936320471044,2022-01-03 15:34:16,"Bobby Nasution menjenguk Rahma Hasibuan, tukang sapu jalan di Medan yang menjadi korban begal. Dia meminta polisi menangkap pelaku. https://t.co/AELr61KFBj",17,2,2,0,2022-01-03,15,Monday,1,19,2
1478026455342845962,2022-01-03 15:32:22,"Romelu Lukaku menumpahkan keluh kesahnya bermain di Chelsea. Kata-kata yang diucapkan Big Rom bak pedang bermata dua, ada positif dan negatifnya. https://t.co/7l0W5oql7M",5,2,0,0,2022-01-03,15,Monday,1,5,2
1478025847684620290,2022-01-03 15:29:57,"Dua tentara Tunisia tewas dalam kecelakaan helikopter. Satu orang sebagai pilot, dan satu lainnya kopilot. https://t.co/j21QpX6o2d",3,0,1,1,2022-01-03,15,Monday,1,4,1
1478024805135921154,2022-01-03 15:25:48,"Kampung Bayam, Kelurahan Paponggo, Jakarta Utara, digusur oleh proyek JIS. Beberapa warganya memilik mendirikan bedeng di tepi rel kereta api. https://t.co/oxtVZDSNui",37,19,10,4,2022-01-03,15,Monday,1,47,23
1478023986579652608,2022-01-03 15:22:33,"Sisno mengatakan, jangan karena adanya negara lain yang menempatkan organisasi kepolisian mereka di bawah kementerian, sehingga ingin menerapkannya juga di Indonesia. https://t.co/FrzGkCC3m5",13,8,6,3,2022-01-03,15,Monday,1,19,11
1478022673691250697,2022-01-03 15:17:20,"Dalam sehari, di Sidoarjo ditemukan dua orang tewas. Dua jenazah tersebut ditemukan di dua tempat, yakni di Kecamatan Candi dan Kecamatan Taman. https://t.co/Q64IqvIJyo",6,0,1,1,2022-01-03,15,Monday,1,7,1
1478022435572228098,2022-01-03 15:16:23,Satgas COVID-19 menolak izin pelaksanaan zikir akbar dan milad Frond Persaudaraan Islam (FPI). Namun pelaksanaan milad FPI pertama itu tetap dilaksanakan. https://t.co/CMyTZiiEyL,86,50,16,5,2022-01-03,15,Monday,1,102,55
1478021885006864394,2022-01-03 15:14:12,"Jembatan Sungai Tajum, Banyumas menjadi saksi bisu kematian tragis sejoli Handi dan Salsa. Jembatan ini menjadi titik Handi dan Salsa dibuang. https://t.co/ktOzi6XkVa",6,0,2,0,2022-01-03,15,Monday,1,8,0
1478021080530960385,2022-01-03 15:11:00,"Sakit yang dialami dua siswa SD di Jombang setelah vaksinasi COVID-19, bukan akibat vaksin. Kondisi kedua siswa SD tersebut saat ini sudah membaik. https://t.co/00wcY0oipr",7,1,1,1,2022-01-03,15,Monday,1,8,2
1478019046696271872,2022-01-03 15:02:55,"Seorang siswa Madrasah Ibtidaiyah (MI) di Magetan meninggal sehari usai divaksinasi Sinovac. Siswa tersebut adalah MRZ (10), siswa MI Al Abror, Bendo, Magetan. https://t.co/gO2hy0l460",28,4,17,10,2022-01-03,15,Monday,1,45,14
1478018809940385796,2022-01-03 15:01:59,Susu jahe merupakan salah satu minuman populer yang sering dinikmati saat udara dingin. Selain menghangatkan badan juga memberi manfaat sehat. Apa saja? https://t.co/4jooc4j8Hc,9,0,1,0,2022-01-03,15,Monday,1,10,0
1478018152751673348,2022-01-03 14:59:22,Ukuran penis besar diyakini para pria bisa memuaskan pasangan di ranjang. Memangnya berapa ukuran ideal penis yang bisa bikin klimaks? https://t.co/LjI3xH2Mjl,57,22,13,13,2022-01-03,14,Monday,1,70,35
1478015847847313413,2022-01-03 14:50:12,Data dari Badan Penanggulangan Bencana Daerah (BPBD) Aceh Utara mencatat banjir yang merendam 14 Kecamatan. Ini foto-fotonya! https://t.co/GEQJqbNHcd,5,1,3,0,2022-01-03,14,Monday,1,8,1
1478014545922830342,2022-01-03 14:45:02,Tersangka tega melakukan aksi biadab itu dengan iming-iming rayuan akan memberikan ilmu kanuragan. Simak selengkapnya: https://t.co/Qvsfg3wKFv,12,9,7,3,2022-01-03,14,Monday,1,19,12
1478013552988504070,2022-01-03 14:41:05,"Sosiolog dari Universitas Nasional, Sigit Rohadi, mengatakan bahwa fenomena boneka arwah merupakan cerminan masyarakat yang kesepian. https://t.co/uPG5njv6hs",183,82,56,37,2022-01-03,14,Monday,1,239,119
1478012231837233152,2022-01-03 14:35:50,"""Hati-hati 280 juta dosis yang disuntikkan itu bukan barang yang mudah, menyuntik 280 juta kali dalam waktu 1 tahun bukan barang yang mudah,"" kata Jokowi. https://t.co/PzEKfni823",38,6,4,1,2022-01-03,14,Monday,1,42,7
1478010966281527297,2022-01-03 14:30:49,"UU Tindak Pidana Perdagangan Orang digunakan menangani kasus Cassandra Angelie. Sebenarnya dalam UU yang sama, ada pasal untuk mengirim pria hidung ke penjara. https://t.co/6HHaAm1EJx",10,3,4,1,2022-01-03,14,Monday,1,14,4
1478010019425759233,2022-01-03 14:27:03,Boneka ini diadopsi dan diperlakukan layaknya bayi manusia. Bagaimana asal-usul tren boneka arwah ini? https://t.co/ay6txOZR2x,26,28,12,4,2022-01-03,14,Monday,1,38,32
1478009002537721857,2022-01-03 14:23:00,Vaksinasi booster COVID-19 di Indonesia bakal dimulai pada 12 Januari 2022. Vaksinasi booster ini akan diberikan dengan kriteria tertentu. https://t.co/3miJDmv8z8,10,1,3,0,2022-01-03,14,Monday,1,13,1
1478007638856249348,2022-01-03 14:17:35,"Jelang bergulirnya putaran kedua Liga 1 2021, Arema FC menambah satu pemain baru. Dia adalah Ryan Kurnia. https://t.co/Z4XXkR44KU",10,0,0,0,2022-01-03,14,Monday,1,10,0
1478007145807421442,2022-01-03 14:15:38,"Pria berinisial EC di Bulukumba, Sulsel meminta maaf di kantor polisi terkait perkataannya menghina kelamin wanita yang viral di media sosial. https://t.co/ESKz8cjFv0",10,3,1,1,2022-01-03,14,Monday,1,11,4
1478006133033996292,2022-01-03 14:11:36,Pihak Habib Bahar bin Smith bercerita detik-detik Pondok Pesantren Tajul Alawiyyin di Bogor diteror tiga kepala anjing. Seperti apa? https://t.co/CSJ2XMUwPe,12,24,3,3,2022-01-03,14,Monday,1,15,27
1478004245861384195,2022-01-03 14:04:06,Carlo Ancelotti lebih memilih Marco Asensio dan Rodrygo yang baru sembuh dari COVID-19 jadi starter ketimbang Eden Hazard. Don Carlo mengungkap alasan soal ini. https://t.co/xDkYhbPD1N,5,0,1,0,2022-01-03,14,Monday,1,6,0
1478004018504941570,2022-01-03 14:03:12,"Selain kondang dengan kuliner kepiting. Pemalang juga punya hidangan berkuah mirip soto dan sup, namanya Nasi Grombyang. Seperti ini lezatnya. https://t.co/yvXh3GLx4D",11,0,3,2,2022-01-03,14,Monday,1,14,2
1478002713908682759,2022-01-03 13:58:01,Langkah membuang sekitar 3.000 liter miras ke kanal itu dilakukan setelah pemerintah Taliban yang kini berkuasa di Afghanistan menindak tegas penjualan miras. https://t.co/RXkEUjggRb,42,12,10,3,2022-01-03,13,Monday,1,52,15
1478001908702978049,2022-01-03 13:54:49,Kasus COVID-19 varian Omicron sudah masuk ke Jawa Timur. Dua pasien asal Surabaya dinyatakan terpapar Corona varian Omicron. Apa gejala mereka? https://t.co/NkgvUvxMmK,11,4,5,3,2022-01-03,13,Monday,1,16,7
1478000752991911936,2022-01-03 13:50:14,"Viral di media sosial 3 unit mobil mewah mendatangi sebuah rumah di Kecamatan Gunungwungkal, Pati, Jateng. Ternyata mobil-mobil itu untuk kado ulang tahun. https://t.co/MQ8cgXkTjb",18,2,4,4,2022-01-03,13,Monday,1,22,6
1477999639496478722,2022-01-03 13:45:48,Pepatah mulutmu harimau tepat untuk Romelu Lukaku. Lukaku kini dikecam banyak pihak akibat bilang tak bahagia di Chelsea dan pingin balik ke Inter Milan. https://t.co/UsAvijBBLe,24,4,1,0,2022-01-03,13,Monday,1,25,4
1477998582133411841,2022-01-03 13:41:36,Selama ini bocoran yang beredar lebih banyak soal Galaxy S22 Ultra. Padahal Galaxy S22 varian standar tidak kalah menarik loh. https://t.co/ZXYhVBOfdX,5,0,3,0,2022-01-03,13,Monday,1,8,0
1477997545943093254,2022-01-03 13:37:29,"Habib Bahar bin Smith menjalani pemeriksaan di Polda Jawa Barat berkaitan dengan kasus dugaan ujaran kebencian. Sudah 7 jam, dia belum keluar ruang pemeriksaan. https://t.co/LzMAYtDNKM",33,26,9,7,2022-01-03,13,Monday,1,42,33
1477996957805256710,2022-01-03 13:35:09,Ada lebih dari lima artis yang jadi sorotan karena mengadopsi boneka arwah. Apa sih efeknya buat kondisi kejiwaan seseorang yang mengadopsinya? https://t.co/xjTQuCWCXH,11,11,4,6,2022-01-03,13,Monday,1,15,17
1477995870922723329,2022-01-03 13:30:50,"Pemuda inisial IR, warga Desa Katapi, Kecamatan Kalukku, Kabupaten Mamuju, Sulawesi Barat, menikam seorang warga saat malam pergantian tahun. IR kini ditangkap https://t.co/nxPjVaSxfe",6,0,0,0,2022-01-03,13,Monday,1,6,0
1477995394428715008,2022-01-03 13:28:56,Mahfud Md mengatakan usulan tersebut tidak pernah didiskusikan apalagi diagendakan oleh pemerintah. https://t.co/2kzlBYt73U,5,0,2,1,2022-01-03,13,Monday,1,7,1
1477994618474184707,2022-01-03 13:25:51,"Motif utama dari pelaku yang menelantarkan pendaki open trip miliknya adalah kehabisan uang. Karena, telah dipakainya untuk keperluan pribadi. Weleh! https://t.co/63TeLMSngJ",5,0,2,0,2022-01-03,13,Monday,1,7,0
1477994600417669131,2022-01-03 13:25:47,Rekonstruksi kasus kecelakaan sejoli Handi dan Salsa juga dilakukan di Banyumas. Ternyata pembuangan kedua sejoli itu dilakukan di Jembatan Sungai Tajum. https://t.co/hsWmT0luv2,6,0,2,0,2022-01-03,13,Monday,1,8,0
1477993609236516865,2022-01-03 13:21:50,"Sejoli H dan S bernasib nahas, ditabrak mobil yang dikemudikan anggota TNI. Bukannya ditolong ke rumah sakit, tubuh mereka dibuang... https://t.co/nX9Ilcsz59",11,0,5,1,2022-01-03,13,Monday,1,16,1
1477991479851290626,2022-01-03 13:13:23,Siswi kelas 4 SD meninggal disebut bukan karena vaksinasi. Tetapi karena pendarahan hebat pada saluran pencernaan tanpa sempat dilakukan endoskopi. https://t.co/jM85wKscw6,12,15,8,8,2022-01-03,13,Monday,1,20,23
1477990185505890305,2022-01-03 13:08:14,"Kota Xi'an, China melakukan lockdown lebih dari sepekan. Usai lockdown dilakukan otoritas China memecat dua pejabat senior kota Xi'an. https://t.co/uRyI1s1YT8",11,0,3,0,2022-01-03,13,Monday,1,14,0
1477989686572376065,2022-01-03 13:06:15,"Dia memberi catatan agar sikap optimisme yang dibangun saat ini tidak hanya soal kesehatan dan ekonomi saja, namun juga pemulihan sosial. https://t.co/gf8hIz1xtp",6,1,2,0,2022-01-03,13,Monday,1,8,1
1477989095611772932,2022-01-03 13:03:54,Pencuri jeruk tertangkap warga usai motor yang dikendarainya menabrak pohon di Klaten. Video penangkapannya viral di medsos. https://t.co/ym9Q01gEkZ,1,0,0,0,2022-01-03,13,Monday,1,1,0
1477987197584388098,2022-01-03 12:56:22,"Dimas menjelaskan pengemudi mobil sempat diam di dalam mobilnya. Namun saat keluar, pengemudi tersebut sambil menenteng benda mirip pistol. https://t.co/fcdcXDEgND",7,0,1,0,2022-01-03,12,Monday,1,8,0
1477986212153630731,2022-01-03 12:52:27,Pengunjung yang sedang menikmati hidangan langsung kocar-kacir. https://t.co/RyUf5mdymW,15,0,3,2,2022-01-03,12,Monday,1,18,2
1477985396801908742,2022-01-03 12:49:12,27 WNI di seluruh penjuru dunia mengajukan gugatan presidential threhold ke MK. Mereka mengutip pendapat Fadli Zon hingga eks Ketua MK Jimly Assidhiqqie. https://t.co/tFmKSYBcxw,23,3,4,3,2022-01-03,12,Monday,1,27,6
1477984371726589954,2022-01-03 12:45:08,"#Terpopuler Habib Bahar terlibat debat panas dengan Danrem 061 Surya Kencana, Brigjen Achmad Fauzi. Usai peristiwa tersebut, Brigjen Achmad memberi Bahar peringatan. https://t.co/tHqWDiUlEQ",38,38,10,1,2022-01-03,12,Monday,1,48,39
1477983382030233603,2022-01-03 12:41:12,"Musisi Danilla Riyadi merilis lagu barunya yang bertajuk MPV. Lagu ini menjadi awal mula dari album selanjutnya Danilla, Pop Seblay. https://t.co/FY0mcmbr6G",12,0,5,0,2022-01-03,12,Monday,1,17,0
1477981109732483077,2022-01-03 12:32:10,"Gunungkidul punya destinasi ngopi anti mainstream nih. Di sini, kamu bisa ngopi di atas awan. Bukan cuma jargon, tapi beneran. Nggak percaya? Lihat deh! https://t.co/vpUsBIjixu",11,2,6,1,2022-01-03,12,Monday,1,17,3
1477980325326295042,2022-01-03 12:29:03,Seorang netizen di Singapura membagikan pengalamannya saat membeli ayam goreng via online. Ia merasa kesal karena mendapati ayam goreng seperti bekas dimakan. https://t.co/lp30LTdGGo,7,1,3,0,2022-01-03,12,Monday,1,10,1
1477978808871436291,2022-01-03 12:23:02,Iif mengaku usahanya tak sengaja berdiri lantaran keinginan mencari penghasilan tambahan di tengah pandemi dan keterbatasan mobilitas yang berlaku. https://t.co/6x43f0su5M,5,0,1,0,2022-01-03,12,Monday,1,6,0
1477978235233255426,2022-01-03 12:20:45,"Video memperlihatkan panggung roboh di konser dangdut di Kediri, viral. Puluhan penonton terjatuh hingga nyemplung ke kolam. https://t.co/Xg9wT0TIi7",11,3,3,0,2022-01-03,12,Monday,1,14,3
1477977389955178498,2022-01-03 12:17:23,"Seorang wanita yang berprofesi sebagai tukang sapu jalan di Medan, Rahma Hasibuan, menjadi korban begal. Rahma dipukul dan sepeda motornya diambil oleh pelaku. https://t.co/bMqne3LsMN",7,0,4,0,2022-01-03,12,Monday,1,11,0
1477976638025515010,2022-01-03 12:14:24,Siapa yang hobi berkebun? Sejumlah pakar tanaman hias memprediksi jenis-jenis tanaman hias apa saja yang akan booming tahun ini. https://t.co/rDVNuYwmIb,19,0,0,0,2022-01-03,12,Monday,1,19,0
1477976141314990086,2022-01-03 12:12:26,"Memiliki dua putra yang berkebutuhan khusus. Seorang wanita berusia 60 tahun, kini menggantungkan hidupnya sebagai food blogger utuk membiayai kedua anaknya. https://t.co/IqMmOKEERN",29,0,9,2,2022-01-03,12,Monday,1,38,2
1477975395026841601,2022-01-03 12:09:28,"3 Siswa SD di Jombang dipastikan mengalami kejadian ikutan pasca imunisasi (KIPI). 1 Siswa meninggal usai divaksin, sedangkan 2 lainnya dirawat di rumah sakit. https://t.co/oUB8T2D1Ym",33,7,13,2,2022-01-03,12,Monday,1,46,9
1477974890623995908,2022-01-03 12:07:28,Sebuah rumah mewah di Tangsel menjadi tempat vandalisme. Pagar rumah tersebut nampak dicoret. https://t.co/zFy8u5kg9r,14,1,0,0,2022-01-03,12,Monday,1,14,1
1477974031764762627,2022-01-03 12:04:03,"Jepang ternyata tidak pernah menjadi tempat masa kecil dan remajanya. Faktanya, di usia sekitar 22 tahun, barulah Reino Barack menetap di Jepang. https://t.co/DjCpmdEjHu",2,1,0,0,2022-01-03,12,Monday,1,2,1
1477974007253286912,2022-01-03 12:03:57,Komda KIPI Jombang menyimpulkan Naura Sabrina Galiyah (9) meninggal bukan karena vaksin COVID-19.Siswi kelas 4 SD meninggal karena pendarahan saluran pencernaan https://t.co/e5yJrIweuE,7,25,5,2,2022-01-03,12,Monday,1,12,27
1477973532894277638,2022-01-03 12:02:04,Tjahjo mengaku tidak setuju terkait usulan Gubernur Lemhannas agar Polri berada di bawah Kementerian. Tjahjo mengatakan Indonesia berbeda dengan negara lain. https://t.co/xLCBLDLXHr,5,6,0,0,2022-01-03,12,Monday,1,5,6
1477973277310173189,2022-01-03 12:01:03,"Lembaga Biologi Molekuler Eijkman yang telah beroperasi hampir tiga dekade kini melebur ke lembaga pemerintah lainnya, BRIN. #CNNIndonesia #detikNetwork  https://t.co/czsp2AgaBy",5,1,0,0,2022-01-03,12,Monday,1,5,1
1477972803953598464,2022-01-03 11:59:10,Menkes Budi mengungkapkan kondisi kasus Omicron di dunia. Disebutkan kasus omicron mengalami kenaikan dengan total kasus sebanyak 408 ribu. https://t.co/9JgScUtvUt,3,2,1,0,2022-01-03,11,Monday,1,4,2
1477971418952384516,2022-01-03 11:53:40,"Pemkab Trenggalek memastikan tahun ini akan membangun kembali jembatan penghubung antar kabupaten yang putus. Pembangunan menelan anggaran Rp 2,7 miliar. https://t.co/zQ8x0D5xKj",4,0,2,0,2022-01-03,11,Monday,1,6,0
1477970945843286019,2022-01-03 11:51:47,#Foto Ada Malioboro mini di bandara Yogyakarta International Airport (YIA). Replika kawasan Malioboro itu pun ramai diserbu wisatawan lokal. Seperti apa ya? https://t.co/Flr2aLKTjg,10,1,1,1,2022-01-03,11,Monday,1,11,2
1477970662258061312,2022-01-03 11:50:39,Video sepasang pengantin di Magelang melaksanakan ijab kabul pernikahan di atas bak truk viral di media sosial. https://t.co/yUAQUtgd7l,7,1,0,1,2022-01-03,11,Monday,1,7,2
1477970439137808388,2022-01-03 11:49:46,"Rodiah mengungkapkan, dia ingin menyelesaikan kasus ini secara kekeluargaan. Namun yang memukul anaknya sampai saat ini belum ada iktikad baik. https://t.co/0zncXodgYD",9,0,1,0,2022-01-03,11,Monday,1,10,0
1477968676737462276,2022-01-03 11:42:46,"Covid Malaysia terus meningkat. Per 3 Januari 2022, kasus harian COVID-19 yang dilaporkan sebanyak 2.690 kasus. https://t.co/rzoq4Ky2zD",3,0,0,0,2022-01-03,11,Monday,1,3,0
1477968675177181191,2022-01-03 11:42:46,Lebaran 2022 jatuh pada tanggal berapa? Hal tersebut menjadi pertanyaan masyarakat karena sudah memasuki pergantian tahun. https://t.co/TOamhe18gu,8,3,4,0,2022-01-03,11,Monday,1,12,3
1477968384637689859,2022-01-03 11:41:36,Kepolisian bakal panggil artis yang terlibat prostitusi Cassandra Angelie. Belum diketahui kapan. https://t.co/xrExlfxfR1,10,5,0,0,2022-01-03,11,Monday,1,10,5
1477967851373965312,2022-01-03 11:39:29,"""Sayang sekali pemimpin lembaga dengan kata-kata inovasi di dalamnya tidak mampu memikirkan hal-hal baik, tidak mampu berinovasi untuk bisa menyelamatkan para peneliti dan periset itu,"" kata Hensat. https://t.co/PM3zIpGRD7",68,6,18,1,2022-01-03,11,Monday,1,86,7
1477967292663320581,2022-01-03 11:37:16,"Its My Dream! Cappadocia ini ramai diperbincangkan. Tak heran, keindahannya memang patut diacungi jempol. Ada tujuan menarik apa saja ya di sana? https://t.co/b72kYSvkkf",15,1,4,0,2022-01-03,11,Monday,1,19,1
1477966548958695427,2022-01-03 11:34:19,"Humas Polda Metro Jaya, Endra Zulpan, mengatakan bahwa artis Cassandra Angelie saat ini diberlakukan wajib lapor. Ini alasannya: https://t.co/2rvhMr7KZW",1,3,2,2,2022-01-03,11,Monday,1,3,5
1477965963924545536,2022-01-03 11:31:59,Sekarang ini masyarakat sudah bisa dengan mudah membayar Pajak Bumi dan Bangunan (PBB) karena bisa dilakukan secara online. Begini caranya: https://t.co/XTyhtkqSYL,6,0,0,0,2022-01-03,11,Monday,1,6,0
1477965113466490880,2022-01-03 11:28:36,Jane Abel tahu Amalia Fujiawati dinikahi. Ia dapat pesan ini dari Bambang Pamungkas. https://t.co/2xpHOX8ueP,9,0,0,1,2022-01-03,11,Monday,1,9,1
1477964325545463808,2022-01-03 11:25:29,Seorang pria mengklaim menemukan kondom di dalam hot pot pesanannya dan meminta kompensasi Rp 22 juta. Tapi pria itu berujung ditahan polisi. https://t.co/J8mUc5l00K,23,2,7,5,2022-01-03,11,Monday,1,30,7
1477963820853248000,2022-01-03 11:23:28,Spirit doll atau boneka arwah tengah digemari para artis untuk diadopsi. Five Vi ikut berkomentar dan mengingatkan soal haram. https://t.co/dcpDFiCpRB,5,1,3,1,2022-01-03,11,Monday,1,8,2
1477963202558312451,2022-01-03 11:21:01,Dinas Pendidikan Kabupaten Lebak belum bisa menerapkan pembelajaran tatap muka (PTM) 100 persen pada hari pertama semester genap. https://t.co/TIvxV3SdVk,4,0,0,0,2022-01-03,11,Monday,1,4,0
1477963180458586113,2022-01-03 11:20:56,Strategi investasi harus dibuat sematang mungkin nih di tahun 2022. Setidaknya harus lebih cuan lah dari tahun sebelumnya. Gimana caranya? https://t.co/dphGaMcYEJ,5,0,1,0,2022-01-03,11,Monday,1,6,0
1477962705227157506,2022-01-03 11:19:02,"Pemain muda Tira Persikabo U18, Raychan Adji tewas usai mengalami kecelakaan mobil di Banyuwangi Senin (3/1/2022). Ia tewas dalam perjalanan menuju ke Bali. https://t.co/HySCe0fz91",17,0,4,0,2022-01-03,11,Monday,1,21,0
1477962681260953602,2022-01-03 11:18:57,Menkes Budi Gunadi menjelaskan persiapan jika terjadi lonjakan kasus COVID-19. Termasuk soal ketersediaan tempat tidur RS dan kebutuhan oksigen. https://t.co/9HmXq2uU29,5,0,1,1,2022-01-03,11,Monday,1,6,1
1477962454827257856,2022-01-03 11:18:03,Pemain Tira Persikabo yang meninggal kecelakaan saat itu dalam perjalanan ke Bali untuk mengikuti pertandingan melawan Arema FC. Begini kronologinya. https://t.co/rJBRk3WaN2,6,1,1,0,2022-01-03,11,Monday,1,7,1
1477962437575987208,2022-01-03 11:17:58,"Pemain muda Tira Persikabo U18, Raychan Adji tewas usai mengalami kecelakaan mobil di Banyuwangi Senin (3/1/2022). Ia tewas dalam perjalanan menuju ke Bali. https://t.co/ePDPO08L6m",14,0,1,0,2022-01-03,11,Monday,1,15,0
1477962210399899651,2022-01-03 11:17:04,"Jalan di wilayah Pangkalan 1 Bantargebang, Kota Bekasi, ambles dan belum diperbaiki. Pengendara diharapkan hati-hati saat melintas di jalan tersebut. https://t.co/QfNACTsIze",2,1,0,0,2022-01-03,11,Monday,1,2,1
1477962189482905600,2022-01-03 11:16:59,"Catat ya, traveler! Berikut persyaratan pelanggan Kereta Api mulai 3 Januari 2022: https://t.co/rqRoHmgGzo",3,1,2,0,2022-01-03,11,Monday,1,5,1
1477961403021643778,2022-01-03 11:13:52,Presiden Jokowi baru saja merilis aturan terbaru tentang bahan bakar minyak (BBM) jenis Premium. Seperti apa? https://t.co/SMb83abrL3,2,0,0,0,2022-01-03,11,Monday,1,2,0
1477961159487672320,2022-01-03 11:12:54,Park Shin Hye dan Choi Tae Joon berencana menggelar pernikahan pada 22 Januari 2022. Detail rencana resepsi pun terungkap. https://t.co/dzCSMSA2dT,21,0,5,0,2022-01-03,11,Monday,1,26,0
1477960410095656963,2022-01-03 11:09:55,"Pemerintah akan membuka pintu-pintu baru untuk pelaku perjalanan luar negeri (PPLN). Pintu baru yang dibuka itu mencakup udara, darat dan laut. https://t.co/eZ6wgXj1rc",9,1,0,1,2022-01-03,11,Monday,1,9,2
1477959656274337793,2022-01-03 11:06:55,"Majalah Forbes merilis daftar 5 pekerjaan yang diprediksi akan banyak dicari pada tahun 2022 mendatang. Kira-kira, ada pekerjaan apa saja, ya? https://t.co/uHYubbDBi1",6,0,1,0,2022-01-03,11,Monday,1,7,0
1477958880265224197,2022-01-03 11:03:50,Para penderita diabetes bisa menikmati buah segar yang manis. Deretan tempat makan outdoor di Bogor dan durian kampung organik asal Jepara yang manis pahit. https://t.co/suAoVWsCvc,5,0,0,0,2022-01-03,11,Monday,1,5,0
1477958335618068480,2022-01-03 11:01:41,Kapten Timnas Thailand Chanathip Songkrasin belum berpacaran lagi sejak batal nikah dengan seorang aktris karena restu orangtua. Intip fakta-faktanya: https://t.co/ChpdGMrdBr,3,0,1,1,2022-01-03,11,Monday,1,4,1
1477957724277288961,2022-01-03 10:59:15,Ivan Gunawan pada 31 Desember 2021 telah mengumumkan Andina Julie menjadi Miss Grand Indonesia 2022. https://t.co/R5dBf8WFf6,3,0,1,0,2022-01-03,10,Monday,1,4,0
1477956069955620867,2022-01-03 10:52:40,Video sepasang pengantin melaksanakan ijab kabul pernikahan di atas bak truk viral di media sosial. Seperti apa kisahnya? https://t.co/WZRTGe4N4n,18,0,2,1,2022-01-03,10,Monday,1,20,1
1477954975485599744,2022-01-03 10:48:19,Warga khawatir diserang ketika sedang menyadap karet di kebun. Warga kemudian berkoordinasi dengan BKSDA. https://t.co/cYqyzcDNKi,28,0,4,1,2022-01-03,10,Monday,1,32,1
1477954414740656128,2022-01-03 10:46:06,"Korea Selatan melaporkan dua kasus pertama kematian akibat varian Omicron. Hingga saat ini, penyebab pasti kematiannya masih diselidiki lebih lanjut. https://t.co/H4nXsTHFYk",11,0,1,1,2022-01-03,10,Monday,1,12,1
1477954090449752067,2022-01-03 10:44:48,Tira Persikabo berduka. Seorang pemain dan seorang ofisial klubnya meninggal dunia akibat kecelakaan pada hari Senin (3/1) ini. https://t.co/isWX4uccHE,8,0,3,1,2022-01-03,10,Monday,1,11,1
1477952199099617280,2022-01-03 10:37:17,Viral sepasang warga negara asing (WNA) panjat dan terobos pagar terluar kompleks Candi Prambanan. Aksi kedua WNA itu ternyata kepergok dan disergap sekuriti. https://t.co/xrOxrbQLvW,8,1,1,2,2022-01-03,10,Monday,1,9,3
1477952197971357698,2022-01-03 10:37:17,Gempa bumi kuat berkekuatan Magnitudo 6 mengguncang wilayah pantai timur Taiwan. Getaran gempa dirasakan kuat di ibu kota Taipei. https://t.co/9TcYdbcjV1,12,0,3,0,2022-01-03,10,Monday,1,15,0
1477951663663161346,2022-01-03 10:35:10,"Selain di Nagreg, rekonstruksi kasus Handi-Salsa juga digelar di Kabupaten Banyumas, Jawa Tengah. Rekonstruksi berlangsung di jembatan Sungai Tajum. https://t.co/LsT7d46ywJ",2,0,0,0,2022-01-03,10,Monday,1,2,0
1477951658286100480,2022-01-03 10:35:09,"Indonesia melaporkan 265 kasus COVID-19 pada Senin (3/1/2022). Total kasus positif menjadi 4.263.433, sembuh 4.114.801, dan meninggal 144.102. https://t.co/BhVHLwTLfr",2,0,4,0,2022-01-03,10,Monday,1,6,0
1477951174267621381,2022-01-03 10:33:13,"Spirit doll tengah heboh dibicarakan karena beberapa artis memilih untuk mengadopsinya. Namun, Indadari punya pandangan lain soal hal ini. https://t.co/Ft8YGSac0N",2,4,2,1,2022-01-03,10,Monday,1,4,5
1477950671236345858,2022-01-03 10:31:13,Irwansyah masih tunggu kepolisian atas kasus adiknya. Hafiz Fatur diduga menipu harta benda Irwan. https://t.co/o0v5R1gB9Z,2,1,1,0,2022-01-03,10,Monday,1,3,1
1477950650570924037,2022-01-03 10:31:08,Detik-detik kecelakaan Handi dan Salsa tidak masuk dalam proses rekonstruksi yang digelar Pusat Polisi Militer Angkatan Darat (Puspomad). https://t.co/jNJGEN6BIt,5,0,2,0,2022-01-03,10,Monday,1,7,0
1477950151838863360,2022-01-03 10:29:09,Muncul nama-nama pesohor yang terlibat usai kasus prostitusi online Cassandra Angelie terkuak. Apa saja profesi mereka? https://t.co/Iynud1Htgg,16,0,2,1,2022-01-03,10,Monday,1,18,1
1477948628215992320,2022-01-03 10:23:06,Geliat pariwisata di Sleman mulai terlihat pada momen libur Tahun Baru 2022. Hal ini tentu menjadi angin segar bagi pelaku pariwisata setelah digempur pandemi. https://t.co/NSqZ3Uawcq,3,0,0,0,2022-01-03,10,Monday,1,3,0
1477948600063873027,2022-01-03 10:22:59,"PTM 100 persen di sekolah DKI Jakarta mulai dilaksanakan hari ini, Senin (3/1/2021). Bagaimana fakta terbarunya hari ini? https://t.co/D9QP1BzKAU",7,0,3,0,2022-01-03,10,Monday,1,10,0
1477947989364776961,2022-01-03 10:20:34,"Indonesia melaporkan 265 kasus COVID-19 pada Senin (3/1/2022). Total kasus positif menjadi 4.263.433, sembuh 4.114.801, dan meninggal 144.102. https://t.co/JQ0weEn2Aa",3,0,4,1,2022-01-03,10,Monday,1,7,1
1477947746682388483,2022-01-03 10:19:36,Sebuah video aksi sepasang warga negara asing (WNA) diduga tengah menerobos kawasan Candi Prambanan viral di media sosial. Dua bule itu tampak panjat pagar. https://t.co/cN4nK1fBVC,2,1,2,1,2022-01-03,10,Monday,1,4,2
1477946689277333504,2022-01-03 10:15:24,Sebuah video aksi sepasang warga negara asing (WNA) diduga tengah menerobos kawasan Candi Prambanan viral di media sosial. Dua bule itu tampak panjat pagar. https://t.co/1AtoW0nnTs,18,1,2,4,2022-01-03,10,Monday,1,20,5
1477946454366953473,2022-01-03 10:14:28,Mohamed Salah menguatkan posisinya di puncak top skor Liga Inggris. Kira-kira siapa bisa menyusul Salah yang libur sebulan karena tampil di Piala Afrika?  https://t.co/sq5cLmVqPm,8,0,2,0,2022-01-03,10,Monday,1,10,0
1477945961175564293,2022-01-03 10:12:30,"Manchester City dianggap sudah menjuarai Liga Inggris musim ini. Meski masih ada 17 pekan lagi, Citizens diperkirakan tak akan terkejar lagi.  https://t.co/mEa0FVHdzr",6,3,0,1,2022-01-03,10,Monday,1,6,4
1477945710922407938,2022-01-03 10:11:31,Liverpool gagal mempertahankan keunggulan dua gol dan mesti puas dengan hasil imbang. Hal itu karena mereka dinilai kalah di lini tengah.  https://t.co/S8r0NFxHBo,3,0,0,0,2022-01-03,10,Monday,1,3,0
1477945200387543043,2022-01-03 10:09:29,"Di tengah kontroversi yang membayangi jalannya Olimpiade Musim Dingin Beijing 2022, penyelenggara mematangkan persiapan ajang olahraga internasional ini. https://t.co/VVtlXZ4ub1",2,0,2,0,2022-01-03,10,Monday,1,4,0
1477944493047439361,2022-01-03 10:06:40,"Setelah muncul mobil listrik murah Wuling Hongguang Mini EV, kini satu merek lain ikut terjun menjual mobil EV murah meriah, yakni Dongfeng.  https://t.co/vgWYMYmkqk",4,0,1,0,2022-01-03,10,Monday,1,5,0
1477944477356539907,2022-01-03 10:06:36,Nani Aprilliani Nurjaman (25) tidak mengajukan banding usai divonis 16 tahun bui. Dia justru mengajukan pindah ke Lapas Bandung. https://t.co/14cGZ1v7un,4,0,1,0,2022-01-03,10,Monday,1,5,0
1477942911710937091,2022-01-03 10:00:23,Menkes Budi Gunadi Sadikin mengungkapkan pemberian vaksin booster akan dilakukan pada 12 Januari mendatang. Berikut kriteria serta teknis pemberiannya. https://t.co/iZ2QcJRBqw,2,0,6,0,2022-01-03,10,Monday,1,8,0
1477942820396621825,2022-01-03 10:00:01,"Yuk! Ulas Kilas Balik Peristiwa Penting Sepanjang 2021 Bareng detikcom
https://t.co/TfZyprgmiQ.",1,0,1,0,2022-01-03,10,Monday,1,2,0
1477942806568222723,2022-01-03 09:59:58,Begini nasib pemotor yang terperosok karena ambruknya Jembatan yang berdiri di atas sungai Citarum.  https://t.co/QsidjxJhSG,7,0,2,0,2022-01-03,9,Monday,1,9,0
1477941991405195264,2022-01-03 09:56:44,Pemerintah menyiapkan ratusan ribu tempat tidur rumah sakit dan oksigen. https://t.co/v0Z8jRbS2r,11,10,6,6,2022-01-03,9,Monday,1,17,16
1477941969246736385,2022-01-03 09:56:38,"Tersangka kasus pencabulan di Polres Metro Bekasi melarikan diri, Jumat (31/12), sekitar pukul 17.00 WIB. Ia kemudian ditemukan di kali dalam keadaan tak bernyawa.  https://t.co/Lq4ideFKw7",2,2,1,0,2022-01-03,9,Monday,1,3,2
1477941732746670082,2022-01-03 09:55:42,Petugas kebersihan ternyata mendapatkan gaji paling tinggi di New York lho. Lalu berapa gaji dan UMR-nya ya. Simak informasinya dari WNI berikut. #detikNetwork  https://t.co/FsERlSKMXP,11,2,3,2,2022-01-03,9,Monday,1,14,4
1477941717781331969,2022-01-03 09:55:39,"Meski mengenakan helm, korban tetap mengalami cedera di kepala. https://t.co/ZTaFVGkmUs",18,4,4,1,2022-01-03,9,Monday,1,22,5
1477941422577930242,2022-01-03 09:54:28,"Mantan Wakil Ketua DPR, Azis Syamsuddin, disebut menerima Rp 2,085 miliar terkait pengurusan dana alokasi khusus (DAK) Lampung Tengah tahun 2017.   https://t.co/3xq9SkQi2w",4,1,2,0,2022-01-03,9,Monday,1,6,1
1477941406798864392,2022-01-03 09:54:24,Mereka diharuskan mematuhi hukum Rusia dan mendaftarkan perusahaannya di Rusia. https://t.co/9U25eDsGqV,1,0,2,0,2022-01-03,9,Monday,1,3,0
1477941109116526593,2022-01-03 09:53:13,"Akan lebih baik bila saat ini masyarakat dapat melakukan cek resi Ninja Xpress, Tiki, JNE, dan sejumlah perusahaan ekspedisi lainnya. Begini caranya: https://t.co/1r7wpk01UT",1,0,1,0,2022-01-03,9,Monday,1,2,0
1477940862869028865,2022-01-03 09:52:15,Hujan Meteor Quadrantid merupakan salah satu hujan meteor tahunan terbesar. Seperti apa fakta-faktanya? https://t.co/4At2fa53JF,9,0,3,2,2022-01-03,9,Monday,1,12,2
1477940300526071812,2022-01-03 09:50:01,Penghapusan BBM Premium menemui kendala yang harus diselesaikan. Apa itu? https://t.co/DIDKTUpBbq,6,1,4,0,2022-01-03,9,Monday,1,10,1
1477940039246098435,2022-01-03 09:48:58,"Seorang lansia nampak buang air besar di Jalan K.H Mas Mansyur, Jakarta, Senin (3/1/2022). Aksi buang air tersebut dilakukan pukul 13.30 WIB. https://t.co/h2FT8s9PFA",18,6,9,6,2022-01-03,9,Monday,1,27,12
1477939800074330113,2022-01-03 09:48:01,Polisi turut memeriksa pemilik akun YouTube yang mengunggah video ceramah habib Bahar bin Smith di Bandung. https://t.co/Ma6PYF0XBv,8,0,2,0,2022-01-03,9,Monday,1,10,0
1477939426303041536,2022-01-03 09:46:32,Luhut Panjaitan memperkenalkan eks CEO Bukalapak Rachmat Kaimuddin sebagai stafnya. Rachmat bertugas di technology sustainability development special adviser di Kemenko Marves.  https://t.co/cJeI8NCu0Y,1,0,1,0,2022-01-03,9,Monday,1,2,0
1477939418208120835,2022-01-03 09:46:30,"""Bawa...bawa! Masukin...masukin ke dalam mobil!"" ucap Kolonel Infanteri Priyanto bernada lantang selagi menatap sejoli korban kecelakaan. https://t.co/BhnqpQpplP",15,11,4,4,2022-01-03,9,Monday,1,19,15
1477939065790124032,2022-01-03 09:45:06,"Dalam siaran pers hasil rapat terbatas evaluasi PPKM, Senin (3/1), Menkes Budi Gunadi Sadikin memaparkan update kasus Covid-19 varian Omicron di dunia.   https://t.co/ZIX93YUqKA",4,0,1,0,2022-01-03,9,Monday,1,5,0
1477939044315279360,2022-01-03 09:45:01,Polisi menangkap 10 orang diduga pelaku pengeroyokan anggota Dit Polairud Baharkam Polri bernama Bripda Rio Novemberyanto Rajagukguk. https://t.co/rIcbMbz05j,4,0,1,0,2022-01-03,9,Monday,1,5,0
1477938283736936451,2022-01-03 09:42:00,"Remaja pria yang viral terekam CCTV diduga tengah berbuat mesum di belakang mobil di Sunter Mas Tengah, Tanjung Priok, Jakut, jadi tersangka dan ditahan. https://t.co/pcrFKAxjO1",7,5,7,2,2022-01-03,9,Monday,1,14,7
1477938268427755522,2022-01-03 09:41:56,Pemain Tira Persikabo Raychan Adji Pangestu meninggal dalam kecelakaan di Banyuwangi. Kecelakaan itu disebabkan oleh sopir yang mengantuk. https://t.co/GAOkefcUsJ,4,0,4,0,2022-01-03,9,Monday,1,8,0
1477937790780329987,2022-01-03 09:40:02,Liverpool gagal mempertahankan keunggulan dua gol dan mesti puas dengan hasil imbang. Hal itu karena mereka dinilai kalah di lini tengah. https://t.co/aApgGJhEZ8,0,0,1,0,2022-01-03,9,Monday,1,1,0
1477937774330359811,2022-01-03 09:39:58,"Wagub DKI Ahmad Riza tegaskan tak ada kas daerah Rp 12,9 Triliun yang mengendap di Bank. Hal ini merespon teguran Mendagri Tito Karnavian soal kas 'menganggur' https://t.co/pkRxqsKsMw",17,12,7,4,2022-01-03,9,Monday,1,24,16
1477937503529312257,2022-01-03 09:38:54,Covid Singapura melaporkan kasus terbaru per Minggu (2/1/) siang waktu setempat. Kasus varian Corona Omicron juga termasuk di dalamnya. https://t.co/ipJxs6fgW5,12,0,1,0,2022-01-03,9,Monday,1,13,0
1477937025705721858,2022-01-03 09:37:00,"Forbes merilis 10 daftar orang terkaya di dunia terbaru. Ternyata, miliarder tersebut merupakan lulusan kampus top dunia. Siapa saja? https://t.co/dXnEuRz0wv",6,0,1,0,2022-01-03,9,Monday,1,7,0
1477936644737146885,2022-01-03 09:35:29,"Marc Marquez kemungkinan bakal absen di tes pramusim MotoGP 2022 yang diselenggarakan di Sirkuit Mandalika, Februari 2022.  https://t.co/KssupTDfiN",10,0,4,0,2022-01-03,9,Monday,1,14,0
1477935636158074880,2022-01-03 09:31:29,"Bali United tak akan didampingi pelatihnya, Stefano Cugurra Teco, saat melawan Persebaya Surabaya di lanjutan Liga 1. Teco sedang mengambil kursus kepelatihan.  https://t.co/bCpOcP7Epy",2,0,0,0,2022-01-03,9,Monday,1,2,0
1477935550741032964,2022-01-03 09:31:08,"Partai tinju kelas berat ini berjalan sengit sekali. Dalam dua ronde saja, kedua petinju bergantian menjatuhkan lawan. Bahkan wasit akhirnya juga kena hantam!  https://t.co/BEfLZBr0U0",2,1,0,0,2022-01-03,9,Monday,1,2,1
1477935378363473922,2022-01-03 09:30:27,Chelsea selamat dari kekalahan usai mengimbangi Liverpool 2-2. Tapi catatan buruk The Blues di kandang belakangan ini masih berlanjut.  https://t.co/IvJfSqJcif,1,0,0,0,2022-01-03,9,Monday,1,1,0
1477935377092591619,2022-01-03 09:30:27,14 kecamatan di Aceh Utara dilanda banjir akibat meluapnya aliran sungai. Pemkab kini menetapkan status tanggap darurat. https://t.co/owoQmZR30P,4,0,1,0,2022-01-03,9,Monday,1,5,0
1477935133172944897,2022-01-03 09:29:29,Piala Super Italia dipastikan tetap dihelat sesuai jadwal. Partai yang mempertemukan Inter Milan vs Juventus itu pentas 12 Januari.  https://t.co/ppM65UpLGy,2,0,2,0,2022-01-03,9,Monday,1,4,0
1477935131809697792,2022-01-03 09:29:28,"Puisi pendidikan dapat mencakup beragam topik, seperti pendidikan nasional hingga masa pandemi yang dihadapi saat ini. Berikut ini contoh-contoh puisinya. https://t.co/zcMlOFMlLK",1,0,1,0,2022-01-03,9,Monday,1,2,0
1477934849713393664,2022-01-03 09:28:21,Manchester United masih tampil inkonsisten di musim ini. Diogo Dalot mengakui bahwa terkadang Setan Merah memang tampak frustrasi.  https://t.co/YAgKEOctyK,13,1,1,0,2022-01-03,9,Monday,1,14,1
1477934848442523651,2022-01-03 09:28:21,Virgil van Dijk dianggap terlalu malas berlari saat gol penyama kedudukan Chelsea terjadi. Ia tak mengejar Christian Pulisic yang bikin gol.  https://t.co/IhtiKnQh7H,0,0,0,0,2022-01-03,9,Monday,1,0,0
1477934522524180481,2022-01-03 09:27:03,"Sejak beberapa hari lalu, ada saja komentar nyasar di Instagram Cassandra Lee. Ia disindir soal kasus prostitusi. https://t.co/jQDWQ4LEyP",7,3,1,1,2022-01-03,9,Monday,1,8,4
1477934499942080514,2022-01-03 09:26:58,"Ralf Rangnick ingin Donny van de Beek tetap bertahan di Manchester United. Meski hingga kini, Van de Beek masih sulit mendapatkan menit bermain.  https://t.co/BVbGOiQ2jJ",3,0,0,0,2022-01-03,9,Monday,1,3,0
1477934219506728960,2022-01-03 09:25:51,"Chelsea vs Liverpool dalam lanjutan Liga Inggris selesai imbang. Andai Romelu Lukaku bermain, hasil laga diyakini akan berbeda untuk The Blues.  https://t.co/D2yiHA1f7A",2,0,0,0,2022-01-03,9,Monday,1,2,0
1477934218432946181,2022-01-03 09:25:51,Dua warga dan empat kerbau terjebak banjir lahar Gunung Semeru. Mereka terjebak selama 12 jam. https://t.co/hE3ln0HhQ2,3,2,0,1,2022-01-03,9,Monday,1,3,3
1477933743394459649,2022-01-03 09:23:57,"Ramai sejumlah selebriti punya spirit doll. Di Indonesia, spirit doll bisa ditemukan di beberapa situs belanja. Jadi penasaran, berapa sih kisaran harganya? https://t.co/DwaDpdVUEb",6,3,2,9,2022-01-03,9,Monday,1,8,12
1477933724155138051,2022-01-03 09:23:53,"Sebanyak 44 eks Pegawai KPK mulai bekerja sebagai ASN Polri hari ini. Novel Baswedan menceritakan hari pertamanya bekerja, dia disambut ramah. https://t.co/a7UtvADboK",7,2,2,0,2022-01-03,9,Monday,1,9,2
1477933400384327681,2022-01-03 09:22:35,"Hakim Anggota Fahzal Hendri mengkonfrontasi keterangan Aliza Gunado yang mengaku tak mengenal saksi Aan Riyanto, Taufik Rahman dan Darius Hartawan. Padahal saksi yang dihadirkan mengenal Aliza Gunado.  https://t.co/KNfOqNCMGE",1,0,1,0,2022-01-03,9,Monday,1,2,0
1477933143055376385,2022-01-03 09:21:34,"Kasus Omicron di Indonesia bertambah menjadi 152 kasus, 6 di antaranya tercatat sebagai kasus transmisi lokal. Menkes Budi Gunadi Sadikin pun menjelaskan kondisi terkini dari para pasien Omicron tersebut.   https://t.co/Oy8qvN9kjr",5,2,1,0,2022-01-03,9,Monday,1,6,2
1477932892135297026,2022-01-03 09:20:34,Seorang tak dikenal melintasi perbatasan yang dijaga ketat ke Korea Utara. Korea Selatan langsung mengirim pesan ke Korea Utara pada Minggu (2/1) pagi untuk memastikan keselamatan orang tersebut.  https://t.co/nsPKPCGrKh,2,0,1,0,2022-01-03,9,Monday,1,3,0
1477932879669776388,2022-01-03 09:20:31,"Gas, jangan ragu! Awal tahun 2022, PT Kao Indonesia membuka lowongan kerja kepada mereka para lulusan D3 dan S1. Ini persyaratannya: https://t.co/DFNkJTlCcf",3,0,6,0,2022-01-03,9,Monday,1,9,0
1477932318383820800,2022-01-03 09:18:18,Luhut Pandjaitan menyampaikan hasil rapat terbatas yang dipimpin Jokowi. Salah satu hasil ratas itu pemerintah mengubah durasi karantina dari luar negeri menjadi 10 dan 7 hari.  https://t.co/OmLnoHYYuF,5,2,3,0,2022-01-03,9,Monday,1,8,2
1477932018776354821,2022-01-03 09:17:06,Sejumlah anggota Pansus RUU Ibu Kota Baru DPR berangkat ke Kazakhstan bersama Bappenas. Pimpinan DPR RI Sufmi Dasco Ahmad memberikan penjelasan atas keberangkatan ini.  https://t.co/GiUDH2USLb,15,37,7,14,2022-01-03,9,Monday,1,22,51
1477932017471926275,2022-01-03 09:17:06,Srihadi Soedarsono dikenal sebagai pelukis yang kerap menggambar Borobudur sampai tarian khas Bedhaya. Berikut 5 fakta tentangnya: https://t.co/51zMwUylkx,4,0,1,0,2022-01-03,9,Monday,1,5,0
1477931747878789120,2022-01-03 09:16:01,"""Pertalite akan menjadi BBM penugasan di mana nanti Pertamina akan mendapatkan dana kompensasi karena penugasan yang diberikan,"" kata Pengamat Energi Mamit. https://t.co/fWMg3uBFDs",1,0,1,0,2022-01-03,9,Monday,1,2,0
1477931246357516290,2022-01-03 09:14:02,Kemendagri tengah memproses pemberhentian Nurdin Abdullah dari jabatan Gubernur Sulsel setelah divonis 5 tahun penjara terkait kasus suap dan gratifikasi. https://t.co/iz2ZHwCnSo,5,1,1,0,2022-01-03,9,Monday,1,6,1
1477930750381117441,2022-01-03 09:12:04,LTMPT mengingatkan sekolah dan siswa untuk menyiapkan akun LTMPT agar dapat mengikuti SNMPTN 2022 dan SBMPTN. Berikut cara daftar akun LTMPT. https://t.co/8cKays90xP,9,0,1,1,2022-01-03,9,Monday,1,10,1
1477930238822727680,2022-01-03 09:10:02,Kabar gembira! Obat COVID-19 bernama Molnupiravir akan tiba di RI hari ini. Obat ini diklaim ampuh menekan laju masuknya pasien COVID-19 ke rumah sakit. https://t.co/UpgD4sHstj,22,0,14,2,2022-01-03,9,Monday,1,36,2
1477929765977960454,2022-01-03 09:08:09,"Oki Setiana Dewi saat ini sedang menghabiskan liburan di Amerika Serikat. Tidak hanya dengan keluarga, Oki juga mengajak ibunda untuk liburan ke sana. https://t.co/DziktFeZM6",9,2,1,1,2022-01-03,9,Monday,1,10,3
1477928937695105027,2022-01-03 09:04:51,Kebakaran terjadi permukiman warga di Tebet dini hari tadi. Kebakaran diduga akibat dua pemotor melempar benda misterius ke salah satu rumah. https://t.co/Rt1li0v7On,3,0,2,0,2022-01-03,9,Monday,1,5,0
1477928173518176263,2022-01-03 09:01:49,"Juara Dunia World Superbike (SBK) Toprak Razgatlioglumenolak untuk beralih ke MotoGP. Padahal, diprediksi ia bisa sangat kuat jika berkiprah di MotoGP.  https://t.co/dyvYvpyq5s",7,0,1,0,2022-01-03,9,Monday,1,8,0
1477927681564057601,2022-01-03 08:59:52,Harga gas LPG 12 kilogram (kg) kini dijual Rp 175.000 oleh warung kepada konsumen. Harga tersebut naik Rp 25.000 dari sebelumnya Rp 150.000. https://t.co/iWh2NYEG99,7,2,11,3,2022-01-03,8,Monday,1,18,5
1477927201052008451,2022-01-03 08:57:57,"Selama melakoni adegan, Priyanto banyak menunduk. Mimiknya serius dan sesekali berbincang dengan Polisi Militer yang mengawalnya. https://t.co/1HeoKiEpOb",6,0,4,1,2022-01-03,8,Monday,1,10,1
1477927189374984194,2022-01-03 08:57:55,"Dua orang meninggal. Salah satu korban adalah pemain muda Tira Persikabo, Raychan Adji Pangestu. https://t.co/BkbkBTp9ES",41,3,6,0,2022-01-03,8,Monday,1,47,3
1477926690999390215,2022-01-03 08:55:56,"Melok Besari, adik kandung dari mendiang Ainun Habibie berkeluh kesah soal lingkungan tempat tinggalnya di Bandung yang kini bising. Seperti apa curhatannya? https://t.co/PDowT4kfoI",65,8,12,4,2022-01-03,8,Monday,1,77,12
1477925936028868608,2022-01-03 08:52:56,Ada sejumlah pertimbangan pihak penyidik tidak menahan Cassandra Angelie. https://t.co/F8gQnF6Kg8,11,13,2,3,2022-01-03,8,Monday,1,13,16
1477925917167173632,2022-01-03 08:52:51,TNI AU (Angkatan Udara) memastikan pembelian pesawat jet tempur Dassault Rafale buatan Prancis. Yuk intip spesifikasinya.  https://t.co/FUbhQM9yfH,24,4,5,0,2022-01-03,8,Monday,1,29,4
1477925432997593088,2022-01-03 08:50:56,"Seorang anak tewas tenggelam di kolam Agro Wisata Desa Cipawon, Purbalingga, Minggu (2/1) siang. Belakangan terungkap, kolam tersebut ternyata belum berizin. https://t.co/0hWPcAmMJM",2,2,2,0,2022-01-03,8,Monday,1,4,2
1477925413288660994,2022-01-03 08:50:51,Kamu punya resolusi ingin beli mobil baru di tahun 2022? Simak tips ini dulu.  https://t.co/OKuCTp2e5Y,6,1,3,0,2022-01-03,8,Monday,1,9,1
1477924911914041346,2022-01-03 08:48:52,"Baru-baru ini, Pajero unjuk kemampuan karena berhasil menarik keluar bus yang terjebak di lumpur. Ini penampakannya! https://t.co/t6Q60KLUkB",8,4,4,2,2022-01-03,8,Monday,1,12,6
1477924006363865092,2022-01-03 08:45:16,Eks CEO Bukalapak Rachmat Kaimuddin resmi bergabung dengan Kemenko Kemaritiman dan Investasi pimpinan Luhut Binsar Pandjaitan. https://t.co/Ul7M1AvLMf,15,3,3,4,2022-01-03,8,Monday,1,18,7
1477923436567662594,2022-01-03 08:43:00,Spirit doll tengah jadi perhatian karena banyak diadopsi para artis dan diperlakukan layaknya bayi sungguhan. Berikut potret 6 artis bersama para spirit doll. https://t.co/dVXUIfbqKo,5,8,2,2,2022-01-03,8,Monday,1,7,10
1477922937915252739,2022-01-03 08:41:01,"Hingga 2 Januari, Balitbangkes mencatat ada 137 pasien Omicron di RI. Paling banyak di DKI mencapai lebih dari 80 kasus, disusul Banten hingga Jabar 20 kasus. https://t.co/i7CbwKSeAf",6,0,5,0,2022-01-03,8,Monday,1,11,0
1477922452722405377,2022-01-03 08:39:05,"Mie ayam gerobakan jadi favorit karena rasanya enak dan harganya murah. Berikut 20 rekomendasi mie ayam gerobakan yang populer di Jakarta, Depok, hingga Bogor. https://t.co/rn0b7FRhtI",11,1,9,0,2022-01-03,8,Monday,1,20,1
1477921468570902530,2022-01-03 08:35:11,Warung mangut lele Pak Gianto yang kondang di Yogayakarta buka cabang di Bekasi. Mangut lele beraroma asap dengan kuah pedas ini bikin nagih. https://t.co/ewPqkqmVRw,6,0,3,3,2022-01-03,8,Monday,1,9,3
1477920729169788934,2022-01-03 08:32:14,Pemprov DKI Jakarta memberlakukan PTM terbatas 100 persen mulai semester genap tahun ajaran/tahun akademik 2021/2022. PTM berlangsung maksimal 6 jam. https://t.co/qw37ActT2t,8,1,3,1,2022-01-03,8,Monday,1,11,2
1477919850672664580,2022-01-03 08:28:45,"Usai kepergok ciuman dan gendongan di kolam salah satu kelab di Bali, Zikri Daulay dan Ayu Aulia kini terlihat bersama. https://t.co/2aULCSqGh9",6,0,2,1,2022-01-03,8,Monday,1,8,1
1477919117017559042,2022-01-03 08:25:50,Bahar tiba di Polda Jabar Senin (3/1/2022) pukul 12.15 WIB. Dia tampak mengenakan pakaian gamis berwarna putih dengan kacamata hitamnya. https://t.co/HB2TlZ7sPT,13,2,3,1,2022-01-03,8,Monday,1,16,3
1477918869171970054,2022-01-03 08:24:51,"BPS mencatat inflasi di Desember 2021 secara month to month mencapai 0,57%. Menariknya, inflasi bulanan ini merupakan rekor tertinggi selama 2 tahun terakhir. https://t.co/f2EKxjdtXZ",6,1,3,2,2022-01-03,8,Monday,1,9,3
1477918366471913475,2022-01-03 08:22:51,"Kecelakaan maut melibatkan enam kendaraan terjadi di Jalan Lingkar Salatiga, Jawa Tengah. Seorang pengendara sepeda motor meninggal dunia. https://t.co/D72UKxCj6C",11,0,5,0,2022-01-03,8,Monday,1,16,0
1477917583831613440,2022-01-03 08:19:45,"Arnold Schwarzenegger dan Maria Shriver akhirnya resmi bercerai. Arnold digugat cerai 10 tahun lalu setelah ketahuan selingkuh dengan ART. Miris, ini kisahnya. https://t.co/aBkkcjexvG",4,1,2,0,2022-01-03,8,Monday,1,6,1
1477916848079441922,2022-01-03 08:16:49,Video Zikri Daulay dan Ayu Aulia ciuman hingga gendong-gendongan di Bali heboh. Sayang keduanya belum mau klarifikasi. https://t.co/BlgsJf5y5c,73,28,12,3,2022-01-03,8,Monday,1,85,31
1477916066265317376,2022-01-03 08:13:43,"Sejumlah selebriti mengaku mengasuh boneka arwah seperti anaknya sendiri, dengan diberi makan dan minum. Apa tanggapan MUI soal fenomena ini? https://t.co/AnUpFeE1TW",32,69,10,22,2022-01-03,8,Monday,1,42,91
1477914102257176577,2022-01-03 08:05:54,"Pada era serba digital ini masyarakat kerap menggunakan marketplace untuk membeli beragam barang kebutuhan mulai dari primer, sekunder, hingga tersier. 

https://t.co/stFEdWzp3O",2,0,1,0,2022-01-03,8,Monday,1,3,0
1477914036985544706,2022-01-03 08:05:39,"Tren kasus COVID-19 di Indonesia dinilai lebih baik ketimbang negara lain, apa rahasianya? Begini ungkapan Luhut. https://t.co/BpfTdcNZWM",8,2,2,1,2022-01-03,8,Monday,1,10,3
1477913306270769152,2022-01-03 08:02:45,"Dinamakan Rediroff, penipuan tersebut beredar di WhatsApp untuk mencuri detail akun bank. Seperti apa? https://t.co/EbVa5RfVDj",13,0,10,1,2022-01-03,8,Monday,1,23,1
1477912366042042370,2022-01-03 07:59:01,Hal ini bentuk aksi yang dilakukan oleh para sopir truk yang menolak penertiban truk obesitas. #Banyuwangi https://t.co/nEUklreeN2,4,0,0,1,2022-01-03,7,Monday,1,4,1
1477912018007044099,2022-01-03 07:57:38,"14 kecamatan di Aceh Utara, Aceh terendam banjir luapan akibat diguyur hujan deras. Banjir menyebabkan satu anak meninggal dunia. #Aceh https://t.co/KpGIhocioS",2,0,1,0,2022-01-03,7,Monday,1,3,0
1477911393420693504,2022-01-03 07:55:09,Pemerintah kembali memperpanjang penerapan PPKM di Jawa-Bali. Masa perpanjangan PPKM Jawa-Bali kali ini selama dua pekan. #PPKM https://t.co/kho4laglQI,5,0,4,2,2022-01-03,7,Monday,1,9,2
1477911382104461314,2022-01-03 07:55:06,Choki berharap polisi memproses kasus ini secara adil. https://t.co/scqQ5BkjjI,2,1,1,0,2022-01-03,7,Monday,1,3,1
1477910861889032195,2022-01-03 07:53:02,Menkes Budi Gunadi menjelaskan persiapan jika terjadi lonjakan kasus COVID-19. Termasuk soal ketersediaan tempat tidur RS dan kebutuhan oksigen. https://t.co/HgYNQSLs4t,2,0,2,0,2022-01-03,7,Monday,1,4,0
1477910376725549056,2022-01-03 07:51:06,PTM akan digelar setiap hari dengan kapasitas 100 persen. #Depok https://t.co/xtELIZBBmp,5,0,2,0,2022-01-03,7,Monday,1,7,0
1477909861853802496,2022-01-03 07:49:03,Deretan para karakter sad boy di drama Korea ini memiliki kisah cinta yang tidak mulus. Mana yang paling ngenes? https://t.co/n4tYH9J0a9,5,0,2,0,2022-01-03,7,Monday,1,7,0
1477909378141462528,2022-01-03 07:47:08,"Video rombongan moge ditilang polisi di BSD, Tangsel ditilang saat sunday morning ride (sunmori) viral di medsos. Begini faktanya. https://t.co/GPMmbQWkQX",8,1,3,0,2022-01-03,7,Monday,1,11,1
1477909364132528129,2022-01-03 07:47:05,"""Ya komplain lah, ada yang mau tukar ke tabung 3 kilo, ya kalau kita mah ngelayanin aja ya. Banyak yang mau beralih ke (LPG) 3 kilo,"" https://t.co/ulvZTLPVhr",8,6,4,1,2022-01-03,7,Monday,1,12,7
1477908853643792386,2022-01-03 07:45:03,Sekolah di Jakarta gelar tatap muka dengan kapasitas 100 persen mulai hari ini. Ada 10 ribu sekolah yang hari ini tatap muka. https://t.co/AwZrzS2l5v,6,0,1,2,2022-01-03,7,Monday,1,7,2
1477908608151179264,2022-01-03 07:44:05,"Bahkan secara nilai, kalau pun besaran gajinya sama tapi nilai yang dapat dinikmati para peneliti Indonesia disebut lebih tinggi. https://t.co/vw8bPJvcVI",4,0,2,0,2022-01-03,7,Monday,1,6,0
1477908178239111172,2022-01-03 07:42:22,PT Pembangunan Jaya Ancol Tbk buka suara soal lahan perusahaan yang akan digunakan sebagai sirkuit Formula E. Ini katanya: https://t.co/e9NjgX9iGi,5,0,1,0,2022-01-03,7,Monday,1,6,0
1477906800699744256,2022-01-03 07:36:54,"BPS mencatat inflasi di Indonesia sepanjang 2021 sebesar 1,87%. Begini data dan faktanya: https://t.co/iZ00aI5Zwq",3,1,1,0,2022-01-03,7,Monday,1,4,1
1477906785449164807,2022-01-03 07:36:50,Airlangga Hartarto menjelaskan alasan dan dampak dari perpanjangan status pandemi COVID-19 di Indonesia. Apa itu? https://t.co/84f915pUxI,1,0,1,0,2022-01-03,7,Monday,1,2,0
1477906542930366466,2022-01-03 07:35:52,Bahar meminta umat Islam hingga ulama terus berjuang menyampaikan kebenaran apabila dia ditahan hari ini. https://t.co/j7ZeR5mLpW,291,229,38,24,2022-01-03,7,Monday,1,329,253
1477906375317463040,2022-01-03 07:35:12,"Tokopedia bersama Pemprov Jawa Tengah mengadakan gerakan #BangkitBersama Jawa Tengah di Semarang.

https://t.co/2ciMoQwDoM",7,0,0,0,2022-01-03,7,Monday,1,7,0
1477906290181562369,2022-01-03 07:34:52,"Menkes menjabarkan kondisi pasien COVID-19 varian Omicron di Indonesia. Disebut-sebut mayoritas tidak bergejala, berapa banyak yang sudah bisa pulang ke rumah? https://t.co/YwCGrp7tTj",8,2,3,0,2022-01-03,7,Monday,1,11,2
1477906057934479363,2022-01-03 07:33:57,"Tokopedia membagikan cerita inspiratif para difabel di balik UMKM, yang telah memanfaatkan teknologi dan berkontribusi terhadap perekonomian digital.

https://t.co/oNhrcwoHU7",3,0,0,0,2022-01-03,7,Monday,1,3,0
1477905800634929153,2022-01-03 07:32:55,"Tokopedia mengajak masyarakat lebih peduli isu sosial serta membantu meningkatkan kesejahteraan masyarakat yang membutuhkan guna mendorong pemulihan ekonomi.

https://t.co/mFNVB6Qd1m",3,0,1,0,2022-01-03,7,Monday,1,4,0
1477905544325345284,2022-01-03 07:31:54,"Visual grup BLACKPINK, Jisoo berulang tahun ke-27. Penasaran skincare yang digunakan pemain drama Korea Snowdrop itu? https://t.co/SkGMSyzHvI",7,0,2,1,2022-01-03,7,Monday,1,9,1
1477905342579175430,2022-01-03 07:31:06,"Product and UX Research Lead Tokopedia Satkar Ulama mengungkapkan dalam menjalankan bisnis, termasuk di industri teknologi maupun media massa, sangat penting untuk mengetahui bagaimana riset yang tepat.

https://t.co/jUDs6Yoqkh",0,0,1,0,2022-01-03,7,Monday,1,1,0
1477905051024650240,2022-01-03 07:29:56,"Usaha Mikro Kecil dan Menengah (UMKM) memiliki kontribusi besar terhadap perekonomian Indonesia. Bahkan UMKM disebut jadi penopang ekonomi nasional saat pandemi COVID-19 melanda.

https://t.co/Z8c8aqwIbV",5,1,2,0,2022-01-03,7,Monday,1,7,1
1477905017101246469,2022-01-03 07:29:48,"Luhut memastikan pemerintah sudah menyiapkan tempat karantina COVID-19. Menurutnya, tempat karantina saat ini jauh lebih bagus. https://t.co/F8lMtIkUoo",6,4,2,1,2022-01-03,7,Monday,1,8,5
1477904805334962176,2022-01-03 07:28:58,"Luhut mengatakan tantangan utama perekonomian di masa pandemi, yaitu digitalisasi UMKM. Hal ini agar pelaku usaha lokal bisa terus beradaptasi dan mempertahankan eksistensi bisnis.

https://t.co/e5SpmlrQNi",5,0,1,0,2022-01-03,7,Monday,1,6,0
1477904443416797184,2022-01-03 07:27:32,"GoTo berupaya meningkatkan daya saing UMKM lokal lewat pemanfaatan teknologi agar mampu menjadi tuan rumah di negeri sendiri.
https://t.co/eLNoAde1dF",6,0,2,0,2022-01-03,7,Monday,1,8,0
1477903776933572608,2022-01-03 07:24:53,"Terpaan COVID-19 pada akhirnya memaksa pelaku usaha UMKM untuk bertransisi secara digital. Salah satunya adalah Verne Indonesia, toko produk kulit yang berasal dari Surabaya.

https://t.co/KpXCdET7UK",7,0,1,1,2022-01-03,7,Monday,1,8,1
1477903716258926592,2022-01-03 07:24:38,Enak banget! Maskapai ini akan menaikkan gaji tiga kali lipat kepada pilotnya. Secara cuma-cuma? https://t.co/Bjh3NdiRLQ,4,0,2,0,2022-01-03,7,Monday,1,6,0
1477903230633918465,2022-01-03 07:22:42,"BPS mencatat inflasi di Desember 2021 secara month to month (mtm) mencapai 0,57%. Sementara inflasi tahunan sepanjang 2021 mencapai 1,87%. https://t.co/sOr7LFxj2A",5,0,1,1,2022-01-03,7,Monday,1,6,1
1477902614306213891,2022-01-03 07:20:16,Pemerintah melalui Kementerian ESDM melarang sementara ekspor batu bara. Ekspor batu bara resmi dilarang dari 1 Januari hingga 31 Januari 2022. https://t.co/S7l2us9TNX,8,0,2,0,2022-01-03,7,Monday,1,10,0
1477902108720517121,2022-01-03 07:18:15,"Di balik otaknya yang cemerlang itu, Einstein juga menyimpan kisah-kisah menarik yang mungkin jarang diceritakan atau diketahui banyak orang. Misalnya...
 https://t.co/5OFPzUeN7n",3,0,0,0,2022-01-03,7,Monday,1,3,0
1477901505932017664,2022-01-03 07:15:51,Kunjungan kerja ini disebut sudah disepakati kedua pihak. https://t.co/dBS78ylwPl,27,24,10,3,2022-01-03,7,Monday,1,37,27
1477900281274896386,2022-01-03 07:10:59,Ada banyak gadget populer yang tinggal kenangan. Sudah pernah pakai yang mana aja nih detikers? https://t.co/W5pnr215ou,8,2,2,2,2022-01-03,7,Monday,1,10,4
1477900260500549632,2022-01-03 07:10:54,"Dari 152 orang itu, 23 persen atau 34 orang di antaranya sudah sembuh. Mereka yang sudah sembuh itu sudah kembali ke rumah masing-masing. https://t.co/NXsYp6SyUc",6,0,4,0,2022-01-03,7,Monday,1,10,0
1477899754738798594,2022-01-03 07:08:54,"Galeri Nasional Indonesia membuat film dokumenter tentang sosok dan proses berkarya seniman kontemporer Indonesia, Heri Dono. https://t.co/uCKmieXBRl",2,0,2,0,2022-01-03,7,Monday,1,4,0
1477899270489624581,2022-01-03 07:06:58,Segregasi adalah pemisahan yang memiliki beragam makna sesuai konteks dan bidang ilmu. Berikut pengertian segregasi dalam sosiologi hingga genetika. https://t.co/3XDU4ZGlfH,2,0,0,0,2022-01-03,7,Monday,1,2,0
1477898965853085697,2022-01-03 07:05:46,"Memasuki tahun 2022, artinya tahun ini akan dilakukan suntik mati TV analog. Kominfo bakal menjalankan migrasi TV analog ke digital. https://t.co/7KpGgohop5",2,0,0,0,2022-01-03,7,Monday,1,2,0
1477898469901848577,2022-01-03 07:03:47,"Ada dua ketentuan untuk karantina untuk pendatang Indonesia dari luar Negeri, yaitu karantina 10 hari dan 14 hari. Bagaimana kerentuannya? Simak nih! https://t.co/yR2lj6yyRZ",3,4,2,0,2022-01-03,7,Monday,1,5,4
1477898202326220800,2022-01-03 07:02:44,"Liverpool tidak mau para pemain Afrikanya buru-buru pulang dari Piala Afrika 2021. Sebab, harus ada yang kembali sebagai juara.  https://t.co/wTA5mqWd3O",3,0,2,0,2022-01-03,7,Monday,1,5,0
1477898200329637893,2022-01-03 07:02:43,"Kontrak Egy Maulana Vikri bersama FK Senica telah berakhir karena cuma dikontrak 6 bulan. Secara teknis, saat ini Egy berstatus tanpa klub. Lanjut di FK Senica?  https://t.co/z8JB5nux7U",37,6,1,1,2022-01-03,7,Monday,1,38,7
1477897958305714177,2022-01-03 07:01:45,Dua warga Surabaya terpapar varian Omicron sepulang berlibur dari Bali. Berikut kronologi selengkapnya. #CNNIndonesia #detikNetwork  https://t.co/v41JiHFFGt,3,1,1,2,2022-01-03,7,Monday,1,4,3
1477897569913249794,2022-01-03 07:00:13,Pemerintah Kota Solo resmi mengoperasikan 8 unit mobil listrik untuk dijadikam menjadi mobil wisatawan keliling Kota Solo. Kedelapan mobil dengan tampilan klasik ini diluncurkan sebagai sarana wisatawan berkeliling kota Solo.  https://t.co/KVBWEXxJCz,5,0,2,0,2022-01-03,7,Monday,1,7,0
1477897324047310851,2022-01-03 06:59:14,"Tahun 2022, banjir menjadi PR dan concern Wali Kota Surabaya Eri Cahyadi. Eri berjanji akan melakukan apapun untuk mencegah banjir. https://t.co/xU9ARo4JmG",4,1,0,0,2022-01-03,6,Monday,1,4,1
1477897313850900484,2022-01-03 06:59:12,Choki melaporkan Edy terkait dugaan pelanggaran dua pasal. Apa saja? https://t.co/QSUkVTXCU6,16,3,2,0,2022-01-03,6,Monday,1,18,3
1477897048217301000,2022-01-03 06:58:08,Korea Selatan melaporkan dua kematian pertama akibat infeksi varian Omicron. Kejadian ini terjadi pada pasien lansia di Gwangju.  https://t.co/krhSoSLfZo,8,1,2,1,2022-01-03,6,Monday,1,10,2
1477897046967390211,2022-01-03 06:58:08,"Ponpes Tajul Alawiyyin, Bogor, milik Habib Bahar bin Smith sempat diteror dengan tiga potongan kepala anjing pada Jumat (31/12) pukul 03.00 WIB. Pengacara Habib Bahar, Aziz Yanuar, menceritakan kronologi kejadian tersebut.  https://t.co/vu0UGTTq7E",4,1,1,0,2022-01-03,6,Monday,1,5,1
1477896043769511937,2022-01-03 06:54:09,"Habib Bahar bin Smith memenuhi panggilan Polda Jawa Barat untuk diperiksa berkaitan dengan kasus ujaran kebencian. Bahar datang bersama tim kuasa hukumnya ke Markas Polda Jabar di Jalan Soekarno-Hatta, Kota Bandung.  https://t.co/zquFRsPxz7",4,1,1,0,2022-01-03,6,Monday,1,5,1
1477895984407527425,2022-01-03 06:53:55,"Di tahun baru, sejumlah harga barang/jasa diprediksi akan mengalami peningkatan. Apa saja? https://t.co/nPueGoHEpD",6,2,1,1,2022-01-03,6,Monday,1,7,3
1477893971401752580,2022-01-03 06:45:55,"Jika ada tagline selangkah dari BSD, Cisauk adalah tempatnya. Daerah ini benar-benar dekat dari kawasan BSD Big City Big Opportunity. Ada apa saja di Cisauk? https://t.co/AW0JdMXnPN",15,0,2,1,2022-01-03,6,Monday,1,17,1
1477893218821935104,2022-01-03 06:42:55,Luhut mengingatkan kunci berkembangnya Omicron di sejumlah negara adalah masalah kedisiplinan. Begini penjelasannya: https://t.co/p7hOBozl9J,5,3,1,0,2022-01-03,6,Monday,1,6,3
1477892696744280066,2022-01-03 06:40:51,"""Saya dilaporkan secepat kilat, sedangkan masih ada penista-penista Allah, penista agama dilaporkan, tidak diproses sama sekali,"" kata Bahar. https://t.co/Uv3EWp6aca",1843,395,388,53,2022-01-03,6,Monday,1,2231,448
1477892694663909376,2022-01-03 06:40:50,"ANS (48), guru silat di Pandeglang, Banten ditetapkan menjadi tersangka usai dilaporkan memperkosa dua muridnya sendiri. Begini sosoknya: https://t.co/aas7HC9XfW",5,0,3,2,2022-01-03,6,Monday,1,8,2
1477891951575941120,2022-01-03 06:37:53,Belum diketahui bagaimana hubungan keduanya. Mereka pun sampai saat ini belum ada yang bisa dimintai komentarnya mengenai hal tersebut. https://t.co/aKhKbF7vTz,4,1,2,0,2022-01-03,6,Monday,1,6,1
1477891413245321218,2022-01-03 06:35:45,Jumlah daerah yang menerapkan PPKM level 1 semakin banyak. Simak rinciannya: https://t.co/0v9micKPBN,5,0,0,0,2022-01-03,6,Monday,1,5,0
1477891098513227776,2022-01-03 06:34:30,Tangan ketiga tersangka diborgol saat melakoni proses rekonstruksi. https://t.co/k5MqGn9NG1,5,0,3,0,2022-01-03,6,Monday,1,8,0
1477890355261546497,2022-01-03 06:31:33,"Masuknya varian Omicron di Indonesia membuat banyak orang kembali sadar pentingnya menggunakan masker. Dari sekain banyak jenis, mana yang terbaik dan terburuk ya? https://t.co/NVw2kNZ8Fo",12,2,10,0,2022-01-03,6,Monday,1,22,2
1477889609384214529,2022-01-03 06:28:35,Pemerintah menggelar rapat terbatas yang salah satu keputusannya mengubah waktu karantina dari luar negeri. Karantina dari luar negeri jadi 10 hari dan 7 hari. https://t.co/KVMOanx6y6,11,1,4,3,2022-01-03,6,Monday,1,15,4
1477888848982069251,2022-01-03 06:25:34,Kementerian Keuangan menaikkan cukai rokok untuk tahun 2022 rata-rata 12%. Namun minimarket belum menyesuaikan label harga. https://t.co/9a2MWR0wun,8,1,1,1,2022-01-03,6,Monday,1,9,2
1477888015267676166,2022-01-03 06:22:15,"Sejumlah bisnis kekinian ini bisa datangkan cuan untuk mahasiswa, padahal cuma butuh modal minim. Sekaligus asah skill profesional juga lho! https://t.co/mzwrdzZMgX",13,0,2,0,2022-01-03,6,Monday,1,15,0
1477887448042684416,2022-01-03 06:20:00,Gudang mebel di Manado terbakar gegara petasan yang diduga dinyalakan oknum polisi saat malam pergantian tahun. Peristiwa ini viral di medsos. https://t.co/sSSlldgTa8,17,1,5,2,2022-01-03,6,Monday,1,22,3
1477886953009913859,2022-01-03 06:18:02,Seorang pria bernama Budiono (61) hilang dan belum ada kabar. Pihak keluarga masih mencari keberadaan Budiono. https://t.co/pXTKJ83GpO,4,0,3,2,2022-01-03,6,Monday,1,7,2
1477886706997157893,2022-01-03 06:17:03,"Di tangan tuner Jepang, DAMD, Suzuki Every disulap tampangnya jadi lebih sangar dengan aplikasi fascia ala Land Rover Defender.  https://t.co/BwSFRbgf6B",26,2,5,3,2022-01-03,6,Monday,1,31,5
1477886696150769669,2022-01-03 06:17:00,Berita soal cara bayar tol tanpa berhenti menjadi berita populer detikOto. Berikut selengkapnya.  https://t.co/toCmiiQsAM,5,0,1,0,2022-01-03,6,Monday,1,6,0
1477886433247510531,2022-01-03 06:15:58,Hyundai Motor Group resmi menyetop pengembangan mesin pembakaran dalam alias Internal Combustion Engine (ICE).  https://t.co/paPjdwafpb,14,0,5,1,2022-01-03,6,Monday,1,19,1
1477886189172633600,2022-01-03 06:14:59,Pengunduran diri PM Hamdok diumumkan setelah militer Sudan menindak secara kasar para demonstran yang memprotes kudeta beberapa hari terakhir. https://t.co/jvGokqMaEv,3,0,0,0,2022-01-03,6,Monday,1,3,0
1477886167613902848,2022-01-03 06:14:54,Berita soal anggota Dishub melakukan pengawalan menjadi salah satu berita populer detikOto kemarin. Berikut selengkapnya.  https://t.co/7gsWe02Ifw,13,3,8,1,2022-01-03,6,Monday,1,21,4
1477885663215247360,2022-01-03 06:12:54,Pemerintah memberlakukan pembelajaran tatap muka yang berlaku mulai Januari 2022. Ini tips agar anak tetap aman dari COVID-19 saat kembali ke sekolah. https://t.co/86FNEnXOVq,5,0,5,0,2022-01-03,6,Monday,1,10,0
1477885642369646592,2022-01-03 06:12:49,"Pada masa libur Natal 2021 dan Tahun Baru 2022 (Nataru), Damri mengumumkan kenaikan jumlah penumpang antar kota dan antar provinsi (AKAP).  https://t.co/R8ftb8ljCe",0,0,0,0,2022-01-03,6,Monday,1,0,0
1477885390212190210,2022-01-03 06:11:49,"Selama libur Natal 2021 dan Tahun Baru 2022, jutaan kendaraan wara-wiri. Angka kecelakaan meningkat.  https://t.co/BhYWvK2NuO",2,0,0,0,2022-01-03,6,Monday,1,2,0
1477885140655300609,2022-01-03 06:10:49,"Sadio Mane dan Edouard Mendy terlibat duel sengit di laga Chelsea vs Liverpool. Setelah itu, keduanya langsung terbang bareng untuk ikut Piala Afrika 2021.  https://t.co/azdT48r4mI",2,1,0,0,2022-01-03,6,Monday,1,2,1
1477885139644555266,2022-01-03 06:10:49,Indonesia berada di urutan ke-40 kasus Omicron dunia. https://t.co/ay0nBRAdEI,17,17,6,4,2022-01-03,6,Monday,1,23,21
1477884890066608128,2022-01-03 06:09:50,Chelsea vs Liverpool sudah selesai dengan hasil imbang 2-2. Manchester City disebut bahagia sebab dua rivalnya cuma berbagi 1 poin.  https://t.co/L9rxiS9zwQ,3,0,0,1,2022-01-03,6,Monday,1,3,1
1477884128733405189,2022-01-03 06:06:48,Flurona belakangan ini menggemparkan Israel. Seorang pasien terinfeksi dua virus sekaligus yakni influenza dan virus Corona. Bagaimana tingkat keparahannya? https://t.co/XwUeMMh2vy,10,5,5,3,2022-01-03,6,Monday,1,15,8
1477883651463553026,2022-01-03 06:04:54,Luna Maya dan Ariel NOAH kali ini menjadi perbincangan. Luna Maya belum lama ini kepergok menyaksikan aksi panggung Ariel NOAH dalam salah satu acara. https://t.co/ImJeiyTp4o,7,0,1,0,2022-01-03,6,Monday,1,8,0
1477883176609632256,2022-01-03 06:03:01,Coki Pardede mengalami perubahan secara fisik usai menjalani rehabilitasi di RSKO Cibubur selama tiga bulan. https://t.co/ZRJxignQvg,2,5,0,0,2022-01-03,6,Monday,1,2,5
1477882527545237505,2022-01-03 06:00:26,Habib Bahar memenuhi panggilan Polda Jawa Barat. Bahar datang didampingi tim kuasa hukumnya. https://t.co/ot09sXk7gn,6,5,3,2,2022-01-03,6,Monday,1,9,7
1477882033275908098,2022-01-03 05:58:29,"Udon merupakan mie Jepang yang tebal kenyal. Kalau biasanya disajikan dengan kuah kaldu yang gurih, kali ini dengan daging sapi berbumbu manis gurih enak. https://t.co/jQuSecl0Qt",22,1,2,0,2022-01-03,5,Monday,1,24,1
1477880818265698305,2022-01-03 05:53:39,"Kabar bahagia di awal 2022 juga datang dari penyanyi Rafael Tan. Belum lama ini dirinya resmi melamar sang kekasih, Sabrina Paz.  https://t.co/cPlmdZ4Wxk",4,1,2,1,2022-01-03,5,Monday,1,6,2
1477880795855527938,2022-01-03 05:53:34,Minibus tanpa trayek atau travel gelap menabrak truk di Tol Cipularang. Satu orang tewas dan lima lainnya luka. https://t.co/jqxF2tcXoP,14,1,5,0,2022-01-03,5,Monday,1,19,1
1477878774041612288,2022-01-03 05:45:32,"Rekonstruksi Lakalantas di Jalan Raya Nagreg-Garut yang menewaskan Handi dan Salsabila digelar Puspomad, Senin ini dan menghadirkan tiga tersangka yang merupakan oknum TNI yakni Kolonel Priyanto, Kopda DA dan Kopda A.  https://t.co/GXIJFNPV8e",3,2,1,0,2022-01-03,5,Monday,1,4,2
1477878322097012739,2022-01-03 05:43:44,#Terpopuler MK menyatakan kebijakan kriminalisasi itu adalah hak DPR-Presiden untuk merumuskannya. Simak penjelasannya: https://t.co/odZaCnJhc0,10,3,1,1,2022-01-03,5,Monday,1,11,4
1477875817510322176,2022-01-03 05:33:47,Luuk de Jong menjadi penentu kemenangan Barcelona atas Mallorca di lanjutan Liga Spanyol. Pemain Belanda itu selalu siap saat dibutuhkan oleh Blaugrana.  https://t.co/qlAlocrC9N,3,0,0,0,2022-01-03,5,Monday,1,3,0
1477875546767958018,2022-01-03 05:32:42,PSSI langsung mengalihkan perhatian ke Piala AFF U-23 2022 setelah beresnya gelaran Piala AFF 2020. Pelatih Shin Tae-yong akan diminta menggelar persiapan.  https://t.co/wyZmRpc7xv,15,0,3,0,2022-01-03,5,Monday,1,18,0
1477875305201209352,2022-01-03 05:31:45,Penuh perjuangan! Pasangan pengantin ini mengarungi banjir dengan naik boat untuk menuju lokasi akad nikah. Seperti apa kisahnya? https://t.co/QW5wHOt7fP,2,0,1,0,2022-01-03,5,Monday,1,3,0
1477875303913603077,2022-01-03 05:31:44,Pelatih Paris Saint-Germain Mauricio Pochettino tak khawatir soal isu masa depan Kylian Mbappe. Mbappe sudah cukup dewasa untuk menanggapinya.  https://t.co/kVqm6LtC9O,2,0,4,0,2022-01-03,5,Monday,1,6,0
1477874538327285767,2022-01-03 05:28:42,Kisah cinta pesepakbola dan wasit di Liga Belanda ini terbilang unik. Asmara berawal dari perjumpaan setelah si pemain bola dikartu merah di sebuah laga.  https://t.co/RGq3XiGQjw,10,0,3,1,2022-01-03,5,Monday,1,13,1
1477874536808914946,2022-01-03 05:28:41,Selada air umumnya hanya dibuat lalapan saja. Kali ini kamu bisa mengolahnya jadi tumisan yang pedas gurih nendang. Cukup dimakan dengan nasi hangat. Mantap! https://t.co/0EK581gFnt,11,0,3,1,2022-01-03,5,Monday,1,14,1
1477873779183345664,2022-01-03 05:25:41,PT Adaro Minerals Indonesia Tbk atau AMI (ADMR) jadi perusahaan yang pertama mencatatkan sahamnya di pasar modal (IPO) tahun 2022 ini. https://t.co/YIOS8AaAg8,4,0,3,0,2022-01-03,5,Monday,1,7,0
1477872745857880067,2022-01-03 05:21:34,Tesla cetak rekor penjualan dan melawan tren penurunan penjualan mobil di seluruh industri karena adanya kekurangan chip komputer dan suku cadang lainnya. https://t.co/fOvPeV2TPv,4,1,1,0,2022-01-03,5,Monday,1,5,1
1477871661408006147,2022-01-03 05:17:16,"Epidemiolog FKM Unair membeberkan 4 ciri utama dari virus COVID-19 terbaru yakni, varian Omicron. Salah satunya, daya tular yang lebih cepat dari varian delta. https://t.co/8rogIzSKMP",17,5,1,2,2022-01-03,5,Monday,1,18,7
1477870898157924355,2022-01-03 05:14:14,Anies Baswedan mengunggah momen bertemu seorang warga bernama Yuni. Anies menyebut Yuni adalah contoh warga berbahagia di kota yang maju. https://t.co/g5fNrd4EvQ,59,36,6,5,2022-01-03,5,Monday,1,65,41
1477870161801666567,2022-01-03 05:11:18,"Apa saja ya nama bayi laki-laki modern 2021 yang sangat disukai tahun ini? Mungkin bisa jadi inspirasimu, coba lihat yuk daftarnya: #NamaBayiLakiLaki https://t.co/KeO0sBHhUm",7,0,1,0,2022-01-03,5,Monday,1,8,0
1477869177876598784,2022-01-03 05:07:24,"Dalam kurun waktu dua bulan terakhir, Elon Musk secara rutin telah menjual sebagian saham Tesla miliknya. Penjualan saham itu untuk membayar utang pajak. https://t.co/onWrTenFnx",10,0,2,0,2022-01-03,5,Monday,1,12,0
1477868188956307460,2022-01-03 05:03:28,Pemerintah berencana menghapus BBM jenis Premium. Penghapusan Premium dilakukan pada tahun ini. Tapi Jokowi baru saja mengeluarkan Perpres terkait Premium. https://t.co/6Rl5LWk8vr,20,1,2,3,2022-01-03,5,Monday,1,22,4
1477867167995633664,2022-01-03 04:59:24,"""Mereka kan kesayangan Laura ya, jadi yang kayak berat adik aku masih nangis, sih. Janos nggak mau ninggalin kamarnya Laura."" https://t.co/sSQoCAz4ET",12,0,1,0,2022-01-03,4,Monday,1,13,0
1477866180383690753,2022-01-03 04:55:29,"Heboh temuan kasus 'Florona' di Israel, terjadi pada ibu hamil. Ia terinfeksi virus influenza dan Corona dalam waktu bersamaan, seperti apa gejalanya? https://t.co/lHln6CC6Ch",14,1,4,4,2022-01-03,4,Monday,1,18,5
1477865419302227969,2022-01-03 04:52:28,COVID-19 Omicron disebut-sebut memiliki gejala yang lebih ringan dibanding varian lain. Studi terbaru mengungkap hal yang bisa jadi penyebabnya. https://t.co/K6UMkRx60R,8,0,3,0,2022-01-03,4,Monday,1,11,0
1477864432575336448,2022-01-03 04:48:32,Cassandra Angelie menjelaskan mengenai tipe pria idamannya. Ia adalah salah satu wanita yang berpikiran realistis dengan melihat kemapanan calon pasangannya. https://t.co/Yk6YNnqZMq,29,15,1,7,2022-01-03,4,Monday,1,30,22
1477863695644565512,2022-01-03 04:45:37,Jokowi mengatakan mayoritas kasus Omicron di Indonesia berasal dari luar negeri. Jokowi meminta aparat untuk mengawasi soal karantina. https://t.co/WxeCNPKuK4,9,2,1,2,2022-01-03,4,Monday,1,10,4
1477863444795858946,2022-01-03 04:44:37,Romelu Lukaku dicap arogan dan rapuh lantaran mengeluhkan kondisinya saat ini di Chelsea. Big Rom padahal baru enam bulan berada di Stamford Bridge musim ini.  https://t.co/jjS65mLxIR,3,0,1,0,2022-01-03,4,Monday,1,4,0
1477863443705249793,2022-01-03 04:44:37,"Tahun baru, semangat baru! Suami ingin alih profesi jadi pengusaha, tapi dananya belum ada? Jangan khawatir, detikcom bantu modalin. Begini cara dapatnya: https://t.co/qj2nBwDaWx",7,1,2,0,2022-01-03,4,Monday,1,9,1
1477862790912167938,2022-01-03 04:42:01,"Kamu pernah dengar Kota Nikosia? Kota ini jadi unik karena 'terbelah'. Ya, secara fisik, kota ini sengaja dibagi menjadi dua bagian. https://t.co/Ol1yW9sqD6",10,0,4,0,2022-01-03,4,Monday,1,14,0
1477862094221496324,2022-01-03 04:39:15,Presiden Jokowi menetapkan aturan baru mengenai distribusi dan harga jual BBM jenis RON 88. Rencana penghapusan premium pada 2022 pun terancam batal. https://t.co/17LuLWDBuM,12,5,1,0,2022-01-03,4,Monday,1,13,5
1477861604133908485,2022-01-03 04:37:18,Pengumuman! Jakarta Smart City membuka lowongan kerja gede-gedean sampai besok (4/1/2022). Ada 21 posisi yang dibuka untuk tenaga ahli. Cek di sini. https://t.co/rhzDBDM2pk,8,0,6,1,2022-01-03,4,Monday,1,14,1
1477861086724562945,2022-01-03 04:35:15,"Asisten Manajer Liverpool, Pepijn Lijnders, cukup puas timnya imbang dengan Chelsea. Pasalnya, Liverpool ke markas Chelsea dengan diterpa badai COVID-19.  https://t.co/mLQJo8mPjN",6,0,0,0,2022-01-03,4,Monday,1,6,0
1477861068596813828,2022-01-03 04:35:10,Viral anak sultan yang mendapat hadiah ulang tahun berupa mobil mewah. Orang tuanya menjabat sebagai sekdes. Gajinya berapa sih? https://t.co/1G30pDTPRR,95,47,18,8,2022-01-03,4,Monday,1,113,55
1477860802057146370,2022-01-03 04:34:07,Timnas Indonesia sudah dinanti banyak agenda di 2022 setelah menuntaskan Piala AFF 2020. Menariknya ada pula Piala AFF yang akan digelar pada akhir tahun 2022.  https://t.co/M3T7s7pJEZ,10,0,1,0,2022-01-03,4,Monday,1,11,0
1477860800912109569,2022-01-03 04:34:06,Adanya toko online memudahkan untuk berbelanja kebutuhan. Tapi terkadang ekpektasi dan realita barang yang dibeli bikin ngelus dada. Hiks... https://t.co/it15aF78rr,6,1,1,0,2022-01-03,4,Monday,1,7,1
1477860293757837320,2022-01-03 04:32:06,Jokowi menceritakan momen mengerikan pandemi Covid-19 di Indonesia pada Juli 2021. Jokowi pun kini bersyukur kasus Covid-19 di awal tahun 2022 yang telah melandai.  https://t.co/Sj9deJX4Op,7,0,1,0,2022-01-03,4,Monday,1,8,0
1477860014463279107,2022-01-03 04:30:59,"Dalam novel Layangan Putus dikisahkan, istri kedua Aris minta maaf ke Kinan. Lalu, kenapa ia keberatan dicap sebagai perebut laki orang alias pelakor? #detikNetwork  https://t.co/Vd2WD4uEV1",10,0,2,1,2022-01-03,4,Monday,1,12,1
1477859268913160193,2022-01-03 04:28:01,"Jokowi membuka perdagangan saham Bursa Efek Indonesia pada Senin (3/1) pagi. Jokowi menyampaikan kinerja Indeks Harga Saham Gabungan (IHSG) yang menguat 10,1% sepanjang 2021.  https://t.co/Z2ug8MLoJH",3,0,1,0,2022-01-03,4,Monday,1,4,0
1477858503717015552,2022-01-03 04:24:59,"Timnas Indonesia sudah tiba di Jakarta, Minggu (2/1/2022). Mereka langsung menjalani karantina 10 hari dan bakal absen di seri 4 BRI Liga 1 2021.  https://t.co/vFgo7ZiaLr",14,0,1,0,2022-01-03,4,Monday,1,15,0
1477858257544826884,2022-01-03 04:24:00,Liverpool mendapat ujian berat dalam persaingan Premier League musim ini. Beberapa penggawa Merseyside Merah absen akibat terpapar virus Corona.  https://t.co/uHhvJ0u0Cq,3,0,0,1,2022-01-03,4,Monday,1,3,1
1477858104255602690,2022-01-03 04:23:23,Ricky Kambuaya tak tergantikan di lini tengah Timnas Indonesia di Piala AFF 2020. Kini dia bicara soal kans merumput di luar negeri!   https://t.co/Nsrkb1gQRy,8,0,1,1,2022-01-03,4,Monday,1,9,1
1477857423868182529,2022-01-03 04:20:41,Berikut jadwal Piala AFF U-23 2022 yang mulai main bulan depan. Timnas Indonesia akan tampil sebagai juara bertahan.  https://t.co/2CWAUDF3PF,4,0,3,1,2022-01-03,4,Monday,1,7,1
1477857408164802567,2022-01-03 04:20:38,"Pengamat top MotoGP Carlo Pernat meyakini, Honda akan menggaet Joan Mir untuk musim 2023. Marc Marquez diprediksi akan melewatkan dua tes musim dingin.  https://t.co/8mqZ5JtJuk",3,0,1,0,2022-01-03,4,Monday,1,4,0
1477857154371571713,2022-01-03 04:19:37,Dispatch kembali mengungkap pasangan selebriti di awal tahun. Kali ini Hyomin T-ara dikabarkan berpacaran dengan pesepakbola Hwang Ui Jo. https://t.co/aq81qnQLxG,27,0,2,0,2022-01-03,4,Monday,1,29,0
1477857134914252800,2022-01-03 04:19:32,Barcelona mengawali tahun 2022 dengan kemenangan di kandang Real Mallorca. Hasil ini sangat penting untuk Barcelona yang memburu empat besar.   https://t.co/ETfIM6sJKa,4,0,1,0,2022-01-03,4,Monday,1,5,0
1477856394879680514,2022-01-03 04:16:36,Hasil seri Chelsea vs Liverpool membuat Manchester City makin nyaman bertengger di puncak klasemen Liga Inggris. City kini unggul 10 angka dari Chelsea.  https://t.co/ncZYoumla3,0,1,1,0,2022-01-03,4,Monday,1,1,1
1477856112888143876,2022-01-03 04:15:29,"Kubu Chelsea kesal karena Sadio Mane cuma dikartu kuning usai menyikut Cesar Azpilicueta. Namun, Jordan Henderson percaya Mane tak punya niat itu.  https://t.co/oB0ojuHlSF",0,1,0,0,2022-01-03,4,Monday,1,0,1
1477856111592157184,2022-01-03 04:15:28,Snowdrop mencuri perhatian karena menampilkan akting Jisoo BLACKPINK. Ini 7 hal menarik tentang Jisoo Blackpink yang kini jadi bintang Snowdrop. Sudah tahu? https://t.co/HjKWhAN8nf,27,1,9,0,2022-01-03,4,Monday,1,36,1
1477855368730619906,2022-01-03 04:12:31,Jenazah Nindy Ellesse Laoh bakal dikebumikan di san Diego Hills. https://t.co/Pt954eJJD0,5,0,2,1,2022-01-03,4,Monday,1,7,1
1477854387749928960,2022-01-03 04:08:37,"Selain Meta, ada Apple, Microsoft, sampai Google yang akan meluncurkan produk hardware ataupun software untuk Metaverse. https://t.co/b0Au60Rg8Y",12,0,6,0,2022-01-03,4,Monday,1,18,0
1477853384677941248,2022-01-03 04:04:38,"Umumnya perayaan Tahun Baru dirayakan lebih dulu oleh masyarakat di Australia. Hanya menuju tahun 2022, negara kepulauan ini merayakan lebih dulu. https://t.co/B1A3JVJ8Cg",4,0,2,0,2022-01-03,4,Monday,1,6,0
1477852612238184453,2022-01-03 04:01:34,"Ekspor komoditas batu bara dilarang untuk sementara di awal tahun 2022. Batu bara bakal disetop untuk ekspor selama sebulan, mulai 1-31 Januari. https://t.co/QhDvlTv11R",17,1,3,0,2022-01-03,4,Monday,1,20,1
1477851514026799109,2022-01-03 03:57:12,Warga Belanda kembali turun ke jalan menggelar demo memprotes pembatasan terkait virus Corona. Demo tersebut berlangsung ricuh. https://t.co/RjSGggtf11,34,5,7,1,2022-01-03,3,Monday,1,41,6
1477850778165514246,2022-01-03 03:54:17,#Foto Istri gubernur Florida ini jadi sorotan. Dia kini berjuang melawan kanker payudara yang dideritanya. Seperti ini potretnya.... https://t.co/plthkZVfbc,6,0,4,0,2022-01-03,3,Monday,1,10,0
1477849745817317376,2022-01-03 03:50:11,"Kementerian Kesehatan Arab Saudi mengumumkan, kasus COVID-19 sudah menyentuh angka di atas 1000 per harinya. Lantas, bagaimana nasib soal haji dan umrah? https://t.co/HJjtsHrw5u",8,0,2,1,2022-01-03,3,Monday,1,10,1
1477848749821112322,2022-01-03 03:46:13,"Kali ini, program pengampunan pajak memiliki nama baru, yaitu Program Pengungkapan Sukarela (PPS) Wajib Pajak. Begini cara daftarnya: https://t.co/teuDzSbVMQ",7,2,2,0,2022-01-03,3,Monday,1,9,2
1477847757926850563,2022-01-03 03:42:17,"Lebih lanjut, pelaku penelantaran pendaki dalam open trip ke Gunung Rinjani ini harus mengembalikan sejumlah uang. Totalnya mencapai Rp 34 juta. https://t.co/IO8sP69KfC",14,0,2,1,2022-01-03,3,Monday,1,16,1
1477846277325045769,2022-01-03 03:36:24,Dua warga Surabaya dinyatakan terpapar Corona varian Omicron. Keduanya kini dirawat di salah satu rumah sakit di Surabaya. https://t.co/rmPoqAgL3I,4,0,3,1,2022-01-03,3,Monday,1,7,1
1477844033913425925,2022-01-03 03:27:29,"Meski sudah berganti tahun, Baim Wong rupanya ingin terus jadi orang baik. Salah satu caranya adalah membuka rumah makan gratis. https://t.co/hNU2CH92JC",102,32,7,5,2022-01-03,3,Monday,1,109,37
1477843238082027522,2022-01-03 03:24:19,"Momen liburan akhir tahun di tengah pandemi memang bikin harap-harap cemas. Diketahui sedang liburan, superstar sepakbola Lionel Messi positif COVID-19. https://t.co/Fo9FX1T2a4",9,0,0,0,2022-01-03,3,Monday,1,9,0
1477842414731776010,2022-01-03 03:21:03,"Gara-gara sistem bubble, 4 pemain Timnas Indonesia dilarang bermain di final leg 2 piala AFF 2020, Sabtu (1/1/2022). Sistem apa sih itu? https://t.co/sbkqYHwQud",10,1,1,0,2022-01-03,3,Monday,1,11,1
1477841675967995908,2022-01-03 03:18:07,"Simak ya Pisces, aturan yang sudah disepakati jangan kamu langgar jika tak ingin kena masalah di kemudian hari. Yuk, lihat kata zodiak lainnya: https://t.co/9qaBZ7o0RK",2,0,0,0,2022-01-03,3,Monday,1,2,0
1477840440426696710,2022-01-03 03:13:12,Kita sering menemukan hewan laut yang terdampar di pantai. Ternyata ada beberapa penyebab umum fenomena ini. https://t.co/CNcrTP9tEZ,8,0,0,0,2022-01-03,3,Monday,1,8,0
1477839689067466752,2022-01-03 03:10:13,Dalam memilih skincare harus memperhatikan komposisi yang ada. Salah satunya yaitu kandungan steroid. Berikut adalah penjelasannya. https://t.co/2nCk53yPDh,2,0,3,0,2022-01-03,3,Monday,1,5,0
1477839180159930370,2022-01-03 03:08:12,Penutupan Bandara Halim Perdanakusuma tidak jadi dilakukan pada 1 Januari 2022. Rencana penutupan akan dilakukan dalam rangka revitalisasi. https://t.co/yP2fZBSk2x,8,0,1,2,2022-01-03,3,Monday,1,9,2
1477838176936996866,2022-01-03 03:04:12,"Kamu hanya perlu melihat gambar di bawah ini dan katakan gambar apa yang pertama kali kamu lihat? Jika sudah, cocokkan jawabannya ya. #TesKepribadian https://t.co/2UkUYMJS8I",3,0,0,0,2022-01-03,3,Monday,1,3,0
1477837290563149828,2022-01-03 03:00:41,Seorang penumpang berulah pada akhir November lalu. Dia dituntut atas penyerangan pramugari Spirit Airlines dan berakhir di penjara. Haduh! https://t.co/cuKHQa9W3k,14,1,1,0,2022-01-03,3,Monday,1,15,1
1477836285607825408,2022-01-03 02:56:42,Seorang anggota polisi jadi korban pengeroyokan oleh sejumlah orang tidak dikenal. Hal ini terjadi saat korban mencoba melerai keributan. https://t.co/sao4GcFwEd,5,0,0,0,2022-01-03,2,Monday,1,5,0
1477835296435752961,2022-01-03 02:52:46,"Di Desa Ngreden, Wonosari, Klaten tidak hanya terdapat makam Ki Ageng Perwito. Di sana ada kue legondo dan intip goreng yang hanya dijual pada hari Kamis. https://t.co/u5cW5NZbPr",6,1,0,0,2022-01-03,2,Monday,1,6,1
1477834801923215367,2022-01-03 02:50:48,Harga logam mulia hari ini naik Rp 7.000. Mau beli emas? Jadi segini harganya: https://t.co/mt8CxHtWw3,9,1,1,0,2022-01-03,2,Monday,1,10,1
1477833810955939845,2022-01-03 02:46:52,"Kopi tak hanya dapat dinikmati sebagai minuman saja, tapi juga menyimpan beragam manfaat bagi kesehatan. Ini kata ahli: https://t.co/3R9Q82YaSh",7,1,2,0,2022-01-03,2,Monday,1,9,1
1477832328521076737,2022-01-03 02:40:58,Presiden Jokowi mengungkap momen mengerikan pandemi COVID-19 di Indonesia pada Juli 2021 hingga kini melandai. Seperti apa ceritanya? https://t.co/7uNaaWQI8x,1,1,0,0,2022-01-03,2,Monday,1,1,1
1477832327250206724,2022-01-03 02:40:58,#Terpopuler Seorang pria berinisial DI jadi tersangka karena menikam pria diduga begal hingga tewas. Polisi menjelaskan. https://t.co/1Zh6FxMQlW,2,0,1,1,2022-01-03,2,Monday,1,3,1
1477831291571691527,2022-01-03 02:36:51,"Saat tiba giliran Emma Watson, muncul sebuah foto anak kecil memakai bando telinga Minnie Mouse. Hanya saja, anak di foto itu bukan Emma Watson. Waduh... https://t.co/c2fd2N6Iov",4,1,0,0,2022-01-03,2,Monday,1,4,1
1477830032752005123,2022-01-03 02:31:51,Sukses di lapangan sayangnya Chanathip Songkrasin belum berhasil dalam kehidupan percintaan. Ia pernah ingin menikah tapi mendapat tentangan orangtua. https://t.co/tLY8X5m8sg,20,8,2,5,2022-01-03,2,Monday,1,22,13
1477827725314375685,2022-01-03 02:22:41,Seorang tersangka diketahui kabur dari sel di Polres Metro Bekasi dan ditemukan tewas di sungai. Simak kronologinya: https://t.co/K5z2ChWQ9n,21,8,3,1,2022-01-03,2,Monday,1,24,9
1477825996367831045,2022-01-03 02:15:48,Kasus COVID-19 di Arab Saudi kembali naik ke angka di atas 1.000 untuk pertama kalinya sejak Agustus silam. https://t.co/y60kHbF57t,6,2,1,1,2022-01-03,2,Monday,1,7,3
1477824647190167555,2022-01-03 02:10:27,"Kemenkes RI kembali menemukan dua kasus transmisi lokal varian Omicron. Kali ini, ditemukan di Surabaya. Begini kronologinya. https://t.co/x57uGQ2ezC",4,2,1,2,2022-01-03,2,Monday,1,5,4
1477824512263692291,2022-01-03 02:09:55,Saya hanya mempunyai ahli waris seorang anak angkat. Bagaimana pembagian warisnya? #detiksAdvocate https://t.co/Gg3r8SX5w1,5,2,2,1,2022-01-03,2,Monday,1,7,3
1477823769372680192,2022-01-03 02:06:57,Gubernur Lemhannas Agus Widjojo mengusulkan agar Polri berada di bawah Kementerian. Usulan ini disorot. https://t.co/YSarQXu0yT,16,6,3,1,2022-01-03,2,Monday,1,19,7
1477823527743074304,2022-01-03 02:06:00,PM Israel Naftali Bennett mengumumkan vaksinasi Covid-19 ke-4 untuk lansia dan tenaga kesehatan. Hal ini didasari lantaran varian omicron terus menyebar.  https://t.co/gmaOEXxX5f,3,0,1,0,2022-01-03,2,Monday,1,4,0
1477822535106543618,2022-01-03 02:02:03,Lesti Kejora melahirkan sampai Cassandra Angelie terjerat prostitusi. Berikut round up sepekan ini: https://t.co/pY6OZHKQTX,2,1,0,0,2022-01-03,2,Monday,1,2,1
1477821444155490308,2022-01-03 01:57:43,Percayakah detikers jika ada seorang pria yang telah memiliki belasan istri hingga ratusan anak? Jika tidak maka yuk kenalan dengan sosok Misheck Nyandoro! https://t.co/63XxQMPsU8,5,0,0,0,2022-01-03,1,Monday,1,5,0
1477819963603881987,2022-01-03 01:51:50,Adelia Zizi menyambut tahun baru dengan suka cita. Kehadirannya selalu menuai pujian dari para pengikut di Instagram. https://t.co/S4ZiRrbfS0 https://t.co/sywJuzL5eE,10,1,3,0,2022-01-03,1,Monday,1,13,1
1477818672282583042,2022-01-03 01:46:42,"Konten video YouTube lama Gaga Muhammad diunggah ulang. Dalam video itu, Gaga Muhammad minum-minum sambil bicara soal kehidupan. https://t.co/hk9z3cgfHX",17,8,3,2,2022-01-03,1,Monday,1,20,10
1477817101700239368,2022-01-03 01:40:28,Kasus dugaan penelantaran puluhan pendaki di Gunung Rinjani akibat ulah operator perjalanan wisata diselesaikan secara damai. https://t.co/gM19jKTQrU,23,6,1,0,2022-01-03,1,Monday,1,24,6
1477815866741846017,2022-01-03 01:35:33,Anak Ayu Azhari kembali jadi sorotan. Kali ini Axel Djody Gondokusumo jadi korban sebuah keributan. https://t.co/IjFZxcqS7Q,10,0,0,0,2022-01-03,1,Monday,1,10,0
1477814868027846660,2022-01-03 01:31:35,"Barcelona memetik kemenangan tipis atas Mallorca 1-0. Bek tengah Barcelona Eric Garcia mengatakan, kemenangan itu bisa didapat berkat Marc-Andre ter Stegen.  https://t.co/aJaWdDs4mT",9,0,0,0,2022-01-03,1,Monday,1,9,0
1477814601391689731,2022-01-03 01:30:32,Gol tunggal Luuk de Jong membawa Barcelona menang tipis 1-0 atas tuan rumah Real Mallorca. Berkat kemenangan ini Barcelona kini merangsek ke 5 besar.  https://t.co/6vdlq6dYOn,6,0,0,0,2022-01-03,1,Monday,1,6,0
1477814600167047172,2022-01-03 01:30:31,"Asa Coast Railway menciptakan sebuah kendaraan yang bisa dikendarai di dua jalur berbeda, yakni jalan raya dan rel kereta api. Seperti apa ya wujudnya?  https://t.co/KhSe2yFBCx",6,1,1,0,2022-01-03,1,Monday,1,7,1
1477814346889801729,2022-01-03 01:29:31,Barcelona mengawali tahun 2022 dengan kemenangan di kandang Real Mallorca. Hasil ini sangat penting untuk Barcelona yang memburu empat besar.  https://t.co/wypVHlnKgU,5,0,0,0,2022-01-03,1,Monday,1,5,0
1477813849973735426,2022-01-03 01:27:32,Seorang pria asal Finlandia merasa kecewa karena harga komponen baterai Tesla yang mahal sampai ratusan juta. Kenapa baterai mahal?  https://t.co/69kJ9nutpC,19,3,2,1,2022-01-03,1,Monday,1,21,4
1477813584990289923,2022-01-03 01:26:29,Sudah sampai mana persiapan Mandalika Grand Prix Association (MGPA) dalam menyambut gelaran MotoGP Mandalika 2022 yang akan digelar pada Maret ini?  https://t.co/jtatr0xo9t,11,0,0,0,2022-01-03,1,Monday,1,11,0
1477813306702417929,2022-01-03 01:25:23,"Meski diyakini menyebabkan gejala ringan, varian Omicron diketahui bisa menimbulkan reinfeksi. Lalu bagaimana mengatasinya? Ini kata dokter. https://t.co/PF5WhWQmom",5,0,2,0,2022-01-03,1,Monday,1,7,0
1477813283851747333,2022-01-03 01:25:17,Sekitar 30 perusahaan rintisan Prancis memamerkan teknologi terbaru di CES Unveiled. Salah satunya perangkat portabel pendeteksi Covid-19 oleh Start-up Grapheal yang diklaim mampu mendeteksi virus dengan sangat cepat.  https://t.co/9yDz6ofdz7,3,1,0,0,2022-01-03,1,Monday,1,3,1
1477812774323503110,2022-01-03 01:23:16,"Mandalika Grand Prix Association (MGPA) tengah menyiapkan MotoGP Mandalika 2022. Namun media asing meragukan MotoGP di Indonesia akan dapat digelar tahun ini, lantaran birokrasi negara yang menyulitkan. Apa tanggapan MGPA?  https://t.co/8R7094ZNjQ",4,2,0,1,2022-01-03,1,Monday,1,4,3
1477812043239600130,2022-01-03 01:20:22,"Pembakaran mobil pada malam tahun baru seakan menjadi kebiasaan di Prancis. Padahal, Prancis telah melarang aksi pembakaran mobil saat merayakan tahun baru.  https://t.co/ErWbCx2lVq",8,0,0,1,2022-01-03,1,Monday,1,8,1
1477812023820001283,2022-01-03 01:20:17,Mobil listrik mungil Wuling Hongguang Mini EV menjadi salah satu kendaraan listrik paling laku di China. Mobil ini dites tabrak. Ini hasilnya.  https://t.co/aD3rmHuqxQ,5,1,0,0,2022-01-03,1,Monday,1,5,1
1477811759184596992,2022-01-03 01:19:14,"Bagi kamu yang meninggalkan sepeda motor di rumah selama liburan, jangan lupa untuk melakukan perawatan saat ingin digunakan kembali untuk beraktivitas.  https://t.co/cbOksIIYvT",1,0,0,0,2022-01-03,1,Monday,1,1,0
1477811757733326855,2022-01-03 01:19:14,Kabar duka di awal 2022 menyelimuti dunia hiburan Tanah Air. Penyanyi senior Nindy Ellesse Laoh meninggal dunia. https://t.co/VVrBuMafr8,9,1,1,0,2022-01-03,1,Monday,1,10,1
1477811259387129857,2022-01-03 01:17:15,"Media asing meragukan MotoGP di Indonesia akan dapat digelar tahun ini, lantaran birokrasi negara yang 'menyulitkan'. Apa tanggapan MGPA?  https://t.co/wF9EfHFbmI",139,56,32,11,2022-01-03,1,Monday,1,171,67
1477810418102018048,2022-01-03 01:13:54,MGPA mengatakan kapasitas penonton yang disediakan untuk MotoGP 2022 lebih besar ketimbang saat WSBK. Total MGPA menyiapkan 60 ribu tiket per harinya.  https://t.co/AKCwC3xyZ5,9,0,1,1,2022-01-03,1,Monday,1,10,1
1477809275011571714,2022-01-03 01:09:22,"#terpopuler Bek muda Indonesia, Pratama Arhan, diprediksi akan jadi pemain top Asia. Eks pemain Singapura, Baihakki Khaizan, yang mengungkapkan pendapat itu.  https://t.co/aI9Tsv88VA",27,0,2,0,2022-01-03,1,Monday,1,29,0
1477809026125774848,2022-01-03 01:08:22,#terpopuler PT Suzuki Indomobil Sales (SIS) mengumumkan pembaruan motor ikonik All New Satria F150. Ini potretnya:   https://t.co/g2rqiii1US,7,5,0,1,2022-01-03,1,Monday,1,7,6
1477807244150517763,2022-01-03 01:01:17,"Prakirawan BMKG melaporkan afanya fenomena sirkulasi siklonik di Papua Barat. Simak penjelasan selengkapnya prakiraan cuaca yang berlaku untuk Senin, 3 Januari 2022.  https://t.co/7Oa2huI3Nf",1,0,0,2,2022-01-03,1,Monday,1,1,2
1477807243055742978,2022-01-03 01:01:17,Margarito Kamis angkat bicara ihwal polemik ambang batas pencalonan presiden atau presidential threshold yang digugat sejumlah pihak ke MK. https://t.co/irC7gGGNKg,1,2,0,0,2022-01-03,1,Monday,1,1,2
1477806482548826114,2022-01-03 00:58:16,"Masuknya varian Omicron di Indonesia membuat banyak orang kembali sadar pentingnya menggunakan masker. Dari sekain banyak jenis, mana yang terbaik dan terburuk? https://t.co/YV6lSFs7ga",2,0,0,0,2022-01-03,0,Monday,1,2,0
1477805996055707648,2022-01-03 00:56:20,Pemkab Klaten mulai mengizinkan pelaksanaan pembelajaran tatap muka (PTM) terbatas setiap hari. PTM diizinkan mulai Senin 3 Januari 2022. https://t.co/p0QWXD6shv,3,0,0,0,2022-01-03,0,Monday,1,3,0
1477805719558754305,2022-01-03 00:55:14,Protes pengunjuk rasa anti-kudeta militer di sudan kembali berlangsung di Khartoum. Pasukan keamanan menembakkan gas air mata untuk membubarkan massa. https://t.co/BiqGiIvndX,1,0,0,0,2022-01-03,0,Monday,1,1,0
1477805490776285185,2022-01-03 00:54:19,"Bek sekaligus kapten Chelsea Cesar Azpilicueta tidak puas dengan keputusan wasit terkait pelanggaran Sadio Mane. Menurut dia, Mane seharusnya dikartu merah.  https://t.co/yVeaL2f3v7",8,0,0,0,2022-01-03,0,Monday,1,8,0
1477805489475964932,2022-01-03 00:54:19,"Gelombang-3 COVID-19 sempat dikhawatirkan terjadi awal 2022 dipicu momen Nataru. Ditambah kini varian Omicron merebak, masih mungkinkah gelombang-3 dicegah? https://t.co/MBd4itKuKj",10,3,0,0,2022-01-03,0,Monday,1,10,3
1477805364968099843,2022-01-03 00:53:49,"Anggota Dinas Perhubungan (Dishub) Kota Bekasi, Dede Fakhrudin Suhendi, nekat melawan arus lalu lintas di Simpang Gadog, Bogor. Disebutkan, anggota Dishub Kota Bekasi itu tengah mengawal kenalan pejabat!  https://t.co/aR7mJ5FaHf",7,5,0,1,2022-01-03,0,Monday,1,7,6
1477805225943646211,2022-01-03 00:53:16,Romelu Lukaku semakin menunjukkan iktikad untuk kembali ke Inter Milan. Striker Chelsea itu menampilkan nama Nerazzurri pada biodata Facebook pribadinya.  https://t.co/XjafecFQTa,8,8,1,1,2022-01-03,0,Monday,1,9,9
1477804999384174592,2022-01-03 00:52:22,Laga big match Chelsea vs Liverpool berlangsung sengit di Stamford Bridge. The blues harus puas bermain imbang dengan Skor 2-2.  https://t.co/dndSWkbFBc,1,0,0,0,2022-01-03,0,Monday,1,1,0
1477804709041815557,2022-01-03 00:51:13,Barcelona memetik poin sempurna dalam laga tandang ke markas Real Mallorca. Blaugrana menang 1-0 berkat gol tunggal Luuk de Jong.  https://t.co/UHGmHDAh2o,5,0,0,0,2022-01-03,0,Monday,1,5,0
1477804690175926275,2022-01-03 00:51:09,"Edinson Cavani semakin santer dikaitkan dengan kepergian dari Manchester United di bursa musim dingin. Ralf Rangnick menegaskan, Cavani akan bertahan!  https://t.co/z56fm00yIY",3,0,0,0,2022-01-03,0,Monday,1,3,0
1477804464526565379,2022-01-03 00:50:15,Pemerintah mengevaluasi Pemberlakuan Pembatasan Kegiatan Masyarakat (PPKM) yang akan berakhir hari ini. Berikut data COVID-19 selama sepekan. https://t.co/3JiTBjQeT7,2,0,1,0,2022-01-03,0,Monday,1,3,0
1477804443169079296,2022-01-03 00:50:10,Real Madrid mengawali tahun dengan kekalahan di markas Getafe. Carlo Ancelotti menilai Madrid kalah karena kurang konsentrasi.  https://t.co/unqnkYFoWv,2,0,0,2,2022-01-03,0,Monday,1,2,2
1477803975122558980,2022-01-03 00:48:18,Nama Romelu Lukaku dicoret dari skuad Chelsea di laga melawan Liverpool. Thomas Tuchel mengakui keputusan ini berkaitan dengan wawancara kontroversial Lukaku.  https://t.co/i3Eyq9XDo5,5,1,0,0,2022-01-03,0,Monday,1,5,1
1477803964825489419,2022-01-03 00:48:16,Bek Liverpool Virgil van Dijk percaya Manchester City kini tanpa pesaing dalam perburuan gelar Premier League. Menyusul hasil seri duel Chelsea vs Liverpool.  https://t.co/8V77xlWWAF,3,0,0,0,2022-01-03,0,Monday,1,3,0
1477803714085896196,2022-01-03 00:47:16,Seorang tahanan kasus pencabulan kabur dari rutan Polres Metro Bekasi Kota. Kompolnas meminta pengamanan kembali lebih diperkuat. https://t.co/1DGsDE4Sjs,2,0,0,0,2022-01-03,0,Monday,1,2,0
1477803693600874496,2022-01-03 00:47:11,Wawancara Romelu Lukaku berujung pencoretan dari skuad Chelsea di laga melawan Liverpool. Thomas Tuchel tak menjamin Lukaku akan segera kembali ke tim.  https://t.co/cvfHwqiaOc,2,0,0,0,2022-01-03,0,Monday,1,2,0
1477803184085159937,2022-01-03 00:45:09,"VR46 Racing Team mendapat sponsor baru dari perusahaan Italia, Mooney. Tim balap milik Valentino Rossi itu pun resmi berganti nama di musim baru 2022.  https://t.co/WHd537RYnn",9,1,0,0,2022-01-03,0,Monday,1,9,1
1477803170378268676,2022-01-03 00:45:06,#Terpopuler Mohammad Ahsan hingga Kevin Sanjaya Sukamuljo mengunggah di media sosial soal bonus Rp 10 miliar Piala Thomas 2020. Isinya berupa sindiran?  https://t.co/mYjbxUmyed,21,0,4,1,2022-01-03,0,Monday,1,25,1
1477802679594278913,2022-01-03 00:43:09,"Sebelas petenis putra dari berbagai daerah akan mengikuti seleksi nasional di lapangan tenis Gelora Bung Karno, mulai Senin (3/1/2022).  https://t.co/eQ0VAu856k",2,0,0,0,2022-01-03,0,Monday,1,2,0
1477802667833536513,2022-01-03 00:43:06,Jakarta BNI 46 diperkuat oleh pemain-pemain nasional dan asing profesional. Pemain asing yang diboyong kali ini berasal dari Kuba dan Jepang.  https://t.co/BLFsulKTug,6,0,1,0,2022-01-03,0,Monday,1,7,0
1477801835058667525,2022-01-03 00:39:48,"Bonus Rp 10 miliar dari Pemerintah, melalui Kemenpora, sedang jadi polemik. Ada persepsi berbeda dari atlet tim Piala Thomas Indonesia dan PBSI.  https://t.co/urMFSRAd13",29,3,2,7,2022-01-03,0,Monday,1,31,10
1477801122144342017,2022-01-03 00:36:58,"Peleburan Eijkman ke dalam BRIN justru untuk memperkuat eksistensi, kapasitas, sumber daya, dan pendanaan lembaga tersebut. https://t.co/gF65xnWIlF",6,3,0,4,2022-01-03,0,Monday,1,6,7
1477799455692931076,2022-01-03 00:30:21,Moin D. Habib bin Habib Muhammad (41) melarikan diri dari Rumah Detensi Imigrasi (Rudenim) Surabaya dengan menerobos pintu gerbang terekam kamera!   https://t.co/Z8LlZjUTpc,6,0,0,1,2022-01-03,0,Monday,1,6,1
1477799339724525569,2022-01-03 00:29:53,Israel mendeteksi kasus pertama Florona. Florona diyakini sebagai infeksi ganda Covid-19 dan influenza.  https://t.co/kJr1oRuVJQ,155,124,67,142,2022-01-03,0,Monday,1,222,266
1477799108756791299,2022-01-03 00:28:58,Nama Romelu Lukaku dicoret dari skuad Chelsea di laga melawan Liverpool. Thomas Tuchel mengakui keputusan ini berkaitan dengan wawancara kontroversial Lukaku. https://t.co/T6YgvAlR8w,3,0,0,0,2022-01-03,0,Monday,1,3,0
1477799087265222657,2022-01-03 00:28:53,Sirkuit Formula E Jakarta di Ancol bakal dibangun di lahan bekas pembuangan lumpur. Begini kondisinya.  https://t.co/EQb6c0jcNL,2,0,0,1,2022-01-03,0,Monday,1,2,1
1477798841252560906,2022-01-03 00:27:54,"Demonstrasi antilockdown di jalanan Kota Amterdam, Belanda berujung ricuh. Massa terlibat aksi saling dorong hingga adu jotos dengan polisi.  https://t.co/vmih73ipN8",2,1,2,0,2022-01-03,0,Monday,1,4,1
1477798580983406595,2022-01-03 00:26:52,Protes pengunjuk rasa anti-kudeta militer di sudan kembali berlangsung di Khartoum. Pasukan keamanan menembakan gas air mata untuk membubarkan massa.  https://t.co/tHvmpghC65,4,0,3,0,2022-01-03,0,Monday,1,7,0
1477798359742271492,2022-01-03 00:25:59,Anggota DPR RI menilai konsumen prostitusi artis bisa dihukum tanpa menunggu Rancangan KUHP disahkan. Sebab konsumen berperan membantu melakukan tindak pidana. https://t.co/cSEsYtfiAD,6,1,5,1,2022-01-03,0,Monday,1,11,2
1477798337856389121,2022-01-03 00:25:54,Paris Saint-Germain mengumumkan Lionel Messi bersama tiga pemain lainnya dinyatakan positif Covid-19. Kini keempat pemain tersebut tengah menjalani isolasi.  https://t.co/2QVi6wovNF,6,0,1,1,2022-01-03,0,Monday,1,7,1
1477797623012671488,2022-01-03 00:23:04,"Sejumlah gadis remaja di Pinrang, Sulawesi Selatan rela menjadi buruh panggul semen demi membantu ekonomi keluarga. Mereka tidak segan-segan melakoni pekerjaan yang biasa dilakukan oleh kaum pria!  https://t.co/8gyYa47kwc",25,0,6,2,2022-01-03,0,Monday,1,31,2
1477797607615442953,2022-01-03 00:23:00,Peleburan Tim Waspada COVID-19 dari Lembaga Eijkman (WASCOVE) ke BRIN menuai pro-kontra. Mereka yang kontra mempertanyakan nasib para peneliti di Eijkman. https://t.co/XBJB98y7fQ,2,0,2,0,2022-01-03,0,Monday,1,4,0
1477797101409128449,2022-01-03 00:20:59,Bek Liverpool Virgil van Dijk percaya Manchester City kini tanpa pesaing dalam perburuan gelar Premier League. Menyusul hasil seri duel Chelsea vs Liverpool. https://t.co/rNZHGOETwn,3,0,0,0,2022-01-03,0,Monday,1,3,0
1477796831908319239,2022-01-03 00:19:55,"Jembatan penyebrangan Cihampelas di Kabupaten Bandung Barat ambruk, Minggu (2/2). Sejumlah pemotor terperosok saat melintas di jembatan tersebut.  https://t.co/uPM0u1dsY8",15,3,2,0,2022-01-03,0,Monday,1,17,3
1477796355418505217,2022-01-03 00:18:01,Diskursus pidana bagi konsumen prostitusi kembali mengemuka selepas kasus prostitusi yang melibatkan pesinetron Cassandra Angelie terbongkar. https://t.co/cRyP96J0VL,18,5,1,0,2022-01-03,0,Monday,1,19,5
1477795859697971201,2022-01-03 00:16:03,IDAI memperbaharui rekomendasi tentang Pembelajaran Tatap Muka (PTM) di tengah munculnya varian Omicron di Indonesia. Apa syaratnya jika ingin PTM 100 persen? https://t.co/pKTnzQWbGB,7,0,2,1,2022-01-03,0,Monday,1,9,1
1477795120036651009,2022-01-03 00:13:07,"Puncak arus balik libur Nataru terjadi di jalur selatan Nagreg-Cileunyi, Kabupaten Bandung, Jawa Barat. Sejumlah kendaraan memadati ruas jalan tersebut. https://t.co/rOn3ubCKhB",2,0,0,0,2022-01-03,0,Monday,1,2,0
1477794138129158150,2022-01-03 00:09:13,"Inggris merayakan awal tahun 2022 dengan kabar kurang mengenakkan. Di hari pertama tahun 2022, Inggris mencatat rekor kasus baru Covid-19. https://t.co/a7xPxTkuS9",10,0,2,0,2022-01-03,0,Monday,1,12,0
1477792279733616644,2022-01-03 00:01:50,Masyarakat Cianjur diresahkan dengan beredarnya isu pelaku penculikan yang berkeliaran dan mencari korban anak-anak. Polisi pastikan hoaks. https://t.co/LvEd7BuXvS,2,0,0,0,2022-01-03,0,Monday,1,2,0
1477791187469754377,2022-01-02 23:57:29,Puncak arus balik tampak di sejumlah wilayah saat hari terakhir libur tahun baru. Kepadatan terjadi Jalur Selatan Nagreg-Cileunyi. https://t.co/XYvIoK6m5D,6,0,2,1,2022-01-02,23,Sunday,7,8,1
1477790445530976256,2022-01-02 23:54:32,"Banyak yang meyakini posisi bercinta bisa menentukan jenis kelamin anak yang dihasilkan. Ternyata cuma mitos, ini yang sebenarnya lebih berpengaruh. https://t.co/zwse5BAqtG",2,0,0,0,2022-01-02,23,Sunday,7,2,0
1477789854406782977,2022-01-02 23:52:11,Satgas COVID-19 Kabupaten Bogor menolak izin pelaksanaan zikir akbar dan milad Front Persaudaraan Islam di Masjid At-Ta'awun. Namun acara itu tetap digelar. https://t.co/TaGD5yXNIe,60,46,9,8,2022-01-02,23,Sunday,7,69,54
1477788660015804417,2022-01-02 23:47:27,"Lionel Messi dinyatakan positif terjangkit virus Corona. Kondisi terkini La Pulga diungkapkan pelatih Paris Saint-Germain, Mauricio Pochettino. Apa katanya? https://t.co/MapGfo7lIx",8,2,1,1,2022-01-02,23,Sunday,7,9,3
1477787915942080519,2022-01-02 23:44:29,"Hujan deras mengguyur Gunung Wilis di Kabupaten Kediri, pada siang hingga sore tadi. Sehingga, sungai di Kecamatan Mojo meluap dan menerjang jembatan antardusun https://t.co/A7JJDIpOAW",9,0,4,1,2022-01-02,23,Sunday,7,13,1
1477786933371846660,2022-01-02 23:40:35,Lembaga Eijkman mengunggah foto bersama para peneliti yang pernah bekerja di lembaga itu. Mereka berpamitan. https://t.co/SZ6kuy6exq,26,0,5,1,2022-01-02,23,Sunday,7,31,1
1477785932279562242,2022-01-02 23:36:36,"""Iya. Benar besok (hari ini) kita akan memenuhi panggilan Polda Jabar,"" ujar pengacara Habib Bahar Smith, Ichwan Tuankotta. https://t.co/Vp3vZJEVJj",19,6,2,1,2022-01-02,23,Sunday,7,21,7
1477784921360023556,2022-01-02 23:32:35,"Satu dari dua wisatawan yang terseret ombak Pantai Suwuk, Kebumen, Jawa Tengah berhasil ditemukan dalam keadaan meninggal dunia. https://t.co/1NxhEeDlAd",6,0,2,0,2022-01-02,23,Sunday,7,8,0
1477784381913714694,2022-01-02 23:30:27,Habib Rizieq Shihab (HRS) dan Habib Bahar bin Smith turut didoakan dalam zikir akbar dan milad Front Persaudaraan Islam. Simak selengkapnya. https://t.co/GncrJq5oPI,68,5,12,2,2022-01-02,23,Sunday,7,80,7
1477783640079753229,2022-01-02 23:27:30,"Polisi menangkap seorang pria inisial IW (25) terkait kasus pencurian HP di sebuah kos di daerah Muara Angke, Jakut. Pelaku nekat mencuri HP milik penghuni kos. https://t.co/EoDGiMOvva",8,0,0,1,2022-01-02,23,Sunday,7,8,1
1477782651176366083,2022-01-02 23:23:34,"Ketua Fraksi Gerindra Ahmad Muzani mendukung larangan ekspor batu bara. Menurutnya, hal itu demi memenuhi kebutuhan listrik secara nasional. https://t.co/zXRkeIsYEp",9,0,3,0,2022-01-02,23,Sunday,7,12,0
1477781648326508549,2022-01-02 23:19:35,"Seorang WN Malaysia, Rahena, menjadi korban kapal karam di perairan Batu Payung Tawau, Sabah, Malaysia, yang diduga terseret ke perairan Indonesia. https://t.co/kId2FZ4ZUK",4,0,1,0,2022-01-02,23,Sunday,7,5,0
1477779890573357056,2022-01-02 23:12:36,"Gempa berkekuatan magnitudo (M) 5,0 mengguncang Halmahera Barat, Maluku Utara atau Malut. Gempa tidak berpotensi tsunami. https://t.co/WB28cg15rp",12,1,1,2,2022-01-02,23,Sunday,7,13,3
1477778844224528384,2022-01-02 23:08:26,Real Madrid mengawali tahun dengan kekalahan di markas Getafe. Carlo Ancelotti menilai Madrid kalah karena kurang konsentrasi. https://t.co/augi2UmoE2,4,0,0,0,2022-01-02,23,Sunday,7,4,0
1477777606485450753,2022-01-02 23:03:31,Pandemi Corona belum juga berakhir. Presiden Jokowi pun memperpanjang status pandemi COVID-19 untuk menindaklanjuti perintah Mahkamah Konstitusi (MK). https://t.co/O7wk1UfpEn,8,2,4,0,2022-01-02,23,Sunday,7,12,2
1477777376432033795,2022-01-02 23:02:36,Seorang warga Korea Selatan yang tak diketahui identitasnya menerobos masuk ke Korea Utara melalui perbatasan. Ini informasinya. https://t.co/7qruhkxSWB,6,3,1,1,2022-01-02,23,Sunday,7,7,4
1477776077359665154,2022-01-02 22:57:27,"Tindakan tegas Polres Ciamis menjatuhkan sanksi kepada 12 restoran, cafe dan bar di kawasan wisata Kampung Turis Pantai Pangandaran ampuh memberikan efek jera. https://t.co/aBd1ShMOQ3",8,0,2,0,2022-01-02,22,Sunday,7,10,0
1477775071087312906,2022-01-02 22:53:27,"Sebanyak lima orang ASN yang bertugas di Kantor Bupati Nagan Raya Aceh, mendapatkan sanksi berupa penundaan pembayaran tunjangan karena menolak divaksin. https://t.co/7IZPG2GVOu",18,3,2,1,2022-01-02,22,Sunday,7,20,4
1477774089318195205,2022-01-02 22:49:33,Arus balik libur Nataru dari wilayah Garut mulai terjadi petang ini. Kendaraan dari kawasan perkotaan mengarah Bandung memadati gerbang keluar Garut. https://t.co/TV5iUzjKKK,8,0,0,0,2022-01-02,22,Sunday,7,8,0
1477773096392212480,2022-01-02 22:45:36,"Edinson Cavani semakin santer dikaitkan dengan kepergian dari Manchester United di bursa musim dingin. Ralf Rangnick menegaskan, Cavani akan bertahan. https://t.co/DyDZ2soxnf",3,0,0,0,2022-01-02,22,Sunday,7,3,0
1477772099171328003,2022-01-02 22:41:38,Barcelona memetik poin sempurna dalam laga tandang ke markas Real Mallorca. Blaugrana menang 1-0 berkat gol tunggal Luuk de Jong. https://t.co/k4YTfNLAiu,2,0,0,0,2022-01-02,22,Sunday,7,2,0
1477771119134482435,2022-01-02 22:37:45,"Zikir akbar dan milad Front Persaudaraan Islam (FPI) selesai di pelataran Masjid At-Ta'awun, Bogor, selesai dilaksanakan. Massa yang hadir membubarkan diri. https://t.co/t6wsGGgWuC",59,23,4,2,2022-01-02,22,Sunday,7,63,25
1477770619584487427,2022-01-02 22:35:46,Komnas KIPI memastikan sejauh ini belum ada kasus meninggal dunia karena vaksinasi COVID-19. Sejauh ini tercatat 363 KIPI serius yang terjadi terkait vaksinasi. https://t.co/LlghBIIEqh,2,1,1,0,2022-01-02,22,Sunday,7,3,1
1477769135178362884,2022-01-02 22:29:52,Polri dinilai memiliki kontribusi di luar fungsi utamanya dalam menjaga keamanan dan ketertiban masyarakat https://t.co/FIrB6Djnfc,9,0,1,0,2022-01-02,22,Sunday,7,10,0
1477767345506603015,2022-01-02 22:22:45,"""Harapan saya jangan sampai mengalami kemunduran setelah diintegrasikan ke dalam BRIN,"" kata anggota Komisi VII DPR RI, Dyah Roro Esti. https://t.co/G64IhkBHjt",12,3,2,0,2022-01-02,22,Sunday,7,14,3
1477767122700967938,2022-01-02 22:21:52,"Bupati Sukabumi memonitor sejumlah lokasi wisata di kawasan Pantai Citepus, Karang Hawu dan Pantai Cibangban, Minggu (2/1/2022) sore. https://t.co/cWqThSUy6N",2,0,0,0,2022-01-02,22,Sunday,7,2,0
1477765635304300547,2022-01-02 22:15:57,Menteri BUMN Erick Thohir mengunjungi kampung ikonik di Surabaya. Yaitu Kampung Lawas Maspati dan Kampung Kuno. https://t.co/b935FTLuFU,9,2,0,0,2022-01-02,22,Sunday,7,9,2
1477764651605762050,2022-01-02 22:12:03,Arus balik libur Nataru dari wilayah Garut mulai terjadi petang ini. Kendaraan dari kawasan perkotaan mengarah Bandung memadati gerbang keluar Garut. https://t.co/68rhbITPoN,4,0,0,0,2022-01-02,22,Sunday,7,4,0
1477763741278257154,2022-01-02 22:08:26,Sebuah backdrop bertulisan 'Ariza Kamu Tidak Sendiri' terpampang di acara Alumni Resimen Mahasiswa (Menwa). Panitia pun memberikan penjelasan. https://t.co/kuDFuYFuoh,7,1,0,0,2022-01-02,22,Sunday,7,7,1
1477762266867113992,2022-01-02 22:02:34,"Polresta Cirebon, Jawa Barat, memberlakukan rekayasa lalu lintas terhadap kendaraan besar bersumbu tiga, seperti truk dan lainnya. https://t.co/bQbbHHkkdz",1,0,0,0,2022-01-02,22,Sunday,7,1,0
1477761199492288516,2022-01-02 21:58:20,Romelu Lukaku semakin menunjukkan iktikad untuk kembali ke Inter Milan. Striker Chelsea itu menampilkan nama Nerazzurri pada biodata Facebook pribadinya. https://t.co/BB2n7cE6de,8,2,2,2,2022-01-02,21,Sunday,7,10,4
1477760209695219716,2022-01-02 21:54:24,Ketua DPD RI LaNyalla Mahmud Mattalitti tetap memberikan apresiasi. https://t.co/VyXl8JrSba,23,4,7,0,2022-01-02,21,Sunday,7,30,4
1477758215035265029,2022-01-02 21:46:28,BMKG mengeluarkan prakiraan cuaca di DKI Jakarta hari ini. Seluruh wilayah DKI Jakarta diprediksi cerah berawan hari ini. https://t.co/7CPedYaG6V,2,0,0,0,2022-01-02,21,Sunday,7,2,0
1477757498627178496,2022-01-02 21:43:37,"Arus kendaraan yang keluar Jateng via Tol Pejagan-Pemalang, Brebes, di hari kedua tahun 2022 meningkat. Diprediksi puncak arus balik Nataru terjadi hari ini. https://t.co/9nmwa7azBc",3,0,0,0,2022-01-02,21,Sunday,7,3,0
1477756504086396936,2022-01-02 21:39:40,"""Masyarakat sudah semakin cerdas, semakin baik, bisa bekerja sama. Tentu semuanya sesuai dengan prestasi yang ada,"" kata Ahmad Riza Patria. https://t.co/1kfjbYAURD",11,1,0,0,2022-01-02,21,Sunday,7,11,1
1477754773772414977,2022-01-02 21:32:48,"Wali Kota Surabaya Eri Cahyadi menyebut, ada 2 warganya yang kena COVID-19 varian Omicron. Mereka merupakan satu keluarga yang pulang liburan dari Bali. https://t.co/xyTVHN5Z14",9,4,3,2,2022-01-02,21,Sunday,7,12,6
1477752269206654976,2022-01-02 21:22:50,"Seorang remaja di Matang Kuli, Kabupaten Aceh Utara, dilaporkan meninggal dunia setelah terseret banjir yang melanda wilayah tersebut. https://t.co/lmIgaaiavd",5,1,0,0,2022-01-02,21,Sunday,7,5,1
1477750544089456644,2022-01-02 21:15:59,"Jembatan penyebrangan Cihampelas di Kabupaten Badung Barat ambruk, Minggu (2/2). Sejumlah pemotor terperosok saat melintas di jembatan tersebut. https://t.co/ZstlNjXgzE",6,0,0,0,2022-01-02,21,Sunday,7,6,0
1477750325276774414,2022-01-02 21:15:07,"Arus lalu lintas adi Tol Cipali arah Jakarta, Kabupaten Cirebon, Jawa Barat, alami peningkatan. Kepadatan kendaraan terjadi di pintu Tol Palimanan. https://t.co/0jY4TQl2CP",3,0,0,0,2022-01-02,21,Sunday,7,3,0
1477749081422413828,2022-01-02 21:10:10,"Satu rombongan wisatawan yang terdiri dari tujuh orang terseret ombak Pantai Suwuk, Kebumen, Jawa Tengah. Lima orang berhasil diselamatkan, dua lainnya hilang. https://t.co/FgsNR0qa4P",4,0,2,0,2022-01-02,21,Sunday,7,6,0
1477747807696134150,2022-01-02 21:05:07,"Polisi memberlakukan sistem one way di Puncak untuk kendaraan yang mengarah ke Jakarta. Akibatnya, lalu lintas dari Masjid At-Taawun sampai Puncak Pass macet. https://t.co/6UQoZxXz7o",4,0,0,0,2022-01-02,21,Sunday,7,4,0
1477746548717113357,2022-01-02 21:00:07,"Bek sekaligus kapten Chelsea Cesar Azpilicueta tidak puas dengan keputusan wasit terkait pelanggaran Sadio Mane. Menurut dia, Mane seharusnya dikartu merah. https://t.co/e0v0NwHYeE",10,0,0,0,2022-01-02,21,Sunday,7,10,0
1477745448274251782,2022-01-02 20:55:44,"Kasus Covid-19 kembali melonjak di Kota Xi'an China Warga dilarang keluar rumah membeli makanan, hingga mereka kesulitan memperoleh makanan pokok. https://t.co/AVnEGGnwmz",12,0,5,3,2022-01-02,20,Sunday,7,17,3
1477744404429512707,2022-01-02 20:51:35,"Kompolnas mengapresisi kinerja kepolisian di bawah kepemimpinan Kapolri Jenderal Sigit. Menurut Kompolnas, Polri kini responsif dan transparan. https://t.co/4aGNxt1lPm",5,1,0,0,2022-01-02,20,Sunday,7,5,1
1477743412765933570,2022-01-02 20:47:39,"Seni kriya logam Tumang ditetapkan sebagai warisan budaya tak benda. Kerajinan itu ternyata sudah ada di Dukuh Tumang, Boyolali, sejak ratusan tahun yang lalu. https://t.co/7Qptm4I2YC",10,0,1,0,2022-01-02,20,Sunday,7,11,0
1477742175245029385,2022-01-02 20:42:44,Jalur utara Sukabumi mengalami kepadatan. Hal itu dampak dari pengalihan arus kendaraan dari Cianjur menuju Jakarta melalui Jonggol dan Sukabumi. https://t.co/TQripCIWTI,5,1,0,0,2022-01-02,20,Sunday,7,5,1
1477740188700975104,2022-01-02 20:34:50,"Gubernur Jawa Tengah Ganjar Pranowo mengungkapkan, meningkatnya indeks kebahagiaan masyarakat itu semua karena masyarakat sendiri. https://t.co/Yb1kqewmqv",16,7,2,0,2022-01-02,20,Sunday,7,18,7
1477739183737294850,2022-01-02 20:30:51,Jakarta BNI 46 diperkuat oleh pemain-pemain nasional dan asing profesional. Pemain asing yang diboyong kali ini berasal dari Kuba dan Jepang. https://t.co/v9T5e3FNpd,1,0,0,0,2022-01-02,20,Sunday,7,1,0
1477736951683899400,2022-01-02 20:21:58,Seorang deteni Rudenim Surabaya di Kabupaten Pasuruan kabur dengan menabrak gerbang menggunakan mobil. Deteni itu warga negara (WN) Palestina. https://t.co/qKNzeMqt5t,1,3,0,0,2022-01-02,20,Sunday,7,1,3
1477735710845292545,2022-01-02 20:17:03,"Arus lalu lintas menuju obyek wisata Lembang, Bandung Barat dari arah Kota Bandung masih terpantau cukup ramai. https://t.co/0jVafMn76e",3,0,0,0,2022-01-02,20,Sunday,7,3,0
1477734398669819909,2022-01-02 20:11:50,Pengetahuan Jan Ethes Srinarendra akan nama-nama pemimpin dunia 'diuji' hari ini. Seperti apa momennya? https://t.co/afBeppqV3V,11,0,5,0,2022-01-02,20,Sunday,7,16,0
1477732902326657034,2022-01-02 20:05:53,"Kasus dugaan penelantaran puluhan pendaki di Gunung Rinjani, Pulau Lombok, NTB, akibat ulah salah satu agen perjalanan wisata diselesaikan secara damai. https://t.co/LbWbc5hXdU",4,0,0,0,2022-01-02,20,Sunday,7,4,0
1477732881543970824,2022-01-02 20:05:48,"BPBD Kabupaten Bungo, Jambi, mencatat ada 4.923 KK yang terdampak banjir besar. Tim gabungan diterjunkan ke lokasi terdampak untuk mengevakuasi warga. https://t.co/RV1taAh8fN",2,0,0,0,2022-01-02,20,Sunday,7,2,0
1477731597445210117,2022-01-02 20:00:42,"Real Madrid memulai 2022 dengan kekalahan di markas Getafe 0-1. Hasil itu tidak lepas dari kesalahan Eder Militao, yang disoroti Casemiro. https://t.co/SRbwDB5Hln",1,0,0,0,2022-01-02,20,Sunday,7,1,0
1477731080950190085,2022-01-02 19:58:39,Gubernur Lembaga Ketahanan Nasional (Lemhannas) Agus Widjojo mengusulkan dibentuknya Kementerian Keamanan Dalam Negeri dan Dewan Keamanan Nasional. https://t.co/b1dUt5vAbv,4,17,2,2,2022-01-02,19,Sunday,7,6,19
1477729554173210631,2022-01-02 19:52:35,IDAI mengeluarkan rekomendasi terbaru terkait pembelajaran tatap muka (PTM) di sekolah untuk anak selama pandemi COVID-19. Berikut rinciannya. https://t.co/UvWzucUcFV,3,1,1,0,2022-01-02,19,Sunday,7,4,1
1477728550069456896,2022-01-02 19:48:35,KAI Commuter mencatat ada 124 juta orang yang menggunakan layanan kereta rel listrik (KRL) Jabodetabek dan Yogyakarta-Solo sepanjang 2021. https://t.co/UPU4WwqwSk,2,0,1,1,2022-01-02,19,Sunday,7,3,1
1477727059875090446,2022-01-02 19:42:40,Fenomena spirit doll semakin ramai dibahas usai beberapa selebriti mengaku merawatnya seperti anaknya sendiri. Apakah ini termasuk gangguan kejiwaan? https://t.co/SRJLh6mkvZ,20,34,3,4,2022-01-02,19,Sunday,7,23,38
1477725336137785351,2022-01-02 19:35:49,"Satgas Penanganan COVID-19 Kabupaten Bogor menolak permohonan izin dari panitia zikir akbar dan milad Front Persaudaraan Islam di Masjid At-Ta'awun, Cisarua. https://t.co/f9A8RJPUbW",3,2,0,1,2022-01-02,19,Sunday,7,3,3
1477723778893426694,2022-01-02 19:29:38,"""Jadi alhamdulillah serapan 2021 mencapai 88,22 persen. Memang tidak mencapai 91 persen,"" kata Wakil Gubernur DKI Jakarta, Ahmad Riza Patria. https://t.co/hhvMGmZfpI",5,1,1,2,2022-01-02,19,Sunday,7,6,3
1477722295649157133,2022-01-02 19:23:44,Perdebatan viral antara Habib Bahar dan Danrem 061 Surya Kendcana Brigjen Achmad menyinggung isu abuse to power. Kedua pihak saling bersitegang. https://t.co/VDgDxbdusC,3,4,0,1,2022-01-02,19,Sunday,7,3,5
1477721544822558725,2022-01-02 19:20:45,Arus kendaraan menuju Jakarta di Tol Jakarta-Cikampek padat. Kakorlantas Irjen Firman Shantyabudi mengatakan pihaknya menambah ruas jalan contraflow di Km 65-47 https://t.co/rWlXg7mdFC,2,0,0,0,2022-01-02,19,Sunday,7,2,0
1477720312896708614,2022-01-02 19:15:51,Tidak ada pemenang dalam big match Chelsea vs Liverpool. Kedua tim harus puas berbagi angka setelah berimbang dengan skor akhir 2-2. https://t.co/ntT7qJN377,10,0,0,0,2022-01-02,19,Sunday,7,10,0
1477719566151208964,2022-01-02 19:12:53,"Polisi memberlakukan one way di kawasan Puncak, Bogor untuk kendaraan yang mengarah ke Jakarta. Lalu lintas dari Masjid At-Taawun sampai Puncak Pass macet. https://t.co/eMndiynVuX",17,1,0,1,2022-01-02,19,Sunday,7,17,2
1477717981316669446,2022-01-02 19:06:36,"Banyak sekali faktor yang bikin pria ejakulasi dini, salah satunya depresi. Namun tak perlu khawatir, ini ada 7 cara mengatasi ejakulasi dini yang bisa dicoba. https://t.co/zF8qzCQnji",20,1,9,0,2022-01-02,19,Sunday,7,29,1
1477716388848541698,2022-01-02 19:00:16,Kemenkes mencatat dua penambahan kasus Omicron. Dua kasus baru ini adalah penularan lokal varian Omicron yang terdeteksi di Surabaya. https://t.co/c8dA8OOfGx,9,5,2,0,2022-01-02,19,Sunday,7,11,5
1477713664476160004,2022-01-02 18:49:26,"Politikus PDIP Rahmad Handoyo menilai peleburan Eijkman ke BRIN tak perlu dipersoalkan. Sebab, menurutnya, Eijkman hanya berpindah induk. https://t.co/kgm7Yfm1jN",8,4,3,2,2022-01-02,18,Sunday,7,11,6
1477712182313996291,2022-01-02 18:43:33,Kasus penelantaran puluhan pendaki Gunung Rinjani menjadi sorotan. Polisi bergerak melakukan penyelidikan https://t.co/PRsGuRkumh,22,0,1,0,2022-01-02,18,Sunday,7,23,0
1477711080000524308,2022-01-02 18:39:10,India kembali mengalami peningkatan tajam kasus Covid selama 5 hari berturut-turut. Hari ini India melaporkan lebih dari 27.000 kasus harian Covid-19. https://t.co/FuODdCGM2B,7,2,4,3,2022-01-02,18,Sunday,7,11,5
1477709806077202436,2022-01-02 18:34:06,"Indonesia mencatat sebanyak 174 kasus baru COVID-19, Minggu (2/1/2022). DKI menyumbang kasus terbanyak dengan jumlah 103. https://t.co/V03DnJY28n",7,2,1,1,2022-01-02,18,Sunday,7,8,3
1477708234169655296,2022-01-02 18:27:52,Israel baru-baru ini melaporkan kasus pertama 'Florona' yang terjadi di negaranya. Berikut beberapa fakta soal 'Florona' yang perlu diketahui. https://t.co/66GhTFFKOI,56,27,24,27,2022-01-02,18,Sunday,7,80,54
1477706223713755137,2022-01-02 18:19:52,"Zikir akbar dan milad Front Persaudaraan Islam digelar di pelataran Masjid At-Ta'awun. Dijaga ketat petugas TNI-Polri, massa memadati acara tersebut. https://t.co/8d0LaMRmGr",22,9,1,3,2022-01-02,18,Sunday,7,23,12
1477704985211285510,2022-01-02 18:14:57,"Penyelenggara pesta yang sajikan tari erotis di Rembang, Jawa Tengah, akhirnya dijatuhi sanksi. Sanksi berupa denda senilai Rp 1 juta. https://t.co/9wP84fbQb8",9,6,0,0,2022-01-02,18,Sunday,7,9,6
1477703708226031625,2022-01-02 18:09:53,Atletico Madrid mengawali tahun baru dengan hasil positif di Liga Spanyol. Los Colchoneros menang 2-0 atas Rayo Vallecano via brace Angel Correa. https://t.co/kr3LHJfAku,3,0,1,0,2022-01-02,18,Sunday,7,4,0
1477701668686942212,2022-01-02 18:01:46,Kemenkes melaporkan adanya dua kasus baru transmisi lokal varian Omicron yang terdeteksi di Surabaya. Bagaimana kondisinya dan apa saja gejalanya? https://t.co/wNDnVZKssR,1,2,3,0,2022-01-02,18,Sunday,7,4,2
1477700108401664007,2022-01-02 17:55:34,Gubernur Lemhannas Agus Widjojo mengusulkan dibentuknya Kementerian Keamanan Dalam Negeri. Dasco menilai usul ini perlu kajian secara mendalam. https://t.co/a0yVyDuXvh,5,4,1,0,2022-01-02,17,Sunday,7,6,4
1477698738747584519,2022-01-02 17:50:08,"Romelu Lukaku menyatakan keinginan kembali ke Inter Milan. Namun, Nerazzurri kini hanya fokus ke skuad yang ada sekarang dan tak mau terjebak masa lalu. https://t.co/OnO0sHIad8",3,2,0,2,2022-01-02,17,Sunday,7,3,4
1477697467965710337,2022-01-02 17:45:05,Yuk latih otak kamu agar bisa lancar memecahkan masalah. Teka-teki ini bisa membuktikan apakah kamu jenius. https://t.co/fhuY2hxJJl,383,309,54,10,2022-01-02,17,Sunday,7,437,319
1477695941046112257,2022-01-02 17:39:01,Seorang bocah inisial H (7) tewas tenggelam di kolam renang wisata di Kabupaten Purbalingga. Polisi turun tangan dan memasang police line di lokasi kejadian. https://t.co/5taaC7yUeU,5,0,1,0,2022-01-02,17,Sunday,7,6,0
1477694453087408129,2022-01-02 17:33:06,"Kepala Dinkes Jatim, Dr Erwin Astha Triyonno mengumumkan COVID-19 varian Omicron di Jawa Timur. Ia juga menjelaskan riwayat perjalanan dari pasien Omicron itu. https://t.co/QNCImc6qUi",6,1,6,1,2022-01-02,17,Sunday,7,12,2
1477688590440497152,2022-01-02 17:09:48,"Sebanyak 12 kecamatan di Kabupaten Bungo, Jambi, terendam banjir. Ketinggian banjir ada yang mencapai 1,5 meter akibat tingginya curah hujan. https://t.co/22bWVXecVt",8,1,4,0,2022-01-02,17,Sunday,7,12,1
1477684486204702724,2022-01-02 16:53:30,"Selama delapan tahun, seorang pria mencari hard disk berisi 7.500 Bitcoin di tumpukan sampah. Nilainya Rp 5 triliun! https://t.co/4DHn5hOGuv",35,7,9,2,2022-01-02,16,Sunday,7,44,9
1477683470839259139,2022-01-02 16:49:28,"Warga di Desa Paku, Kabupaten Polewali Mandar, Provinsi Sulawesi Barat menutup akses ke Tempat Pembuangan Akhir sampah. Warga kesal dengan pencamaran lingkungan dan masalah kesehatan yang dikeluhkan. https://t.co/0Mi2jtVKAs",10,1,1,0,2022-01-02,16,Sunday,7,11,1
1477681832653201411,2022-01-02 16:42:57,"Banjir bandang terjadi Padang Lawas (Palas), Sumatera Utara (Sumut). Akibatnya rumah warga dan sekolah rusak berat. https://t.co/ckSE8bxcVy",14,1,3,1,2022-01-02,16,Sunday,7,17,2
1477681605871296512,2022-01-02 16:42:03,BMW 320i Dynamic hadir jadi sedan termurah yang saat ini resmi dijual oleh BMW Indonesia.   https://t.co/lVKUsa8PLY,33,3,5,1,2022-01-02,16,Sunday,7,38,4
1477680352562929667,2022-01-02 16:37:04,Sejumlah relawan di Kota Pahlawan kembali menggelar deklarasi mendukung Erick Thohir jadi capres 2024. Mereka dari Relawan Kerja Erick Thohir (Raket) Merdeka. https://t.co/hcgVThLqZp,10,2,0,1,2022-01-02,16,Sunday,7,10,3
1477679153520517121,2022-01-02 16:32:18,"Cristiano Ronaldo terus dikritik di Manchester United. Eks pemain Setan Merah, Mikael Silvestre, memberi pembelaan untuk CR7. https://t.co/c2fWbmF98t",11,2,3,1,2022-01-02,16,Sunday,7,14,3
1477678050611507200,2022-01-02 16:27:55,"Jack Riso wisuda di usia 15 tahun dengan nilai 3,78. Jack bahkan menyelesaikan studinya di universitas hanya dalam setahun saja.  https://t.co/PWNlPdqHnP",91,9,16,2,2022-01-02,16,Sunday,7,107,11
1477676936163995649,2022-01-02 16:23:30,"Awalnya tak direstui orangtua saat buka warung sate, kakak-beradik ini berhasil membuktikan bisa mendapatkan omzet hingga Rp 10 juta. https://t.co/wO5gHSDZwQ",42,2,7,1,2022-01-02,16,Sunday,7,49,3
1477675929027686421,2022-01-02 16:19:30,Berlliana Lovell sayangkan artis yang prostitusi. Ia heran wanita cantik kok jual keseksian. https://t.co/wAXHbkCP4D,125,72,8,18,2022-01-02,16,Sunday,7,133,90
1477674942867152903,2022-01-02 16:15:34,"Dalam unggahan terbaru, Kate Middleton dan Pangeran William menunjukkan foto mesra. Apa arti bahasa tubuh mereka? Pakar bahasa tubuh mengungkapnya:  https://t.co/zcw9Qete8s",9,1,1,0,2022-01-02,16,Sunday,7,10,1
1477673675692388354,2022-01-02 16:10:32,"Aksi menggemaskan ditunjukkan para anak SD yang datang ke pesta pernikahan gurunya. Mereka membawa perabotan rumah seperti wajan, panci, hingga toples kerupuk. https://t.co/mAqbl00aH1",24,2,1,0,2022-01-02,16,Sunday,7,25,2
1477672680027471872,2022-01-02 16:06:35,"Ketika Freddy Budiman, dieksekusi mati pada 2016, sempat muncul konspirasi. Sejumlah orang mengatakan Freddy masih hidup. Ini jawaban Fikri Budiman:  https://t.co/HBMG5vu5ia",8,0,3,0,2022-01-02,16,Sunday,7,11,0
1477671715039764480,2022-01-02 16:02:45,"Kementerian Perindustrian menggulirkan wacana 'mobil rakyat' yang bakal dibebaskan PPnBM. Di luar mobil rakyat, ini mobil-mobil yang dibebaskan dari PPnBM. https://t.co/7d59fjrZDp",6,4,1,1,2022-01-02,16,Sunday,7,7,5
1477670582225408002,2022-01-02 15:58:15,Gong Yoo mengutarakan pendapatnya soal ulasan yang beragam drama Korea original Netflix The Silent Sea. #GongYoo  https://t.co/JBcFc6PbcY,4,0,1,1,2022-01-02,15,Sunday,7,5,1
1477669602997981188,2022-01-02 15:54:21,Krisdayanti memperlihatkan potret romantisnya dengan Raul Lemos dalam unggahan terbarunya di Instagram. KD mengungkap rahasia pernikahan harmonisnya. https://t.co/LNUtOuuIks,15,3,0,0,2022-01-02,15,Sunday,7,15,3
1477668519462551552,2022-01-02 15:50:03,Mangaka Inuyasha raih penghargaan komik bergengsi di AS. Sosoknya itu ialah Rumiko Takahashi. https://t.co/Ja07y6dgz9,17,0,6,1,2022-01-02,15,Sunday,7,23,1
1477667250719109131,2022-01-02 15:45:00,Viral video seorang pria yang terbang hingga 9 meter karena terbawa layang-layang. Netizen pun dibuat ngeri melihatnya...  https://t.co/LKuUT2VEYD,43,3,7,4,2022-01-02,15,Sunday,7,50,7
1477665940263391232,2022-01-02 15:39:48,Berita terpopuler sepakan datang dari Paing Takhon yang merupakan seorang biksu yang dinobatkan sebagai pria tertampan di dunia versi TC Candler. https://t.co/nmfVVQzFUJ,18,2,3,2,2022-01-02,15,Sunday,7,21,4
1477664951049330692,2022-01-02 15:35:52,"Wali Kota Surabaya Eri Cahyadi menyebut, ada 2 warganya yang kena COVID-19 varian Omicron. Menurutnya, dua warga tersebut dirawat di rumah sakit. https://t.co/SHFHbyeG9Q",16,3,12,4,2022-01-02,15,Sunday,7,28,7
1477662338559971337,2022-01-02 15:25:29,Cisauk merupakan salah satu wilayah yang terletak sangat dekat dengan kawasan BSD. Fasilitas lengkap yang ada di BSD bisa dinikmati oleh warga Cisauk. https://t.co/Bb1uCggVbB,37,6,8,2,2022-01-02,15,Sunday,7,45,8
1477661600802914310,2022-01-02 15:22:33,Madam Pang kian jadi buah bibir usai Thailand juara Piala AFF 2020. Kabarnya ia jadi calon kuat presiden Federasi Sepakbola Thailand.  https://t.co/MhWNSMVN8C,34,0,3,1,2022-01-02,15,Sunday,7,37,1
1477659848762445829,2022-01-02 15:15:36,"Banjir lahar Gunung Semeru kembali terjadi di Lumajang. Dua warga dan empat kerbau terjebak banjir di Sungai Regoyo, Desa Bades, Kecamatan Pasirian. https://t.co/R2SKqqhR0A",26,1,4,0,2022-01-02,15,Sunday,7,30,1
1477658627800539138,2022-01-02 15:10:45,"Seorang wanita viral di TikTok setelah mengungkapkan cara mudah mendapatkan uang. Dia hanya mengirim pesan ke seorang pria, lalu dibayar Rp 28 juta sebulan. https://t.co/8JV9pvw9Bc",12,1,3,3,2022-01-02,15,Sunday,7,15,4
1477657649961447426,2022-01-02 15:06:51,Perusahaan Swedia DSruptive Subdermals membuat microchip berisi data vaksinasi COVID-19 yang dapat dimasukan ke bawah kulit manusia. Ini penamapakannya: https://t.co/6tHA7xy5cx,57,23,30,24,2022-01-02,15,Sunday,7,87,47
1477656383126491136,2022-01-02 15:01:49,Menikmati udara sejuk di Bogor memang menenangkan. Apalagi bisa sekaligus kumpul bareng keluarga sambil makan enak. Ini daftar resto outdoor di Bogor:   https://t.co/EPKzEJlqyo,33,0,8,0,2022-01-02,15,Sunday,7,41,0
1477655599252971523,2022-01-02 14:58:43,COVID-19 varian Omicron sudah terdeteksi di Jatim. Gubernur Khofifah Indar Parawansa meminta warga tidak panik dan tetap meningkatkan kewaspadaan. https://t.co/oiYT7CJJNd,30,17,10,1,2022-01-02,14,Sunday,7,40,18
1477654857867841537,2022-01-02 14:55:46,Manajer Crystal Palace Patrick Vieira tak puas dengan wasit saat timnya kalah 2-3 dari West Ham United. Ia terus mengomel sampai akhirnya dikartu wasit. https://t.co/wcVh6xglx9,4,0,0,0,2022-01-02,14,Sunday,7,4,0
1477653872432889857,2022-01-02 14:51:51,COVID-19 varian Omicron sudah terdeteksi di Jatim. Pemprov Jatim mewaspadai varian ini dan mencegah terjadinya penularan lokal.  https://t.co/SYIBvPv9l1,19,4,7,3,2022-01-02,14,Sunday,7,26,7
1477653581876576257,2022-01-02 14:50:42,"Front Persaudaraan Islam (FPI) menggelar zikir akbar di Masjid At-Ta’awun, Puncak, Bogor pada Minggu (2/1). Aparat TNI-Polri bersiaga di lokasi kegiatan. https://t.co/Yg8Jr5yrPe",11,7,2,0,2022-01-02,14,Sunday,7,13,7
1477653084377698317,2022-01-02 14:48:43,Gaga Muhammad menyampaikan prinsip hidupnya. Dia bicara soal kepribadian yang rusak. #GagaMuhammad  https://t.co/NAMbV3Efhj,45,15,5,9,2022-01-02,14,Sunday,7,50,24
1477652352140197890,2022-01-02 14:45:48,Chelsea akan menghadapi Liverpool di lanjutan Liga Inggris. Apakah Romelu Lukaku bakal absen karena dihukum Thomas Tuchel? https://t.co/NaMX6SzaU5,4,1,2,0,2022-01-02,14,Sunday,7,6,1
1477651232072380425,2022-01-02 14:41:21,Lalu lintas di Kota Batu terpantau padat merayap sejak siang tadi. Banyak kendaraan yang keluar Kota Batu sehingga kemacetan mengular sampai 3 km.  https://t.co/k1aBb5vDE1,10,0,2,0,2022-01-02,14,Sunday,7,12,0
1477650596001980419,2022-01-02 14:38:50,Pihak pelatih Biliar PON merespons pernyataan Ketua KONI Sumut yang menyebut jeweran Gubsu Edy Rahmayadi terhadap Khoirudin Aritonang lumrah. https://t.co/FoH0ch3OPg,6,11,3,0,2022-01-02,14,Sunday,7,9,11
1477649856848089091,2022-01-02 14:35:53,"Ponpes AS-Sunnah, Bagek Nyaka, Lombok Timur, dirusak oleh orang tak dikenal. Kejadian diduga buntut dari menyebarnya potongan video makam leluhur di Lombok. https://t.co/ZpjpOIfSSZ",9,0,1,0,2022-01-02,14,Sunday,7,10,0
1477649512730669060,2022-01-02 14:34:31,"Selebgram Rachmawati Kekeyi Putri Cantika sejak dulu punya keinginan tampil bak Barbie, karakter kesukaannya. Ternyata, hal itu bukan cuma impian belaka. https://t.co/80g2D3aeZy",16,3,5,2,2022-01-02,14,Sunday,7,21,5
1477647641538351106,2022-01-02 14:27:05,"Sukses di Piala AFF 2020 tak bikin Timnas Thailand puas. Kapten Chanathip Songkrasin, Messi-nya Thailand, menegaskan The War Elephants masih punya ambisi besar. https://t.co/B0Wpc1z4KG",11,0,3,1,2022-01-02,14,Sunday,7,14,1
1477647631950094336,2022-01-02 14:27:03,"Yuk! Ulas Kilas Balik Peristiwa Penting Sepanjang 2021 Bareng detikcom
https://t.co/TfZyprgmiQ",5,1,1,0,2022-01-02,14,Sunday,7,6,1
1477646397944082435,2022-01-02 14:22:09,"Kalau sedang mencari nasi campur halal di Bali, coba datang ke Warung Mek Juwel. Warung makan ini menawarkan menu nasi campur ayam yang sudah terkenal lezat. https://t.co/W9DEzfwqe0",31,0,3,0,2022-01-02,14,Sunday,7,34,0
1477645344754315270,2022-01-02 14:17:58,Deretan lowongan kerja dibuka di tahun baru 2022. Perusahaan swasta sekelas Unilever hingga Astra mulai membuka kesempatan berkarier di tahun baru ini. https://t.co/2CBwfn65rl,32,0,7,0,2022-01-02,14,Sunday,7,39,0
1477644361617846274,2022-01-02 14:14:03,"Foto kamuflase yang secara tidak sengaja dibuat ini mampu mengelabui otak dan mata kita, tidak percaya? Yuk buktikan sendiri, siap-siap mata tertipu! https://t.co/4FZx9V7vX4",5,0,2,1,2022-01-02,14,Sunday,7,7,1
1477643556886040579,2022-01-02 14:10:51,"Saat ini aktivitas ngopi dan nongkrong jadi kebiasaan di kalangan masyarakat. Saat liburan ke Lembang, cobain dua tempat nongkrong kekinian ini:  https://t.co/2B9HQVtass",10,0,3,0,2022-01-02,14,Sunday,7,13,0
1477642568255283203,2022-01-02 14:06:56,Berita menyayat hati datang dari seekor harimau di kebun binatang AS. Harimau tersebut harus ditembak mati padahal jadi spesies terancam punah. https://t.co/57EmDWvmcz,12,1,2,0,2022-01-02,14,Sunday,7,14,1
1477642074283520014,2022-01-02 14:04:58,"Ketua Umum PSSI Mochamad Iriawan menyambut kepulangan Timnas Indonesia. Dalam pidatonya, ia menyebut tugas selanjutnya adalah berlaga di Piala AFF U-23. https://t.co/gUpR1Ryzi8",18,5,1,1,2022-01-02,14,Sunday,7,19,6
1477640968996372492,2022-01-02 14:00:34,"Wanita kelahiran Tangerang ini ceritakan pengalaman jalani bisnis kuliner di London, Inggris, Bunda. Berapa keuntungannya? Simak cerita selengkapnya, ya. #detiknetwork  https://t.co/cTD6gNQEqd",26,5,5,0,2022-01-02,14,Sunday,7,31,5
1477640456813137928,2022-01-02 13:58:32,"Pemerintah melakukan larangan ekspor batu bara di awal tahun 2022, ekspor batu bara bakal disetop sementara selama sebulan mulai 1-31 Januari.  https://t.co/41Kj4Sz0WU",8,0,3,3,2022-01-02,13,Sunday,7,11,3
1477639693718233088,2022-01-02 13:55:30,#Terpopuler Daus Mini dan Shelvie Hana Wijaya membagikan kabar bahagia. Shelvie ternyata sudah melahirkan anak pertama dari pernikahannya dengan Daus Mini. https://t.co/VheLCF0Fm0,15,1,2,0,2022-01-02,13,Sunday,7,17,1
1477638940110868481,2022-01-02 13:52:31,Indonesia lagi-lagi gagal menjadi juara Piala AFF 2020. Pemain skuad Garuda cuma bisa meratapi dan memegang sedikit trofi di atas panggung. https://t.co/afMblqVRWP,27,0,3,0,2022-01-02,13,Sunday,7,30,0
1477638211077910528,2022-01-02 13:49:37,Seorang transgender pria melahirkan seorang anak tapi merasa sangat kesal dan tersinggung karena selalu dipanggil 'ibu' oleh perawat dan staf rumah sakit. Begini curhatnya: https://t.co/N3xTO2FaP1,14,0,4,4,2022-01-02,13,Sunday,7,18,4
1477637708679991301,2022-01-02 13:47:37,Melihat lagi sikap pemerintah soal konsumen prostitusi artis tidak dipenjara di kasus muncikari Robby Abbas. https://t.co/g4HXUvXoTp,13,3,2,1,2022-01-02,13,Sunday,7,15,4
1477636719835025412,2022-01-02 13:43:41,"Operasi Lilin 2021 yang digelar oleh Polri mencatat terjadinya 772 kasus kecelakaan. Diketahui, ada 1.064 orang mengalami luka-luka. https://t.co/e7Gm5NJ9Bg",4,0,2,0,2022-01-02,13,Sunday,7,6,0
1477635557857574912,2022-01-02 13:39:04,Gaga Muhammad ngaku mau nikahi Laura Anna. Greta Irene seloroh yang ada dibikin gila...  https://t.co/nCJciAK07G,13,0,2,0,2022-01-02,13,Sunday,7,15,0
1477634550964572160,2022-01-02 13:35:04,Kementerian ESDM memutuskan untuk menghentikan sementara ekspor batu bara di bulan ini untuk memenuhi kebutuhan pembangkit listrik dalam negeri. https://t.co/WEfhGhNi4p,50,2,18,6,2022-01-02,13,Sunday,7,68,8
1477632790363525122,2022-01-02 13:28:04,Polres Cianjur melakukan relayasa lalin penutupan arus dari Cianjur ke Jakarta. Kendaraan menuju Jakarta dialihkan ke jalur alternatif Jonggol dan Sukabumi. https://t.co/f7GXBtpFum,7,0,1,1,2022-01-02,13,Sunday,7,8,1
1477632076518207491,2022-01-02 13:25:14,#Terpopuler Polisi kembali menangkap seorang artis yang diduga terlibat dalam kasus prostitusi. Ia adalah Cassandra Angelie. Ini profilnya:  https://t.co/uO0UHOYrCH,17,2,6,0,2022-01-02,13,Sunday,7,23,2
1477631084397486083,2022-01-02 13:21:18,Tim d'House hunter kali ini tiba di wilayah Cisauk. Daerah yang terletak di Selatan Jakarta ini memiliki banyak perumahan yang nyaman dan asri. https://t.co/vFJPibp7K7,7,1,3,0,2022-01-02,13,Sunday,7,10,1
1477629854757572616,2022-01-02 13:16:25,Pencipta alat bunuh diri instan bernama Sarco Suicide Pods ini angkat bicara mengenai temuannya yang menghebohkan itu. https://t.co/8Hst7DmclG,13,0,4,4,2022-01-02,13,Sunday,7,17,4
1477629064001249283,2022-01-02 13:13:16,"Mark Zuckerberg kembali membeli lahan di Hawaii seluas 100 hektar. Untuk memperluas propertinya, ia merogoh kocek Rp 251 miliar. https://t.co/ASwenmk93k",27,3,1,1,2022-01-02,13,Sunday,7,28,4
1477628542057910274,2022-01-02 13:11:12,Banjir lahar dingin Semeru kembali terjadi. Banjir lahar dingin ini mengalir ke sejumlah sungai usai diguyur hujan intensitas tinggi. Warga diimbau waspada. https://t.co/haPkSN63C2,16,1,2,0,2022-01-02,13,Sunday,7,18,1
1477628069452132353,2022-01-02 13:09:19,Jeff Bezos sampai Elon Musk ingin hidup abadi. Setidaknya otaknya saja sudah cukup bagi Elon Musk. Apa alasannya orang-orang kaya ingin hidup selamanya? https://t.co/jWIF79uq7R,13,0,4,2,2022-01-02,13,Sunday,7,17,2
1477627091696988160,2022-01-02 13:05:26,"Bek muda Indonesia, Pratama Arhan, diprediksi akan jadi pemain top Asia. Eks pemain Singapura, Baihakki Khaizan, yang mengungkapkan pendapat itu. https://t.co/5sGSwozuQ8",135,6,9,2,2022-01-02,13,Sunday,7,144,8
1477626567933280259,2022-01-02 13:03:21,Lionel Messi positif COVID-19. Kabar ini disampaikan langsung oleh klub Paris Saint-Germain. Begini kondisi Messi:  https://t.co/tdtLK3o4ZR,9,0,7,0,2022-01-02,13,Sunday,7,16,0
1477626035231408131,2022-01-02 13:01:14,"Manchester United disarankan untuk menepikan Cristiano Ronaldo. Eks pemain Arsenal, Paul Merson, yang mengungkapkan pendapat itu. https://t.co/QJjW3wfgC5",6,1,0,1,2022-01-02,13,Sunday,7,6,2
1477625273344573441,2022-01-02 12:58:12,"Belakangan ini, spirit doll atau boneka arwah kini ramai dibicarakan banyak orang. Lalu, apakah orang yang percaya dengan boneka ini termasuk gangguan jiwa? https://t.co/okEnNzPjMD",15,9,5,2,2022-01-02,12,Sunday,7,20,11
1477624764025950208,2022-01-02 12:56:11,Paris Saint-Germain mengumumkan empat pemainnya positif COVID-19. Salah satunya Lionel Messi.  https://t.co/YSi2sh0Xja,29,0,7,3,2022-01-02,12,Sunday,7,36,3
1477622989890138112,2022-01-02 12:49:08,Banjir akibat luapan Bengawan Njero masih melanda satu desa di Lamongan. Warga akhirnya melewati momen tahun baru dengan di rumah saja. https://t.co/gnnpJE64wI,16,2,5,0,2022-01-02,12,Sunday,7,21,2
1477622248794165252,2022-01-02 12:46:11,"Video Gaga Muhammad yang sempat hilang secara misterius muncul lagi. Di situ, dia mengutarakan beberapa hal termasuk soal harapan.   https://t.co/ndWUunG3Vn",12,1,0,0,2022-01-02,12,Sunday,7,12,1
1477620499198840832,2022-01-02 12:39:14,Skuad Thailand diestimasikan sudah mengantongi nyaris Rp 20 miliar berkat keberhasilannya menjadi juara Piala AFF 2020 usai mengatasi Indonesia. https://t.co/l5M1lgOenH,12,3,0,2,2022-01-02,12,Sunday,7,12,5
1477620005546217473,2022-01-02 12:37:16,PT Suzuki Indomobil Sales (SIS) mengumumkan pembaruan motor ikonik All New Satria F150. Ini potretnya:  https://t.co/HqL0TtyZyd,8,1,0,0,2022-01-02,12,Sunday,7,8,1
1477619021780508672,2022-01-02 12:33:22,"Teleskop James Webb telah mengudara dengan teknologi jauh lebih canggih dari sebelumnya untuk mendeteksi exoplanet, sebutan untuk planet di luar Tata Surya. https://t.co/kZty0ygtCJ",11,0,3,0,2022-01-02,12,Sunday,7,14,0
1477618259050516484,2022-01-02 12:30:20,Final leg kedua Piala AFF 2020 antara Thailand vs Indonesia menjadi panggung Theeraton Bunmathan. Bek The War Elephants itu sukses bikin pusing skuad Garuda. https://t.co/uRRH7Xgvn6,11,0,0,2,2022-01-02,12,Sunday,7,11,2
1477617469795835904,2022-01-02 12:27:12,"Dokter Rinal asli Aceh yang membuka praktik di Depok rela dibayar seikhlasnya oleh pasien, bahkan pernah dibayar oleh sayur hingga biskuit. Berikut kisahnya:  https://t.co/EiEBi7SrCt",79,9,17,2,2022-01-02,12,Sunday,7,96,11
1477616736111374337,2022-01-02 12:24:17,Kasus prostitusi artis kembali membuka diskursus pidana bagi konsumennya. Simak lagi gugatan Robby Abbas ke MK agar konsumen prostitusi artis di bui:  https://t.co/h9vLBntzmb,5,1,0,1,2022-01-02,12,Sunday,7,5,2
1477615747543322627,2022-01-02 12:20:21,COVID-19 varian Omicron sudah terdeteksi di Jawa Timur. Pasien pertama yang terdeteksi di Jatim yakni warga Surabaya yang pulang dari Bali. https://t.co/EbetIDxqqF,32,3,23,12,2022-01-02,12,Sunday,7,55,15
1477615008586600456,2022-01-02 12:17:25,Seorang tahanan kasus pencabulan kabur dari rutan di Polres Metro Bekasi Kota. Bagaimana caranya? https://t.co/zPfKwZQxbL,12,1,2,1,2022-01-02,12,Sunday,7,14,2
1477614238525005825,2022-01-02 12:14:21,"Pulau Gorgona pernah disebut sebagai Alcatraz-nya Kolombia. Di sanalah para tahanan politik dan penjahat berbahaya jalani hukuman, bahkan sampai mati. Ini potretnya:  https://t.co/GqlIuXJF2M",9,0,0,1,2022-01-02,12,Sunday,7,9,1
1477613748512776196,2022-01-02 12:12:25,"Setiap musim libur tiba, ribuan wisatawan berbondong-bondong menuju Los Organos, Peru, untuk menikmati keindahan bawah lautnya. Ini keindahannya:  https://t.co/GBdJbNpb5j",5,0,0,0,2022-01-02,12,Sunday,7,5,0
1477612611688611847,2022-01-02 12:07:53,"Jembatan Cihampelas atau Jembalas yang menghubungkan dua Kecamatan Batujajar-Kecamatan Cihampelas, Kabupaten Bandung Barat patah di satu bagian penopangnya. https://t.co/7CCiuJpxJb",12,0,3,0,2022-01-02,12,Sunday,7,15,0
1477611869183840258,2022-01-02 12:04:56,"Rudy memiliki keterbatasan dalam berjalan. Saat erupsi Semeru terjadi, dia susah payah menyelamatkan diri. Kini, mari bantu Rudy bangkit lewat https://t.co/gJZ8ovBJyo https://t.co/qVyjJvpuVh",12,0,2,0,2022-01-02,12,Sunday,7,14,0
1477610806699343875,2022-01-02 12:00:43,NASA menyewa 24 ahli agama untuk membantu meneliti alien. Program ini dilakukan untuk menjawab pertanyaan tentang kehidupan makhluk di luar bumi. #CNNIndonesia  #detiknetwork  https://t.co/pBTAxeo2Yk,39,17,11,5,2022-01-02,12,Sunday,7,50,22
1477610261632716802,2022-01-02 11:58:33,"Ribuan wisatawan memadati kawasan Pantai Glagah. Puncak libur nataru ini, jalan menuju Pantai Glagah sampai macet.  https://t.co/A7kv7vZr7g",6,0,0,1,2022-01-02,11,Sunday,7,6,1
1477609745364230154,2022-01-02 11:56:30,"dr. Rinal, viral di media sosial karena kebaikan hatinya yang mau dibayar seikhlasnya oleh pasiennya. https://t.co/nS9dmLe8PM",50,1,4,1,2022-01-02,11,Sunday,7,54,2
1477609500936912898,2022-01-02 11:55:32,Wamenkumham Prof Dr Eddy OS Hiariej SH MH ternyata setuju agar konsumen prostitusi artis juga dipidana. Ini penjelasannya: https://t.co/4tXDSMLZGv,36,8,4,1,2022-01-02,11,Sunday,7,40,9
1477609010442518528,2022-01-02 11:53:35,"Taman Impian Jaya Ancol masih jadi tujuan tempat rekreasi keluarga. Di liburan tahun baru ini, pengunjung Ancol dinilai mengalami penurunan.  https://t.co/KoJ9VCTRuP",7,0,0,0,2022-01-02,11,Sunday,7,7,0
1477608461269704710,2022-01-02 11:51:24,"Menkominfo Johnny G. Plate menyebut iPhone 12 dan iPhone 13 yang beredar di Indonesia hanya mendukung jaringan 5G di frekuensi 2,6 GHz. Masa sih? https://t.co/RuNhRfHSld",17,7,9,2,2022-01-02,11,Sunday,7,26,9
1477607204454912002,2022-01-02 11:46:24,"Di awal 2022, Tim Waspada COVID-19 dari Lembaga Eijkman (WASCOVE) mengumumkan perpisahannya. Perpisahan tersebut disambut sedih oleh warganet. https://t.co/4knL5yrYTD",3,0,0,0,2022-01-02,11,Sunday,7,3,0
1477606957439721474,2022-01-02 11:45:25,Chelsea vs Liverpool jadi sajian utama Liga Inggris akhir pekan ini. Link live streaming bigmatch itu bisa dilihat di sini:  https://t.co/wbNK4LMMUp,3,0,3,0,2022-01-02,11,Sunday,7,6,0
1477606544858656769,2022-01-02 11:43:47,Arsenal harus menelan kekalahan secara tragis saat bertanding lawan Man City. Dipaksa bermain 10 pemain dan menelan kekalah di menit akhir pertandingan. https://t.co/5fBqDufElH,7,0,1,0,2022-01-02,11,Sunday,7,8,0
1477605834179895296,2022-01-02 11:40:58,"Jumlah penumpang di Bandara Yogyakarta International Airport, Kulon Progo, DIY, pada Minggu (2/1) naik 2 kali lipat dibandingkan hari-hari sebelumnya. #BandaraYIA  https://t.co/LBLX7ExRlb",6,0,0,0,2022-01-02,11,Sunday,7,6,0
1477605109920063492,2022-01-02 11:38:05,Ilmuwan Jepang membuat prototipe layar TV yang bisa dijilat untuk mencicipi rasa makanan. Begini cara kerja TV unik ini:  https://t.co/H13jeP4ZjF,13,8,4,4,2022-01-02,11,Sunday,7,17,12
1477604613457121282,2022-01-02 11:36:07,Pengadilan akhinya mengakui anak Amalia Fujiawati adalah darah daging Bambang Pamungkas. Mantan pemain timnas itu wajib nafkahi anak Rp 7 juta perbulan. https://t.co/EtKA9Kraay,73,9,19,9,2022-01-02,11,Sunday,7,92,18
1477604121528213506,2022-01-02 11:34:09,Kapenrem 061 menepis anggapan abuse of power soal komandannya mendatangi Habib Bahar. Dia menilai kedatangan komandannya itu bentuk tanggung jawab. https://t.co/HZFzggxoys,17,14,1,3,2022-01-02,11,Sunday,7,18,17
1477603630673010692,2022-01-02 11:32:12,Bingung memilih produk eye cream untuk kamu yang berusia 30-an? Ini rekomendasi eye cream yang bisa kamu gunakan:  https://t.co/5KCjASKUzO,3,0,2,0,2022-01-02,11,Sunday,7,5,0
1477602712166535173,2022-01-02 11:28:33,Tingkat kunjungan wisatawan ke Garut di momen libur Natal dan tahun baru kali ini cenderung sepi. Wisatawan yang datang mayoritas dari sekitaran Garut. https://t.co/hH8uGFpcsp,5,0,0,0,2022-01-02,11,Sunday,7,5,0
1477601720587161607,2022-01-02 11:24:37,"Cristiano Ronaldo jadi sorotan belakangan ini. Patung menggambarkan sosok Ronaldo yang berada di pantai barat daya India, tuai kontroversi. https://t.co/uTniZpq4wW",6,1,2,1,2022-01-02,11,Sunday,7,8,2
1477600926546411523,2022-01-02 11:21:28,Menko Polhukam Mahfud Md mengapresiasi penerapan protokol kesehatan yang ada di Taman Margasatwa Ragunan. #MahfudMD  https://t.co/HE8JzlFDBl,2,0,0,1,2022-01-02,11,Sunday,7,2,1
1477600178827931652,2022-01-02 11:18:29,Apa pasangan sedang marah? Coba rayu dengan kata-kata gombalan romantis yang bisa melunakkan hatinya. https://t.co/PJHuE9wqKM,12,3,2,2,2022-01-02,11,Sunday,7,14,5
1477599975790063616,2022-01-02 11:17:41,"Perjuangan Timnas Indonesia di Piala AFF 2020 diapresiasi netizen. Meski skuat Garuda harus jadi runner-up, namun ucapan terima kasih dan dukungan mengalir kepada Shin Tae-yong. https://t.co/95ZHhfLLuA",178,3,7,1,2022-01-02,11,Sunday,7,185,4
1477598121635033088,2022-01-02 11:10:19,Presiden Jokowi resmi memperpanjang status pandemi nasional COVID-19. Ini dilakukan untuk menindaklanjuti perintah Mahkamah Konstitusi (MK). https://t.co/0jqEWOhzN3,13,1,2,3,2022-01-02,11,Sunday,7,15,4
1477598120099958789,2022-01-02 11:10:18,Presiden Jokowi menandatangani Keppres Nomor 24 Tahun 2021 yang memperpanjang status pandemi nasional COVID-19. Lalu apa dampaknya? https://t.co/RDv3FNIyd7,13,9,9,4,2022-01-02,11,Sunday,7,22,13
1477597398578962433,2022-01-02 11:07:26,"Manchester City melaju jauh di papan atas klasemen Liga Inggris. Manajer Chelsea, Thomas Tuchel, menyebut The Citizens layaknya mesin pemetik kemenangan. https://t.co/7WTDrc7fWR",12,1,0,1,2022-01-02,11,Sunday,7,12,2
1477596653796446208,2022-01-02 11:04:29,"#Terpopuler Parker Solar Probe, pesawat milik NASA, berhasil 'menyentuh' dengan jarak yang sangat dekat. Kok bisa tidak terbakar dan masih utuh ya? https://t.co/vgSCzZ0OEN",10,9,1,0,2022-01-02,11,Sunday,7,11,9
1477595620609339396,2022-01-02 11:00:23,"Timnas Thailand juara Piala AFF 2020 tanpa catatan kekalahan. Manajer Gajah Perang, Nualphan Lamsam, pun merasa puas dengan pencapaian itu. https://t.co/aRMmyOvjAm",18,2,0,1,2022-01-02,11,Sunday,7,18,3
1477594634687762432,2022-01-02 10:56:27,Puncak libur tahun baru masih dirayakan oleh banyak orang. Pantai Glagah Kulon Progo diserbu ribuan wisatawan. Ini potretnya:  https://t.co/k63hVCQzlj,8,1,2,0,2022-01-02,10,Sunday,7,10,1
1477593635579469827,2022-01-02 10:52:29,Taman Margasatwa Ragunan menerapkan ganjil genap bagi kendaraan yang akan masuk. Pengunjung dengan sepeda motor plat nomor ganjil terpaksa parkir liar di luar Ragunan. https://t.co/SM3mNjstAg,4,1,0,0,2022-01-02,10,Sunday,7,4,1
1477592646633893889,2022-01-02 10:48:33,"Menko Polhukam Mahfud Md kunjungi Taman Margasatwa Ragunan, Jakarta Selatan bersama keluarga. #MahfudMD  https://t.co/ty5OC2eset",8,0,0,0,2022-01-02,10,Sunday,7,8,0
1477591642999828480,2022-01-02 10:44:34,Dua lipa memamerkan tubuh bugarnya. Penampilan seksi itu ditunjukkan setelah kabar putus dengan Anwar Hadid.  https://t.co/0uj4SzrmLT,9,1,0,0,2022-01-02,10,Sunday,7,9,1
1477590654507274240,2022-01-02 10:40:38,"MGPA tengah menyiapkan MotoGP Mandalika 2022. Namun media asing meragukan MotoGP di Indonesia dapat digelar tahun ini, lantaran birokrasi yang 'menyulitkan'. Ini kata MGPA:  https://t.co/iVeKxZayLh",7,4,2,0,2022-01-02,10,Sunday,7,9,4
1477589917723201544,2022-01-02 10:37:43,Naura Sabrina Galiyah (9) meninggal setelah divaksin Sinovac dosis pertama. Direktur RSUD Jombang dr Pudji Umbaran menduga siswi itu mengalami KIPI. https://t.co/79ww50C5lQ,86,38,47,4,2022-01-02,10,Sunday,7,133,42
1477588908946952192,2022-01-02 10:33:42,"Freddy Budiman, gembong narkoba terbesar di Indonesia, dihukum mati. Ada peluit panjang hingga badai jelang eksekusi. Simak kisahnya:  https://t.co/vs7pHb7qeq",29,7,7,2,2022-01-02,10,Sunday,7,36,9
1477587885641633797,2022-01-02 10:29:38,"Dear Aries, terus perbaiki sikap Anda agar dirinya juga semakin tergerak untuk berubah. Bagaimana dengan ramalan zodiak cinta kamu hari ini? Simak di sini:  https://t.co/OERJ1KbDyR",4,0,1,0,2022-01-02,10,Sunday,7,5,0
1477587366688792577,2022-01-02 10:27:35,Sebuah video yang memperlihatkan beras bansos untuk warga Pandeglang yang tak layak konsumsi beredar di medsos. Beras tersebut berasal dari BPNT. https://t.co/8j5BTO0JuX,23,0,2,2,2022-01-02,10,Sunday,7,25,2
1477587141190463492,2022-01-02 10:26:41,Pengumuman menyenangkan datang dari pasangan Gilang Dirga dan Adiezty Fersa. Adiezty Fersa hamil. Selamat!  https://t.co/0X1baNDrqV,18,1,3,1,2022-01-02,10,Sunday,7,21,2
1477586406570700803,2022-01-02 10:23:46,Ia bahkan dijuluki sebagai 'sang pembunuh obeng' lantaran bisa menghabisi 18 korbannya dengan obeng. https://t.co/IvJRlkOAPU,24,6,10,6,2022-01-02,10,Sunday,7,34,12
1477585902495059969,2022-01-02 10:21:46,"Dengan waktu yang terbatas dan kondisi pandemi yang fluktuatif, ada pihak yang meragukan Indonesia menggelar MotoGP tahun ini. https://t.co/lCsHS4BREl",13,0,4,1,2022-01-02,10,Sunday,7,17,1
1477585156970102786,2022-01-02 10:18:48,Mandalika Grand Prix Association resmi merilis harga tiket resmi untuk ajang MotoGP Mandalika 2022. Ini daftar harganya:   https://t.co/CeR3dCJ8EL,10,2,1,2,2022-01-02,10,Sunday,7,11,4
1477584413068341253,2022-01-02 10:15:50,"Awal 2022 ini, Jokowi memang menghabiskan akhir pekan bersama 2 cucunya. Ada momen Ethes ditanya nama pemimpin dunia. Ia mampu menjawab satu persatu pertanyaan itu. https://t.co/pb1A6kBhxA",41,19,7,3,2022-01-02,10,Sunday,7,48,22
1477583928894660610,2022-01-02 10:13:55,Matahari made in China ini mencapai durasi terlama pada suhu plasma tinggi. Rekor baru bisa panas lebih lama sejauh ini. https://t.co/zw4VyFwM5W,10,3,1,0,2022-01-02,10,Sunday,7,11,3
1477582413303848960,2022-01-02 10:07:54,Erupsi Semeru menyisakan duka bagi Rudy yang memiliki keterbatasan pada kakinya. Mari bantu Rudy menyambung asa lagi lewat https://t.co/gJZ8ovBbIQ https://t.co/EvBeNMRCpO,8,0,0,0,2022-01-02,10,Sunday,7,8,0
1477581920083058689,2022-01-02 10:05:56,"Hari ini, ada 174 kasus baru positif Corona yang dilaporkan pemerintah. Kasus sembuh bertambah 190 dan meninggal bertambah 1. https://t.co/OG9XCK4Mc0",8,1,1,1,2022-01-02,10,Sunday,7,9,2
1477581179993923587,2022-01-02 10:03:00,"Indonesia melaporkan 174 kasus baru Corona COVID-19 pada Minggu (2/1/2022). Total kasus positif menjadi 4.263.168, sembuh 4.114.689, dan meninggal 144.097. https://t.co/9qKkNIkoDL",4,0,0,0,2022-01-02,10,Sunday,7,4,0
1477581035131047937,2022-01-02 10:02:25,Pakar dari Fakultas Kedoktera UI menyebut bahwa Indonesia masih berada dalam fase bencana COVID-19. Begini cara untuk mengakhirinya:  https://t.co/PhGVFyqqTd,6,1,1,1,2022-01-02,10,Sunday,7,7,2
1477579919228026882,2022-01-02 09:57:59,"Tiara terus berharap agar ayah Rezky Aditya, Triyogo Drajatmoko, mengakui anaknya. Kalau selama ini Triyogo mengelak, dia meminta Triyogo untuk tes DNA. https://t.co/BT9hmZ4GoO",10,0,1,0,2022-01-02,9,Sunday,7,11,0
1477579397859270659,2022-01-02 09:55:55,Tersangka kasus pencabulan ditemukan tewas mengambang di sungai usai kabur dari sel di Polres Metro Bekasi Kota. Simak penampakan sungai maut itu di sini. https://t.co/h21WTjpFYz,4,0,0,0,2022-01-02,9,Sunday,7,4,0
1477578901434114050,2022-01-02 09:53:56,"LaNyalla Mattalitti menghadiri istighosah akbar dan doa bersama yang diselenggarakan Majelis Sholawat Syababul Kheir, pimpinan Habib Mahdi bin Hamzah Assegaf. https://t.co/SdJchPQ8Fn",17,0,10,0,2022-01-02,9,Sunday,7,27,0
1477578172338249730,2022-01-02 09:51:03,Seorang tersangka pencabulan berinisial M kabur dari Polres Metro Bekasi Kota dan ditemukan tewas di sungai. Berikut detik-detik kaburnya tersangka pencabulan:   https://t.co/0VoVW1pU0k,8,5,0,0,2022-01-02,9,Sunday,7,8,5
1477577273570177024,2022-01-02 09:47:28,Chelsea berusaha keras meraih kemenangan atas Liverpool di tengah situasi sulit. Meski kemenangan belum tentu juga melepaskan The Blues dari situasi tersebut. https://t.co/xYwqdMypOM,5,0,1,0,2022-01-02,9,Sunday,7,6,0
1477575506841280512,2022-01-02 09:40:27,"ICMI memaparkan 10 refleksi akhir tahun 2021. Dalam refleksinya, ICMI membahas demokrasi, pandemi &amp; pemulihan ekonomi. https://t.co/cjZq5GXQ5l",5,0,0,0,2022-01-02,9,Sunday,7,5,0
1477574769419694080,2022-01-02 09:37:31,"Belakangan ini, spirit doll atau boneka arwah kini ramai dibicarakan banyak orang. Lalu, apakah orang yang percaya dengan boneka ini termasuk gangguan jiwa? https://t.co/4TRjX73nus",16,10,8,8,2022-01-02,9,Sunday,7,24,18
1477573800019607552,2022-01-02 09:33:40,Ibunda Gaga Muhammad dituding bawa dukun untuk sembuhkan Laura Anna. Begini responnya: #GagaMuhammad  https://t.co/7BpLVFsTNU,6,0,0,0,2022-01-02,9,Sunday,7,6,0
1477572779805454338,2022-01-02 09:29:37,"Elkan Baggott, dan 3 pemain Indonesia, dihukum sehingga tak boleh main di leg kedua final Piala AFF 2020. Ada misteri menyertai, terkait sosok ofisial tim. https://t.co/ZwZFcBXqmN",19,1,4,0,2022-01-02,9,Sunday,7,23,1
1477571275425988608,2022-01-02 09:23:38,"Kawasan permukiman di daerah Muka Kuning, Batam, terendam banjir. Banjir ini disebabkan tingginya intensitas hujan. https://t.co/WDDPFba5cF",3,0,1,1,2022-01-02,9,Sunday,7,4,1
1477571274155171842,2022-01-02 09:23:38,WNI yang kembali dari luar negeri wajib melakukan karantina 10 atau 14 hari. Perbedaan lama masa karantina itu tergantung negara asal pelaku perjalanan. https://t.co/Ebq35QklMY,14,1,1,2,2022-01-02,9,Sunday,7,15,3
1477570555956150278,2022-01-02 09:20:47,Penyidik Polres Metro Bekasi diperiksa Propam Polda Metro Jaya karena tahanan kabur dan ditemukan tewas di sungai. Tersangka itu terjerat kasus pencabulan anak. https://t.co/sdJOeq234a,13,0,7,0,2022-01-02,9,Sunday,7,20,0
1477569564510760966,2022-01-02 09:16:50,"Hampir 30 tahun segala bentuk tempat hiburan hingga tempat konser di Arab Saudi tutup. Tingginya minat masyarakat, otoritas dunia hiburan didirikan untuk mendiversifikasi ekonomi Arab. https://t.co/oc21OExz29",16,6,7,3,2022-01-02,9,Sunday,7,23,9
1477568573455450116,2022-01-02 09:12:54,Varian Omicron terdeteksi di Jawa Timur. Kasus penularan lokal atau imported cases? Begini kata Kemenkes:  https://t.co/NFqrwrxzq5,8,2,6,1,2022-01-02,9,Sunday,7,14,3
1477567544538112003,2022-01-02 09:08:49,"Akademisi menilai rencana penghapusan layanan 3G di Indonesia sudah memang seharusnya dilakukan, di mana sekarang pengembangan 4G tengah gencar. https://t.co/Z9MZsQqRzI",12,1,5,0,2022-01-02,9,Sunday,7,17,1
1477566814779416578,2022-01-02 09:05:55,"Presiden Joko Widodo memperpanjang status pandemi COVID-19, untuk menindaklanjuti perintah Mahkamah Konstitusi. https://t.co/YrMlvr8aEL",34,6,12,3,2022-01-02,9,Sunday,7,46,9
1477566574911389696,2022-01-02 09:04:57,"Timnas Thailand sudah sukses menjuarai Piala AFF 2020. Pencapaian itu tak membuat Gajah Perang puas, mau lebih berprestasi lagi. #Thailand  https://t.co/dzCh9YKExm",7,1,1,1,2022-01-02,9,Sunday,7,8,2
1477565533520375811,2022-01-02 09:00:49,"Lika-liku asmara Putri Diana kerap menjadi sorotan publik. Sempat menikah dan bercerai dengan Pangeran Charles, ia juga pernah berpacaran dengan dokter tampan. #detiknetwork  https://t.co/C2ByB8JxrE",8,0,1,0,2022-01-02,9,Sunday,7,9,0
1477564778587504645,2022-01-02 08:57:49,Menpora Zainudin Amali mengapresiasi hasil kerja keras Timmas Indonesia di Piala AFF 2020. Ia juga optimistis masa depan Timnas bakal lebih baik. https://t.co/Pa42NhLDwq,29,5,3,2,2022-01-02,8,Sunday,7,32,7
1477563812446359553,2022-01-02 08:53:59,Sepuluh orang ditangkap Satreskrim Polsek Sukapura. Mereka ditangkap dalam kasus kepemilikan dan menanam ganja di lereng Gunung Bromo. https://t.co/v2SNjRL2yG,12,1,3,1,2022-01-02,8,Sunday,7,15,2
1477562048909398022,2022-01-02 08:46:58,"Budaya peninggalan Portugis masih terasa di kawasan Tugu Semper Barat, Cilincing. Ada budaya musik keturunan Portugis Krontjong Toegoe dan kegiatan Rabo-rabo. Ini potretnya:  https://t.co/KR2Cq8jtQC",16,3,3,0,2022-01-02,8,Sunday,7,19,3
1477561301639610369,2022-01-02 08:44:00,Chanathip Songkrasin jadi MVP dan topskor di Piala AFF 2020. Hadiah terbesar tentunya trofi juara. Ini potretnya:   https://t.co/yQykoSz7ax,10,1,1,0,2022-01-02,8,Sunday,7,11,1
1477560312530448388,2022-01-02 08:40:04,WNI dari luar negeri kini wajib karantina 10 atau 14 hari. Perbedaan ketentuan lamanya masa karantina ini bergantung pada negara asal pelaku perjalanan. https://t.co/XdyGAq7tA0,23,5,19,6,2022-01-02,8,Sunday,7,42,11
1477559810195435524,2022-01-02 08:38:05,"Anggota Dishub Kota Bekasi, Dede Fakhrudin Suhendi, nekat melawan arus lalu lintas di Simpang Gadog, Bogor. Memangnya Dishub boleh mengawal? https://t.co/M6VwtD3erK",13,1,4,2,2022-01-02,8,Sunday,7,17,3
1477559317704359939,2022-01-02 08:36:07,"Kebakaran terjadi di sebuah bengkel di Jalan Bangka 11, Mampang Prapatan, Jaksel, Minggu (2/1). Akibat kejadian ini, 2 orang meninggal dunia.  https://t.co/BalF7ns5MH",4,1,1,0,2022-01-02,8,Sunday,7,5,1
1477558577330073600,2022-01-02 08:33:11,Peristiwa langka terjadi di perbatasan Korut-Korsel. Sosok misterius menerobos masuk dari Korsel ke Korut. https://t.co/TctLDMplP7,4,0,1,2,2022-01-02,8,Sunday,7,5,2
1477558087569530882,2022-01-02 08:31:14,"Indonesia harus mengakhiri Piala AFF 2020 sebagai runner-up. Dua penghargaan juga diraih, yakni Fair Play Award dan gelar Pemain Muda Terbaik. https://t.co/ynW0RllTx7",21,3,6,1,2022-01-02,8,Sunday,7,27,4
1477557586564165638,2022-01-02 08:29:14,"Aksi ayah Vanessa Angel, Doddy Sudrajat, memasuki episode baru di awal tahun 2022. Doddy melaporkan Marissya Icha soal penggalangan donasi untuk Gala Sky ke Mabes Polri. https://t.co/uMvjdqkrsE",33,36,7,6,2022-01-02,8,Sunday,7,40,42
1477556708058832897,2022-01-02 08:25:45,"Dua siswa SD menjalani perawatan intensif di RSUD Jombang setelah mengikuti vaksinasi COVID-19. Siswa pertama demam, sedangkan siswa kedua kejang. https://t.co/x3EUvXdcJC",18,1,13,3,2022-01-02,8,Sunday,7,31,4
1477555443987795975,2022-01-02 08:20:44,"Pelintas Tol Trans Jawa di ruas tol Pejagan-Pemalang, Jawa Tengah, arah Jakarta, akan melihat pemandangan Rest Area KM 260B Banjaratma yang bernilai sejarah. Ini potretnya:  https://t.co/pOSc3dKh3Y",7,3,3,3,2022-01-02,8,Sunday,7,10,6
1477554507613716480,2022-01-02 08:17:00,Barcelona tetap harus melawan Real Mallorca meski lagi dilanda badai COVID-19. Pelatih Xavi Hernandez tak habis pikir dengan aturan LaLiga.  https://t.co/Xi7YnZiAvS,9,1,0,0,2022-01-02,8,Sunday,7,9,1
1477553454050648065,2022-01-02 08:12:49,"Salah satu dealer mobil bekas di bilangan Rawa Kalong, Kabupaten Bogor ngaku penjualannya meningkat drastis sejak dealer-nya 'main' ke YouTube. https://t.co/Krxa3sDVVn",19,0,1,0,2022-01-02,8,Sunday,7,20,0
1477552293314764800,2022-01-02 08:08:12,"Mulai 2022, tarif parkir di Kota Bandung akan naik. Kenaikan tarif parkir ini berlaku untuk mobil dan motor yang besarannya tergantung zona atau kawasan. https://t.co/PKm9fzA7Xk",7,0,1,4,2022-01-02,8,Sunday,7,8,4
1477551306395037699,2022-01-02 08:04:17,Pakar otomotif asal Institut Teknologi Bandung mempertanyakan dari mana dasarnya harga Rp 240 juta bisa disebut mobil rakyat. https://t.co/bpvWgAK6xB,155,64,34,11,2022-01-02,8,Sunday,7,189,75
1477550437536571392,2022-01-02 08:00:50,Ketua PA 212 Slamet Maarif mengatakan umat Islam di Bogor akan menggelar zikir akbar di Masjid At-Ta'awun Puncak sekaligus Milad Front Persaudaraan Islam. https://t.co/YZ4LSDj5AH,53,29,6,5,2022-01-02,8,Sunday,7,59,34
1477549686487662592,2022-01-02 07:57:51,"Hari kedua tahun 2022, Gerbang Tol Kalihurip Utama ramai. Kendaraan yang didominasi pelat DKI Jakarta dan sekitarnya mengarah ke Bandung. https://t.co/8D6ZQSYodG",30,1,2,0,2022-01-02,7,Sunday,7,32,1
1477548948634099719,2022-01-02 07:54:55,Malam tahun baru di Prancis diwarnai dengan tradisi tak biasa yang telah dilakukan bertahun-tahun. Sedikitnya 874 mobil dibakar di seluruh Prancis.  https://t.co/2rFC9kuqt3,3,1,2,0,2022-01-02,7,Sunday,7,5,1
1477547961102045184,2022-01-02 07:51:00,"Sebanyak 137 ribu kendaraan kembali ke wilayah Jabotabek melalui jalan tol pada 1 Januari 2022. Jumlah tersebut menurun 2,8 % dibanding November 2021 lalu. https://t.co/avN5HaBs2V",5,1,2,0,2022-01-02,7,Sunday,7,7,1
1477547217380679680,2022-01-02 07:48:02,"Perjuangan Timnas Indonesia mencapai Final Piala AFF 2020 diapresiasi netizen. Dengan skuad rata-rata masih muda, namun bisa melaju sampai puncak kompetisi. https://t.co/9RmmhFxkpb",130,4,13,1,2022-01-02,7,Sunday,7,143,5
1477546223481536512,2022-01-02 07:44:05,Sosok Princess Pitaloka sudah tak asing di dunia cosplayer Indonesia. Ia sempat mendapat cibiran sebagai cewek simpanan. Ini potret Princess Pitaloka:  https://t.co/qiPGDCXPwx,12,1,3,0,2022-01-02,7,Sunday,7,15,1
1477544923171897346,2022-01-02 07:38:55,"Thailand jadi juara Piala AFF 2020. Salah satu perayaan Skuad Gajah Perang melibatkan Madam Pang, yang dilontarkan tinggi-tinggi ke udara. Ini potretnya:  https://t.co/frQC00PO5J",12,2,2,1,2022-01-02,7,Sunday,7,14,3
1477543682903617536,2022-01-02 07:34:00,"Menteri Perhubungan Budi Karya Sumadi lakukan kunjungan kerja di Pelabuhan Kali Adem Muara Angke, pada Minggu, (2/1).  https://t.co/3VIdTsPUl5",4,0,1,0,2022-01-02,7,Sunday,7,5,0
1477542942755762179,2022-01-02 07:31:03,Polres Bogor menerapkan one way untuk antisipasi peningkatan volume kendaraan dari Puncak Bogor menuju Jakarta. One way hanya berlaku bagi kendaraan roda empat. https://t.co/G4FZmttW05,4,0,1,1,2022-01-02,7,Sunday,7,5,1
1477542204067524615,2022-01-02 07:28:07,Warga yang berpergian ke luar kota di periode Nataru mulai tiba di Jakarta. Puncak arus balik warga diperkirakan terjadi hari ini sampai Senin (3/1). Ini suasana Stasiun Pasar Senen:  https://t.co/Vj1NOnlO8u,5,0,1,0,2022-01-02,7,Sunday,7,6,0
1477541451370270720,2022-01-02 07:25:08,"#Terpopuler Irwansyah sedang menghadapi cobaan lantaran ditipu oleh saudaranya sendiri, yakni sang adik. Irwansyah yang masih bisa tersenyum usai ditipu miliaran rupiah. https://t.co/RpbIwkqte1",19,1,3,0,2022-01-02,7,Sunday,7,22,1
1477540698522112004,2022-01-02 07:22:08,Cassandra Angelie pilih sederhana hasil uang sendiri. Ia juga ungkap tipe pria idamannya:  https://t.co/QeM1BpaZkU,16,10,4,3,2022-01-02,7,Sunday,7,20,13
1477539954221850626,2022-01-02 07:19:11,Terjadi kepadatan penumpang di Bandara Yogyakarta International Airport pada puncak libur Nataru 2021. Ada kenaikkan jumlah penumpang hingga 2 kali lipat. Ini potretnya:  https://t.co/A5tQtm6dNn,11,1,2,0,2022-01-02,7,Sunday,7,13,1
1477538967952281602,2022-01-02 07:15:15,"Sudah bukan rahasia lagi, jika Afgan dan Rossa sering tampil mesra di depan publik. Namun mereka tidak pernah mengumumkan hubungan itu adalah cinta. Ini potret mereka:  https://t.co/J5AwolaAnt",23,10,3,1,2022-01-02,7,Sunday,7,26,11
1477538450366676992,2022-01-02 07:13:12,Data Komnas KIPI hingga 30 November 2021 menunjukkan ada 363 KIPI serius yang dilaporkan di RI. Namun belum ada satupun kematian akibat vaksin COVID-19. https://t.co/ALkZvS5nmy,5,0,2,0,2022-01-02,7,Sunday,7,7,0
1477537215089623040,2022-01-02 07:08:18,"Rio Ramadhan, mantan kekasih Kekeyi, dikabarkan meninggal dunia dan jadi perbincangan di media sosial. Begini faktanya:  https://t.co/iiCHlFfnsk",6,3,0,5,2022-01-02,7,Sunday,7,6,8
1477536465018138640,2022-01-02 07:05:19,COVID-19 varian Omicron sudah terdeteksi di Jatim. Pasien pertama yang terdeteksi di Jatim yakni warga Surabaya. #Omicron  https://t.co/rn1SOhj1uZ,12,4,1,1,2022-01-02,7,Sunday,7,13,5
1477535388721946626,2022-01-02 07:01:02,"Vaksin booster atau dosis ketiga dilakukan secara bersembunyi di Surabaya, Jawa Timur. Peminat diharuskan membayar Rp250 ribu. Simak penelusuran #CNNIndonesia selengkapnya di sini #detiknetwork  https://t.co/OfG8opU95Y",14,10,9,7,2022-01-02,7,Sunday,7,23,17
1477534398383890434,2022-01-02 06:57:06,Hari terakhir libur tahun baru dimanfaatkan warga untuk berlibur. Terlihat masih terjadinya antrean kendaraan di gerbang tol Kalihurip Utama menuju Bandung. Begini penampakannya:  https://t.co/XWUUWB7mko,13,0,0,0,2022-01-02,6,Sunday,7,13,0
1477533641895026690,2022-01-02 06:54:06,Bandara Halim Perdanakusuma mau ditutup untuk proses revitalisasi. Beberapa penerbangan akan dipindah ke bandara terdekat.  https://t.co/OOB8GoCTLf,21,1,6,1,2022-01-02,6,Sunday,7,27,2
1477532568987836416,2022-01-02 06:49:50,Indonesia masih harus menunda mimpi untuk menjuarai Piala AFF untuk pertama kalinya. Thailand seakan jadi kryptonite untuk skuad Garuda di laga final. https://t.co/ACW4lVYC9w,10,4,0,0,2022-01-02,6,Sunday,7,10,4
1477531586769960969,2022-01-02 06:45:56,"Salah satu tempat yang cocok untuk dilirik para d'House Hunter adalah Cisauk, yang masuk dalam Kabupaten Tangerang, Banten. Ada apa aja sih di sana? https://t.co/90XaYc0wI1",13,0,1,2,2022-01-02,6,Sunday,7,14,2
1477530597597884417,2022-01-02 06:42:00,"#FOTO Pia Butsakorn merupakan jurnalis cantik kekasih striker timnas Thailand, Supachai Jaided. Ini potretnya:  https://t.co/fl29NtCt23",15,0,1,0,2022-01-02,6,Sunday,7,16,0
1477529612099989506,2022-01-02 06:38:05,"Kemacetan terlihat di sepanjang Jalan Raya Puncak, Cisarua, Bogor, tepatnya menuju Pasar Cisarua. Pantauan sekitar pukul 11.30 WIB, kendaraan melambat. https://t.co/NyI3gWKO9f",1,0,0,0,2022-01-02,6,Sunday,7,1,0
1477528622680449025,2022-01-02 06:34:09,Makan di restoran saat musim liburan perlu memperhatikan 7 etiket ini. Mulai dari sabar menunggu pesanan hingga mengawasi anak-anak. Ini daftarnya:  https://t.co/SBvQdx9rcc,1,2,0,1,2022-01-02,6,Sunday,7,1,3
1477527137657757698,2022-01-02 06:28:15,COVID-19 varian Omicron terdeteksi di Jawa Timur. Pemerintah gencar menyampaikan imbauan waspada varian baru. #Omicron  https://t.co/Jlx1W9ue1x,6,0,2,0,2022-01-02,6,Sunday,7,8,0
1477526643342254081,2022-01-02 06:26:17,"Nagita Slavina punya ketertarikan terhadap beberapa brand fashion ternama, salah satunya Christian Dior. Raffi Ahmad belikan Vespa Dior. Nagita Slavina pun semringah. https://t.co/qkJkc7Jv49",14,0,0,4,2022-01-02,6,Sunday,7,14,4
1477525408535003137,2022-01-02 06:21:23,Naiknya harga gorengan disorot Gubernur Jawa Barat Ridwan Kamil. Ia sampai tepok jidat mengetahui harga gorengan naik. https://t.co/rOH8VALM6Z,119,64,24,34,2022-01-02,6,Sunday,7,143,98
1477524167507738626,2022-01-02 06:16:27,"Jika ditengok sejarahnya, Lembaga Eijkman pernah dipimpin oleh dr Achmad Mochtar yang wafat dipancung karena difitnah oleh tentara Jepang. Begini kisahnya:  https://t.co/V4FmrkQVb6",111,2,16,1,2022-01-02,6,Sunday,7,127,3
1477523675268194305,2022-01-02 06:14:29,"SBS Drama Awards dihelat pada malam tahun baru, 31 Desember 2021. Acara penghargaan itu dihadiri sejumlah artis Korea kenamaan. Ini penampilan mereka:  https://t.co/BuzMIgAjir",5,0,1,0,2022-01-02,6,Sunday,7,6,0
1477522687002124289,2022-01-02 06:10:34,"Sepakbola Asia Tenggara sempat ""mati suri"" gara-gara pandemi virus corona. Piala AFF 2020 diharapkan bisa menghidupkan lagi gairah yang sempat padam. #PialaAFF  https://t.co/wIhVM2sx3K",10,0,1,1,2022-01-02,6,Sunday,7,11,1
1477522179063492608,2022-01-02 06:08:33,Indonesia tetap harus bangga walaupun gagal juara. Cuma Skuad Garuda yang bisa dua kali menjebol gawang Thailand sang juara Piala AFF 2020.  https://t.co/mGdVTi89Dw,69,4,2,3,2022-01-02,6,Sunday,7,71,7
1477520952506388482,2022-01-02 06:03:40,"Aaron Ramsdale memuji penampilan Arsenal saat kalah tipis dari Manchester City. Meski demikian, ia juga mengakui The Gunners selevel dengan The Citizens.  https://t.co/T43WDG83Na",2,0,0,0,2022-01-02,6,Sunday,7,2,0
1477520147283951616,2022-01-02 06:00:28,"Durian di Kampung Organik Kabupaten Jepara, Jawa Tengah rasanya istimewa. Durian inipun jadi incaran pembeli saat liburan menjelang Tahun Baru 2022. https://t.co/oNMrhUYDfs",13,2,1,0,2022-01-02,6,Sunday,7,14,2
1477518922643652608,2022-01-02 05:55:36,Habib Muhammad Luthfi bin Yahya dikukuhkan sebagai Ketua Kelompok Ahli BNPT. BNPT berkolaborasi dengan tokoh agama untuk mencegah aksi terorisme di Indonesia. https://t.co/w7InAbZLn3,54,10,3,1,2022-01-02,5,Sunday,7,57,11
1477518126111678465,2022-01-02 05:52:26,"Sebanyak 30 ribu orang mendaftar untuk kunjungi Taman Margasatwa Ragunan, Minggu (2/1).Pukul 08.00 WIB, pengunjung sudah mulai berdatangan.  https://t.co/i1OqvCB852",7,0,0,1,2022-01-02,5,Sunday,7,7,1
1477516897218437121,2022-01-02 05:47:33,"Di wisata alam Tirtosari, pengunjung bisa berenang dan berfoto under water bersama ikan koi yang warna-warni. Wisata ini di Kecamatan Candipuro, Lumajang. https://t.co/sj4HAzgucM",15,0,3,0,2022-01-02,5,Sunday,7,18,0
1477516152200908800,2022-01-02 05:44:36,Awal tahun baru 2022 di Inggris dirayakan di tengah rekor terkini kasus harian Corona. Rekor kembali tercatat dengan 162.572 kasus sehari. #Inggris  https://t.co/p68x3S0sfn,8,0,6,1,2022-01-02,5,Sunday,7,14,1
1477515160512344068,2022-01-02 05:40:39,Orang Korea gemar makan ubi saat diet karena lezat dan tinggi kandungan serat. Ini 5 kreasi ubi agar tak bosan menikmatinya:  https://t.co/0YlefI9xGV,40,1,7,1,2022-01-02,5,Sunday,7,47,2
1477514172032327680,2022-01-02 05:36:44,"Merunut ke belakang, Lembaga Eijkman merupakan aset langka negeri ini dalam penanganan wabah penyakit sejak zaman kolonial Belanda. Ini sejarahnya:   https://t.co/nA7GWEb2t5",65,1,14,1,2022-01-02,5,Sunday,7,79,2
1477513430659739648,2022-01-02 05:33:47,Axel Djody Gondokusumo mengaku dipukul oleh seorang pria. Orang tersebut diduga anak dari seorang artis terkenal. Siapakah dia? https://t.co/DSMempSpny,5,3,0,0,2022-01-02,5,Sunday,7,5,3
1477512185081475072,2022-01-02 05:28:50,Ini dia lima berita entertainment terpopuler minggu ini. Mulai dari Ririn Dwi Ariyanti dan Aldi Bragi resmi cerai hingga Cassandra Angelie terjerat kasus prostitusi:  https://t.co/WzaNQrfaae,3,0,0,0,2022-01-02,5,Sunday,7,3,0
1477510947589742593,2022-01-02 05:23:55,V BTS mengungkapkan bahwa tipe kepribadiannya berubah dari ekstrovert ke introvert. Bisakah kepribadian seseorang berubah? Ini faktanya:  https://t.co/rkjHRm6PZW,27,3,12,4,2022-01-02,5,Sunday,7,39,7
1477509714795716613,2022-01-02 05:19:01,Tottenham Hotspur melanjutkan catatan tak terkalahkan saat menundukkan Watford. Sang manajer Antonio Conte juga membukukan rekor baru. https://t.co/jXyxzP9u8Q,5,0,1,0,2022-01-02,5,Sunday,7,6,0
1477508452419309573,2022-01-02 05:14:00,"Seorang suami di Blora tega menculik, menyekap hingga memperkosa istrinya sendiri. Bahkan untuk melancarkan aksinya itu, MUS menyewa jasa penculikan. https://t.co/Y1zpIXBQyK",351,156,53,81,2022-01-02,5,Sunday,7,404,237
1477507704771989507,2022-01-02 05:11:02,Bintang OnlyFans Jackson O'Doherty menyambut 2022 dengan menggelar pesta Tahun Baru yang meriah dan 'liar'. Ini potretnya:  https://t.co/wHMiXFly5v,7,0,1,1,2022-01-02,5,Sunday,7,8,1
1477506467427192832,2022-01-02 05:06:07,"Cucu Presiden Jokowi, Jan Ethes menunjukkan kepiawaiannya mengenal para pemimpin dunia. Jan Ethes berhasil menjawab nama Presiden AS hingga Presiden China. https://t.co/ZUGwocDAqx",23,0,2,2,2022-01-02,5,Sunday,7,25,2
1477505387016466432,2022-01-02 05:01:49,"Penerimaan pajak tembus 100% dari target tahun ini. Itu artinya, pegawai Ditjen Pajak Kementerian Keuangan bakal mendapatkan tunjangan kinerja alias tukin 100%. https://t.co/3TlGy3HvvI",30,30,7,8,2022-01-02,5,Sunday,7,37,38
1477504367326642177,2022-01-02 04:57:46,Komnas Perempuan mendesak polisi agar konsumen dari prostitusi online artis Cassandra Angelie diungkap oleh pihak kepolisian dan berharap konsumennya bisa dikenakan pidana. https://t.co/bUlGKPWKnD,145,68,21,11,2022-01-02,4,Sunday,7,166,79
1477503606668603395,2022-01-02 04:54:45,"Video debat panas Habib Bahar Smith dan Danrem 061 Surya Kencana, Brigjen Achmad Fauzi beredar luas di jagat maya. Masing-masing pihak berikan penjelasan. https://t.co/Vqx8Dx8wIi",7,1,1,1,2022-01-02,4,Sunday,7,8,2
1477502868462743556,2022-01-02 04:51:49,Ricky Kambuaya tampil bagus selama memperkuat Timnas Indonesia di Piala AFF 2020. Ia ngaku siap andai mendapat tawaran bermain di luar negeri. https://t.co/x5iQesnpRd,62,1,3,0,2022-01-02,4,Sunday,7,65,1
1477501881526243329,2022-01-02 04:47:53,#FOTO Almira Andani tak cuma jago menyanyi. Pelantun Jangan Ubah Takdirku ternyata juga lihai olahraga berkuda. Ini potretnya:  https://t.co/xCZjkG4c7F,2,0,0,1,2022-01-02,4,Sunday,7,2,1
1477500765770067969,2022-01-02 04:43:27,"Beredar viral pasangan yang beda usia 14 tahun, 2004 istri masih TK. Sedangkan suami sudah menjadi anggota polisi. Ini kisahnya:  https://t.co/VgqhR6OZaB",7,0,0,2,2022-01-02,4,Sunday,7,7,2
1477499775079563265,2022-01-02 04:39:31,Badan Antariksa Nasional China merilis 4 foto terbaru kondisi Mars yang diabadikan oleh robot penjelajah Zhurong. #Mars  https://t.co/l5kSZu2Egy,9,0,3,1,2022-01-02,4,Sunday,7,12,1
1477498551135518720,2022-01-02 04:34:39,Malaysia menangguhkan perjalanan umrah ke Arab Saudi mulai 8 Januari 2022 mendatang sampai waktu yang belum bisa ditentukan. #Malaysia  https://t.co/kcY9fIaoHJ,18,2,3,1,2022-01-02,4,Sunday,7,21,3
1477497792843157507,2022-01-02 04:31:39,Pemenang kontes bokong terendah Miss BumBum ini jadi kontroversi. Dia akan melakukan hal yang tak terduga jika Messi menang.  https://t.co/ltfUO92oME,12,1,1,1,2022-01-02,4,Sunday,7,13,2
1477496802999951363,2022-01-02 04:27:43,Berikut deretan pernikahan unik dan viral yang membuat warganet heboh di media sosial. Ada nikah di gang sempit habiskan ratusan juta! https://t.co/tzZm9ibBoe,4,2,0,1,2022-01-02,4,Sunday,7,4,3
1477495566691143683,2022-01-02 04:22:48,Lee Jung Jae membocorkan bahwa Gi Hun akan kembali ke arena Squid Game di season 2. Tapi misinya bisa jadi berbeda. #SquidGame  https://t.co/FLQ6Zkhg1C,6,2,4,1,2022-01-02,4,Sunday,7,10,3
1477494330885562370,2022-01-02 04:17:53,Nama Nualphan Lamsam muncul di sejumlah pemberitaan saat gelaran Piala AFF 2020. Manajer Timnas Thailand ini ternyata pemilik distributor mobil mewah. https://t.co/iNuCfPwPOw,6,0,1,0,2022-01-02,4,Sunday,7,7,0
1477493825337757696,2022-01-02 04:15:53,Andina Julie dinobatkan sebagai Miss Grand Indonesia 2022 dan akan mewakili Indonesia di Miss Grand International. Ini sosoknya:  https://t.co/Or80ruZFT1,5,0,0,0,2022-01-02,4,Sunday,7,5,0
1477493092676734981,2022-01-02 04:12:58,"20Detik merangkum kejadian heboh dan menarik dalam sepekan ini. Apa saja, ya? Simak dalam video berikut ini:  https://t.co/wDLaR4uJ27",0,0,0,0,2022-01-02,4,Sunday,7,0,0
1477492600466718721,2022-01-02 04:11:01,#Terpopuler Mohammad Ahsan hingga Kevin Sanjaya Sukamuljo mengunggah di media sosial soal bonus Rp 10 miliar Piala Thomas 2020. Isinya berupa sindiran? https://t.co/hYQgWtgQEq,64,21,9,1,2022-01-02,4,Sunday,7,73,22
1477491598141411332,2022-01-02 04:07:02,"Skuter listrik Ola sempat jadi fenomena di India saat dijual dengan banderol murah meski kaya fitur. Kini saat motornya di tangan konsumen, protes bermunculan. https://t.co/fzgAoTkGtl",2,0,0,0,2022-01-02,4,Sunday,7,2,0
1477490368786710529,2022-01-02 04:02:09,Tim Waspada COVID-19 dari lembaga Eijkman mengumumkan perpisahannya di awal tahun 2022. Sejumlah warganet bertanya-tanya terkait perpisahan itu. https://t.co/mkOX8vNGZL,7,1,0,0,2022-01-02,4,Sunday,7,7,1
1477490130055225350,2022-01-02 04:01:12,"Situasi arus lalu lintas di Simpang Gadog, Bogor, Jawa Barat sekitar pukul 08.30 WIB terpantau ramai lancar. Kendaraan menuju Puncak lebih dominan dibanding arah sebaliknya. https://t.co/zhF9bHzsaV",1,0,1,0,2022-01-02,4,Sunday,7,2,0
1477490111159881728,2022-01-02 04:01:07,Fortune Teller Beby Djenar membagikan prediksinya tentang 5 zodiak yang mendapat kesuksesan besar dari segi keuangan di tahun 2022. Apa saja ya? Yuk simak! #detiknetwork  https://t.co/0C4gusTwVt,2,0,1,1,2022-01-02,4,Sunday,7,3,1
1477489125158707200,2022-01-02 03:57:12,Naura Sabrina Galiyah (9) yang meninggal setelah disuntik vaksin Sinovac dimakamkan tanpa diautopsi. Polisi menyebut orang tua korban menolak autopsi. https://t.co/TcROrX2KCx,4,1,1,1,2022-01-02,3,Sunday,7,5,2
1477488394112483329,2022-01-02 03:54:18,"Dear Aquarius, menunggu adalah langkah terbaik yang harus diterapkan untuk saat ini. Bagaimana dengan ramalan zodiak kamu hari ini? Simak di sini:  https://t.co/f0JfYWDUPH",6,0,0,0,2022-01-02,3,Sunday,7,6,0
1477487888992555008,2022-01-02 03:52:17,Shin Tae-yong memuji permainan Indonesia yang menahan imbang Thailand 2-2 pada leg kedua final Piala AFF 2020. Ia menyayangkan kekalahan telak di leg pertama. https://t.co/lowVGYs0Ae,59,0,1,1,2022-01-02,3,Sunday,7,60,1
1477487379338469381,2022-01-02 03:50:16,Ibu Kota Jakarta perlahan mulai berbenah jadi lebih rapi dan bersih. Siapa sangka di balik itu semua ada secuil peran PPSU alias pasukan oranye. Ini potretnya:  https://t.co/mbtTeI1wdK,52,7,1,4,2022-01-02,3,Sunday,7,53,11
1477486367433236487,2022-01-02 03:46:15,Liverpool mendapat ujian berat kala menghadapi Chelsea akhir pekan ini. Manajer Juergen Klopp dipastikan absen karena positif COVID-19. #JuergenKlopp  https://t.co/4l4JfZ6zLT,11,0,4,1,2022-01-02,3,Sunday,7,15,1
1477485919590662148,2022-01-02 03:44:28,"Kasus Corona di dunia mencapai 288.628.287 per Sabtu (1/1/2022), pukul 20.00 WIB, berdasarkan data Worldometers. Sementara untuk kasus sembuh mencapai 253.856.539 pasien. https://t.co/lrCV0G0wjp",3,0,2,1,2022-01-02,3,Sunday,7,5,1
1477484903382106113,2022-01-02 03:40:25,#Terpopuler Seorang pria berinisial DI jadi tersangka karena menikam pria diduga begal hingga tewas. Polisi menjelaskan alasan mengapa DI dijerat sebagai tersangka. https://t.co/HYCP43f2ad,10,14,2,4,2022-01-02,3,Sunday,7,12,18
1477483661960355840,2022-01-02 03:35:29,BIGHIT Entertainment sudah berikan bantahan soal RM pacaran. Kini RM buka suara dan membantah langsung secara personal. #RM #BTS  https://t.co/Vo143R6s1m,9,2,2,1,2022-01-02,3,Sunday,7,11,3
1477482426196766720,2022-01-02 03:30:35,"Cassandra Angelie jadi sorotan usai diamankan polisi karena kasus prostitusi online. Hidup mandiri, Cassandra Angelie mengatakan mesti bisa masak. https://t.co/M0Oo9mhsnW",21,14,2,4,2022-01-02,3,Sunday,7,23,18
1477481117288734720,2022-01-02 03:25:23,Masalah perceraian Ririn Dwi Ariyanti dengan Aldi Bragi sudah berakhir. Pengadilan mengungkap beban nafkah yang dipenuhi Aldi terhadap Ririn.  https://t.co/LQ3v1JW6Sb,8,0,0,0,2022-01-02,3,Sunday,7,8,0
1477479967327981573,2022-01-02 03:20:49,Departemen Luar Negeri AS menaikkan biaya paspor. Kenaikan itu termasuk untuk pembuatan paspor baru atau perpanjangan. #Paspor  https://t.co/a9IdviKzLN,6,0,1,0,2022-01-02,3,Sunday,7,7,0
1477478682654564354,2022-01-02 03:15:42,Lagi-lagi siswa SD meninggal usai divaksin COVID-19. Kali ini menimpa Naura Sabrina Galiyah (9). Naura meninggal setelah disuntik Vaksin Sinovac dosis pertama. https://t.co/xovWglMakU,134,20,39,7,2022-01-02,3,Sunday,7,173,27
1477477691691520001,2022-01-02 03:11:46,"Harapan Berlliana Lovell tiap tahun baru. Ia ingin nikah, tapi belum ketemu jodoh...  https://t.co/3gQKSaZGiz",11,1,0,3,2022-01-02,3,Sunday,7,11,4
1477476701995212809,2022-01-02 03:07:50,"dr. Rinal Dhuhri (32) buka praktik dokter di Depok dengan bayaran seikhlasnya, bahkan pernah dengan sayuran hingga biskuit. Ini kisahnya:  https://t.co/E9nRqshUJU",93,8,19,4,2022-01-02,3,Sunday,7,112,12
1477475957053214725,2022-01-02 03:04:52,"Shin Tae-yong kecewa atas sanksi yang diberikan pemerintah Singapura terhadap Elkan Baggott, Victor Igbonefo, Rizky Ridho, dan Rizky Dwi. https://t.co/EMHp1Nckmz",35,3,0,1,2022-01-02,3,Sunday,7,35,4
1477475053486977025,2022-01-02 03:01:17,Kronologi empat pemain Timnas RI dilarang bermain di final leg 2 piala AFF 2020 pada Sabtu (1/1/2022) karena dianggap melanggar aturan COVID-19 di Singapura. https://t.co/OooghKMKiw,10,0,1,0,2022-01-02,3,Sunday,7,11,0
1477474427084361730,2022-01-02 02:58:48,"Pelatih Thailand, Alexandre Polking, menilai Indonesia punya masa depan cerah. Ia memuji semangat pentang menyerah pasukan muda Garuda di final Piala AFF 2020. https://t.co/qPragX48a5",76,10,4,1,2022-01-02,2,Sunday,7,80,11
1477473416697585678,2022-01-02 02:54:47,Manchester City lagi panas dan sulit diadang lawan-lawannya di Liga Inggris. Citizens menorehkan kemenangan ke-11 beruntun usai mengalahkan Arsenal. Top! https://t.co/l724mX77Ju,11,1,4,1,2022-01-02,2,Sunday,7,15,2
1477472674662305793,2022-01-02 02:51:50,Hujan deras mengguyur Semeru membuat banjir lahar dingin ke Sejumlah Daerah Aliran Sungai. Salah satunya Sungai Leprak hingga membuat rumah terbawa arus. https://t.co/EN04QnHtu5,8,0,1,0,2022-01-02,2,Sunday,7,9,0
1477472179243696138,2022-01-02 02:49:52,Jenderal TNI mengatakan pihaknya tak segan membubarkan ceramah Habib Bahar jika provokatif. Pengacara mengatakan Habib Bahar tetap melakukan ceramah. https://t.co/TfYCixXd5o,25,27,3,3,2022-01-02,2,Sunday,7,28,30
1477470942037172226,2022-01-02 02:44:57,Pelaku pembunuhan para PSK ini adalah Richard Francis Cottingham. Sepintas tampaknya Richard mustahil jadi tersangka pembunuhan sadis. Ini sosoknya:  https://t.co/p4OmxOE0V8,6,0,3,1,2022-01-02,2,Sunday,7,9,1
1477469702406524928,2022-01-02 02:40:01,"Kemenkes melaporkan 68 kasus baru COVID-19 varian Omicron. Ada pasien yang mengalami gejala sedang, ini laporan Kemenkes lebih lanjut:  https://t.co/Z2n1gVFk3n",11,0,4,4,2022-01-02,2,Sunday,7,15,4
1477468430668288001,2022-01-02 02:34:58,"Berbagai legenda mengatakan neraka bukan hanya bagian dari akhirat, tetapi dapat diakses dari Bumi. Tempat-tempat ini diyakini adalah gerbang menuju neraka:  https://t.co/4wCmR2ilZB",6,2,2,1,2022-01-02,2,Sunday,7,8,3
1477467184486039552,2022-01-02 02:30:01,"BRIN menyampaikan sedang melakukan perampingan di kapal riset, termasuk Kapal Baruna Jaya. Oleh sebab itu, mereka memutus kontrak beberapa awak kapal non PNS. https://t.co/hZTTBAYoLK",17,2,5,3,2022-01-02,2,Sunday,7,22,5
1477466440001331200,2022-01-02 02:27:03,China lakukan lockdown ketat di Kota Xi'an imbas kasus COVID-19 yang naik. Warga tidak diperkenankan keluar rumah kecuali untuk tes Corona. #China  https://t.co/afClLCR1o4,14,0,3,1,2022-01-02,2,Sunday,7,17,1
1477465209916870669,2022-01-02 02:22:10,BNPT mengukuhkan Habib Muhammad Luthfi bin Yahya sebagai Ketua Kelompok Ahli BNPT. Hal itu sebagai upaya pencegahan aksi terorisme. https://t.co/MLkfyMwfjT,57,4,15,3,2022-01-02,2,Sunday,7,72,7
1477463959188000770,2022-01-02 02:17:12,Curhatan lama Cassandra Angelie soal kehidupan pribadinya tuai sorotan. Dia buka-bukaan soal cowok mesum hingga ditusuk sahabat. #CassandraAngelie  https://t.co/LQO00XFpbQ,12,3,0,0,2022-01-02,2,Sunday,7,12,3
1477462472596537345,2022-01-02 02:11:18,Menyantap makanan di pesawat sudah jadi hal biasa yang dilakukan penumpang. Tapi jangan makan makanan yang sudah jatuh di meja lipat ya! https://t.co/GyQEKm7pYG,4,0,0,2,2022-01-02,2,Sunday,7,4,2
1477461238540034058,2022-01-02 02:06:23,"Saat naik pesawat, sebaiknya traveler memilih pakaian yang tepat agar nyaman selama penerbangan. Bahkan, ada pakaian sebaiknya tak dikenakan di pesawat. https://t.co/FPl85kKy2k",2,0,3,1,2022-01-02,2,Sunday,7,5,1
1477459913630748674,2022-01-02 02:01:07,Gubernur Sumatera Utara Edy Rahmayadi mengaku punya ciri khas sebagai sosok tegas dan susah senyum. Mantan Pangkostrad itu pernah sakit selama tiga bulan gara-gara diminta mengubah kebiasaannya. #CNNIndonesia #detiknetwork  https://t.co/bETqUC7QJR,155,144,50,57,2022-01-02,2,Sunday,7,205,201
1477458841637900292,2022-01-02 01:56:52,Cassandra Angelie membuka diri. Dia ngaku tidak percaya pada siapa pun sehingga membuatnya tidak punya teman. #CassandraAngelie  https://t.co/Z4mVqkobTj,65,42,16,12,2022-01-02,1,Sunday,7,81,54
1477457852507824129,2022-01-02 01:52:56,Thailand sukses menjuarai Piala AFF 2020. Media-media lokal Negeri Gajah Putih itu menyambut gelar tersebut dengan suka cita. #Thailand  https://t.co/GGE4IuZzMb,15,1,2,0,2022-01-02,1,Sunday,7,17,1
1477457108157227008,2022-01-02 01:49:59,"Anak Ayu Azhari, Axel Djody Gondokusumo, ngaku dipukul oleh orang tak dikenal di sebuah beach club. Ia rugi mental dan materi. https://t.co/I6vHc855iP",6,1,1,2,2022-01-02,1,Sunday,7,7,3
1477456618317041665,2022-01-02 01:48:02,Chanathip Songkrasin berperan besar dalam keberhasilan Thailand juara Piala AFF 2020. Kapten 'Gajah Perang' itu dinobatkan sebagai pemain terbaik.  https://t.co/hGepuNBaHL,7,0,0,1,2022-01-02,1,Sunday,7,7,1
1477455626338979841,2022-01-02 01:44:05,"Jalan-jalan ke Bantul, tentu sayang melewatkan berkunjung ke Hutan Pinus Mangunan. Ini spot cantik untuk wisatawan foto-foto:  https://t.co/INv0OpoiTR",12,0,4,0,2022-01-02,1,Sunday,7,16,0
1477454603356622853,2022-01-02 01:40:01,Cassandra Angelie bilang lebih dari 10 akun pria mengirimkan foto tidak senonoh ke DM-nya. Ia merasa dijebak oleh pria tersebut karena isi pesannya. https://t.co/mad7s3iuvs,8,6,1,2,2022-01-02,1,Sunday,7,9,8
1477453366817140744,2022-01-02 01:35:07,"LBM Eijkman telah terintegrasi ke dalam BRIN. Eks Ketua LBM Eijkman, Profesor Amin Soebandrio buka suara soal isu ilmwuan Eijkman yang kehilangan pekerjaan:  https://t.co/qYe2iceIBy",13,1,6,0,2022-01-02,1,Sunday,7,19,1
1477452336180125698,2022-01-02 01:31:01,"Pratama Arhan terpilih jadi pemain muda terbaik di Piala AFF 2020. Ia mengalahkan dua kompatriotnya, Witan Sulaeman dan Alfeandra Dewangga. https://t.co/8D0MSORz8u",174,0,14,1,2022-01-02,1,Sunday,7,188,1
1477451109220429824,2022-01-02 01:26:08,Ketua Komnas KIPI menegaskan belum ada kasus meninggal yang disebabkan vaksinasi COVID-19. Investigasi telah dilakukan untuk membuktikan hal tersebut. https://t.co/DK9HmaE0Nb,8,4,4,2,2022-01-02,1,Sunday,7,12,6
1477449821007003655,2022-01-02 01:21:01,"Setidaknya ada enam rekomendasi destinasi wisata yang patut traveler kunjungi lagi di tahun 2022. Pasti istimewa dan di Indonesia saja, di mana saja letaknya? https://t.co/J4wwreoars",8,0,2,0,2022-01-02,1,Sunday,7,10,0
1477448586619142145,2022-01-02 01:16:07,"Seorang turis mabuk masuk ke istana Presiden Rumania setelah memanjat tembok setinggi 1,8 meter. Dia mengira Balai Kota itu sebuah hotel. https://t.co/wQqovvCzCC",12,2,1,0,2022-01-02,1,Sunday,7,13,2
1477447552937218053,2022-01-02 01:12:00,Lembaga Biologi Molekuler Eijkman kini dilebur ke dalam BRIN. Nasib para ilmuwan yang menjadi peneliti hingga staf jadi bahasan. BRIN memberi opsi ini:  https://t.co/9osmC3Iijk,8,2,7,0,2022-01-02,1,Sunday,7,15,2
1477446582907936769,2022-01-02 01:08:09,Elkan Baggott beri klarifikasi usai dilarang tampil di leg kedua final Piala AFF 2020. Ia ngaku tak tahu kalau telah melanggar batas bubble di Singapura. #ElkanBagott  https://t.co/G6aYvpiu2h,19,2,3,1,2022-01-02,1,Sunday,7,22,3
1477445599427543043,2022-01-02 01:04:15,PTM Terbatas 2022 di dalam kelas harus dilaksanakan dengan tetap menerapkan protokol kesehatan yang sudah diatur. Begini penjelasannya: https://t.co/OIzmm5uhi7,6,1,0,0,2022-01-02,1,Sunday,7,6,1
1477444659131658247,2022-01-02 01:00:30,Komnas Perempuan menyambut baik rencana Kapolri yang mengubah Subdirektorat Pelayanan Perempuan dan Anak (PPA) menjadi Direktorat di Mabes Polri. https://t.co/O6OHnjyl2I,7,0,0,0,2022-01-02,1,Sunday,7,7,0
1477444188044148737,2022-01-02 00:58:38,Pelaku pembunuhan para PSK ini adalah Richard Francis Cottingham. Sepintas tampaknya Richard mustahil jadi tersangka pembunuhan sadis ini. https://t.co/nFPh6P19hl,24,2,2,2,2022-01-02,0,Sunday,7,26,4
1477444166460260352,2022-01-02 00:58:33,"Selesai sudah perhelatan Piala AFF 2020. Ada empat pemain, termasuk dua penggawa Thailand, yang jadi top scorer. Ini daftarnya:  https://t.co/jSrQn18vha",5,0,0,0,2022-01-02,0,Sunday,7,5,0
1477443671956107268,2022-01-02 00:56:35,Tottenham Hotspur berhasil mengalahkan Watford 1-0. Davinson Sanchez jadi penentu kemenangan The Lilywhites berkat golnya di menit akhir. https://t.co/tq2B4tE3wW,2,0,0,0,2022-01-02,0,Sunday,7,2,0
1477443398189690883,2022-01-02 00:55:30,Antonio Conte catatkan rekor baru bersama Tottenham. Spurs tak kalah dalam 8 laga beruntun di Liga Inggris. Ada 5 kemenangan dan 3 seri yang didapat Tottenham. https://t.co/rKD1atEn9G,3,0,1,0,2022-01-02,0,Sunday,7,4,0
1477443168236937218,2022-01-02 00:54:35,"LBM Eijkman telah terintegrasi ke dalam BRIN. Eks Ketua LBM Eijkman, Profesor Amin Soebandrio buka suara mengenai isu ilmwuan Eijkman yang kehilangan pekerjaan. https://t.co/UghVbeg3Bo",6,2,3,0,2022-01-02,0,Sunday,7,9,2
1477442924250079235,2022-01-02 00:53:37,Thailand sukses menjuarai Piala AFF 2020. Media-media lokal Negeri Gajah Putih itu pun menyambut gelar tersebut dengan suka cita. https://t.co/5hTUkz71Du,10,0,0,0,2022-01-02,0,Sunday,7,10,0
1477442431020904449,2022-01-02 00:51:39,"Habib Bahar berdebat panas dengan Danrem 061 Surya Kencana, Brigjen Achmad Fauzi. Habib Bahar diminta untuk tidak menghina KSAD Jenderal Dudung Abdurachman. https://t.co/yD9DA1EpMM",11,7,0,1,2022-01-02,0,Sunday,7,11,8
1477441685269487616,2022-01-02 00:48:41,Jenderal TNI mengatakan pihaknya tak segan membubarkan ceramah Habib Bahar jika provokatif. Pengacara mengatakan Habib Bahar akan tetap melakukan ceramah. https://t.co/UokpRtdIwf,69,38,19,7,2022-01-02,0,Sunday,7,88,45
1477440882655862784,2022-01-02 00:45:30,"Enam pengedar ganja, sabu dan obat-obatan terlarang diringkus Satuan Reserse Narkoba Polres Sukabumi. https://t.co/aSSazwdDPb",1,0,1,0,2022-01-02,0,Sunday,7,2,0
1477440603080343553,2022-01-02 00:44:23,"Untuk menghindari orgasme lebih cepat, pria harus tahu posisi seks yang tepat, salah satunya posisi berdiri. Posisi ini bisa menghindari ejakulasi dini. https://t.co/zntlpCZ7KF",9,1,4,0,2022-01-02,0,Sunday,7,13,1
1477439859123965966,2022-01-02 00:41:26,"Untuk diketahui, Jong-Un menyampaikan pidato menjelang tahun baru untuk menandai 10 tahun kekuasaannya. https://t.co/pPMiFyW8fV",3,0,0,1,2022-01-02,0,Sunday,7,3,1
1477439364456136710,2022-01-02 00:39:28,"Habib Bahar terlibat debat panas dengan Danrem 061 Surya Kencana, Brigjen Achmad Fauzi. Usai peristiwa tersebut, Brigjen Achmad memberikan Bahar peringatan. https://t.co/3Tbb5Hdast",82,33,13,5,2022-01-02,0,Sunday,7,95,38
1477437856868098056,2022-01-02 00:33:29,Masih ingat dengan Fabio Coentrao? Eks bek Real Madrid dan sahabatnya Cristiano Ronaldo kini banting setir jadi nelayan! https://t.co/EfUlkUxIsc,20,1,3,2,2022-01-02,0,Sunday,7,23,3
1477437391879258113,2022-01-02 00:31:38,"Wali Kota Solo Gibran Rakabuming Raka mengundang seluruh tim Persis Solo ke rumah dinas Loji Gandrung, Sabtu (1/1). Itu setelah Persis lolos ke Liga 1. https://t.co/GzOppjHXfU",17,0,0,1,2022-01-02,0,Sunday,7,17,1
1477436643946774533,2022-01-02 00:28:40,PT Kereta Api Indonesia (KAI) Daop 2 Bandung menurunkan harga tes antigen dari Rp 45 ribu menjadi Rp 35 ribu. https://t.co/aEn3OORkOK,22,6,4,1,2022-01-02,0,Sunday,7,26,7
1477436150398730257,2022-01-02 00:26:42,"LBM Eijkman telah terintegrasi ke dalam BRIN. Eks Ketua LBM Eijkman, Profesor Amin Soebandrio buka suara mengenai isu ilmwuan Eijkman yang kehilangan pekerjaan. https://t.co/MVIceuLL5x",10,1,4,0,2022-01-02,0,Sunday,7,14,1
1477435654279778305,2022-01-02 00:24:44,"Kemenkes melaporkan 68 kasus baru COVID-19 varian Omicron. Terdapat pasien yang mengalami gejala sedang, berikut laporan Kemenkes lebih lanjut. https://t.co/ITtKZFzg6b",11,0,4,2,2022-01-02,0,Sunday,7,15,2
1477435122332971012,2022-01-02 00:22:37,"Ribuan pengunjung memadati Wisata Umbul Bening, Glenmore, Banyuwangi. Destinasi wisata pemandian ini banyak di antara pengunjung yang mengabaikan prokes. https://t.co/g5xhtOxFqC",6,0,0,0,2022-01-02,0,Sunday,7,6,0
1477434621730115587,2022-01-02 00:20:37,Danrem 061 Brigjen Achmad Fauzi mengimbau Habib Bahar memberikan ceramah kedamaian. Dia akan membubarkan ceramah Habib Bahar jika ada unsur provokatif. https://t.co/dOOPmEALpX,410,161,41,24,2022-01-02,0,Sunday,7,451,185
1477433876494618632,2022-01-02 00:17:40,WHO mengharapkan pandemi Corona bisa berakhir di tahun 2022. Iran mengakui kegagalan dalam peluncuran roket yang membawa perangkat penelitian ke luar angkasa. https://t.co/9WYGERu3Xs,5,0,3,0,2022-01-02,0,Sunday,7,8,0
1477433387124248580,2022-01-02 00:15:43,"Filipina melaporkan tambahan nyaris 3.000 kasus virus Corona (COVID-19) dalam sehari, yang tercatat sebagai lonjakan kasus tertinggi dalam dua bulan terakhir. https://t.co/BcwFOE2a0K",3,0,2,1,2022-01-02,0,Sunday,7,5,1
1477432902329769990,2022-01-02 00:13:47,Wisata di Kabupaten Pasuruan ramai pada libur Tahun Baru 2022. Pemerintah memang mengizinkan tempat-tempat wisata buka meski Omicron mengintai. https://t.co/Dd25G9S0jW,6,1,1,1,2022-01-02,0,Sunday,7,7,2
1477432396878422022,2022-01-02 00:11:47,Ribuan pengunjung menikmati libur Tahun Baru di Kebun Binatang Surabaya (KBS). Pengelola KBS juga menyiapkan puluhan satgas mandiri awasi pengunjung. https://t.co/APAlc9mAgQ,1,1,0,0,2022-01-02,0,Sunday,7,1,1
1477431899480076289,2022-01-02 00:09:48,Polisi membongkar markas penyuplai PSK di Garut. Komisi II DPR RI meminta agar Pemda peduli dengan kasus prostitusi. https://t.co/jul7dFgBY1,16,0,1,1,2022-01-02,0,Sunday,7,17,1
1477431403709149185,2022-01-02 00:07:50,"Aparat Polres Ciamis menindak restoran, kafe dan bar yang berada di kompleks wisata Kampung Turis Pantai Pangandaran. https://t.co/08TJo6BPMp",6,0,0,0,2022-01-02,0,Sunday,7,6,0
1477430874744496131,2022-01-02 00:05:44,Shin Tae-yong memuji permainan Indonesia yang menahan imbang Thailand 2-2 pada leg kedua final Piala AFF 2020. Ia menyayangkan kekalahan telak di leg pertama. https://t.co/gRzqqDWSPB,34,2,2,0,2022-01-02,0,Sunday,7,36,2
1477429789627756544,2022-01-02 00:01:25,Liverpool mengantisipasi laga sulit lainnya melawan Chelsea. 'Si Merah' belum lupa alotnya pertemuan terakhir di Anfield. https://t.co/N9J4OELTe4,5,0,0,0,2022-01-02,0,Sunday,7,5,0
1477428984702984199,2022-01-01 23:58:13,Lembaga Biologi Molekuler Eijkman kini dilebur ke dalam BRIN. Nasib para ilmuwan yang menjadi peneliti hingga staf menjadi bahasan. BRIN memberi opsi-opsi. https://t.co/7qBzCbDSB4,15,4,6,1,2022-01-01,23,Saturday,6,21,5
1477428490546913285,2022-01-01 23:56:16,Ketua Komnas KIPI menegaskan belum ada kasus meninggal yang disebabkan vaksinasi COVID-19. Investigasi telah dilakukan untuk membuktikan hal tersebut. https://t.co/20Sd7L0hac,8,2,2,3,2022-01-01,23,Saturday,6,10,5
1477427748343894017,2022-01-01 23:53:19,"Petugas Dishub Kota Bekasi nekat melawan arus di Simpang Gadog, Bogor. Anggota Komisi V DPR berharap petugas diberi sanksi oleh Dishub. https://t.co/BKlsWHAiag",12,4,2,0,2022-01-01,23,Saturday,6,14,4
1477426960175353857,2022-01-01 23:50:11,"Liga China sedang melakukan revolusi ke arah yang lebih baik. Klub-klub disetop berikan gaji selangit, serta pemain harus lebih sopan nggak boleh tatoan! https://t.co/deSkUEsdxj",37,4,7,2,2022-01-01,23,Saturday,6,44,6
1477426707242131459,2022-01-01 23:49:10,Pihak Habib Bahar menyindir Animal Defender yang tak bersuara saat ada teror tiga kepala anjing di pesantrennya terjadi. Animal Defender Indonesia merespons. https://t.co/RHoKFTYRPV,65,48,11,5,2022-01-01,23,Saturday,6,76,53
1477425208554360835,2022-01-01 23:43:13,Shin Tae-yong kecewa dengan Pemerintah Singapura yang melarang empat pemainnya tampil di final leg kedua Piala AFF 2020. Ia heran dengan sistem bubble yang ada. https://t.co/6XNMlBtWgn,68,7,5,0,2022-01-01,23,Saturday,6,73,7
1477425207358935045,2022-01-01 23:43:13,"dr. Rinal Dhuhri (32) buka praktik dokter di Depok dengan bayaran seikhlasnya, bahkan pernah dengan sayuran hingga biskuit. https://t.co/LVVDmoaZhv",1065,44,206,37,2022-01-01,23,Saturday,6,1271,81
1477424986746982405,2022-01-01 23:42:20,"Libur Tahun Baru 1 Januari diisi kader PDIP Surabaya bergerak turun ke masyarakat, khususnya ke wong cilik. Mereka mendistribusikan beras ""Mbak Puan Maharani"". https://t.co/qvgJqXUsaS",19,24,1,9,2022-01-01,23,Saturday,6,20,33
1477424230077771779,2022-01-01 23:39:20,Banyuwangi tengah bersiap menerapkan sistem tilang elektronik atau ETLE (electronic traffic law enforcement). Salah satunya dengan memasang kamera CCTV. https://t.co/qGlR9lk9t9,6,0,0,0,2022-01-01,23,Saturday,6,6,0
1477422506516656132,2022-01-01 23:32:29,"Timnas Indonesia menjadi runner-up Piala AFF 2020. Menjadi tim yang paling subur di turnamen kali ini, perjuangan skuad Garuda patut diacungi jempol. https://t.co/euNHvv50bn",87,1,7,0,2022-01-01,23,Saturday,6,94,1
1477421976058748929,2022-01-01 23:30:22,Wacana mobil rakyat digulirkan oleh Menteri Perindustrian Agus Gumiwang Kartasasmita. Tapi mobil yang masuk kategori mobil rakyat harus memenuhi tiga syarat. https://t.co/Wo6gmMsKK3,4,3,0,2,2022-01-01,23,Saturday,6,4,5
1477420985934561282,2022-01-01 23:26:26,"Ponpes milik AR berlokasi di Desa Cisantana, Kabupaten Kuningan. Polisi telah mengecek legalitas tempat tersebut. https://t.co/pQYGlijVoY",11,0,4,2,2022-01-01,23,Saturday,6,15,2
1477420243379232773,2022-01-01 23:23:29,"Fraksi Gerindra DPRD DKI Jakarta, M Taufik menyebut dirinya tidak memasukkan nama Anies di antara 3 calon Gubernur DKI karena Anies adalah calon presiden. https://t.co/Jh4f7tzjEW",128,80,19,11,2022-01-01,23,Saturday,6,147,91
1477419497518731267,2022-01-01 23:20:31,"Seorang perempuan ditemukan tewas di kamar hotel Jalan Urip Sumoharjo, Jombang. Pegawai negeri sipil (PNS) ini tewas usai menenggak cairan pembersih lantai. https://t.co/y62xcXLvVo",2,2,0,2,2022-01-01,23,Saturday,6,2,4
1477418756058005512,2022-01-01 23:17:35,Hingga 31 Desember 2021 jumlah kasus COVID-19 di Garut yang terkonfirmasi oleh Pemkab Garut hanya tersisa dua kasus. https://t.co/oWftxCqGi5,4,0,0,0,2022-01-01,23,Saturday,6,4,0
1477417753745231876,2022-01-01 23:13:36,183 pejabat struktural di Pemkab Banyuwangi dilantik jadi jabatan fungsional. Pelantikan dan pengambilan sumpah jabatan dilakukan malam pergantian tahun. https://t.co/bv7HBmdQFu,3,0,0,0,2022-01-01,23,Saturday,6,3,0
1477416972279291904,2022-01-01 23:10:29,Thailand bermain imbang 2-2 dengan Indonesia di leg kedua final Piala AFF 2020. Hasil ini mengantarkan War Elephant menjadi juara dengan agregat 6-2. https://t.co/ygnlEDKtYE,11,0,2,1,2022-01-01,23,Saturday,6,13,1
1477415728642990085,2022-01-01 23:05:33,Kkasus positif Corona pada hari ini sebanyak 274 pada hari ini. Sedangkan pasien COVID-19 dinyatakan sembuh sebanyak 165 dan 2 pasien meninggal akibat Corona. https://t.co/rfjFUyY5GD,3,0,0,1,2022-01-01,23,Saturday,6,3,1
1477414430333886469,2022-01-01 23:00:23,Banyak pria penasaran berapa ukuran penis yang ampuh membuat wanita klimaks saat bercinta. Sebuah survei menjawab pertanyaan tersebut. Simak selengkapnya. https://t.co/8pZFmNoduX,4,0,0,2,2022-01-01,23,Saturday,6,4,2
1477413147539656705,2022-01-01 22:55:18,Hidung tersumbat pada anak dapat diatasi dengan memberikan perawatan rumahan yang sederhana dan tanpa obat dokter. Salah satunya dengan humidifer. https://t.co/aysjjOaA6b,12,0,6,1,2022-01-01,22,Saturday,6,18,1
1477411848236453890,2022-01-01 22:50:08,"Sejak libur Natal 2021, destinasi wisata Alun-Alun Suroboyo ditutup. Meski begitu, antusias warga mendatangi alun-alun di Jalan Yos Sudarso itu tak surut. https://t.co/eFI5U78l88",9,2,0,1,2022-01-01,22,Saturday,6,9,3
1477410339532816388,2022-01-01 22:44:08,Tottenham Hotspur melanjutkan catatan tak terkalahkan saat menundukkan Watford. Sang manajer Antonio Conte juga membukukan rekor baru. Apa itu? https://t.co/PhLkFfU4ay,5,0,0,0,2022-01-01,22,Saturday,6,5,0
1477409347865137157,2022-01-01 22:40:12,"Kawanan kelompok bermotor meneror warga Kampung Gedongbengkok, Kabupaten Sukabumi. Kaca rumah warga pecah diduga akibat lemparan batu. https://t.co/njCqZwSVWw",6,2,1,3,2022-01-01,22,Saturday,6,7,5
1477407872120205314,2022-01-01 22:34:20,"Libur Tahun Baru 1 Januari diisi kader PDIP Surabaya bergerak turun ke masyarakat, khususnya ke wong cilik. Mereka mendistribusikan beras ""Mbak Puan Maharani"". https://t.co/KtxAW9qCjG",49,123,4,17,2022-01-01,22,Saturday,6,53,140
1477406198693515265,2022-01-01 22:27:41,Komnas Perempuan mendesak polisi agar konsumen prostitusi online itu juga diungkap polisi. Komnas Perempuan juga menyatakan Cassandra adalah korban. https://t.co/ByPaGOPUXe,66,42,4,10,2022-01-01,22,Saturday,6,70,52
1477404607022350338,2022-01-01 22:21:21,Manchester City lagi panas dan sulit diadang lawan-lawannya di Liga Inggris. Citizens menorehkan kemenangan ke-11 beruntun usai mengalahkan Arsenal. Top! https://t.co/Whg6B2B5vR,9,0,0,0,2022-01-01,22,Saturday,6,9,0
1477403371984326656,2022-01-01 22:16:27,Di mana sebenarnya rumah yang menjadi tempat Ratu Elizabeth II dilahirkan? Apakah sudah hancur karena serangan bom pada masa perang? https://t.co/bTWYFQzBRd,13,1,0,1,2022-01-01,22,Saturday,6,13,2
1477402002657316868,2022-01-01 22:11:00,Ada beberapa negara yang memiliki jam sekolah pendek. Walaupun begitu para siswanya tetap unggul dari berbagai aspek. https://t.co/cOH3rpSuMD,17,5,3,1,2022-01-01,22,Saturday,6,20,6
1477400764226187267,2022-01-01 22:06:05,"Saling lapor sempat mewarnai keributan antara driver Grab (sekarang sudah mantan driver Grab) dengan penumpang perempuan. Kini, mereka sudah sepakat berdamai. https://t.co/snVZkBpRQ9",12,5,2,2,2022-01-01,22,Saturday,6,14,7
1477398978312474625,2022-01-01 21:58:59,"Wali Kota Solo, Gibran Rakabuming Raka menyambut Tahun Baru 2022 dengan optimisme. Dirinya yakin pertumbuhan ekonomi Kota Solo semakin terasa di tahun 2022. https://t.co/anDAWvSci0",19,1,3,1,2022-01-01,21,Saturday,6,22,2
1477397757946212353,2022-01-01 21:54:08,"Kasus aktif COVID-19 di Jawa Timur terus menurun. Pada 1 Januari 2022, kasus aktif COVID-19 di Jatim tersisa 98 kasus. https://t.co/kJjRrLJiSK",4,0,1,1,2022-01-01,21,Saturday,6,5,1
1477396174084653059,2022-01-01 21:47:51,Indonesia tampil sip di babak pertama melawan Thailand dalam leg kedua final Piala AFF 2020. Skuad Garuda sejauh ini memimpin 1-0. https://t.co/ZaOzP4yJ2G,15,1,1,0,2022-01-01,21,Saturday,6,16,1
1477394908612804614,2022-01-01 21:42:49,"Karim Benzema mengukuhkan namanya sebagai striker mematikan di Liga Spanyol. Penyerang Real Madrid itu, begitu galak di tahun 2021! https://t.co/l14xAOGMee",14,1,0,0,2022-01-01,21,Saturday,6,14,1
1477393641329106949,2022-01-01 21:37:47,Liverpool mendapat ujian berat kala menghadapi Chelsea akhir pekan ini. Manajer Juergen Klopp dipastikan absen karena positif COVID-19. https://t.co/RlfeiFHJHR,4,0,2,0,2022-01-01,21,Saturday,6,6,0
1477391904924917765,2022-01-01 21:30:53,Booster vaksin COVID-19 ditargetkan mulai 12 Januari 2022. Bakal semempan apa atasi varian Omicron yang kecepatan transmisinya mengalahkan varian Delta? https://t.co/n01EG7yCYa,4,1,5,0,2022-01-01,21,Saturday,6,9,1
1477390669622747136,2022-01-01 21:25:58,Kondisi JPO atau Jembatan Konferensi Asia Afrika (KAA) sungguh memprihatinkan. Jembatan yang dibangun di era Wali Kota Ridwan Kamil itu jorok dan bau pesing. https://t.co/9N7c8f13sP,99,29,30,5,2022-01-01,21,Saturday,6,129,34
1477389420269641735,2022-01-01 21:21:01,"Harimau Malaya bernama Eko menggigit salah seorang pekerja kebun binatang di Florida, Amerika Serikat (AS). Karena itu, harimau Malaya tersebut ditembak mati. https://t.co/cNNaNUatwU",27,11,3,6,2022-01-01,21,Saturday,6,30,17
1477387402041724929,2022-01-01 21:12:59,Pedagang gorengan masih pikir-pikir untuk menaikkan harga dagangannya karena takut ditinggal pembeli. https://t.co/9iTZfKDk5u,74,12,13,8,2022-01-01,21,Saturday,6,87,20
1477385425950060549,2022-01-01 21:05:08,Bermacam teka-teki berikut punya tingkat kesulitan berbeda. Bisa jawab nggak detikers? https://t.co/sZEWlkHVkj,19,10,0,1,2022-01-01,21,Saturday,6,19,11
1477384169835671562,2022-01-01 21:00:09,"Bagi orang-orang yang tahun kemarin kehilangan anggota keluarganya karena COVID-19, perayaan tahun baru tak lagi sama. https://t.co/JCaSdrxoLY",13,1,2,0,2022-01-01,21,Saturday,6,15,1
1477381900008366085,2022-01-01 20:51:08,"Arsenal tak terima dengan kekalahan dari Manchester City. Sebab, The Gunners seharusnya juga mendapat penalti seperti halnya The Citizens. https://t.co/5csATA1pYb",12,2,1,0,2022-01-01,20,Saturday,6,13,2
1477380607713943559,2022-01-01 20:45:59,"Para ahli menemukan, warna dapat memengaruhi perasaan, suasana hati, dan perilaku seseorang. Berikut ini 10 arti warna dalam psikologi yang perlu diketahui. https://t.co/wXji1qIemx",15,1,2,0,2022-01-01,20,Saturday,6,17,1
1477377339566743560,2022-01-01 20:33:00,"Kebakaran hebat melanda Colorado, Amerika Serikat (AS). Kejadian tersebut juga akibatkan dua orang menghilang. https://t.co/ersJ1pQ4WV",4,2,0,0,2022-01-01,20,Saturday,6,4,2
1477376113479462917,2022-01-01 20:28:08,Artis Cassandra Angelie menjadi tersangka kasus prostitusi online dengan tarif kencan Rp 30 juta. Kenapa jasa prostitusi masih laku meski mahal? https://t.co/1kpyb3xVal,124,100,8,26,2022-01-01,20,Saturday,6,132,126
1477374612119998467,2022-01-01 20:22:10,"Para konten kreator merilis YouTube Rewind 2021. Dalam video tersebut, ada 5 makanan viral di tahun 2021. Adakah favoritmu? https://t.co/cCKaZaUlOx",3,0,0,0,2022-01-01,20,Saturday,6,3,0
1477373374477352961,2022-01-01 20:17:15,Isu soal hamil duluan di kalangan artis sebenarnya bukan hal baru. Ini deretan artis yang akui hamil sebelum nikah:  https://t.co/KSkX6c9UkX,4,4,1,3,2022-01-01,20,Saturday,6,5,7
1477371840012169216,2022-01-01 20:11:09,Libur Tahun Baru 2022 Kebun Binatang Surabaya (KBS) tetap buka. Pengunjung yang datang pun membeludak. https://t.co/hLcYERyEcv,1,1,0,0,2022-01-01,20,Saturday,6,1,1
1477370351797653510,2022-01-01 20:05:14,"Sebuah mobil menabrak dua pengendara sepeda motor di jalur wisata Purwakarta, Jawa Barat. Akibatnya, 4 orang mengalami luka berat. https://t.co/eT19E2r6Ih",1,0,0,0,2022-01-01,20,Saturday,6,1,0
1477369259009482756,2022-01-01 20:00:54,"Sebagian besar kehidupan di Antartika berada di permukaan es. Sekarang, para ilmuwan menemukan kehidupan baru di bawah lapisan es.  https://t.co/sZLRu10kO4",9,1,3,0,2022-01-01,20,Saturday,6,12,1
1477367772418125829,2022-01-01 19:54:59,PT Kereta Api Indonesia (Persero) menerapkan tarif baru Rapid Test Antigen di Stasiun dari sebelumnya Rp 45.000 menjadi Rp 35.000. https://t.co/JeVi6e861L,8,0,2,1,2022-01-01,19,Saturday,6,10,1
1477366496452124674,2022-01-01 19:49:55,Miliarder Baru Austin Russell ini dijuluki Elon Musk 2.0 karena kepintarannya di bidang teknologi. Ini sosoknya:  https://t.co/7LLRccXLqV,25,0,7,3,2022-01-01,19,Saturday,6,32,3
1477364753177718789,2022-01-01 19:42:59,"Selama ini, Edward sering disebut sebagai penerus alami ahli biologi pencetus teori evolusi, Charles Darwin. https://t.co/F28GBn7WCI https://t.co/pvroLPihIJ",5,0,0,0,2022-01-01,19,Saturday,6,5,0
1477362975585542147,2022-01-01 19:35:56,"Lantas, ketika Freddy Budiman telah tiada, bagaimana dengan semua harta tersebut. Aset properti, kendaraan, uang tunai dan lainnya? Simak kisahnya:   https://t.co/A9gJ0A596V",29,3,5,0,2022-01-01,19,Saturday,6,34,3
1477361439845330946,2022-01-01 19:29:49,"Tidak semua pria ditakdirkan memiliki ukuran penis yang besar. Tetapi, cara alami berikut mungkin dapat membantu meningkatkan ukuran pada penis. https://t.co/9jYeZJkOYO",17,4,2,1,2022-01-01,19,Saturday,6,19,5
1477359950649249794,2022-01-01 19:23:54,"Setelah ayahnya dihukum mati 2016, sejatinya warisan yang ditinggalkan berupa tanggung jawab untuk terus menyebarkan kisah-kisah baik Freddy Budiman.  https://t.co/9iuQlVZ4MR",14,0,2,0,2022-01-01,19,Saturday,6,16,0
1477358708246130698,2022-01-01 19:18:58,"Kesuksesan adalah milik bagi siapa saja yang mau bekerja keras, tanpa terkecuali kembar siam ini. Kisah keberhasilan mereka curi atensi pembaca selama sepekan. https://t.co/npfQ3M8AHl",14,2,3,1,2022-01-01,19,Saturday,6,17,3
1477357464530137088,2022-01-01 19:14:02,"Pratama Arhan terpilih menjadi pemain muda terbaik di Piala AFF 2020. Pemain 20 tahun itu mengalahkan dua kompatriotnya, Witan Sulaeman dan Alfeandra Dewangga. https://t.co/8gEeKLPwyA",58,1,2,0,2022-01-01,19,Saturday,6,60,1
1477356468265496584,2022-01-01 19:10:04,Sejumlah studi yang dilakukan para ilmuwan sejak 1950-an berhasil mengungkap bahwa banyak mamalia dan burung bermimpi dalam tidurnya. https://t.co/CEz66hHiSI,9,0,0,0,2022-01-01,19,Saturday,6,9,0
1477354934580428801,2022-01-01 19:03:58,"Sudah punya resolusi hidup sehat di Tahun Baru 2022? Ternyata bukan makanan yang paling bikin gagal, tapi minuman! Awas kalorinya 'amazing'. https://t.co/6H2BdS4PqC",4,0,1,0,2022-01-01,19,Saturday,6,5,0
1477353561453432834,2022-01-01 18:58:31,"Sebagian pria mungkin sudah tahu eksistensi dari tisu magic. Tapi, bagaimana dengan fungsinya? Berikut ini 4 fungsi tisu magic yang perlu diketahui. https://t.co/b0HLXpl894",5,0,2,0,2022-01-01,18,Saturday,6,7,0
1477350957801521157,2022-01-01 18:48:10,Elkan Baggott memberi klarifikasi usai dilarang tampil di leg kedua final Piala AFF 2020. Ia mengaku tak tahu kalau telah melanggar batas bubble di Singapura. https://t.co/bEXa1VhSz0,15,0,2,0,2022-01-01,18,Saturday,6,17,0
1477350729706876929,2022-01-01 18:47:16,Olahraga bola basket merupakan passion Baim Wong sejak lama. Siapa sangka kini dia bisa jadi presiden salah satu klub basket Indonesia. https://t.co/kSCaJnzrHk,9,0,2,0,2022-01-01,18,Saturday,6,11,0
1477348204429692928,2022-01-01 18:37:14,Ungkapan Cinta Laura kagumi sosok Gus Dur. Ia harap milenial mengenal sosok eks Presiden Indonesia tersebut. https://t.co/JGrfkJt1H0,22,1,4,0,2022-01-01,18,Saturday,6,26,1
1477346710565367812,2022-01-01 18:31:18,Di dalam gambar berikut ada beberapa hal yang tidak masuk akal. Bila kamu bisa menemukannya berarti logika kamu jalan. https://t.co/aXRhJnWheb,7,4,0,0,2022-01-01,18,Saturday,6,7,4
1477345695107584003,2022-01-01 18:27:16,Apa itu rambut lepek? Gong Yoo cannot relate! Dengarkan Podcast ngedrakor! episode The Silent Sea di artikel ini. https://t.co/ZwaLhBzm5r,9,0,1,0,2022-01-01,18,Saturday,6,10,0
1477344597244354577,2022-01-01 18:22:54,Chanathip Songkrasin berperan besar dalam keberhasilan Thailand juara Piala AFF 2020. Kapten 'Gajah Perang' itu dinobatkan sebagai pemain terbaik. https://t.co/g1puzPdzJG,12,2,1,0,2022-01-01,18,Saturday,6,13,2
1477344109073514497,2022-01-01 18:20:57,"Freddy Budiman kerap mengirimkan surat untuk anak-anaknya, yang bertuliskan kerinduan dan pesan. #FikriBudiman  https://t.co/rOlOLif9ki",21,4,1,0,2022-01-01,18,Saturday,6,22,4
1477342629218197508,2022-01-01 18:15:05,Tahun 2022 dibuka dengan penayangan drama Korea terbaru. Berikut 6 drakor terbaru yang tayang di bulan Januari 2022. https://t.co/2XP6mLIcs4,13,0,4,1,2022-01-01,18,Saturday,6,17,1
1477341113140842505,2022-01-01 18:09:03,Penulis skenario Spider-Man: No Way Home membeberkan sebuah fakta menarik soal nasib Peter Parker. Rupanya hal ini menentukan perkembangan karakternya. https://t.co/6tj2xvYSuO,6,0,0,1,2022-01-01,18,Saturday,6,6,1
1477339882401976322,2022-01-01 18:04:10,Almira Andani tak cuma jago menyanyi. Pelantun Jangan Ubah Takdirku ternyata juga lihai olahraga berkuda.  https://t.co/fIVOHOJBrJ,5,0,0,0,2022-01-01,18,Saturday,6,5,0
1477338831615676418,2022-01-01 17:59:59,Iko Uwais akhirnya kembali ke Indonesia setelah syuting film The Expendables 4 di Amerika Serikat. Ia bercerita pengalamannya syuting di Hollywood:  https://t.co/iPbxNxVc0q,19,0,1,2,2022-01-01,17,Saturday,6,20,2
1477337536871731201,2022-01-01 17:54:51,"BPS sudah mengukur Indeks Kebahagiaan di Jakarta sejak 2014, era Gubernur Ahok. Kini, DKI dipimpin Gubernur Anies Baswedan. Era siapa yang lebih berbahagia? https://t.co/5tuTEUaiG3",28,34,1,3,2022-01-01,17,Saturday,6,29,37
1477336503198101510,2022-01-01 17:50:44,Sebuah adegan pada episode 6 di serial Layangan Putus jadi viral di media sosial. Ini potretnya: #LayanganPutus  https://t.co/PnLwHVqt20,2,0,1,0,2022-01-01,17,Saturday,6,3,0
1477335523517677569,2022-01-01 17:46:51,NFT diprediksi akan makin menjamur di Indonesia pada tahun 2022. Bisnis digital yang menyasar ibu-ibu juga akan jadi inovasi yang trending tahun depan. https://t.co/HwJ8GnOIP3,6,3,4,0,2022-01-01,17,Saturday,6,10,3
1477334433418072072,2022-01-01 17:42:31,Mengeluarkan suara saat berhubungan intim sudah menjadi hal lazim dilakukan. Tetapi apa sebenarnya arti desahan wanita?  https://t.co/PEGCxKn2BF,19,3,7,1,2022-01-01,17,Saturday,6,26,4
1477333388373766145,2022-01-01 17:38:21,Thailand baru saja kembali menjuarai Piala AFF. Mari melihat lagi daftar pemenang turnamen terakbar se-Asia Tenggara tersebut sejak dimulai pada 1996. https://t.co/TaNfrUwZZ6,15,1,2,0,2022-01-01,17,Saturday,6,17,1
1477332091146846216,2022-01-01 17:33:12,"Aktris legendaris Betty White meninggal dunia dalam usia 99 tahun. Sebelum eksis di TV, ia sempat menjadi sukarelawan tentara AS di Perang Dunia II. https://t.co/hK7dWc1EZI",10,1,0,0,2022-01-01,17,Saturday,6,10,1
1477330169207660550,2022-01-01 17:25:34,"Elon Musk mengutarakan bahwa untuk mengetahui siapa Satoshi Nakamoto sang pencipta Bitcoin, bisa dengan menelusuri siapa yang menuliskan idenya. https://t.co/zDiR0RxxF6",15,0,5,0,2022-01-01,17,Saturday,6,20,0
1477327872616501248,2022-01-01 17:16:26,Hujan deras mengguyur Semeru membuat banjir lahar hujan ke Sejumlah Daerah Aliran Sungai (DAS). Salah satunya Sungai Leprak hingga membuat rumah terbawa arus. https://t.co/A8AsrvKvPE,15,0,7,1,2022-01-01,17,Saturday,6,22,1
1477326291439427590,2022-01-01 17:10:09,Tottenham Hotspur berhasil mengalahkan Watford 1-0. Davinson Sanchez jadi penentu kemenangan The Lilywhites berkat golnya di menit akhir. https://t.co/nUlzk7EuVS,6,0,1,0,2022-01-01,17,Saturday,6,7,0
1477325537001541635,2022-01-01 17:07:10,Awal mula Irwansyah laporkan adik kandung ke polisi. Ia rugi besar karena kelakuan Hafiz Fatur. #Irwansyah  https://t.co/wS5Db4If99,18,4,0,1,2022-01-01,17,Saturday,6,18,5
1477324110103515148,2022-01-01 17:01:29,"Resolusi hidup sehat di tahun baru tak jarang jadi wacana belaka. Biar tak terulang di 2022, begini tips dan trik capai resolusi hidup sehat ala trainer. https://t.co/2TnVJDAZEo",6,0,2,0,2022-01-01,17,Saturday,6,8,0
1477321507575672834,2022-01-01 16:51:09,Iko Uwais akhirnya kembali ke Indonesia setelah syuting film The Expendables 4 di Amerika Serikat. Ia bercerita pengalamannya syuting di Hollywood:  https://t.co/lu8863mDA8,22,1,5,3,2022-01-01,16,Saturday,6,27,4
1477320185237360640,2022-01-01 16:45:54,Viral video seorang pria yang terbang hingga 9 meter karena terbawa layang-layang. Netizen pun dibuat ngeri melihatnya...  https://t.co/wYCroMHX0I,48,8,10,4,2022-01-01,16,Saturday,6,58,12
1477319140578938885,2022-01-01 16:41:45,"""Kita mau bekerja sama tapi jangan memberatkan kita karena biar bagaimanapun Pemkot Solo ini punya kekuatan untuk membuat aplikasi serupa sendiri."" https://t.co/GApVMBio93",120,71,8,20,2022-01-01,16,Saturday,6,128,91
1477317862901653506,2022-01-01 16:36:40,SBS Drama Awards memberikan penghargaan pada aktor dan aktris hingga drama Korea terbaik di Korea Selatan. Ini daftar pemenang tahun ini: https://t.co/8xyYExa57s,14,1,1,1,2022-01-01,16,Saturday,6,15,2
1477316630866710535,2022-01-01 16:31:46,#Terpopuler Pengadilan akhinya mengakui anak Amalia Fujiawati adalah darah daging Bambang Pamungkas. Mantan pemain timnas itu wajib nafkahi anak Rp 7 juta perbulan.  https://t.co/in7PUb63GG,23,0,4,2,2022-01-01,16,Saturday,6,27,2
1477315605611130891,2022-01-01 16:27:42,"Parker Solar Probe, pesawat milik NASA, berhasil 'menyentuh' dengan jarak yang sangat dekat. Kok bisa tidak terbakar dan masih utuh ya? https://t.co/fsX65k1mLH",18,7,5,2,2022-01-01,16,Saturday,6,23,9
1477313446832181252,2022-01-01 16:19:07,Presiden RI Joko Widodo bangga dengan perjuangan Indonesia di Piala AFF 2020. Jokowi tak lupa menyelamati Thailand yang berhasil jadi juara. https://t.co/bVy1vk1DoD,37,1,3,0,2022-01-01,16,Saturday,6,40,1
1477312972313800706,2022-01-01 16:17:14,Bermacam teka-teki berikut punya tingkat kesulitan berbeda. Bisa jawab nggak detikers? https://t.co/oGSaw95RtX,10,5,2,2,2022-01-01,16,Saturday,6,12,7
1477311655746981895,2022-01-01 16:12:00,Muncul video yang menunjukkan Xiaomi 12 dan 12 Pro dibongkar. Dari situ terlihat cara Xiaomi menjinakkan panas dari Snapdragon 8 Gen 1. https://t.co/zUvqMQJoL0,7,0,1,0,2022-01-01,16,Saturday,6,8,0
1477310394439974916,2022-01-01 16:06:59,"Libur Tahun Baru 2022 Kebun Binatang Surabaya (KBS) tetap buka. Dibuka mulai pukul 08.00 WIB hingga pukul 13.00 WIB, pengunjung mencapai 8 ribu. https://t.co/sn1M3OiHLG",7,1,0,0,2022-01-01,16,Saturday,6,7,1
1477309113612787712,2022-01-01 16:01:54,"Foto kamuflase yang secara tidak sengaja dibuat ini mampu mengelabui otak dan mata kita, tidak percaya? Yuk buktikan sendiri, siap-siap mata tertipu! https://t.co/WGcuGyuyM0",7,2,1,0,2022-01-01,16,Saturday,6,8,2
1477307174347022346,2022-01-01 15:54:12,"Watford vs Tottenham Hotspur masih 0-0 di babak pertama. The Lilywhites gagal membongkar lini pertahanan The Hornets, meski tampil dominan menguasai laga. https://t.co/TxFLYiEh9d",3,0,0,0,2022-01-01,15,Saturday,6,3,0
1477306700717867008,2022-01-01 15:52:19,"YouTuber Korea ini pergi membagikan Indomie goreng secara gratis di jalan. Walaupun ada yang asing dengan mie goreng, namun banyak juga yang mengetahuinya. https://t.co/4ZLEQk6zKJ",25,1,2,0,2022-01-01,15,Saturday,6,27,1
1477305692981796872,2022-01-01 15:48:18,Hujan biasanya adalah air sehingga kalau yang berjatuhan dari langit adalah ikan tentu akan sangat mengagetkan. Itulah yang terjadi di sebuah kota. https://t.co/nGkK9TFLp5,15,1,3,0,2022-01-01,15,Saturday,6,18,1
1477304115315236870,2022-01-01 15:42:02,Humas KAI Daop 1 memprediksi puncak arus balik yang terjadi di Stasiun Pasar Senen hingga Gambir jatuh pada tanggal 2 atau 3 Januari 2022. Adapun jumlah kedatangan penumpang KA pada 1 Januari 2022 mencapai 7.504 penumpang. https://t.co/uxUsAQyZVj,6,0,2,0,2022-01-01,15,Saturday,6,8,0
1477304097367855105,2022-01-01 15:41:58,"Jokowi bangga dengan perjalanan tim nasional sepakbola di gelaran Piala AFF 2020. Meski tak juara AFF, kegigihan tim Indonesia dipuji Jokowi. https://t.co/KRUEo5wV5l",433,20,30,5,2022-01-01,15,Saturday,6,463,25
1477303552624283652,2022-01-01 15:39:48,"Seekor ular piton ditangkap warga di kandang unggas milik warga Desa Sumberejo, Pasuruan. Ular sepanjang 3 meter itu diyakini selama ini memakan ternak warga. https://t.co/S3FaSwHhpW",8,0,0,0,2022-01-01,15,Saturday,6,8,0
1477303020677480450,2022-01-01 15:37:41,Sejumlah pengunjung kecewa karena tak bisa memasuki kawasan Taman Impian Jaya Ancol. Hal itu dikarenakan Kawasan Ancol hanya beroperasi sampai pukul 14.00 WIB. https://t.co/cx8mTwYL7K,3,1,0,1,2022-01-01,15,Saturday,6,3,2
1477302028871380999,2022-01-01 15:33:45,"Wali Kota Solo Gibran Rakabuming Raka mengundang seluruh pemain, official tim Persis Solo ke rumah dinas Loji Gandrung, Sabtu (1/1/2022). https://t.co/mwBCwOrZ1q",27,3,5,0,2022-01-01,15,Saturday,6,32,3
1477301196474007554,2022-01-01 15:30:26,Gonta-ganti jenis BBM meski ke RON yang lebih besar ternyata tidak disarankan. Pemilik motor sebaiknya setia dengan bensin pilihannya. https://t.co/OpSX3MkYqj,17,7,1,3,2022-01-01,15,Saturday,6,18,10
1477300444242366468,2022-01-01 15:27:27,Beli jaket buat motor enggak bisa asal-asalan. Berikut tips memilih jaket motor yang enak dipakai touring sekalian jaket motor harian. https://t.co/n7GPRhLVif,2,1,0,0,2022-01-01,15,Saturday,6,2,1
1477299956050534401,2022-01-01 15:25:31,"Duh, relaksasi PPnBM buat mobil berakhir per Desember 2021. Harga mobil bakal naik lagi.. https://t.co/bwE6XVYxer",10,1,2,0,2022-01-01,15,Saturday,6,12,1
1477299405141286915,2022-01-01 15:23:19,Isu soal hamil duluan di kalangan artis sebenarnya bukan hal baru. Ini deretan artis yang akui hamil sebelum nikah:  https://t.co/ZjGQYkfuji,10,9,3,0,2022-01-01,15,Saturday,6,13,9
1477298070610194433,2022-01-01 15:18:01,"Tingginya curah hujan menyebabkan rentetan longsor-banjir terjadi di Trenggalek. Longsor terjadi di 7 titik, sedangkan banjir menerjang 4 desa di Kec Panggul. https://t.co/hKiU5MbldN",8,1,0,0,2022-01-01,15,Saturday,6,8,1
1477297489745170433,2022-01-01 15:15:43,Chelsea dan Liverpool kabarnya terancam bermain di tempat netral pada babak 16 besar Liga Champions. Masalah vaksinasi pemain menjadi alasannya. https://t.co/0Zq4hnMEae,11,0,3,0,2022-01-01,15,Saturday,6,14,0
1477295650094170115,2022-01-01 15:08:24,Aktris Betty White meninggal dunia pada Jumat (31/12) waktu setempat sebelum perayaan ultah ke-100 pada 17 Januari mendatang. https://t.co/lJzideyBVW,10,1,0,0,2022-01-01,15,Saturday,6,10,1
1477294388770484225,2022-01-01 15:03:23,Ada beberapa makanan yang dianggap membawa keberuntungan di tahun baru. Disantap saat momen pergantian tahun oleh masyarakat di berbagai negara. https://t.co/0MsIDlvixv,8,0,2,1,2022-01-01,15,Saturday,6,10,1
1477293375590223877,2022-01-01 14:59:22,Maria Eva bicara pengaruh internet. Sebab ia ada bisnis yang di desa. https://t.co/CmtyO01k3g,5,2,0,1,2022-01-01,14,Saturday,6,5,3
1477292268352647176,2022-01-01 14:54:58,"Acara tahunan gadget terbesar di dunia bertajuk Consumer Electronics Show (CES) 2022, mengungkapkan akan menutup pagelaran lebih awal dari jadwal. https://t.co/fmjugTbZKV",5,0,1,0,2022-01-01,14,Saturday,6,6,0
1477291273606287360,2022-01-01 14:51:01,"Keputusan Jae pun mendapatkan respons beragam dari fans. Walaupun begitu, banyak juga yang mendukung keputusan apa pun yang dibuat oleh sang idola. https://t.co/1J1npSCrRT",10,3,2,1,2022-01-01,14,Saturday,6,12,4
1477290778724548615,2022-01-01 14:49:03,"Mengawali libur Tahun Baru 2022, warga padati Kebun Binatang Surabaya (KBS). Sedikitnya ada 8 ribu orang yang masuk ke KBS, alhasil pihak pengelola wisata membuka semua pintu masuk. https://t.co/iLPoNdBLG0",7,0,2,0,2022-01-01,14,Saturday,6,9,0
1477290041466630145,2022-01-01 14:46:07,"Perusahaan perabotan hingga furnitur rumah tangga, IKEA mengumumkan akan menaikkan harga semua produknya. https://t.co/hjozKdgylM",26,14,7,9,2022-01-01,14,Saturday,6,33,23
1477288936506593287,2022-01-01 14:41:43,"Untuk mengawali tahun baru supaya otak tetap fresh dan cemerlang, yuk main teka-teki asah otak sambil mengisi waktu libur. https://t.co/zoYiYtCXaI",11,20,4,0,2022-01-01,14,Saturday,6,15,20
1477287940892024832,2022-01-01 14:37:46,Wisata kuliner di Jogja memang tak ada habisnya. Selama 24 jam ada makanan yang bisa memanjakan lidah. Termasuk kuliner malamnya yang enak dan murah meriah. https://t.co/V9gtFaRU2M,23,1,6,0,2022-01-01,14,Saturday,6,29,1
1477286844974960645,2022-01-01 14:33:25,Perusahaan Swedia DSruptive Subdermals membuat microchip berisi data vaksinasi COVID-19 yang dapat dimasukan ke bawah kulit manusia. Ini penamapakannya: https://t.co/Ft5bzobW5K,32,8,17,10,2022-01-01,14,Saturday,6,49,18
1477285203425038340,2022-01-01 14:26:53,Thailand bermain imbang 2-2 dengan Indonesia di leg kedua final Piala AFF 2020. Hasil ini mengantarkan War Elephant menjadi juara dengan agregat 6-2. https://t.co/GHNN7zq2fe,146,20,12,5,2022-01-01,14,Saturday,6,158,25
1477284302702395396,2022-01-01 14:23:19,Sebuah jembatan darurat penghubung antar kabupaten di Trenggalek putus total setelah diterjang banjir. Jembatan itu sebelumnya juga putus total tahun 2019. https://t.co/5nvFBQDpGw,7,0,1,0,2022-01-01,14,Saturday,6,8,0
1477283587531673606,2022-01-01 14:20:28,"Di dealer mobil Syariah Mobilindo, program kredit syariah ini tak hanya dikhususkan untuk orang muslim. https://t.co/caIq9jEHI8",28,6,8,0,2022-01-01,14,Saturday,6,36,6
1477281865874788353,2022-01-01 14:13:38,Thailand vs Indonesia dalam leg II final Piala AFF memasuki babak kedua. Egy Maulana menyamakan kedudukan 2-2! https://t.co/B0SYF0wH5r,39,0,8,0,2022-01-01,14,Saturday,6,47,0
1477281749566730249,2022-01-01 14:13:10,Thailand vs Indonesia dalam leg II final Piala AFF memasuki babak kedua. Egy Maulana menyamakan kedudukan 2-2! https://t.co/L684dppOcy,18,0,1,0,2022-01-01,14,Saturday,6,19,0
1477281028444237830,2022-01-01 14:10:18,"Romelu Lukaku mengaku tidak bahagia di Chelsea. Sang manajer Thomas Tuchel, enggan membiarkan drama itu berlarut-larut! https://t.co/MGPmVnOuFf",7,0,2,4,2022-01-01,14,Saturday,6,9,4
1477279790394753025,2022-01-01 14:05:23,BRIN mendengar adanya kabar yang menyebut banyak ilmuwan di Eijkman kehilangan pekerjaan. BRIN menepis kabar soal nasib para ilmuwan dan peneliti itu. https://t.co/bYh0cLPHGK,29,3,6,7,2022-01-01,14,Saturday,6,35,10
1477279288516911107,2022-01-01 14:03:23,#Terpopuler Gisel dan Gading Marten saat ini sedang berlibur akhir tahun di Bali. Senyuman Gisel saat kepergok jalan bareng Gading jadi sorotan. https://t.co/DKynw1IQqh,18,6,2,0,2022-01-01,14,Saturday,6,20,6
1477278799393923077,2022-01-01 14:01:26,Serial Layangan Putus makin viral semenjak perselingkuhan Aris terbongkar. Adegan Kinan dan Aris bertengkar ramai. Pas banget nih dengan suara hari para Bunda. #detiknetwork  https://t.co/CIg7IfkKMT,12,5,0,1,2022-01-01,14,Saturday,6,12,6
1477277788851871745,2022-01-01 13:57:26,Thailand vs Indonesia dalam leg II final Piala AFF dimulai. Thailand berbalik unggul 2-1. https://t.co/xtsaKpCMae,3,1,0,0,2022-01-01,13,Saturday,6,3,1
1477277751107334147,2022-01-01 13:57:17,"Timnas Indonesia akan menghadapi Thailand di leg kedua final Piala AFF 2020. Pengamat sepakbola, Binder Singh sebut pemain Timnas harus bermain tanpa beban dan fokus mencetak gol cepat agar peluang comeback semakin terbuka. https://t.co/TyNzB9lslL",8,4,0,1,2022-01-01,13,Saturday,6,8,5
1477276968261492738,2022-01-01 13:54:10,Gejala penyakit COVID-19 bisa bertahan hingga mingguan bahkan berbulan-bulan setelah pasien dinyatakan sembuh. Hal itu pula yang dirasakan penyanyi Ava Max. https://t.co/okbDqsytZT,10,0,1,4,2022-01-01,13,Saturday,6,11,4
1477276465779687431,2022-01-01 13:52:10,Thailand vs Indonesia dalam leg II final Piala AFF dimulai. Thailand berbalik unggul 2-1. https://t.co/dhPw8FIjl7,8,3,0,0,2022-01-01,13,Saturday,6,8,3
1477275672901046273,2022-01-01 13:49:01,"Seorang pemuda tiba-tiba pingsan di atas pohon setinggi 10 meter. Dia mengaku kelelahan, usai memotong cabang dan dahan pohon randu untuk pakan kambingnya. https://t.co/nLqxP8Yhd0",13,0,0,0,2022-01-01,13,Saturday,6,13,0
1477275399793123333,2022-01-01 13:47:56,"Thailand vs Indonesia dalam leg II final Piala AFF dimulai. Babak kedua dimulai, Thailand menyamakan kedudukan 1-1. https://t.co/eUznEoNDs2",5,6,1,2,2022-01-01,13,Saturday,6,6,8
1477274921327902720,2022-01-01 13:46:02,Harga rapid test antigen COVID-19 yang disediakan di sejumlah stasiun PT KAI Daop 1 Jakarta turun. Tarif tes antigen yang tadinya Rp 45 ribu kini Rp 35 ribu. https://t.co/4Qnru7rGdI,9,0,5,3,2022-01-01,13,Saturday,6,14,3
1477273626068013056,2022-01-01 13:40:53,Kabar soal buron kasus korupsi Harun Masiku ditangkap KPK beredar. KPK mengatakan kabar tersebut tidak benar. https://t.co/0KTsAZNSuY,14,12,4,3,2022-01-01,13,Saturday,6,18,15
1477272651756412930,2022-01-01 13:37:01,M Taufik menyebut tiga nama yang dianggapnya berpotensi menggantikan Anies sebagai Gubernur DKI. PDIP menilai Taufik ogah jatuh di kesalahan yang sama. https://t.co/nZMw0L6ZQB,6,4,0,3,2022-01-01,13,Saturday,6,6,7
1477271665910370305,2022-01-01 13:33:06,Naura Sabrina Galiyah (9) meninggal usai divaksin Sinovac dosis pertama. Siswi kelas 4 SD ini sempat dibawa ke tempat pengobatan. Salah satunya orang pintar. https://t.co/SdRzlCb4Wu,22,9,7,2,2022-01-01,13,Saturday,6,29,11
1477271169871093765,2022-01-01 13:31:07,Bonus sebesar Rp 10 miliar dari pemerintah ke tim Piala Thomas 2020 ternyata dipangkas untuk pembinaan. Kekecewaan pun muncul dari para pebulutangkis. https://t.co/yfzGKFLRhr,726,244,266,99,2022-01-01,13,Saturday,6,992,343
1477269913236611075,2022-01-01 13:26:08,Saat liburan di Surabaya kamu wajib mencicipi tahu campur yang terkenal lezat. Ada 5 tempat yang telah terkenal enak dan ramai pelanggan. Cek daftarnya! https://t.co/QJZSUNLp7F,20,0,2,2,2022-01-01,13,Saturday,6,22,2
1477268914895794181,2022-01-01 13:22:10,Naura Sabrina Galiyah (9) meninggal setelah divaksin Sinovac dosis pertama. Siswi kelas 4 SD ini mengalami muntah dan berak darah saat dirawat di RSUD Jombang. https://t.co/4GQ02mphFF,106,11,21,8,2022-01-01,13,Saturday,6,127,19
1477267921361641477,2022-01-01 13:18:13,Bu Vera si Cassandra Angelie bikin heboh jelang akhir 2021. Ia jadi tersangka kasus prostitusi online. https://t.co/ThqjaaKaNs,15,2,0,1,2022-01-01,13,Saturday,6,15,3
1477266624637984772,2022-01-01 13:13:04,Komnas Perempuan mendesak polisi agar konsumen prostitusi online itu juga diungkap polisi. Komnas Perempuan juga menyatakan Cassandra adalah korban. https://t.co/MiZUKi2lAq,28,22,6,5,2022-01-01,13,Saturday,6,34,27
1477266103420297216,2022-01-01 13:10:59,"Ada Jalan Misteri di Gunung Kelud Kediri, di mana kendaraan tampak menanjak sendiri meski mesin dalam kondisi mati. Menurut pakar, itu hanya ilusi optik belaka. https://t.co/ZdiY1PjeOt",9,0,1,0,2022-01-01,13,Saturday,6,10,0
1477266080225710083,2022-01-01 13:10:54,"Kendati harganya tembus ratusan juta rupiah, TV premium tetap diminati karena membawa teknologi canggih dan terkini. Berikut ini 5 TV premium terbaik 2021 https://t.co/5RNm76vAdT",4,0,1,0,2022-01-01,13,Saturday,6,5,0
1477265343072686084,2022-01-01 13:07:58,Shell Indonesia menghapus penjualan bensin Shell Regular. Produk ini merupakan bensin versi Pertalite-nya dari Shell. https://t.co/qsRKN1Ac87,8,0,2,2,2022-01-01,13,Saturday,6,10,2
1477264095128788992,2022-01-01 13:03:01,Superhero klasik Miracleman akan memulai debutnya di semesta Marvel. https://t.co/MIg1zLdSfH,5,0,0,0,2022-01-01,13,Saturday,6,5,0
1477262811386499084,2022-01-01 12:57:55,MGPA sebagai penyelenggara MotoGP di Indonesia sudah merilis daftar harga MotoGP Indonesia. Harga tiket MotoGP Indonesia dijual mulai Rp 100-an ribu. https://t.co/vZQdnJU0ik,18,2,7,1,2022-01-01,12,Saturday,6,25,3
1477261572204638208,2022-01-01 12:52:59,Larissa Chou kurung anak yang lagi tantrum di kamar mandi. Ia beri penjelasan mengenai hal itu. https://t.co/BGnxdpsYep,5,1,1,1,2022-01-01,12,Saturday,6,6,2
1477260805343264771,2022-01-01 12:49:56,"Freddy Budiman kerap mengirimkan surat untuk anak-anaknya, yang bertuliskan kerinduan dan pesan. #FikriBudiman  https://t.co/k46GJQRZqF",18,0,1,0,2022-01-01,12,Saturday,6,19,0
1477260561486336001,2022-01-01 12:48:58,Indonesia harus mengejar ketertinggalan 4-0 di leg kedua final Piala AFF 2020 malam nanti. Egy dan Witan berpotensi mengubah jalannya laga di tubuh Garuda. https://t.co/5PZHTMqaOM,14,0,2,0,2022-01-01,12,Saturday,6,16,0
1477259530035736578,2022-01-01 12:44:52,"Awal tahun 2022, Jalan Kaligawe tepatnya di bawah fly over tol terendam banjir. Genangan air belanjut sampai di Jalan Terboyo depan RSI Sultan Agung Semarang. https://t.co/H63dPCsU2w",4,4,2,3,2022-01-01,12,Saturday,6,6,7
1477259248295981056,2022-01-01 12:43:45,Thailand vs Indonesia dalam leg II final Piala AFF dimulai. Ricky Kambuaya mencatatkan nama di papan skor buat gol pertama Indonesia! https://t.co/11hSXrdhS2,37,1,4,0,2022-01-01,12,Saturday,6,41,1
1477258279222972416,2022-01-01 12:39:54,Menteri Keuangan Sri Mulyani belum memberikan kepastian soal nasib PPnBM 0% untuk mobil baru. Jangan heran kalau per Januari harga mobil meroket. https://t.co/PvTOlIgRpK,4,0,2,0,2022-01-01,12,Saturday,6,6,0
1477257507282239488,2022-01-01 12:36:50,"Sebuah mobil menabrak dua pengendara sepeda motor di jalur wisata Purwakarta, Jawa Barat. Akibatnya, 4 orang mengalami luka berat. https://t.co/EP9XMCh786",3,0,0,0,2022-01-01,12,Saturday,6,3,0
1477256774898143233,2022-01-01 12:33:55,Manga My Hero Academi memasuki bagian akhir cerita. Sayangnya fans menebak ending-nya bakal terburuk sepanjang seri ini ada. https://t.co/NB3pxJO3Lm,2,0,1,0,2022-01-01,12,Saturday,6,3,0
1477256745600929796,2022-01-01 12:33:48,Binder Singh menilai strategi high-pressing Thailand masih memiliki kelemahan. Timnas Indonesia bisa memanfaatkan kelemahan itu lewat umpan terobosan. https://t.co/usrlCPa1jk,3,0,0,0,2022-01-01,12,Saturday,6,3,0
1477255240726597638,2022-01-01 12:27:50,"Jauh sebelum produksi No Time To Die, Daniel Craig sudah membahas soal akhir cerita James Bond. Begini kata sang aktor:  https://t.co/2bUrs271N4",9,0,1,0,2022-01-01,12,Saturday,6,10,0
1477254482731876352,2022-01-01 12:24:49,Puluhan pemuda di Lamongan menggelar aksi 'angon bebek' di tengah banjir. Aksi ini bentuk protes karena tiap tahun kerap dikepung banjir. https://t.co/O6lztKNuq9,6,1,3,1,2022-01-01,12,Saturday,6,9,2
1477254147812560901,2022-01-01 12:23:29,"Indonesia mencatat sebanyak 274 kasus baru COVID-19, Sabtu (1/1/2022). DKI menyumbang kasus terbanyak dengan jumlah 118. https://t.co/E6f2pZrxHc",1,1,1,0,2022-01-01,12,Saturday,6,2,1
1477252491058233344,2022-01-01 12:16:54,"Indonesia harus main ngotot melawan Thailand di leg kedua final Piala AFF 2020. Jika langsung injak gas sejak menit pertama, skuad Garuda bisa saja menang. https://t.co/aIrxo3Ijof",13,3,0,1,2022-01-01,12,Saturday,6,13,4
1477252227609808896,2022-01-01 12:15:51,"Thailand vs Indonesia akan tersaji malam nanti. Inilah leg kedua final Piala AFF, untuk raih mahkota tertinggi di ASEAN! https://t.co/RqPr2NUq1O",13,0,2,0,2022-01-01,12,Saturday,6,15,0
1477251093910503425,2022-01-01 12:11:21,Video debat panas Habib Bahar Smith dengan Danrem 061 Surya Kencana Brigjen Achmad Fauzi viral di media sosial. Jenderal bintang satu itu pun buka suara. https://t.co/8GlHE2TADv,38,32,7,2,2022-01-01,12,Saturday,6,45,34
1477250599972478979,2022-01-01 12:09:23,#Terpopuler Polisi kembali menangkap seorang artis yang diduga terlibat dalam kasus prostitusi. Ia adalah Cassandra Angelie. Ini profilnya:  https://t.co/Dw53arjfMQ,13,2,3,2,2022-01-01,12,Saturday,6,16,4
1477249282986196995,2022-01-01 12:04:09,Indonesia tak bisa menurunkan empat pemain di leg kedua final Piala AFF 2020 kontra Thailand malam ini. Singapura menyatakan mereka melanggar aturan bubble. https://t.co/4lhkVtEP9Q,58,23,21,8,2022-01-01,12,Saturday,6,79,31
1477247435009314817,2022-01-01 11:56:49,"Warisan kartel Freddy Budiman ternyata tak cuma cerita penangkapan 1,4 juta butir pil ekstasi dan hukuman mati. Fikri Budiman menceritakan dari hulu ke hilir. https://t.co/VVpkF0D5zl",11,1,3,0,2022-01-01,11,Saturday,6,14,1
1477246698820886528,2022-01-01 11:53:53,Prisia Nasution mengungkapkan pengalamannya soal bagaimana kondisi masyarakat di daerah wisata. Ini kata Prisia Nasution:  https://t.co/ebhiqzDMpG,24,0,2,1,2022-01-01,11,Saturday,6,26,1
1477246201858871300,2022-01-01 11:51:55,#Terpopuler Cassandra Angelie ditetapkan jadi tersangka dalam kasus prostitusi artis. Ini pelanggan Cassandra Angelie:  https://t.co/NkVsdO4az2,21,18,4,3,2022-01-01,11,Saturday,6,25,21
1477244638058663936,2022-01-01 11:45:42,Gerinda DKI M Taufik bicara soal 3 nama pengganti Anies Baswedan sebagai Gubernur DKI Jakarta. Golkar DKI Basri menilai pernyataan M Taufik kode Anies nyapres. https://t.co/YuaHhZ9XNe,10,1,1,0,2022-01-01,11,Saturday,6,11,1
1477244411981578242,2022-01-01 11:44:48,"Pariwisata Lamongan mulai bergeliat. Awal libur Tahun Baru 2022, pengunjung Maharani Zoo dan Goa Lamongan (Mazoola) meningkat. https://t.co/aQo076hOjf",2,0,1,0,2022-01-01,11,Saturday,6,3,0
1477242826463268864,2022-01-01 11:38:30,Kementerian Ketenagakerjaan kembali mengimbau para Gubernur untuk mengacu pada PP Nomor 36 Tahun 2021. https://t.co/y5GQhBjid3,14,18,6,8,2022-01-01,11,Saturday,6,20,26
1477241336738766849,2022-01-01 11:32:35,"Menjadi destinasi wisata keluarga, Puncak tak pernah kehabisan tempat untuk dikunjungi. Lima restoran ramah anak ini bisa menjadi alternatifnya. https://t.co/W30aUIAqop",8,0,1,0,2022-01-01,11,Saturday,6,9,0
1477240070671409154,2022-01-01 11:27:33,"Irwansyah sedang menghadapi cobaan lantaran ditipu oleh saudaranya sendiri, yakni sang adik. Irwansyah yang masih bisa tersenyum usai ditipu miliaran rupiah. https://t.co/Une7BNjkq6",15,1,3,1,2022-01-01,11,Saturday,6,18,2
1477238809226096640,2022-01-01 11:22:32,Aturan PTM Terbatas di Jakarta sudah berlaku sejak hari pertama sekolah pada 3 Januari 2022. Begini aturan lengkapnya: https://t.co/tBFDrhnODu,5,0,4,0,2022-01-01,11,Saturday,6,9,0
1477237541774446592,2022-01-01 11:17:30,"Indonesia melaporkan 274 kasus COVID-19 pada Sabtu (1/1/2022). Total kasus positif menjadi 4.262.994, sembuh 4.114.499, dan meninggal 144.096. https://t.co/3IvWzIZeVG",3,1,2,0,2022-01-01,11,Saturday,6,5,1
1477237060343898121,2022-01-01 11:15:35,Gaga Muhammad ngaku mau nikahi Laura Anna. Greta Irene seloroh yang ada dibikin gila...   https://t.co/k9ld7fEW55,7,1,1,2,2022-01-01,11,Saturday,6,8,3
1477235662231384066,2022-01-01 11:10:02,"Fikri Budiman menceritakan kedekatannya dengan sang ayah, Freddy Budiman, gembong narkoba Indonesia. Apa momen yang paling diingat? https://t.co/OdyM77ed9Y",6,0,2,0,2022-01-01,11,Saturday,6,8,0
1477233897125695490,2022-01-01 11:03:01,Ketum PSSI Mochamad Iriawan memastikan hasil Piala AFF 2020 tidak akan memengaruhi posisi Shin Tae-yong. Pelatih asal Korea dikontrak sampai 2023. https://t.co/dOaOhJAGwI,96,10,9,2,2022-01-01,11,Saturday,6,105,12
1477233379196219393,2022-01-01 11:00:57,NT juga meminta untuk masyarakat tidak menyudutkan dirinya maupun GJ. NT kemudian berterima kasih pada Polsek Tambora. https://t.co/NyP7E3otWn,4,0,1,0,2022-01-01,11,Saturday,6,5,0
1477232385662062595,2022-01-01 10:57:01,"Ketika Freddy Budiman, dieksekusi mati pada 2016, sempat muncul konspirasi. Sejumlah orang mengatakan Freddy masih hidup. Ini jawaban Fikri Budiman:  https://t.co/p9b6hcT4yw",12,0,2,0,2022-01-01,10,Saturday,6,14,0
1477231626199478272,2022-01-01 10:53:59,Polisi kembali memeriksa saksi lain berkaitan dengan kasus dugaan ujaran kebencian yang dilakukan oleh Habib Bahar bin Smith. Kini sudah ada 50 saksi termasuk ahli yang diperiksa. https://t.co/svNkIxewix,11,9,1,2,2022-01-01,10,Saturday,6,12,11
1477230927130480642,2022-01-01 10:51:13,"Sebelum jadi tersangka sekaligus korban, Cassandra Angelie mengaku sosok yang pemalu. Begini penuturannya: https://t.co/5NfNspsNRc",29,26,3,6,2022-01-01,10,Saturday,6,32,32
1477229633062023169,2022-01-01 10:46:04,Video perdebatan antara habib Bahar bin Smith dengan Danrem 061/Surya Kencana Brigjen TNI Achmad Fauzi viral di medsos. https://t.co/lzUpMZYB3c,32,25,10,2,2022-01-01,10,Saturday,6,42,27
1477228851608576002,2022-01-01 10:42:58,Kemenkes mengumumkan ada 68 kasus baru varian Omicron. Hal ini membuat total kasus Omicron di Indonesia menjadi 136 hingga Sabtu (1/1/2022). https://t.co/zvocylZXVn,30,16,25,8,2022-01-01,10,Saturday,6,55,24
1477227864365965318,2022-01-01 10:39:03,Personel Satnarkoba Polresta Bandara Soekarno-Hatta (Soetta) ramai-ramai dimutasi ke Yanma Polda Metro Jaya. Ada 10 polisi yang dimutasi untuk diperiksa. https://t.co/A1zq4e0pF7,4,0,2,0,2022-01-01,10,Saturday,6,6,0
1477227288479555584,2022-01-01 10:36:45,Libur Tahun Baru 2022 terjadi kemacetan di jalur menuju wisata Telaga Sarangan Magetan. Kemacetan sepanjang sekitar 2 KM terjadi di depan Pasar Sayur Plaosan. https://t.co/9qsnAvWB92,3,1,1,1,2022-01-01,10,Saturday,6,4,2
1477226545345400833,2022-01-01 10:33:48,Pengunjung perdana tahun 2022 di Candi Borobudur mendapatkan hadiah. Mereka ini juga diajak keliling naik mobil listrik dan melakukan penanaman Pohon Pranajiwa. https://t.co/TEWOBY1gSt,12,0,1,0,2022-01-01,10,Saturday,6,13,0
1477225785559764993,2022-01-01 10:30:47,"Inilah daftar tarif jalan tol untuk rute Jakarta ke Semarang, Jawa Tengah. https://t.co/dasn6ChaG7",7,1,3,0,2022-01-01,10,Saturday,6,10,1
1477224795163009029,2022-01-01 10:26:51,"Larissa Chou saat ini menikmati masa-masa menjaga dan merawat anak semata wayangnya, Yusuf. Ini respons Larissa Chou ketika anaknya minta papa baru:  https://t.co/SnclMUjJH2",10,1,1,1,2022-01-01,10,Saturday,6,11,2
1477224303590621187,2022-01-01 10:24:54,Dakota Johnson ungkap gaya pacaran dengan Chris Martin. Seperti apa? https://t.co/clG3zN1be8,19,1,0,0,2022-01-01,10,Saturday,6,19,1
1477223172596449281,2022-01-01 10:20:24,PT KAI menerapkan tarif baru layanan tes antigen yang semula Rp 45.000 menjadi Rp 35.000. Tarif ini berlaku sejak 1 Januari 2021. https://t.co/n0RWMwkpyZ,24,2,11,4,2022-01-01,10,Saturday,6,35,6
1477222930677481473,2022-01-01 10:19:26,Tarif cukai hasil tembakau (CHT) atau cukai rokok resmi naik mulai 1 Januari 2022. https://t.co/pW7GKiEwnw,72,20,30,10,2022-01-01,10,Saturday,6,102,30
1477222190122684417,2022-01-01 10:16:30,Tablet masih menjadi gadget pilihan untuk kerja dan belajar dari rumah. Berikut ini tujuh tablet terbaik tahun 2021 dengan spesifikasi dan harga yang beragam. https://t.co/sKVa3lquRn,16,0,4,0,2022-01-01,10,Saturday,6,20,0
1477219678531559426,2022-01-01 10:06:31,Masa jabatan Anies sebagai Gubernur DKI berakhir Oktober 2022. Penasihat Fraksi Gerindra DPRD DKI Jakarta M Taufik bicara tiga nama calon pengganti Anies. https://t.co/e12m6TYEpc,13,15,3,1,2022-01-01,10,Saturday,6,16,16
1477218038004862983,2022-01-01 10:00:00,"Yuk! Ulas Kilas Balik Peristiwa Penting Sepanjang 2021 Bareng detikcom
https://t.co/TfZyprgmiQ",2,0,0,0,2022-01-01,10,Saturday,6,2,0
1477217169150779393,2022-01-01 09:56:33,SRN Entertainment siap kembangkan industri musik yang sehat pada 2022. https://t.co/5BTTxXJpta,6,0,1,0,2022-01-01,9,Saturday,6,7,0
1477216671081406465,2022-01-01 09:54:34,"Fajar mengatakan, imam masjid itu awalnya sedang berjalan ke masjid untuk melaksanakan salat subuh. Saat itu korban nyaris diserempet pelaku. Pelakupun ditegur https://t.co/B5F4ETFEtC",12,1,0,1,2022-01-01,9,Saturday,6,12,2
1477215683117211653,2022-01-01 09:50:38,"Dengan minimnya humor dan visual efek yang terlihat murah, film ini susah menarik fans baru meskipun bisa jadi menyenangkan untuk fans Resident Evil sejati. Simak reviewnya di sini:  https://t.co/pQI8k3PVgS",3,1,1,0,2022-01-01,9,Saturday,6,4,1
1477214656372563969,2022-01-01 09:46:34,"Lantas, ketika Freddy Budiman telah tiada, bagaimana dengan semua harta tersebut. Aset properti, kendaraan, uang tunai dan lainnya? Simak kisahnya:  https://t.co/rM2kRP3BeB",2,0,0,1,2022-01-01,9,Saturday,6,2,1
1477214139508531203,2022-01-01 09:44:30,Fuji sebut tahun 2021 penuh duka. Thariq Halilintar pun beri semangat. https://t.co/jViBHosmqi,14,13,0,1,2022-01-01,9,Saturday,6,14,14
1477212130378014721,2022-01-01 09:36:31,Salah satu eks pegawai KPK Rasamala Aritonang bergabung dengan Visi Law Office yang dibentuk oleh mantan Kabiro Humas KPK Febri Diansyah. https://t.co/LAUhRLnTnO,115,3,11,3,2022-01-01,9,Saturday,6,126,6
1477211904187809793,2022-01-01 09:35:37,Sebuah adegan pada episode 6 di serial Layangan Putus jadi viral di media sosial. Ini potretnya: #LayanganPutus  https://t.co/vVqDdAKDrt,8,0,0,1,2022-01-01,9,Saturday,6,8,1
1477211569293606912,2022-01-01 09:34:18,Gaga Muhammad ngaku cuti kuliah di Inggris. Hal itu dilakukan demi rawat Laura Anna. #GagaMuhammad  https://t.co/zTQ3hZc1tX,2,3,0,1,2022-01-01,9,Saturday,6,2,4
1477210825802895363,2022-01-01 09:31:20,Web Series Layangan Putus yang dibintangi Reza Rahardian jadi perbincangan. Bagaimana cerita asli Layangan Putus versi Mommy ASF yang viral? https://t.co/ZKH8lmAN8h,10,0,0,1,2022-01-01,9,Saturday,6,10,1
1477210065845329921,2022-01-01 09:28:19,Momen Ari Lasso memutuskan hengkang dari Dewa 19 pada 90-an memang masih mengenang. Ternyata ini alasan Ari Lasso hengkang dari Dewa 19:  https://t.co/INJAT1xlpt,22,3,3,0,2022-01-01,9,Saturday,6,25,3
1477209076392153089,2022-01-01 09:24:23,Pomau menahan Sersan Kepala (Serka) S yang diduga terlibat membantu pengiriman TKI Ilegal ke Malaysia. Serka S juga telah ditetapkan sebagai tersangka. https://t.co/isWHxuwWBl,3,0,0,0,2022-01-01,9,Saturday,6,3,0
1477208576569626628,2022-01-01 09:22:24,Pemerintah telah resmi menaikkan tarif cukai hasil tembakau atau cukai rokok dan lainnya mulai 1 Januari 2022. https://t.co/umqEV4Htmb,27,14,5,7,2022-01-01,9,Saturday,6,32,21
1477208084514844675,2022-01-01 09:20:27,Pemerintah melarang ekspor batu bara pada 1 hingga 31 Januari 2022 bagi pemegang Izin Usaha Pertambangan (IUP) atau IUPK. https://t.co/HY8nYVjGEP,7,0,4,1,2022-01-01,9,Saturday,6,11,1
1477207340982149123,2022-01-01 09:17:29,Greta Irene kini bicara soal Gaga Muhammad. Dia geram dengan pernyataan-pernyataan dari pihak Gaga soal Laura Anna. #GagaMuhammad  https://t.co/30fQYdUSip,5,1,0,0,2022-01-01,9,Saturday,6,5,1
1477205557564121094,2022-01-01 09:10:24,"Militan Palestina di Gaza menembakkan dua roket ke arah Laut Mediterania. Roket-roket itu dilaporkan jatuh di pantai Tel Aviv, Israel, dan memicu ledakan. https://t.co/JH12izwSN7",6,2,2,0,2022-01-01,9,Saturday,6,8,2
1477205083968491525,2022-01-01 09:08:31,Timnas Indonesia akan melawan Thailand pada final leg kedua Piala AFF 2020. Pelatih Shin Tae-yong berpotensi melakukan perubahan susunan pemain demi kemenangan. https://t.co/uaOnbHBh4g,5,1,1,0,2022-01-01,9,Saturday,6,6,1
1477204089738047492,2022-01-01 09:04:34,Situs milik Kodim 0201/Medan diduga diretas (di-hack). TNI menyatakan sedang menindaklanjuti peristiwa peretasan itu. https://t.co/DBRb480CeD,2,0,0,0,2022-01-01,9,Saturday,6,2,0
1477203038188314630,2022-01-01 09:00:24,Pola diet artis Korea banyak dijadikan rujukan untuk menurunkan berat badan dengan cepat. 4 artis Korea ini berbagi menu dietnya hingga berat turun drastis. #detiknetwork  https://t.co/U9ylfeV2jf,16,0,3,0,2022-01-01,9,Saturday,6,19,0
1477202267992465411,2022-01-01 08:57:20,Wacana mobil rakyat digulirkan oleh Menteri Perindustrian Agus Gumiwang Kartasasmita. Tapi mobil yang masuk kategori mobil rakyat harus memenuhi tiga syarat. https://t.co/lRJC8ZvF3r,1,0,1,0,2022-01-01,8,Saturday,6,2,0
1477201531762102275,2022-01-01 08:54:24,PSS Sleman menutup tahun 2022 dengan sejumlah perubahan. Manajemen klub Laskar Sembada itu malam tadi mengumumkan melepas lima orang pemain. https://t.co/x6wEwvyB7p,6,0,0,0,2022-01-01,8,Saturday,6,6,0
1477200490014334978,2022-01-01 08:50:16,"Sebagian besar kehidupan di Antartika berada di permukaan es. Sekarang, para ilmuwan menemukan kehidupan baru di bawah lapisan es. Wow! https://t.co/CG46OkGDwl",11,0,1,0,2022-01-01,8,Saturday,6,12,0
1477199413722468352,2022-01-01 08:45:59,"Selebgram Rachmawati Kekeyi Putri Cantika sejak dulu punya keinginan tampil bak Barbie, karakter kesukaannya. Ternyata, hal itu bukan cuma impian belaka. https://t.co/FbvYuoiBlD",5,0,0,0,2022-01-01,8,Saturday,6,5,0
1477198664586117122,2022-01-01 08:43:01,"Setelah ayahnya dihukum mati 2016, sejatinya warisan yang ditinggalkan berupa tanggung jawab untuk terus menyebarkan kisah-kisah baik Freddy Budiman.  https://t.co/QD0AHkOx57",21,0,3,1,2022-01-01,8,Saturday,6,24,1
1477197921707864066,2022-01-01 08:40:04,Kementerian Energi dan Sumber Daya Mineral (ESDM) melarang ekspor batu bara selama Januari 2022. https://t.co/2NJ6wNU2IC,13,0,8,0,2022-01-01,8,Saturday,6,21,0
1477196914852601860,2022-01-01 08:36:04,"Proyek jalan tembusan Pasar Minggu, Jaksel mangkrak sekitar 2 tahun. Anggota Komisi D DPRD DKI Jakarta Yuke Yurike menganggap Pemprov DKI tidak serius. https://t.co/uFw4OJepMn",10,3,4,1,2022-01-01,8,Saturday,6,14,4
1477195918327824387,2022-01-01 08:32:06,"Freddy Budiman, gembong narkoba terbesar di Indonesia, dihukum mati. Ada peluit panjang hingga badai jelang eksekusi. Simak kisahnya: #HotQuestions  https://t.co/jSnOWtTxz5",13,0,8,0,2022-01-01,8,Saturday,6,21,0
1477195129681321984,2022-01-01 08:28:58,Mohammad Ahsan hingga Kevin Sanjaya Sukamuljo mengunggah di media sosial terkait bonus Rp 10 miliar Piala Thomas 2020. Isinya berupa sindiran? https://t.co/ROegyuMpky,52,4,10,5,2022-01-01,8,Saturday,6,62,9
1477194141339725827,2022-01-01 08:25:02,"Akhir tahun 2021 ditutup Chelsea dengan berbagai masalah. Dari badai cedera, masalah kontrak, sampai curhat Romelu Lukaku yang mengejutkan. https://t.co/Mh28PLx1BD",4,1,0,0,2022-01-01,8,Saturday,6,4,1
1477193652510375936,2022-01-01 08:23:06,"Pelatih legendaris Manchester United, Sir Alex Ferguson, ultah yang ke-80. Netizen pun ramai merayakannya. https://t.co/uCU20SYRQu",21,0,2,2,2022-01-01,8,Saturday,6,23,2
1477192403903725568,2022-01-01 08:18:08,"Selama delapan tahun, seorang pria mencari hard disk berisi 7.500 Bitcoin di tumpukan sampah. Nilainya Rp 5 triliun! https://t.co/kRThFRsdsl",68,8,18,2,2022-01-01,8,Saturday,6,86,10
1477192116950478849,2022-01-01 08:17:00,Bandara Soekarno Hatta tampak masih dipenuhi oleh calon penumpang yang akan melakukan perjalanan domestik. Tercatat pukul 08.00-12.00 WIB akan ada 39 penerbangan yang mengangkut 5.139 penumpang. https://t.co/PXFQz9vlaS,4,1,0,0,2022-01-01,8,Saturday,6,4,1
1477191771260137472,2022-01-01 08:15:37,Rafael Tan ingin menikah di tahun 2022. Kriterianya tak banyak yang penting seiman. Siapa mau? https://t.co/NMvA2xDqKn,5,1,0,1,2022-01-01,8,Saturday,6,5,2
1477191013370413060,2022-01-01 08:12:37,"Kementerian Pekerjaan Umum dan Perumahan Rakyat (PUPR) mencatat total jalan tol yang telah beroperasi di Indonesia pada akhir 2021 sepanjang 2.489,2 km. https://t.co/wPDlR9mrY2",8,0,2,0,2022-01-01,8,Saturday,6,10,0
1477190190871502849,2022-01-01 08:09:21,#Terpopuler Cassandra Angelie ditetapkan jadi tersangka kasus dugaan prostitusi online. Ia terlibat karena kebutuhan ekonomi.  https://t.co/WGG5VjUgBt,38,33,4,5,2022-01-01,8,Saturday,6,42,38
1477189688884703233,2022-01-01 08:07:21,Badan Pusat Statistik (BPS) merilis Indeks Kebahagiaan 2021. Ada 10 daerah dengan skor terendah dalam Indeks Kebahagiaan 2021. https://t.co/n9Sayi6nQ8,4,0,4,2,2022-01-01,8,Saturday,6,8,2
1477188708302569472,2022-01-01 08:03:27,"Skuter listrik Ola sempat jadi fenomena di India saat dijual dengan banderol murah meski kaya fitur. Kini saat motornya di tangan konsumen, protes bermunculan. https://t.co/NeEALWLoXi",6,0,4,0,2022-01-01,8,Saturday,6,10,0
1477187627535187971,2022-01-01 07:59:09,Cassandra Angelie dan muncikari ditangkap karena diduga terlibat prostitusi. Polisi mengungkap ada selebritas lain di daftar atau list muncikari Cassandra. https://t.co/qQzXs9y1YS,14,1,0,1,2022-01-01,7,Saturday,6,14,2
1477186733439602690,2022-01-01 07:55:36,"Pandemi COVID-19 sudah dua tahun berlalu, namun asal virusnya masih juga belum diketahui. WHO sudah membentuk tim ahli yang menginvestigasi hal ini. https://t.co/vzekG2kHl1",12,3,1,0,2022-01-01,7,Saturday,6,13,3
1477186254898962432,2022-01-01 07:53:42,"Polisi memberlakukan sistem one way ke bawah di Simpang Gadog, Kabupaten Bogor, Jawa Barat. Terpantau one way dari arah Puncak ke bawah mulai pukul 13.00 WIB. https://t.co/WsKUx7Hhxu",5,0,0,0,2022-01-01,7,Saturday,6,5,0
1477185767856353280,2022-01-01 07:51:46,"Bagi yang ingin cuci mata ke mal, sebaiknya mengetahui terlebih dahulu jam operasional dan persyaratannya selama Tahun Baru. https://t.co/90K8Y77ivR",6,0,0,0,2022-01-01,7,Saturday,6,6,0
1477185266305675268,2022-01-01 07:49:46,Arus lalu lintas di gerbang tol Cikatama arah Cirebon padat. Terjadi antrean kendaraan di gerbang tol. https://t.co/hAbH0U3iTF,9,0,0,0,2022-01-01,7,Saturday,6,9,0
1477184576980242438,2022-01-01 07:47:02,"Di Bogor ada destinasi kuliner baru, namanya Tapos Garden and Eatery. Kamu bisa kulineran di tengah taman bunga yang cantik. Cocok banget buat foto-foto! https://t.co/miA3mgJBbq",7,0,1,1,2022-01-01,7,Saturday,6,8,1
1477183484120739840,2022-01-01 07:42:42,"Ini satu-satunya mobil yang dimiliki Endang Tirtana, Komisaris Independen PT KAI (Persero). Mobil apa ya? Simak yuk! https://t.co/w2SRIzmYVM",3,1,0,2,2022-01-01,7,Saturday,6,3,3
1477182488367800323,2022-01-01 07:38:44,Kata terpanjang dalam kamus bahasa Indonesia terdiri dari 31 huruf. Begini asal-usul kata terpanjang di kamus bahasa Indonesia dan prosesnya masuk KBBI. https://t.co/kVN40WIiB3,22,3,4,3,2022-01-01,7,Saturday,6,26,6
1477181455348416512,2022-01-01 07:34:38,"Sebuah gereja tidak biasa berada di Georgia. Predikatnya, gereja paling kesepian, tertinggi, dan paling misterius di dunia. https://t.co/G1YnqZf6Gb",10,2,0,1,2022-01-01,7,Saturday,6,10,3
1477180173359493122,2022-01-01 07:29:32,"Baru-baru ini, ramai kabar Thailand akan kena diskualifikasi di Piala AFF karena kasus doping. Namun, kabar itu dipastikan hoaks! https://t.co/yGjqoTbZNG",77,3,7,2,2022-01-01,7,Saturday,6,84,5
1477179427780014080,2022-01-01 07:26:34,Salah satu bus tronton pertama di dunia lahir dari Mercedes-Benz. Merek asal Jerman itu kali pertama memperkenalkan bus tronton pada 1928 silam. https://t.co/9ZWeylVqyM,29,1,8,0,2022-01-01,7,Saturday,6,37,1
1477178442353459204,2022-01-01 07:22:39,GMF dan Citilink telah selesai menindaklanjuti seluruh rekomendasi Direktorat Jenderal Perhubungan Udara Kementerian Perhubungan (Ditjen Hubud Kemenhub). https://t.co/LFx6OwQeA5,1,0,4,0,2022-01-01,7,Saturday,6,5,0
1477177200046710787,2022-01-01 07:17:43,"Tim Waspada COVID-19 dari Lembaga Eijkman (WASCOVE) pamit. Selama pandemi COVID-19, tim WASCOVE telah berperan mendeteksi dan meneliti virus Corona. https://t.co/zjXGPUWb1W",11,1,6,0,2022-01-01,7,Saturday,6,17,1
1477175953944158211,2022-01-01 07:12:46,"Cukai rokok, pajak pertambahan nilai (PPN), dan pajak penghasilan (PPh) orang kaya naik di 2022 ini. Berapa kenaikannya? https://t.co/ADNgpDrr96",8,0,4,4,2022-01-01,7,Saturday,6,12,4
1477175137862627332,2022-01-01 07:09:32,"Pemilik Grup Texmaco, Marimutu Sinivasan menggugat Kantor Pelayanan Kekayaan Negara Dan Lelang (KPKNL) Jakarta III di Pengadilan Negeri Jakarta Pusat. https://t.co/KM1W07MMWX",9,0,2,3,2022-01-01,7,Saturday,6,11,3
1477172997274451969,2022-01-01 07:01:01,"Tjahjo mengatakan PNS tidak diwajibkan mengikuti pelatihan Komcad, karena bersifat sukarela. Meski demikian, PNS diharapkan dapat terlibat dalam program Komcad sebagai bentuk dukungan terhadap upaya pertahanan negara. #CNNIndonesia #detiknetwork  https://t.co/9wgTzlRXTF",9,3,4,2,2022-01-01,7,Saturday,6,13,5
1477172256753266688,2022-01-01 06:58:05,Satuan Tugas Penanganan Hak Tagih Negara Dana Bantuan Likuiditas Bank Indonesia (Satgas BLBI) memanggil Hindarto Tantular dan Anton Tantular. https://t.co/fsd8a47AUC,4,0,1,0,2022-01-01,6,Saturday,6,5,0
1477171273377751043,2022-01-01 06:54:10,Usulan penghapusan PPnBM untuk mobil rakyat muncul. Menteri Perindustrian Agus Gumiwang mengusulkan hal itu kepada Menteri Keuangan Sri Mulyani Indrawati. https://t.co/bI8JMd41bb,5,2,3,1,2022-01-01,6,Saturday,6,8,3
1477170259949985797,2022-01-01 06:50:09,"Pria ini ingin bakar-bakar ikan pada malam tahun baru, realitanya tak sesuai harapan. https://t.co/MbV2mtw82R",6,2,1,0,2022-01-01,6,Saturday,6,7,2
1477169739608862720,2022-01-01 06:48:05,"Sejumlah pengunjung mengaku tak tahu soal cara pembelian tiket masuk Ragunan yang baru, yakni secara online. Salah satunya Yuni (33). https://t.co/CAO7h1obzj",6,1,2,0,2022-01-01,6,Saturday,6,8,1
1477168744581500928,2022-01-01 06:44:07,Sekitar 60 orang ditelantarkan di Gunung Rinjani oleh penyelenggara open trip. Begini kronologinya: https://t.co/FcNtQCRK8M,58,11,30,7,2022-01-01,6,Saturday,6,88,18
1477167766650163201,2022-01-01 06:40:14,Polda Jabar kembali memeriksa saksi lain berkaitan dengan kasus dugaan ujaran kebencian yang dilakukan oleh Bahar Smith. Kini sudah ada 50 saksi diperiksa. https://t.co/hiQiZeq9y0,3,2,3,0,2022-01-01,6,Saturday,6,6,2
1477166990116765696,2022-01-01 06:37:09,Cassandra Angelie ditangkap polisi karena diduga terlibat prostitusi. Polisi menduga Cassandra terlibat prostitusi berawal dari pertemanan dengan muncikari. https://t.co/j3G8lvcxha,10,0,4,1,2022-01-01,6,Saturday,6,14,1
1477165750326542336,2022-01-01 06:32:13,Instansi pemerintah diimbau untuk melaksanakan apel pagi setiap hari Senin secara rutin. https://t.co/Yf9IUSx0ff,7,1,4,2,2022-01-01,6,Saturday,6,11,3
1477164763247435778,2022-01-01 06:28:18,Aktris Natalie Tong mengaku jika dirinya kini alergi terhadap 20 jenis makanan. Bagaimana penjelasannya? https://t.co/hzs8WnUDwm,0,2,1,0,2022-01-01,6,Saturday,6,1,2
1477163526628290564,2022-01-01 06:23:23,Seorang pria berinisial DI (sebelumnya disebut DD) menjadi tersangka karena menikam pria diduga begal hingga tewas. Polisi menjelaskan alasan mengapa DI dijerat sebagai tersangka. https://t.co/oAW2djMjW9,45,105,9,33,2022-01-01,6,Saturday,6,54,138
1477162492627496960,2022-01-01 06:19:17,Laura Anna menangis histeris lihat kecelakaan Vanessa Angel. Ia takut dan teringat momen yang sama dengan Gaga Muhammad. https://t.co/E8cJyU8N8f,38,15,6,0,2022-01-01,6,Saturday,6,44,15
1477161497491124225,2022-01-01 06:15:19,Tahun depan Indonesia akan menerapkan sistem bayar tol tanpa berhenti atau disebut multi lane free flow (MLFF). Begini cara bayar tol tanpa berhenti: https://t.co/LV5dvVFJAj,21,7,7,3,2022-01-01,6,Saturday,6,28,10
1477160016159387651,2022-01-01 06:09:26,Sinyal kehadiran Toyota Fortuner Legender di Indonesia sebelumnya muncul dalam lampiran Peraturan Menteri Dalam Negeri No. 40 Tahun 2021. https://t.co/3rKgSjCZU3,7,0,1,2,2022-01-01,6,Saturday,6,8,2
1477159024365907976,2022-01-01 06:05:30,"Sebanyak delapan pegawai Kementerian ATR/BPN jadi tersangka kasus mafia tanah di Cakung, Jakarta Timur. Mereka hingga saat ini masih berstatus PNS aktif. https://t.co/18TWHv45Qs",82,12,39,12,2022-01-01,6,Saturday,6,121,24
1477158227343298562,2022-01-01 06:02:20,"Saat ini, Anya Geraldine adalah salah satu wanita yang paling disorot di Indonesia karena penampilan dan karyanya. Berikut transformasinya: https://t.co/8xyMoGSqP8",11,5,1,0,2022-01-01,6,Saturday,6,12,5
1477156934285508613,2022-01-01 05:57:12,Yoyo Chen dan Vincent Wong sempat diterpa isu tak sedap dan dikabarkan ingin bercerai. Namun nyatanya keduanya malah akur di media sosial. https://t.co/bP5yuNh4Vu,5,0,0,0,2022-01-01,5,Saturday,6,5,0
1477155942630313994,2022-01-01 05:53:15,Seorang model terbawa dalam kontroversi yang belakangan marak jadi perbincangan di China. Iklan yang dibintanginya dikritik karena penampilannya bermata sipit. https://t.co/BSfOZxfYsD,6,0,1,1,2022-01-01,5,Saturday,6,7,1
1477154710067023873,2022-01-01 05:48:21,"Jajan memang jadi aktivitas yang mengasyikkan. Sayangnya, kebanyakan orang lebih sering jajan makanan atau minuman yang kurang bergizi. https://t.co/nykwxNvwaD",8,0,2,0,2022-01-01,5,Saturday,6,10,0
1477153368904716294,2022-01-01 05:43:01,Meskipun sama-sama suka kopi tetapi soal selera pasti berbeda. Ternyata ada penelitian yang mengungkap mengapa orang suka minum kopi hitam. https://t.co/dDlFZLq5Kx,21,3,6,2,2022-01-01,5,Saturday,6,27,5
1477151996549423108,2022-01-01 05:37:34,"Seandainya teori konspirasi Bumi datar memang benar, seperti inilah fenomena alam yang akan terjadi. https://t.co/ptIbjqdXmn",10,0,2,1,2022-01-01,5,Saturday,6,12,1
1477151391370121221,2022-01-01 05:35:10,"Mark Zuckerberg kembali membeli lahan di Hawaii seluas 100 hektar. Untuk memperluas propertinya, ia merogoh kocek Rp 251 miliar. https://t.co/WfhLMFaWYD",46,14,4,4,2022-01-01,5,Saturday,6,50,18
1477150154998554631,2022-01-01 05:30:15,"Dirjen WHO, Tedros Adhanom Ghebreyesus, menyampaikan harapannya agar pandemi virus Corona (COVID-19) bisa berakhir di tahun 2022. https://t.co/uCs9HONWyw",14,2,3,0,2022-01-01,5,Saturday,6,17,2
1477148917624197124,2022-01-01 05:25:20,Greta Irene kini bicara soal Gaga Muhammad. Dia geram dengan pernyataan-pernyataan dari pihak Gaga soal Laura Anna. https://t.co/ponNNp58Fp,7,1,0,0,2022-01-01,5,Saturday,6,7,1
1477147372153098263,2022-01-01 05:19:12,"Sudah nonton 'Spider-Man: No Way Home'? Kalau belum, mending skip dulu baca berita ini karena bakalan ada spoiler banget nih artikelnya. https://t.co/WTnAHyubZX",17,1,3,0,2022-01-01,5,Saturday,6,20,1
1477146139166220290,2022-01-01 05:14:18,"Belum lama bercerai, Tong Liya kini telah melepas masa lajangnya itu dengan seorang pejabat. Ternyata pejabat China tersebut adalah kekasih lamanya. https://t.co/iyrGvDhUOt",5,1,2,0,2022-01-01,5,Saturday,6,7,1
1477144896079343617,2022-01-01 05:09:21,"Lelah melihat berat badannya yang terus naik, pria ini berkomitmen jalani diet intermittent fasting. Dalam 6 bulan dirinya bisa turun berat badan hingga 35 kg. https://t.co/KSoFFDfUvt",12,1,2,0,2022-01-01,5,Saturday,6,14,1
1477143666758148097,2022-01-01 05:04:28,"Pengacara Habib Bahar bin Smith, Aziz Yanuar, menyebut tindakan anggota TNI mendatangi Habib Bahar adalah bentuk abuse of power. https://t.co/AXntztoPaT",43,21,12,3,2022-01-01,5,Saturday,6,55,24
1477142665783300096,2022-01-01 05:00:30,Sudah tahu belum fakta dan manfaat nutrisi camilan jelly? https://t.co/wUFOkyNDIu,6,0,0,0,2022-01-01,5,Saturday,6,6,0
1477141666976915458,2022-01-01 04:56:32,"Dari Indonesia hingga film Korea, deretan film berbagai genre hadir di bioskop buat dinikmati di awal tahun dan akhir pekan ini. Lihat daftarnya! https://t.co/6wIdrGN4i1",1,0,0,0,2022-01-01,4,Saturday,6,1,0
1477140674445197316,2022-01-01 04:52:35,Menko Polhukam Mahfud Md menanggapi Hutomo Mandala Putra alias Tommy Soeharto yang mengaku tak memiliki utang BLBI. https://t.co/PJ5WNJ8zTK,12,1,1,0,2022-01-01,4,Saturday,6,13,1
1477139400022704128,2022-01-01 04:47:31,"Ada banyak laptop yang dirilis selama 2021, baik dari 'anak lama' ataupun perusahaan yang sebelumnya belum pernah merilis laptop. Apa saja yang menarik? https://t.co/Yuh6qFShYD",7,0,2,1,2022-01-01,4,Saturday,6,9,1
1477138144881479683,2022-01-01 04:42:32,Sempat populer 'food combining' yang diklaim sebagai diet paling benar. Ternyata pola makan ini sudah diterapkan oleh nabi Muhammad SAW sejak dahulu kala. https://t.co/jQklwF0Ld2,60,1,25,1,2022-01-01,4,Saturday,6,85,2
1477136932882821125,2022-01-01 04:37:43,"Foto kamuflase yang secara tidak sengaja dibuat ini mampu mengelabui otak dan mata kita, tidak percaya? Yuk buktikan sendiri, siap-siap mata tertipu! https://t.co/LiMKJdrU0g",3,0,1,1,2022-01-01,4,Saturday,6,4,1
1477136433534181380,2022-01-01 04:35:44,"Langit kita penuh dengan keajaiban kosmik. Di tahun 2022, sejumlah fenomena langit akan menyapa, mulai dari gerhana Bulan total hingga bintang jatuh. https://t.co/X2OrnBwJSX",16,0,3,3,2022-01-01,4,Saturday,6,19,3
1477135133576601601,2022-01-01 04:30:34,"Panji Trihatmodjo yang merupakan cucu Soeharto menikah dengan seorang bule berdarah Austria bernama Varsha Strauss, Bunda. Intip potret-potretnya di sini, ya. #detiknetwork  https://t.co/TmXS4r7CaV",11,1,6,4,2022-01-01,4,Saturday,6,17,5
1477133654744776705,2022-01-01 04:24:41,"Pemerintah Kabupaten Pangandaran melancarkan razia ke sejumlah kafe, bar, dan restoran di kawasan Kampung Turis Pamugaran, Jumat (31/12/2021) malam. Razia berfokus pada pemeriksaan kartu vaksinasi. https://t.co/gnMO4yCpwH",4,0,0,2,2022-01-01,4,Saturday,6,4,2
1477132421262979075,2022-01-01 04:19:47,"Bukan pesta Natal keluarga Kardashian-Jenner jika tidak super mewah dan glamor. Begitu pula untuk kado Natal. Tahun ini, mobil listrik jadi hadianya. https://t.co/2t4N1wqixx",11,1,0,1,2022-01-01,4,Saturday,6,11,2
1477131171574292481,2022-01-01 04:14:49,"Ditnarkoba Polda Metro Jaya bubarkan pengunjung yang merayakan malam tahun baru di food court Pantai Indah Kapuk (PIK) 2, Jakarta Utara, Jumat (31/12).  https://t.co/YjvfmJdEyS",7,0,1,0,2022-01-01,4,Saturday,6,8,0
1477129937739988994,2022-01-01 04:09:55,Pihak Irwansyah masih menunggu proses kasus pemalsuan tanda tangan yang dilakukan adiknya Hafiz Fatur. Hafiz Fatur kini masuk DPO. https://t.co/bjyHjOYjhw,14,0,1,2,2022-01-01,4,Saturday,6,15,2
1477128449231933440,2022-01-01 04:04:00,Shin Tae-yong berjanji Timnas Indonesia berusaha mendapatkan hasil terbaiknya di leg kedua malam ini. Pelatih asal Korea Selatan itu masih percaya dengan kemampuan para pemain. https://t.co/ucOH5Zu9IQ,25,1,5,3,2022-01-01,4,Saturday,6,30,4
1477126946257526785,2022-01-01 03:58:02,"Lesti Kejora baru saja melahirkan anak pertamanya. Selain Lesti, begini penampilan para pedangdut tanah air usai melahirkan. Tetap cantik natural tanpa makeup. https://t.co/kqw5PXPa9O",6,2,1,0,2022-01-01,3,Saturday,6,7,2
1477125710854639618,2022-01-01 03:53:07,"Selamat tinggal 2021, selamat datang 2022. Bagi kamu yang ingin menuliskan di media sosial kata-kata Tahun Baru 2022 Islami penuh doa, berikut inspirasinya: https://t.co/O3OcMYXr2O",3,1,0,0,2022-01-01,3,Saturday,6,3,1
1477124712098680839,2022-01-01 03:49:09,"Heboh pria gagal nikah ingin mencari orang untuk mengganti DP gedung pernikahan, ternyata dia selingkuh dan sudah berhubungan dengan cewek open bo. https://t.co/pZMZtPQOAj",17,12,6,8,2022-01-01,3,Saturday,6,23,20
1477123724147146757,2022-01-01 03:45:14,Berikut rentetan game yang akan hadir pada tahun 2022. Semoga ada judul di mana dapat membuat kalian tertarik untuk memainkannya ya. https://t.co/5dCHnjnFcB,8,0,1,0,2022-01-01,3,Saturday,6,9,0
1477122354648133637,2022-01-01 03:39:47,"Dear Taurus, hati tak boleh ciut nyali nya tetaplah berhati besar dan selalu optimis. Bagaimana dengan ramalan zodiak lainnya? Simak di sini: #RamalanZodiak #ZodiakHariIni  https://t.co/QatTWX9AG3",7,0,0,0,2022-01-01,3,Saturday,6,7,0
1477120992937971718,2022-01-01 03:34:22,"Sejumlah petugas Dinas Kehutanan tengah merapikan tanaman-tanaman. Sejauh pengamatan, kawasan tersebut bersih dari sampah. https://t.co/t0ufi6uGZw",16,0,0,1,2022-01-01,3,Saturday,6,16,1
1477119756641751041,2022-01-01 03:29:28,"Satu lagi klub Serie A mengumumkan kasus anyar positif COVID-19. Kali ini, giliran Juventus yang menyampaikan dua pemainnya terjangkit virus Corona. https://t.co/YicoSg99qA",4,0,2,0,2022-01-01,3,Saturday,6,6,0
1477118777254977536,2022-01-01 03:25:34,Seorang pemuda pingsan di atas pohon randu setinggi 10 meter. Dia mengaku kelelahan dan sempat muntah sebelum tak bergerak duduk di antara dua cabang pohon. https://t.co/IAKLhJwM53,25,4,8,1,2022-01-01,3,Saturday,6,33,5
1477117525846540293,2022-01-01 03:20:36,Romelu Lukaku blak-blakan soal penyesalannya meninggalkan Inter Milan. Striker Belgia itu awalnya berharap bisa pindah ke Barcelona atau Real Madrid. https://t.co/K0QAqxbhd1,10,0,0,3,2022-01-01,3,Saturday,6,10,3
1477115209508691972,2022-01-01 03:11:24,"Cassandra Angelie ditangkap terkait dugaan prostitusi pada Rabu (29/12). Saat digerebek, Cassandra tak berbusana bersama seorang pria. Polisi mengungkap tarif Cassandra Rp 30 juta. https://t.co/CqpJ94ECLb",7,9,3,2,2022-01-01,3,Saturday,6,10,11
1477113945941065728,2022-01-01 03:06:22,Seorang bocah berusia 12 tahun tewas dalam insiden kembang api di Belanda. Seorang bocah lainnya mengalami luka serius dalam insiden yang sama. https://t.co/XKGKGgfTnI,9,0,1,0,2022-01-01,3,Saturday,6,10,0
1477112957083561985,2022-01-01 03:02:27,PKB meminta 2 oknum TNI yang diduga terlibat mengirim PMI ilegal yang menjadi korban kapal tenggelam di perairan Malaysia diproses hukum secara tegas. https://t.co/kaUFOgXDh5,5,0,4,0,2022-01-01,3,Saturday,6,9,0
1477110520905932800,2022-01-01 02:52:46,"VR46 Racing Team mendapat sponsor baru dari perusahaan Italia, Mooney. Tim balap milik Valentino Rossi itu pun resmi berganti nama di musim baru 2022. https://t.co/vKb7pHnMCI",8,0,1,0,2022-01-01,2,Saturday,6,9,0
1477110023331459075,2022-01-01 02:50:47,Peristiwa Kebakaran di RSUP dr Kariadi Semarang di penghujung tahun 2021 cukup mengejutkan. Beberapa fakta mulai terungkap dari peristiwa Kamis malam. https://t.co/nIhBDRLMss,6,0,0,0,2022-01-01,2,Saturday,6,6,0
1477109529477267458,2022-01-01 02:48:49,Di media sosial beredar kabar ada buku terbitan tahun 2020 yang membahas soal COVID-19 varian Omicron. Benarkah hal tersebut? Ini faktanya. https://t.co/VNnYgNGQI6,5,0,0,0,2022-01-01,2,Saturday,6,5,0
1477109303496556544,2022-01-01 02:47:55,Awal mula Irwansyah laporkan adik kandung ke polisi. Ia rugi besar karena kelakuan Hafiz Fatur. https://t.co/guv9lwTEQE,8,0,0,0,2022-01-01,2,Saturday,6,8,0
1477108066650894340,2022-01-01 02:43:01,"Tidak hanya obat kuat ataupun ramuan herbal saja, menjaga ereksi agar tahan lama bisa didapat dari makanan, buah, sayur, hingga kopi. https://t.co/tEeXLS34et",14,3,4,2,2022-01-01,2,Saturday,6,18,5
1477106577362624513,2022-01-01 02:37:06,"Polisi menyebut korban pemerkosaan pemilik ponpes di OKU Selatan, Moh Syukur, awalnya tidak mau melaporkan kasus pemerkosaan ini ke polisi. Kenapa? https://t.co/IvdB0JRyr5",22,6,5,1,2022-01-01,2,Saturday,6,27,7
1477105305351774210,2022-01-01 02:32:02,Tarif antigen Daop 8 turun menjadi Rp 35 ribu dari sebelumnya Rp 45 ribu. Penyesuaian harga itu mulai berlaku pada I Januari 2022 di 11 stasiun wilayah Daop 8. https://t.co/5whQGd5Smv,1,0,0,1,2022-01-01,2,Saturday,6,1,1
1477104067516289029,2022-01-01 02:27:07,"Gubernur Sumatera Utara (Gubsu) Edy Rahmayadi kembali membuat kontroversi. Untuk kedua kalinya, Edy melarang orang memiliki kumis. https://t.co/oTWkDhd2N7",27,72,10,14,2022-01-01,2,Saturday,6,37,86
1477102562411225093,2022-01-01 02:21:08,"Siswa SD meninggal usai divaksin COVID-19 kembali terjadi di Jombang. Kali ini Naura Sabrina Galiyah (9), siswi kelas 4 SDN Catakgayam 1 Mojowarno. https://t.co/EoGBte68Sf",637,106,354,93,2022-01-01,2,Saturday,6,991,199
1477101528628580353,2022-01-01 02:17:02,Kabar duka datang dari dunia hiburan internasional. Aktris dan komedian legendaris AS Betty White meninggal dunia di usia 99 tahun. https://t.co/3T2HCFjfnw,35,1,3,3,2022-01-01,2,Saturday,6,38,4
1477100532561027078,2022-01-01 02:13:04,"Pengacara Habib Bahar bin Smith, Aziz Yanuar, menyebut tindakan anggota TNI mendatangi Habib Bahar adalah bentuk abuse of power https://t.co/51UNAeTje4",307,90,67,6,2022-01-01,2,Saturday,6,374,96
1477099537575649283,2022-01-01 02:09:07,"Satgas kali ini dilengkapi dengan para pejabat dari Kementerian Agraria dan Tata Ruang, Bareskrim, dan Tata Usaha Negara Kejaksaan Agung. https://t.co/r84VZa25LF",12,0,1,1,2022-01-01,2,Saturday,6,13,1
1477099046850412544,2022-01-01 02:07:10,Cassandra Angelie menyita perhatian negeri setelah terciduk prostitusi online dan jadi tersangka. Berikut sejumlah faktanya https://t.co/53OmqKzsNC,15,17,5,5,2022-01-01,2,Saturday,6,20,22
1477098302135013378,2022-01-01 02:04:13,"Final Piala AFF 2020 leg kedua akan digelar nanti malam, antara Thailand vs Indonesia. Berikut link live streaming laga penentuan itu. https://t.co/SAgvfWi5s8",32,0,10,2,2022-01-01,2,Saturday,6,42,2
1477097433041674240,2022-01-01 02:00:45,"Saat berusia enam bulan, Shauna Rae didiagnosis menderita kanker otak dan harus menjalani berbagai pengobatan, termasuk kemoterapi untuk menyelamatkan hidupnya. #CNNIndonesia #detiknetwork  https://t.co/rUm6zaRtki",13,0,2,0,2022-01-01,2,Saturday,6,15,0
1477095930184847360,2022-01-01 01:54:47,Menko PMK Muhadjir Effendy mengecek penerapan protokol kesehatan di Tangerang City Mall. Dia bertemu dengan beberapa pengunjung di sana. https://t.co/vQWhTt4TTF,2,0,0,0,2022-01-01,1,Saturday,6,2,0
1477094440984584199,2022-01-01 01:48:52,Polisi melarang warga untuk berhenti di beberapa flyover di Bandung saat malam momen pergantian tahun baru. Polisi akan berpatroli ke setiap flyover di Bandung. https://t.co/OoQnC4QeuV,4,0,0,0,2022-01-01,1,Saturday,6,4,0
1477093159716937731,2022-01-01 01:43:46,Dua kasus besar di Boyolali tahun 2021 ini yang belum berhasil diungkap polisi. Kedua kasus itu adalah penganiayaan berat yang mengakibatkan korban meninggal. https://t.co/1ePvoRET7z,6,0,1,0,2022-01-01,1,Saturday,6,7,0
1477091113026699267,2022-01-01 01:35:39,"Wakil Ketua Komisi VIII DPR, Ace Hasanmeminta agar pemilik pesantren di OKU, Sumsel, Moh Syukur (50) yang memperkosa santri dihukum berat. https://t.co/802bmBbexB",15,5,1,1,2022-01-01,1,Saturday,6,16,6
1477090191542304774,2022-01-01 01:31:59,"Petugas polisi di Pos Pam Tapal kuda, Salawu, Kabupaten Tasikmalaya memergoki sebuah mobil yang ditumpangi tiga orang membawa paket sabu. https://t.co/wZmjtouk72",6,0,0,0,2022-01-01,1,Saturday,6,6,0
1477089088192794627,2022-01-01 01:27:36,"Warga mengeluhkan proyek jalan tembusan Pasar Minggu, Jakarta Selatan (Jaksel), yang terbengkalai. Proyek itu disebut terbengkalai sekitar 2 tahun. https://t.co/pLBeUzHtCg",19,14,6,0,2022-01-01,1,Saturday,6,25,14
1477088067878014980,2022-01-01 01:23:33,Suasana malam pergantian tahun di Surabaya begitu sunyi. Kondisi ini sama seperti tahun lalu yang masih dalam keadaan pandemi saat tahun baru telah menanti. https://t.co/tZ2WDTrfHj,33,3,1,0,2022-01-01,1,Saturday,6,34,3
1477087089904820224,2022-01-01 01:19:39,Jembatan Suramadu di malam tahun baru ditutup hingga 1 Januari pukul 05.00 WIB. Ratusan kendaraan yang akan melintas di Jembatan Suramadu diputar balik. https://t.co/Aszd7FiHWl,7,0,1,0,2022-01-01,1,Saturday,6,8,0
1477085836709699586,2022-01-01 01:14:41,Kabar buruk menimpa Liverpool menjelang duel big match kontra Chelsea. Tiga pemain The Reds harus absen akibat terpapar COVID-19. https://t.co/JqCzgBXdOP,5,0,0,0,2022-01-01,1,Saturday,6,5,0
1477083781156777994,2022-01-01 01:06:30,Perlengkapan sekolah gratis siswa SD dan SMP dari keluarga masyarakat berpenghasilan rendah (MBR) mulai dibagikan. Pendistribusian dilakukan secara bertahap. https://t.co/I0q68FLqPN,14,0,0,0,2022-01-01,1,Saturday,6,14,0
1477082287938445316,2022-01-01 01:00:34,Seorang ginekolog menyarankan untuk tidak terlalu sering memakai panty liner dan menganjurkan untuk mengganti pakaian dalam saja. Ternyata ini alasannya. https://t.co/wFib7WprcF,10,0,0,0,2022-01-01,1,Saturday,6,10,0
1477081790384857089,2022-01-01 00:58:36,Fraksi PKB-PPP DPRD DKI Jakarta kecewa dengan peringkat indeks kebahagiaan DKI Jakarta berada pada posisi 27 dari 34 provinsi di Indonesia. https://t.co/rLG8tfeWi0,6,3,1,0,2022-01-01,0,Saturday,6,7,3
1477081049003921411,2022-01-01 00:55:39,Presenter Robby Purba baru saja menjalani operasi pengangkatan tumor payudara. Tumor payudara diketahui memang bisa menyerang pria meski kasusnya jarang. https://t.co/LYu6W9OV7f,17,2,3,0,2022-01-01,0,Saturday,6,20,2
1477080517858238473,2022-01-01 00:53:32,"Pemkab Pangandaran melancarkan patroli dan razia ke sejumlah kafe, bar dan restoran di kawasan Kampung Turis Pamugaran, Pantai Pangandaran. https://t.co/dLL8HhgxCW",4,1,1,0,2022-01-01,0,Saturday,6,5,1
1477080021562974217,2022-01-01 00:51:34,Seorang wanita yang mengaku istri Kajari Tebing Tinggi mencak-mencak di sebuah toko sepatu. Dia kemudian membuat klarifikasi. Apa katanya? https://t.co/Q3ndT2nImn,5,10,3,5,2022-01-01,0,Saturday,6,8,15
1477079474294468609,2022-01-01 00:49:24,"Menag Yaqut Cholil Qoumas meminta pemilik pesantren di Ogan Komering Ulu Selatan, Moh Syukur, dihukum berat karena memperkosa santriwati hingga melahirkan. https://t.co/XhQv6RRKae",26,10,15,1,2022-01-01,0,Saturday,6,41,11
1477078982705176583,2022-01-01 00:47:26,Seorang pemuda dilaporkan pingsan di atas pohon randu setinggi 10 meter. Dia mengaku kelelahan sebelum tak bergerak duduk diantara dua cabang pohon. https://t.co/vtDj0KvQN7,9,1,4,1,2022-01-01,0,Saturday,6,13,2
1477078482421260289,2022-01-01 00:45:27,Warga ingin duduk bareng mencari solusi bersama pengelola Rusunami dan PAM Jaya supaya masalah air minum menemui solusi. Wakil rakyat bersedia menjadi mediator. https://t.co/g7Czu4jkAG,5,0,0,0,2022-01-01,0,Saturday,6,5,0
1477077993952587777,2022-01-01 00:43:31,"Kepada nelayan, Ida menjelaskan Jamsos Ketenagakerjaan merupakan sarana untuk memberikan perlindungan dan meningkatkan kesejahteraan bagi rakyat Indonesia. https://t.co/SNyktlkbG0",9,0,1,0,2022-01-01,0,Saturday,6,10,0
1477077497888092161,2022-01-01 00:41:32,"Polisi mengatakan ada 680 personel gabungan dari TNI, Polri, hingga Dinas Perhubungan (Dishub) yang dikerahkan di sepanjang jalur menuju Puncak, Bogor. https://t.co/hzV0q6t2sE",2,0,0,0,2022-01-01,0,Saturday,6,2,0
1477076976913506305,2022-01-01 00:39:28,Bupati Ciamis Herdiat Sunarya mengingatkan tempat hiburan dan lokasi lainnya tak menggelar kegiatan malam tahun baru. Dia siapkan sanksi bagi yang melanggar. https://t.co/M8iD5MUAdS,5,0,1,0,2022-01-01,0,Saturday,6,6,0
1477076481675341831,2022-01-01 00:37:30,"Sejumlah warga terlihat berkerumun di Lapangan Merdeka, Medan, Sumatera Utara (Sumut) untuk menyambut malam pergantian tahun. https://t.co/PlqHkgCUaW",4,1,0,0,2022-01-01,0,Saturday,6,4,1
1477075989293412358,2022-01-01 00:35:33,Wakil Ketua Komisi II DPR menyoroti pernyataan Gubsu Edy melarang guru hingga pelatih olahraga berkumis. Dia meminta Edy tak mengurusi masalah personal. https://t.co/b7mgE3AoNM,12,1,1,1,2022-01-01,0,Saturday,6,13,2
1477075496940847104,2022-01-01 00:33:35,Pria inisial HL (28) asal Medan ditangkap oleh Krimsus Polda Banten karena telah memproduksi dan menjual sampo-minyak rambut diduga palsu. https://t.co/3Jupbmkbkn,7,0,1,0,2022-01-01,0,Saturday,6,8,0
1477074974812815361,2022-01-01 00:31:31,Sebab menurutnya keseriusan pemerintah dalam menagih denda dari pelaku akan menjaga marwah hukum dan negara. https://t.co/9CoX5aOz2F,8,0,0,0,2022-01-01,0,Saturday,6,8,0
1477074461774036994,2022-01-01 00:29:29,"Thailand menggasak Indonesia di leg pertama final Piala AFF 2020. Sebelum laga, kapten Chanathip Songkrasin membakar semangat The War Elephant lewat pidatonya. https://t.co/JWHk2OByWE",10,0,3,0,2022-01-01,0,Saturday,6,13,0
1477073966795825159,2022-01-01 00:27:31,"Malam pergantian tahun 2022, lalu lintas di Pantai Indah Kapuk (PIK) 2 terpantau macet. Kerumunan juga terlihat dari warga yang ingin merayakan tahun baru. https://t.co/YV5KgVXA1o",8,4,0,0,2022-01-01,0,Saturday,6,8,4
1477073474967515142,2022-01-01 00:25:33,Polri merekrut anggota dari 83 santri di sepanjang tahun 2021. 56 di antaranya merupakan calon bintara hafiz Qur'an. https://t.co/hGJiEEVFL8,53,8,8,2,2022-01-01,0,Saturday,6,61,10
1477072981373423617,2022-01-01 00:23:36,Wilayah Kabupaten Bandung Barat (KBB) mengalami serangkaian bencana alam yang terjadi sepanjang tahun 2021. https://t.co/tVFrvxYHHf,5,1,1,1,2022-01-01,0,Saturday,6,6,2
1477072484394586122,2022-01-01 00:21:37,"Indeks Kebahagiaan di Jakarta merosot di sisa masa jabatan Anies. Fraksi PDIP DPRD DKI beri tamparan keras jargon Anies 'Maju Kotanya, Bahagia Warganya'. https://t.co/0FwnMDt9OG",42,52,8,5,2022-01-01,0,Saturday,6,50,57
1477071990804647938,2022-01-01 00:19:39,"Batas waktu somasi itu telah habis, hingga kini Choki belum mendapat permintaan maaf dari Gubsu Edy. Akankah Edy meminta maaf atas heboh 'jeweran' itu? https://t.co/Bq5ZLk3PhL",9,11,0,1,2022-01-01,0,Saturday,6,9,12
1477071247540428800,2022-01-01 00:16:42,"Tidak hanya obat kuat ataupun ramuan herbal saja, menjaga ereksi agar tahan lama bisa didapat dari makanan, buah, sayur, hingga kopi. https://t.co/uZe4A3alUK",12,1,4,1,2022-01-01,0,Saturday,6,16,2
1477070510211145738,2022-01-01 00:13:46,"Momen pergantian tahun selalu menjadi yang ditunggu-tunggu. Meski masih pandemi corona, sejumlah negara menyambutnya dengan semarak. Yuk lihat potretnya. https://t.co/w7wrb2Kt3w",3,0,0,0,2022-01-01,0,Saturday,6,3,0
1477069722462175234,2022-01-01 00:10:39,"Polisi menangkap pimpinan ponpes di Kuningan gegera kasus pencabulan. Pelaku, inisial AH (38), mencabuli delapan santrinya. https://t.co/g7QGV8IZH8",235,62,106,43,2022-01-01,0,Saturday,6,341,105
1477068974890364929,2022-01-01 00:07:40,Polisi sempat membubarkan warga dengan menyemprot air melalui water cannon. https://t.co/ANyO1DylaQ,4,0,0,0,2022-01-01,0,Saturday,6,4,0
1477068232448217089,2022-01-01 00:04:43,"Polisi juga telah mengantongi daftar public figure yang diduga masuk daftar muncikari tersebut, siapa saja? https://t.co/ryQQR5Svtg",9,4,3,0,2022-01-01,0,Saturday,6,12,4
1481777509322604545,2022-01-13 23:57:42,Cristiano Ronaldo belum berpikir pensiun dalam waktu. Pesepakbola Portugal itu bahkan bertekad main di level tertinggi sampai usia 42 tahun. https://t.co/qryOSkpSHj,12,1,2,1,2022-01-13,23,Thursday,4,14,2
1481777078433419264,2022-01-13 23:56:00,"Surabaya disebut kota termacet di Indonesia. Itu hasil penelitian Global Traffic Scorecard 2021, Inrix. Dishub Surabaya mengaku ada solusi minimalisir kemacetan https://t.co/TqCzvWGCEd",9,6,3,5,2022-01-13,23,Thursday,4,12,11
1481776763051159557,2022-01-13 23:54:45,Seorang pria di Kota Batu terekam CCTV menodongkan pistol. Potongan video CCTV itu kini menyebar luas di media sosial. https://t.co/NdyY9Emj4X,5,0,1,1,2022-01-13,23,Thursday,4,6,1
1481776159784411137,2022-01-13 23:52:21,Dua PNS di Kabupaten Sumedang diganjar penghargaan oleh Gubernur Jawa Barat Ridwan Kamil dalam ajang employee of the month 2022. https://t.co/j6jWvJ9aZt,6,4,1,0,2022-01-13,23,Thursday,4,7,4
1481775900723134466,2022-01-13 23:51:19,NU dan Muhammadiyah Jombang meminta polisi menuntaskan kasus pencabulan yang diduga dilakukan anak kiai berinisial MSAT. Agar tak menodai citra pesantren. https://t.co/olA78OQmFE,14,0,6,0,2022-01-13,23,Thursday,4,20,0
1481773228444073985,2022-01-13 23:40:42,Bupati Penajam Paser Utara Abdul Gafur Mas'ud kena operasi tangkap tangan KPK di sebuah mal di Jakarta. Gafur diduga menerima suap dan gratifikasi. https://t.co/ZXF26t8Own,12,4,4,2,2022-01-13,23,Thursday,4,16,6
1481772635264630792,2022-01-13 23:38:20,Guru Besar Ilmu Politik Unpad Muradi menilai konten Youtube mendongkrak popularitas Dedi Mulyadi sehingga bisa menyalip elektabilitas Ketum Golkar. https://t.co/v6hAmmq3gS,11,1,2,0,2022-01-13,23,Thursday,4,13,1
1481772344024645632,2022-01-13 23:37:11,"Penyanyi dan aktor Ardhito Pramono ditetapkan sebagai tersangka narkoba. Dalam penetapan itu istri Ardhito, Jeanneta Sanfadelia, tampak hadir menemani. https://t.co/nBm6ltofTD",12,4,0,1,2022-01-13,23,Thursday,4,12,5
1481770754500968450,2022-01-13 23:30:52,Presiden Jokowi bersama istri ke NTT meninjau persiapan MotoGP. Jokowi sempat mengendarai motor di Jalan Bypass BIL-Mandalikadan memakai jaket bertuliskan G20. https://t.co/BSxUj6AKlp,24,22,10,4,2022-01-13,23,Thursday,4,34,26
1481770232985366538,2022-01-13 23:28:48,Seorang pria di Kota Batu terekam CCTV menodongkan pistol. Aksi itu dilakukan setelah kepergok warga menawarkan makanan kepada dua bocah. https://t.co/PaxceOqPLn,5,1,2,0,2022-01-13,23,Thursday,4,7,1
1481769556125229056,2022-01-13 23:26:06,"Cangkok jantung babi ke manusia untuk pertama kalinya dipuji sebagai terobosan. Namun sebagian orang menganggapnya kontroversial, terutama dari segi agama. https://t.co/yx4pW7hNSu",15,0,4,0,2022-01-13,23,Thursday,4,19,0
1481768962635538434,2022-01-13 23:23:45,"Apple baru saja merilis iOS 15.2.1 untuk pengguna iPhone di seluruh dunia. Update ini membawa perbaikan bug, sehingga penting untuk di-install. https://t.co/aQQ3JxqiHC",3,1,0,3,2022-01-13,23,Thursday,4,3,4
1481768404251987968,2022-01-13 23:21:32,Emosi tidak ada hubungannya dengan apakah obyek reaksi itu sesuatu yang benar atau salah. Perasaan menginformasikan kita tentang suatu obyek. https://t.co/HxsxHbo62m,4,0,1,0,2022-01-13,23,Thursday,4,5,0
1481767801996156928,2022-01-13 23:19:08,"Apple dikabarkan akan memberikan fitur pemantau kadar gula darah dan tekanan pada Apple Watch , namun sayangnya fitur ini tidak akan hadir dalam waktu dekat. https://t.co/YDD0u9tOup",4,0,0,0,2022-01-13,23,Thursday,4,4,0
1481767508214521857,2022-01-13 23:17:58,Berapa lama durasi bercinta yang diidamkan dan diidealkan oleh kebanyakan wanita? Simak penjelasannya berikut ini. https://t.co/sbTdVyWuPt,9,2,1,2,2022-01-13,23,Thursday,4,10,4
1481766162367229954,2022-01-13 23:12:37,Pengadilan Agama (PA) Ponorogo menerima 1.990 perkara perceraian selama tahun 2021. Penyumbang terbanyak dari pekerjaan migran Indonesia (PMI)/TKW. https://t.co/wkZcqTRk9A,7,0,1,0,2022-01-13,23,Thursday,4,8,0
1481764994782011392,2022-01-13 23:07:59,"Sebuah rumah terbakar di Jalan Villa Kapuk Mas 2, Kapuk Muara, Jakarta Utara (Jakut). Sebanyak 5 unit mobil pemadam kebakaran diterjunkan ke lokasi. https://t.co/7oAi6dw4jS",4,0,0,1,2022-01-13,23,Thursday,4,4,1
1481764211474767878,2022-01-13 23:04:52,Jumlah kehamilan di kalangan remaja Zimbabwe meningkat tajam. Para orang tua memandang pernikahan dan kehamilan sebagai solusi dari kemiskinan. https://t.co/aElOrOIx5K,8,2,2,4,2022-01-13,23,Thursday,4,10,6
1481763271002710017,2022-01-13 23:01:08,Mahfud Md mengatakan Presiden Jokowi memerintahkan pengusutan tuntas terkait dugaan pelanggaran hukum di proyek satelit di Kementerian Pertahanan pada 2015. https://t.co/ypEybZEYcD,18,4,8,2,2022-01-13,23,Thursday,4,26,6
1481762280706658309,2022-01-13 22:57:12,"Pembunuhan di Bekasi diusut polisi. Diketahui, pembunuhan itu terjadi di daerah Jatibening, Bekasi, Jawa Barat. https://t.co/yShNdLnIag",5,0,1,0,2022-01-13,22,Thursday,4,6,0
1481760759164153861,2022-01-13 22:51:09,Seorang bidan desa di Situbondo tewas dibunuh suaminya sendiri dengan cara dicekik. Dugaan sementara motifnya karena cemburu. https://t.co/h5xNGNDAtE,14,0,2,1,2022-01-13,22,Thursday,4,16,1
1481759661799968769,2022-01-13 22:46:47,"Surabaya disebut menjadi kota termacet di Indonesia, berdasarkan hasil penelitian Global Traffic Scorecard 2021, Inrix. Dishub Surabaya meragukan data tersebut. https://t.co/3wMdtgpavZ",20,9,1,3,2022-01-13,22,Thursday,4,21,12
1481758384043044872,2022-01-13 22:41:43,Kejagung menetapkan 2 tersangka baru dalam kasus korupsi penyelenggaraan pembiayaan ekspor nasional oleh Lembaga Pembiayaan Ekspor Indonesia tahun 2013-2019. https://t.co/hOyJU55kVm,8,0,3,1,2022-01-13,22,Thursday,4,11,1
1481758023030874112,2022-01-13 22:40:17,Liverpool gagal memaksimalkan keunggulan jumlah pemain saat menghadapi Arsenal. The Reds dipaksa bermain imbang tanpa gol. https://t.co/ISOT662fig,9,1,2,1,2022-01-13,22,Thursday,4,11,2
1481756320936120328,2022-01-13 22:33:31,Bupati Penajam Paser Utara Abdul Gafur Masud ditangkap KPK karena diduga menerima suap dan gratifikasi. Sejumlah fakta terkait OTT ini pun terungkap. https://t.co/Hik4rIyQmO,6,0,3,1,2022-01-13,22,Thursday,4,9,1
1481755493572005899,2022-01-13 22:30:14,Pelatih biliar Khoirudin (Choki) Aritonang yang melaporkan Gubsu Edy Rahmayadi penuhi panggilan polisi. Choki dicecar 18 pertanyaan sebagai pelapor. https://t.co/wfPBqapCj9,7,2,1,0,2022-01-13,22,Thursday,4,8,2
1481752514924003330,2022-01-13 22:18:23,#Mostpop Seragam satpam yang saat ini berwarna cokelat muda akan berubah menjadi warna krem. https://t.co/QIBwveEHrS,18,15,2,6,2022-01-13,22,Thursday,4,20,21
1481752489502384135,2022-01-13 22:18:17,"BMKG mengeluarkan peringatan dini cuaca untuk wilayah DKI Jakarta. BMKG memprediksi terjadi hujan disertai petir di Jakbar, Jaksel dan Jaktim siang ini. https://t.co/1m7u5204SC",16,0,2,0,2022-01-13,22,Thursday,4,18,0
1481751310454120449,2022-01-13 22:13:36,#Mostpop HF dan istrinya mengundurkan diri sebagai pengajar di ponpes itu sejak beberapa bulan lalu. https://t.co/ezGJavRGaK,9,3,3,1,2022-01-13,22,Thursday,4,12,4
1481749735367229450,2022-01-13 22:07:21,Petenis nomor satu Novak Djokovic masih menanti nasibnya terkait saga visa. Unggulan empat Australia Terbuka 2022 Stefanos Tsitsipas geram dengan rivalnya itu. https://t.co/er0Q6lXrhq,9,0,1,1,2022-01-13,22,Thursday,4,10,1
1481748782350053379,2022-01-13 22:03:33,"Dedi Mulyadi meminta agar Komnas HAM jangan hanya melihat dari sisi pelaku saja. Tetapi, juga harus melihat dari sisi korban secara holistik. https://t.co/uoIAXiH6uF",146,42,14,5,2022-01-13,22,Thursday,4,160,47
1481746963930492932,2022-01-13 21:56:20,"Polres Tanjungbalai, Sumatera Utara (Sumut) menangkap tujuh orang pelaku pengeroyokan yang menyebabkan korban meninggal dunia usai disiksa para pelaku. https://t.co/uHnOVbfjk3",4,0,0,1,2022-01-13,21,Thursday,4,4,1
1481745624819195906,2022-01-13 21:51:01,Prabowo Subianto menerima vaksinasi COVID-19 dosis ketiga atau booster. Prabowo disuntik vaksin Nusantara oleh dokter Terawan Agus Putranto. https://t.co/tzqBH8IKdx,136,16,24,16,2022-01-13,21,Thursday,4,160,32
1481744596812115983,2022-01-13 21:46:56,Epidemiolog yakin ledakan kasus varian Omicron di RI sangat sulit dihindari. Apa saja yang jadi pemicunya? https://t.co/or2hAdtxfP,16,8,7,2,2022-01-13,21,Thursday,4,23,10
1481743528745226248,2022-01-13 21:42:41,"Timnas Indonesia batal menggelar uji coba melawan Bangladesh. Alasannya, banyak pemain dari kubu lawan yang belum melakukan vaksinasi COVID-19.  https://t.co/ds5zx5XgoP",16,0,2,0,2022-01-13,21,Thursday,4,18,0
1481742081215418376,2022-01-13 21:36:56,"Liverpool melawan Arsenal di semifinal Piala Liga Inggris tanpa kehadiran Mohamed Salah dan Sadio Mane. Meski begitu, Liverpool diyakini tetap akan sangat kuat.  https://t.co/Mbr3BVKhsa",9,1,0,0,2022-01-13,21,Thursday,4,9,1
1481740938397593603,2022-01-13 21:32:23,"Serangan roket mengenai sebuah sekolah dan Kedutaan Amerika Serikat (AS) di Ibu Kota Irak, Baghdad. Tiga orang dilaporkan terluka. https://t.co/ddPiUBUIwa",4,1,0,0,2022-01-13,21,Thursday,4,4,1
1481739893755764745,2022-01-13 21:28:14,Para pejabat kesehatan setempat meminta maaf setelah viralnya unggahan di media sosial tentang wanita hamil 8 bulan yang keguguran karena ditolak rumah sakit. https://t.co/DxVM6qYqNj,7,1,1,0,2022-01-13,21,Thursday,4,8,1
1481738930156412937,2022-01-13 21:24:24,Athletic Bilbao comeback untuk mengalahkan Atletico Madrid dengan skor 2-1 di Piala Super Spanyol. Bilbao berhak maju ke final untuk berjumpa Real Madrid. https://t.co/VHYfIYYlFl,2,0,0,0,2022-01-13,21,Thursday,4,2,0
1481737520069107719,2022-01-13 21:18:48,"Konsep virtual reality kerap digunakan pada video games, tapi di industri peternakan sapi dipakaikan kacamatan VR hasilnya pun bikin produksi susu banyak. https://t.co/1ga4u2fltt",18,0,4,1,2022-01-13,21,Thursday,4,22,1
1481736295760244742,2022-01-13 21:13:56,Anggota Badan Kehormatan (BK) DPRD DKI Jakarta dari Fraksi PDIP Rasyidi menyebut ada dewan yang datang berkantor dengan memakai celana jeans robek. https://t.co/sCJVI9k9cL,6,7,0,0,2022-01-13,21,Thursday,4,6,7
1481735081450422275,2022-01-13 21:09:07,"Pembahasan soal game di Twitter mencetak rekor baru pada tahun 2021. Genshin Impact, jadi judul yang sering dibicarakan oleh pengguna media sosial ini. https://t.co/P2FNmm8mJI",4,0,1,0,2022-01-13,21,Thursday,4,5,0
1481733920559452168,2022-01-13 21:04:30,"Krisis air bersih terjadi di Kampung Marlina Elektro RT 10 RW 17, Penjaringan, Jakut. Direktur Pelayanan PAM Jaya, Syahrul menyampaikan permintaan maaf. https://t.co/M56vltNLsL",3,0,2,0,2022-01-13,21,Thursday,4,5,0
1481732800407830528,2022-01-13 21:00:03,Didi Soekarno menegaskan nama Partai Pelopor berubah jadi Partai Perkasa tak terkait Rachmawati. Didi menekankan Partai Perkasa bukan sarana perjuangan ibunya. https://t.co/VwASCOH7CP,4,0,2,0,2022-01-13,21,Thursday,4,6,0
1481731291452260360,2022-01-13 20:54:03,"Seorang warga di Rembang, Slamet, menemukan umbi ketela yang berukuran jumbo panjangnya 2,6 meter. Gede banget! Begini penampakannya: https://t.co/wYtQjsQRFe",22,5,1,0,2022-01-13,20,Thursday,4,23,5
1481729980996501509,2022-01-13 20:48:51,"Sejumlah siswa dan guru di sekolah Jakarta terpapar Corona. Imbasnya, belasan sekolah menyetop sementara pembelajaran tatap muka (PTM) 100 persen. https://t.co/5QTqPDkJ8m",15,3,3,1,2022-01-13,20,Thursday,4,18,4
1481728738802946048,2022-01-13 20:43:55,"#Terpopuler Kalau biasanya bayi kembar lahir dalam waktu yang relatif bersamaan, bayi 'kembar' asal Sumenep ini memiliki jarak lahir 6 tahun. Simak ceritanya: https://t.co/aCUemp13OH",16,1,1,0,2022-01-13,20,Thursday,4,17,1
1481727557150121992,2022-01-13 20:39:13,Polisi menetapkan 12 tersangka kasus kapal diduga mengangkut TKI ilegal yang tenggelam. Polisi menyebut 8 di antaranya telah ditangkap dan 4 lainnya buron. https://t.co/jUtvOd7sSo,5,0,2,0,2022-01-13,20,Thursday,4,7,0
1481726349878431746,2022-01-13 20:34:25,#Terpopuler Adalah pilihan yang sulit saat Niko memutuskan resign dari Tesla dan kembali ke Tanah Air. Namun keputusannya itu untuk cita-cita yang lebih tinggi. https://t.co/XXSBSdZ6F5,35,3,9,3,2022-01-13,20,Thursday,4,44,6
1481725216732729350,2022-01-13 20:29:55,"Menurut Bambang Pacul dalam rapat bersama Komnas HAM soal Herry Wirawan, jika seseorang merusak kehidupan orang lain, maka mesti dihukum mati. https://t.co/4swNO5Ek2y",43,9,5,3,2022-01-13,20,Thursday,4,48,12
1481723691134328836,2022-01-13 20:23:51,Fiorentina berhasil mengalahkan Napoli 5-2 di 16 besar Coppa Italia. La Viola selanjutnya menantang Atalanta di perempatfinal. https://t.co/aQzGVqDONk,3,0,0,0,2022-01-13,20,Thursday,4,3,0
1481723671265873921,2022-01-13 20:23:46,KPK mengungkap peran keenam orang ini terdiri dari pemberi dan penerima suap terkait pengadaan barang dan jasa serta perizinan. https://t.co/9U4s59Y8S0,2,2,0,0,2022-01-13,20,Thursday,4,2,2
1481722379130839044,2022-01-13 20:18:38,"#Terpopuler ""Di balik kesuksesan, ada mantan yang menyesal,"" ucap wanita itu. https://t.co/wCxhhoq5xf",10,1,3,0,2022-01-13,20,Thursday,4,13,1
1481721114275504129,2022-01-13 20:13:37,Chef Arnold ikut mengoleksi NFT foto selfie Ghozali. Awalnya mengira hanya meme dan lucu-lucuan. Ini cerita Chef Arnold saat membeli koleksi unik itu:  https://t.co/xlpfi73Ukj,14,2,1,1,2022-01-13,20,Thursday,4,15,3
1481719738531258374,2022-01-13 20:08:09,"#Mostpop Setelah kejeblos dan bertemu kambing saat meninjau venue Formula E di Anco, Giring kembali melontarkan kritik. Kali ini soal komitmen fee Rp 560 M. https://t.co/CiYeQASKQa",29,29,1,3,2022-01-13,20,Thursday,4,30,32
1481718090874380294,2022-01-13 20:01:36,"""Kalau memang niatnya mau bantu tak usah diumuk-umukke. Jangan lah saudara sendiri dijadikan pengewan-ewan begitu"" demikain saran Bambang Pacul. https://t.co/trlk4tohLQ",14,13,1,1,2022-01-13,20,Thursday,4,15,14
1481716177181282304,2022-01-13 19:54:00,Tim SAR gabungan menemukan jasad teksini kapal yang dilaporkan tenggelam di Sungai Batanghari Jambi. Jasad Ratimj berhasil dievakuasi setelah 2 hari pencarian. https://t.co/BLrstmD9EF,7,0,0,0,2022-01-13,19,Thursday,4,7,0
1481715203821682692,2022-01-13 19:50:08,Santrinya yang semuanya perempuan berusia 13 tahunan tak pernah belajar... https://t.co/bICT68JCW4,23,6,3,5,2022-01-13,19,Thursday,4,26,11
1481714623674032142,2022-01-13 19:47:49,Nasi adalah makanan pokok di Asia terlepas dari lokasi dan kondisi ekonomi. Ada beberapa negara yang tercatat sebagai pengonsumsi nasi terbesar di dunia. https://t.co/XCNhBWVb9J,10,0,0,0,2022-01-13,19,Thursday,4,10,0
1481713640587857922,2022-01-13 19:43:55,#Mostpop Anies Baswedan menganggarkan Rp 197 miliar untuk program penyaring sampah. Program ini ditargetkan selesai Juni 2022. Seperti apa? https://t.co/4dyVrSEiG4,11,1,1,0,2022-01-13,19,Thursday,4,12,1
1481712498277560329,2022-01-13 19:39:23,"Akui istrinya punya kebiasaan aneh, pria ini ungkap kombinasi makanan kocak di rumahnya. Kehabisan nasi, dirinya disajikan pecel lele dengan mashed potato. https://t.co/Z32xKM4I5N",19,1,3,2,2022-01-13,19,Thursday,4,22,3
1481711100131487746,2022-01-13 19:33:49,"Menteri Energi dan Sumber Daya Mineral (ESDM), Arif Tasrif, mengatakan akan membuka kran ekspor batu bara. Sebelumnya pemerintah melarang ekspor baru bara pada 1-31 Januari 2022. https://t.co/U4AB5Jwk53",4,2,1,2,2022-01-13,19,Thursday,4,5,4
1481709943438950402,2022-01-13 19:29:14,Luas tanah miliknya yang terdampak proyek Tol Yogya-Solo lebih dari 1.000 meter persegi. Tanah itu hak miliknya setelah diberi orang tua. https://t.co/O6qIw4GDaX,7,0,0,0,2022-01-13,19,Thursday,4,7,0
1481709076497186818,2022-01-13 19:25:47,"Sebagai pilot maskapai kerajaan Belanda, KLM, Willem Eduard de Graaff sering diperlakukan secara diskriminatif. Kecewa, pria kelahiran Sukabumi itu membelot masuk pasukan elit Jerman. https://t.co/zSHxSqqWId",20,1,3,0,2022-01-13,19,Thursday,4,23,1
1481707960590123008,2022-01-13 19:21:21,Pemerintah melaporkan kasus harian positif Corona hari ini sebanyak 793 kasus. Simak sebarannya. https://t.co/YBbStvxhX7,3,0,0,0,2022-01-13,19,Thursday,4,3,0
1481707171985473536,2022-01-13 19:18:13,Wakil Ketua PAC PDIP Kecamatan Temanggung Fajar Nugroho mengembalikan bantuan Ganjar Pranowo. Fajar mengaku hal itu dari hati nurani dan tak ada intervensi. https://t.co/rKDaJwzwUE,6,5,1,0,2022-01-13,19,Thursday,4,7,5
1481707150997082121,2022-01-13 19:18:08,"Dalam waktu dekat, kasus yang merugikan negara hampir Rp 1 triliun itu bakal naik penyidikan karena disebut telah cukup bukti. https://t.co/GQ6SvPcz2K",26,4,6,1,2022-01-13,19,Thursday,4,32,5
1481705819850870785,2022-01-13 19:12:50,Para orang tua patut waswas. Game Roblox dan Sakura School Simulator kemasukan adegan seksual di dalamnya. https://t.co/U7Dt1Z8Qro,0,1,1,0,2022-01-13,19,Thursday,4,1,1
1481705072996331525,2022-01-13 19:09:52,"Tuan rumah Kamerun menang lagi di Piala Afrika 2021 usai mengalahkan Ethiopia 4-1. Sementara itu, Pantai Gading menundukkan Equatorial Guinea 1-0. https://t.co/yfYsDsyxg0",2,0,0,0,2022-01-13,19,Thursday,4,2,0
1481704010436554752,2022-01-13 19:05:39,Seragam satpam mirip polisi kini bakal diubah dari warna cokelat muda menjadi warna krem. Seperti apa warna baru seragam satpam? https://t.co/yR2tPY4Kx8,3,3,0,2,2022-01-13,19,Thursday,4,3,5
1481702926104072205,2022-01-13 19:01:20,Kemenkes RI mendorong pemerintah daerah untuk lebih dulu menggunakan vaksin Corona yang hampir kedaluwarsa. Dikenal sebagai sistem 'Early Expired First Out'. https://t.co/DVXQAQUnsi,4,0,3,0,2022-01-13,19,Thursday,4,7,0
1481701759341015048,2022-01-13 18:56:42,Irfansyah berdalih memalak sopir angkot demi memberi makan hewan-hewan peliharaannya. https://t.co/2d6rG2hd4M,2,0,2,3,2022-01-13,18,Thursday,4,4,3
1481701206800179203,2022-01-13 18:54:31,Seorang pria karyawan resto di Jakut diduga mengambil foto perempuan sedang di toilet. Aksinya ketahuan korban. https://t.co/XgrwSwutco,0,0,0,2,2022-01-13,18,Thursday,4,0,2
1481699990703685633,2022-01-13 18:49:41,Wamenag Zainut mendorong mendorong adanya muatan terkait pengawasan dalam pondok pesantren di undang-undang tersebut. https://t.co/3G9TB0ZVkO,5,2,1,0,2022-01-13,18,Thursday,4,6,2
1481698585691529217,2022-01-13 18:44:06,"Seorang pria masuk ke halaman Polres Lumajang dengan membawa dan mengacungkan pisau. Ternyata, pria tersebut merupakan ODGJ. https://t.co/8nuAGTVt0J",1,1,0,0,2022-01-13,18,Thursday,4,1,1
1481697151185039360,2022-01-13 18:38:24,"Di hadapan polis,i BY mengakui perbuatannya dan minta maaf. https://t.co/o5GngMoums",6,1,3,1,2022-01-13,18,Thursday,4,9,2
1481695698982739969,2022-01-13 18:32:37,Kurniawan Dwi Yulianto mengaku akan menjadi asisten pelatih klub Italia FC Como. Saat ini mantan striker Timnas Indonesia sedang menunggu visa untuk ke Italia. https://t.co/eUkh4oPSRi,12,0,4,0,2022-01-13,18,Thursday,4,16,0
1481693125584297996,2022-01-13 18:22:24,Polisi menyebut ada kesalahpahaman sehingga mereka meminta maaf. https://t.co/kwlIjZNI7J,136,120,33,32,2022-01-13,18,Thursday,4,169,152
1481691618654760963,2022-01-13 18:16:25,WNI asal Makassar dibajak milisi Houthi di Yaman. Namun pembajak tak meminta tebusan. https://t.co/DeFzoxD7iH,11,0,1,1,2022-01-13,18,Thursday,4,12,1
1481690077227098112,2022-01-13 18:10:17,"#Mostpop Mendapat pemasukan lewat jembatan perahu sampai Rp 25 juta per hari terkesan mudah. Tapi, pembangunan jembatan ini butuh waktu dan biaya yang tinggi lho! https://t.co/uiWQQsUNnm",11,0,4,0,2022-01-13,18,Thursday,4,15,0
1481690059082502146,2022-01-13 18:10:13,"Hadfana Firdaus, pembuang dan penendang sesajen di lokasi terdampak erupsi Semeru tertangkap. Hadfana tertangkap di Bantul. https://t.co/ibx166T4Xc",298,125,75,28,2022-01-13,18,Thursday,4,373,153
1481689038113460228,2022-01-13 18:06:09,"Komnas HAM tak setuju hukuman mati bagi Herry Wirawan, pemerkosa 13 santri di Bandung. Habiburokhman menyayangkan hal tersebut. https://t.co/8HBurc1EB8",17,16,6,2,2022-01-13,18,Thursday,4,23,18
1481689019964661766,2022-01-13 18:06:05,"Benda berukuran sekepalan tangan itu, diduga merupakan fosil gigi hiu raksasa megalodon. Seperti apa? https://t.co/gtpCHLiSbm",6,0,3,0,2022-01-13,18,Thursday,4,9,0
1481686177837195270,2022-01-13 17:54:47,"Sebelum terjaring OTT KPK, Abdul Gafur pernah disorot terkait pembangunan rumah dinasnya yang menghabiskan anggaran fantastis, yakni Rp 34 miliar. https://t.co/TPqnIMLTfA",8,3,2,2,2022-01-13,17,Thursday,4,10,5
1481684783327547396,2022-01-13 17:49:15,Bupati PPU ditetapkan tersangka dugaan suap bersama Bendum DPC Partai Demokrat (PD) Balikpapan. KPK pun akan menyusuri ada tidaknya aliran dana suap ke partai. https://t.co/iwCCtFilWS,20,4,4,3,2022-01-13,17,Thursday,4,24,7
1481683510050054146,2022-01-13 17:44:11,Mereka dianggap menyalahi prosedur pada saat membawa Andi keluar dari Lapas untuk pengembangan kasus narkoba 75 kilogram. https://t.co/kUjkvJA9Zf,6,0,2,0,2022-01-13,17,Thursday,4,8,0
1481681556565630983,2022-01-13 17:36:26,"KPK menyita uang dalam OTT Bupati Penajam Paser Utara (PPU), Kalimantan Timur, Abdul Gafur Mas'ud. Total uang yang disita KPK sekitar Rp 1,4 miliar. https://t.co/axdHLMZh2v",23,1,7,2,2022-01-13,17,Thursday,4,30,3
1481680994511900673,2022-01-13 17:34:12,Seorang nenek yang tinggal sebatang kara mengalami nasib pilu. Ia dipaksa untuk meninggalkan rumahnya usai ditipu cucu tirinya... https://t.co/9HSqlVvjUE,56,11,11,6,2022-01-13,17,Thursday,4,67,17
1481679633489842178,2022-01-13 17:28:47,"KPK menetapkan Bupati Penajem Paser Utara, Abdul Gafur Mas'ud tersangka kasus suap. KPK menyita uang Rp 1 miliar dan rekening bank dengan saldo Rp 447 juta. https://t.co/vb7k4pe57e",9,1,1,0,2022-01-13,17,Thursday,4,10,1
1481678361445425153,2022-01-13 17:23:44,"KPK menyita uang dalam operasi tangkap tangan (OTT) Bupati Penajam Paser Utara (PPU), Kalimantan Timur, Abdul Gafur Mas'ud. https://t.co/nMRJy9bTol",5,0,1,1,2022-01-13,17,Thursday,4,6,1
1481678360304627718,2022-01-13 17:23:44,"KPK menetapkan Bupati Penajam Paser Utara, Kalimantan Timur, Abdul Gafur Mas'ud sebagai tersangka. https://t.co/VlcA91u8Hf",16,2,6,0,2022-01-13,17,Thursday,4,22,2
1481677805167460353,2022-01-13 17:21:31,"Seorang balita menjadi korban kekerasan di Kota Sukabumi. Berdasarkan hasil pemeriksaan, ditemukan patah tulang di bagian kepala. https://t.co/T0vDdsfceE",20,9,9,9,2022-01-13,17,Thursday,4,29,18
1481676419356925955,2022-01-13 17:16:01,"KPK menetapkan Bupati Penajem Paser Utara, Abdul Gafur Mas'ud tersangka kasus suap. KPK menyita uang Rp 1 miliar dan rekening bank dengan saldo Rp 447 juta. https://t.co/3odvXGFzh2",13,2,4,0,2022-01-13,17,Thursday,4,17,2
1481675889582739457,2022-01-13 17:13:54,Newcastle United terus memperkuat diri di bursa transfer Januari ini. Kali ini giliran penyerang Burnley Chris Wood yang digaet. https://t.co/lyGzPLBDBl,3,1,0,0,2022-01-13,17,Thursday,4,3,1
1481674993754910740,2022-01-13 17:10:21,"Serangga disebut sebagai salah satu makanan di masa depan yang lebih ramah lingkungan. Tapi faktanya, 7 dari 10 orang di dunia masih enggan memakan serangga. https://t.co/5D4Cawdyme",1,2,0,2,2022-01-13,17,Thursday,4,1,4
1481673623102492672,2022-01-13 17:04:54,Polri memberikan waktu selama 1 tahun bagi satpam beserta tempat kerjanya untuk menyiapkan seragam baru berwarna krem. https://t.co/9elCP18ayi,44,47,6,6,2022-01-13,17,Thursday,4,50,53
1481672683951697930,2022-01-13 17:01:10,"PKS menggelar sidang Musyawarah Majlis Syuro VI, Kamis (13/1) di Hotel Bidakara. Hasil sidang tersebut menegaskan bahwa PKS tolak penundaan Pemilu 2024 dan wacana perpanjangan masa jabatan presiden RI menjadi 3 periode. https://t.co/ZoJTfyFHUD",15,5,4,0,2022-01-13,17,Thursday,4,19,5
1481671717940518913,2022-01-13 16:57:20,"Persela melepas bek kanannya, Birrul Walidain. Birrul dipastikan gabung Persikabo untuk putaran kedua Liga 1. https://t.co/NVAABgHg2u",3,0,0,0,2022-01-13,16,Thursday,4,3,0
1481671443779891202,2022-01-13 16:56:14,Pemprov DKI menutup sementara tujuh sekolah. Penutupan dilakukan setelah ada temuan siswa terpapar COVID-19. https://t.co/TAXUw2PfaQ,12,1,2,1,2022-01-13,16,Thursday,4,14,2
1481669621509988356,2022-01-13 16:49:00,"KPK menetapkan Bupati Penajam Paser Utara (PPU), Kalimantan Timur, Abdul Gafur Mas'ud sebagai tersangka menerima suap. Begini konstruksinya. https://t.co/SWo8ePC7jS",13,1,3,0,2022-01-13,16,Thursday,4,16,1
1481669620172038145,2022-01-13 16:49:00,"Berikut ini kronologi operasi tangkap tangan (OTT) Bupati Penajam Paser Utara (PPU), Abdul Gafur Mas'ud yang dilakukan KPK. https://t.co/2m22iKhHj6",17,3,1,2,2022-01-13,16,Thursday,4,18,5
1481668956582813696,2022-01-13 16:46:21,Ardhito Pramono mengaku menyesal menggunakan ganja. Ia pun mengimbau masyarakat agar tidak meniru dirinya dengan alasan apapun. https://t.co/KypaZD3JRV,9,3,0,1,2022-01-13,16,Thursday,4,9,4
1481667761361334282,2022-01-13 16:41:37,Sebaiknya jangan langsung memakai celana dalam begitu selesai bercinta. Ada tiga alasannya: https://t.co/WvJxqrhv0l,24,9,2,5,2022-01-13,16,Thursday,4,26,14
1481666646292979713,2022-01-13 16:37:11,Partai Gerindra buka suara mengenai duet Prabowo Subianto dengan Muhaimin Iskandar (Cak Imin) dalam Pilpres 2024 mendatang. Gerindra menganggap keduanya memiliki kecocokan dan usulan tersebut dipertimbangkan. https://t.co/HwTlouDYKO,3,3,0,1,2022-01-13,16,Thursday,4,3,4
1481665646341537797,2022-01-13 16:33:12,Mahfud Md mengungkapkan adanya dugaan pelanggaran hukum di balik proyek yang ada di Kemhan pada tahun 2015. Seperti apa? https://t.co/cAG0kCGjPv,10,4,1,3,2022-01-13,16,Thursday,4,11,7
1481664929509912578,2022-01-13 16:30:21,"Seorang pria berinisial R (29) tega menyundut seorang bayi di Tambora, Jakbar menggunakan korek. Pelaku kini sudah ditangkap. https://t.co/tdXyqkV7yK",5,0,0,1,2022-01-13,16,Thursday,4,5,1
1481663846490202112,2022-01-13 16:26:03,Kadang polisi menyalakan strobo agar cepat sampai ke tempat tujuan. Lalu bagaimana bila masyarakat umum tidak menepikan kendaraan karena macet? #detiksAdvocate https://t.co/NEPwqJxyEU,5,1,0,0,2022-01-13,16,Thursday,4,5,1
1481662958983954435,2022-01-13 16:22:32,"Dengan panjang tol 206,65 km, maka total biaya yang dibutuhkan untuk menjajal Gedebage-Tasikmalaya-Cilacap secara penuh kurang lebih Rp 418.500. https://t.co/DoOlxNmEjR",12,2,3,5,2022-01-13,16,Thursday,4,15,7
1481661403702431751,2022-01-13 16:16:21,Bendahara Umum DPC Partai Demokrat Balikpapan itu adalah Nur Afifah Balqis (NAB). Namanya masuk dalam daftar 6 orang yang ditetapkan sebagai tersangka oleh KPK. https://t.co/bzQpFX929j,19,6,2,6,2022-01-13,16,Thursday,4,21,12
1481660203561062403,2022-01-13 16:11:35,#Mostpop Sebuah panti pijat refleksi yang diduga menjadi lokasi prostitusi membuat gempar usai digerebek warga. Terapis dalam keadaan bugil turut diamankan warga. https://t.co/tNO5tQ1MWn,5,5,3,2,2022-01-13,16,Thursday,4,8,7
1481658959610195970,2022-01-13 16:06:38,Bocah perempuan ini harus tegar mengidap penyakit tanpa didampingi kedua orang tua yang telah meninggal dunia... https://t.co/osdkZ8cV7u,38,5,6,1,2022-01-13,16,Thursday,4,44,6
1481658004684480513,2022-01-13 16:02:50,Salah satu hasil Sidang Musyawarah Majelis Syuro ke VI PKS membeberkan sejumlah kriteria calon presiden dan wakil presiden yang akan diusung oleh PKS pada Pemilu 2024.  https://t.co/d9z7dOBN5E,7,2,0,1,2022-01-13,16,Thursday,4,7,3
1481656501995380750,2022-01-13 15:56:52,"KPK menetapkan Bupati Penajam Paser Utara, Kalimantan Timur, Abdul Gafur Mas'ud sebagai tersangka kasus suap. https://t.co/E1LS74O2iP",25,0,7,0,2022-01-13,15,Thursday,4,32,0
1481655633925468176,2022-01-13 15:53:25,"Pengadilan Maroko menjatuhkan hukuman 2 tahun bui pada seorang dosen, yang dituduh meminta kesenangan seksual untuk ditukar dengan nilai bagus mahasiswinya. https://t.co/FMvABaEo6u",28,6,6,4,2022-01-13,15,Thursday,4,34,10
1481654702655692803,2022-01-13 15:49:43,Pencarian dilakukan dibantu sejumlah penyidik polisi di wilayah luar Jawa Timur. https://t.co/q3AE0CcoIB,24,12,3,4,2022-01-13,15,Thursday,4,27,16
1481653162893144071,2022-01-13 15:43:36,Bali United berhasil menumbangkan Persib Bandung dalam lanjutan Liga 1 2021. Serdadu Tridatu menang dengan skor 1-0. https://t.co/PQPyXMRnol,8,2,0,1,2022-01-13,15,Thursday,4,8,3
1481652282504597504,2022-01-13 15:40:06,"Bupati Penajam Paser Utara, Kalimantan Timur, Abdul Gafur Mas'ud terlihat telah mengenakan rompi tahanan KPK. https://t.co/gvZzejWyTi",26,4,3,1,2022-01-13,15,Thursday,4,29,5
1481651592084398090,2022-01-13 15:37:21,"Pria yang viral karena onani di atas motor saat berhenti di tepi jalan di Rokan Hilir, Riau, ditangkap polisi. Motif pelaku pun terungkap. https://t.co/ZA9Ju5J36y",13,8,3,7,2022-01-13,15,Thursday,4,16,15
1481651231248453649,2022-01-13 15:35:55,Puting merupakan salah satu daerah sensitif wanita. Tapi tahukah kamu kalau wanita bisa orgasme hanya dengan dirangsang putingnya? https://t.co/GyFi8mUjzu,83,15,10,8,2022-01-13,15,Thursday,4,93,23
1481650263861575683,2022-01-13 15:32:05,Partai Demokrat menyebut hubungan SBY dan Prabowo memang terjalin baik dan tetap terjaga sampai saat ini. Begini pembahasannya: https://t.co/DQO3J1g9Tj,11,0,0,2,2022-01-13,15,Thursday,4,11,2
1481650239190695939,2022-01-13 15:31:59,"Jerinx SID mengaku kapok bermain media sosial untuk kritik sosial, lantaran banyak orang yang memanfaatkan situasi. Jerinx akan fokuskan akun medsosnya hanya untuk pekerjaan. https://t.co/fK1Sy7SLVR https://t.co/Hek1zLeQ9S",13,0,0,0,2022-01-13,15,Thursday,4,13,0
1481647910253056010,2022-01-13 15:22:44,"Sejumlah emak-emak di Asahan, Sumut mengaku menjadi korban penipuan arisan online. Mereka pun beramai-ramai datang ke rumah admin arisan itu. https://t.co/Fr7otisksE",14,4,0,0,2022-01-13,15,Thursday,4,14,4
1481647354520301571,2022-01-13 15:20:31,"Dengan panjang 206,65 km, tol yang akan menghubungkan Jawa Barat dengan Jawa Tengah ini jadi tol terpanjang di Indonesia sejauh ini setelah Padang-Pekanbaru. https://t.co/eTmE4V2DUq",37,6,14,0,2022-01-13,15,Thursday,4,51,6
1481645468828372999,2022-01-13 15:13:02,"Sebelum menjadi bupati, Abdul Gafur Masud dikenal sebagai seorang pengusaha. Berikut profilnya: https://t.co/0lAREInr3d",9,2,3,0,2022-01-13,15,Thursday,4,12,2
1481644487340277761,2022-01-13 15:09:08,Bisa kah kripto digunakan sebagai alat pembayaran? https://t.co/3rAPjVshJ6,12,4,1,0,2022-01-13,15,Thursday,4,13,4
1481643815018500105,2022-01-13 15:06:27,Paulo Dybala dilaporkan berpeluang menolak perpanjangan kontrak dari Juventus andai gajinya dipangkas Si Nyonya Tua.  https://t.co/kaiBAwYkb3,14,0,0,2,2022-01-13,15,Thursday,4,14,2
1481643576488443919,2022-01-13 15:05:30,Beberapa kesalahan terjadi di Piala Afrika. Salah memutar lagu kebangsaan Mauritius hingga kontroversi wasit hentikan laga sebelum waktu normal habis.  https://t.co/tVUhwcuT7I,4,2,1,1,2022-01-13,15,Thursday,4,5,3
1481643562773082118,2022-01-13 15:05:27,"Jutaan obat Anti-Virus COVID-19 buatan Pfizer, Paxlovid, tiba di Korea Selatan. Obat ini diklaim mampu bertahan melawan varian Omicron. https://t.co/DCFN2wzjJ6",17,0,2,0,2022-01-13,15,Thursday,4,19,0
1481642293434085383,2022-01-13 15:00:24,"Fuji, adik Bibi Ardiansyah debut main film. Fadly, sang kakak yang sudah lebih dulu jadi model memberikan pesan. https://t.co/av8WBZPfEK",19,1,2,0,2022-01-13,15,Thursday,4,21,1
1481641108245409793,2022-01-13 14:55:42,"Polisi memastikan viral pengakuan siswa SD diculik orang tak dikenal di Barru, Sulsel cuma hoaks. Sang siswa takut dimarahi oleh ibunya. https://t.co/mNAuuu5eyG",4,0,0,0,2022-01-13,14,Thursday,4,4,0
1481640758654300164,2022-01-13 14:54:19,"Gelaran MotoGP Mandalika akan berlangsung 18-22 Maret mendatang. Berkaca dari gelaran Superbike Mandalika November tahun lalu, Presiden Joko Widodo memperingatkan agar insiden pembongkaran logistik tanpa izin tak terjadi lagi. https://t.co/MPUZqewRN9",21,2,3,0,2022-01-13,14,Thursday,4,24,2
1481639052013027336,2022-01-13 14:47:32,Nur Rachman alias Dede alias Ivan divonis hukuman mati. Sementara Honi Aprizal alias Apri alias Oni divonis penjara seumur hidup. https://t.co/SdRSceSkEE,36,12,4,0,2022-01-13,14,Thursday,4,40,12
1481638546024722435,2022-01-13 14:45:31,Ada faktor kecanduan game online dibalik pembunuhan sadis terhadap bocah 9 tahun di Banjarnegara. Berikut ini fakta-faktanya. https://t.co/oHu07dWbuQ,17,3,5,0,2022-01-13,14,Thursday,4,22,3
1481636904365801474,2022-01-13 14:39:00,"Kasus Corona di Krukut, Jakarta Barat kian bertambah. Saat ini temuan warga terpapar Corona melewati angka 50-an. https://t.co/kk4EzRqgZe",13,1,0,1,2022-01-13,14,Thursday,4,13,2
1481636374570684423,2022-01-13 14:36:53,"Tahun 2018 silam, warga Sukabumi digegerkan dengan munculnya lubang raksasa. Seperti apa kondisinya sekarang? https://t.co/QFdAYTSFHL",11,0,1,0,2022-01-13,14,Thursday,4,12,0
1481634962067509251,2022-01-13 14:31:17,Presiden Joko Widodo berharap penyelenggaraan MotoGP Mandalika mampu mengangkat ekonomi warga sekitar. Salah satunya adalah homestay. Jokowi ingin seluruh homestay yang totalnya 300 bisa terisi penuh. https://t.co/R3bKAJQxCj,18,3,4,0,2022-01-13,14,Thursday,4,22,3
1481633658708451330,2022-01-13 14:26:06,Album Virus nampaknya jadi perbincangan dan sangat ikonik dengan grup band Slank. Ini fakta di balik cover album Slank:  https://t.co/p7yLymOo66,14,1,2,0,2022-01-13,14,Thursday,4,16,1
1481633633484132354,2022-01-13 14:26:00,"Sejumlah desa di lima kecamatan di Pidie Jaya, Aceh terendam banjir. Banjir menyebabkan badan jalan di beberapa titik amblas. https://t.co/58T0CtHW6W",4,0,2,0,2022-01-13,14,Thursday,4,6,0
1481632511813816321,2022-01-13 14:21:32,"Banjir bandang menerjang tiga desa di Kecamatan Selaawi, Kabupaten Garut pada Kamis (13/1/2022) petang. https://t.co/KmP5xu6tA7",11,2,3,1,2022-01-13,14,Thursday,4,14,3
1481631449631625219,2022-01-13 14:17:19,"Longsor talut tebing Sungai Babadan Klaten, Jawa Tengah semakin membuat warga khawatir. Longsoran terus melebar. https://t.co/rmApqmrm1G",9,1,2,0,2022-01-13,14,Thursday,4,11,1
1481628187239067658,2022-01-13 14:04:21,"Presidential Threshold kembali ramai hiasi media massa. Banyak yang tak puas dalam kebijakan tersebut hingga meminta keadilan, meja sidang Mahkamah Konstitusi menjadi taruhannya.  https://t.co/PtjR2Z00sa",16,3,0,0,2022-01-13,14,Thursday,4,16,3
1481627494499471362,2022-01-13 14:01:36,Ada cerita menarik di balik hubungan Jet Li dan Nina Li Chi yang harus menunggu 10 tahun hingga akhirnya menikah. Simak cerita selengkapnya yuk. #detikNetwork  https://t.co/V6jgfYqICU,10,0,3,1,2022-01-13,14,Thursday,4,13,1
1481626533739511809,2022-01-13 13:57:47,Cerita Bunga Citra Lestari yang makin cinta masak selama pandemi. Ia sangat hobi memasak.  https://t.co/lKh5v3CrGO,19,0,2,0,2022-01-13,13,Thursday,4,21,0
1481625424253833219,2022-01-13 13:53:23,"Kabupaten Pemalang, Jawa Tengah, dihebohkan oleh kabar adanya mayat seorang remaja perempuan, SAR (14), yang disimpan oleh keluarganya di rumah selama sekitar 2,5 bulan. Berikut ini fakta-fakta terbaru yang dirangkum: https://t.co/b7EOLsaFp6",16,2,3,1,2022-01-13,13,Thursday,4,19,3
1481624502232563717,2022-01-13 13:49:43,Nyeri sendi banyak dialami orang dewasa. Mengubah pola makan menjadi lebih sehat perlu dilakukan jika tak ingin nyeri sendi semakin parah. https://t.co/8OmYFAyYqI,29,0,7,1,2022-01-13,13,Thursday,4,36,1
1481623391346044937,2022-01-13 13:45:18,Bandar tersebut mencoba kabur saat polisi mengejarnya. Bandar yang mengendarai mobil itu kemudian menabrak kendaraan hingga rumah warga di Tangerang. https://t.co/OpvgzgHo9S,9,0,1,0,2022-01-13,13,Thursday,4,10,0
1481622491957284865,2022-01-13 13:41:43,Sekali-sekali sarapan nasi goreng istimewa. memakai isian daging sapi rebus dan sosis sapi. Diaduk dengan bumbu gule rasanya jadi sedap berempah. https://t.co/5YKz6ptqOL,17,0,5,0,2022-01-13,13,Thursday,4,22,0
1481621249709293580,2022-01-13 13:36:47,"Dalam sesi acara Launching BUMN Holding Pangan, Menteri Perdagangan, Muhammad Lutfi mengaku pusing banyak pihak yang komplain terkait harga beberapa bahan pokok yang kini sedang mengalami kenaikan tajam. https://t.co/rhGTkMelKf",10,4,5,2,2022-01-13,13,Thursday,4,15,6
1481620223421816835,2022-01-13 13:32:43,"Kabupaten Pemalang, Jawa Tengah, dihebohkan oleh kabar adanya mayat seorang remaja perempuan, SAR (14), yang disimpan oleh keluarganya di rumah selama sekitar 2,5 bulan. Berikut ini fakta-fakta terbaru yang dirangkum: https://t.co/oeqFyzGqHu https://t.co/MgL7OHnqYh",16,2,3,2,2022-01-13,13,Thursday,4,19,4
1481618692282662916,2022-01-13 13:26:38,Penderita kolesterol tinggi harus hati-hati memilih menu sarapan. Ahli gizi ungkap lima menu sarapan terbaik untuk menjaga kadar kolesterol. https://t.co/dX0weOEs9o,19,0,6,2,2022-01-13,13,Thursday,4,25,2
1481617634718367755,2022-01-13 13:22:25,Beberapa daerah ini masih menawarkan program pemutihan denda pajak kendaraan bermotor (PKB). https://t.co/oSFIfmjncY,13,0,3,0,2022-01-13,13,Thursday,4,16,0
1481616451865915397,2022-01-13 13:17:43,Raffi Ahmad dan Rudy Salim membangun kebun binatang di PIK 2 dengan modal fantastis. Raffi Ahmad mengungkapkan kebun binatang itu sebagai kado untuk kelahiran anak keduanya. https://t.co/bSMCy1kNhn,103,10,15,5,2022-01-13,13,Thursday,4,118,15
1481616075892699137,2022-01-13 13:16:14,"Berdasarkan survei program, persentase lulusan SMK yang melanjutkan ke pendidikan tinggi mengalami peningkatan. Begini rinciannya. https://t.co/QE4hVTePGF",15,0,1,0,2022-01-13,13,Thursday,4,16,0
1481615462249213952,2022-01-13 13:13:47,#Terpopuler Desa Cibubuan di Sumedang masih mempertahankan desain rumah akhir 1950-an hingga 1960-an. Rumah jadul ini bahkan ditawar miliaran rupiah. Seperti apa ya? https://t.co/7ansI922ZZ,42,4,2,2,2022-01-13,13,Thursday,4,44,6
1481613756228685827,2022-01-13 13:07:01,Pundi-pundi penadapatan terus mengalir dari kamar 308 Grand Inna Samudra Beach Sukabumi. Citra Nyi Roro Kidul berpengaruh besar dalam hal itu. https://t.co/ykoOGmSPMj,11,1,1,0,2022-01-13,13,Thursday,4,12,1
1481613225762435074,2022-01-13 13:04:54,"Gempa magnitudo (M) 3,8 terjadi di barat daya Tobelo, Maluku Utara. Pusat gempa berada di darat. https://t.co/ZgtIKtCNWm",13,0,1,0,2022-01-13,13,Thursday,4,14,0
1481611990145679361,2022-01-13 13:00:00,Seorang tukang timbang ikan di Banyuwangi menyodomi anak di bawah umur dan  diketahui mereka saling kenal! https://t.co/Dlw0MWPvve,13,6,1,0,2022-01-13,13,Thursday,4,14,6
1481611202010746885,2022-01-13 12:56:52,"Sejumlah upaya dilakukan sekutu untuk membungkam Mbah Boncolono 'Robin Hood' Kediri. Dia dibunuh, kepala dan tubuhnya dipisahkan. Begini ceritanya: https://t.co/tx3ZEUcbxk",16,1,1,0,2022-01-13,12,Thursday,4,17,1
1481610165958983682,2022-01-13 12:52:45,#Terpopuler Ikan itu ditemukan sepekan sebelum penemuan terowongan kuno. Bagaimana ceritanya? https://t.co/vd3JhBCqKu,10,0,1,0,2022-01-13,12,Thursday,4,11,0
1481609680136847365,2022-01-13 12:50:49,"Aksi warga Depok menggerebek panti pijat refleksi viral di media sosial. Lokasi itu diduga untuk menutupi kegiatan prostitusi. Pasalnya saat digerebek warga, ada terapis yang bugil. https://t.co/bPPaslkc6X https://t.co/mMHLfHIeI8",86,70,29,23,2022-01-13,12,Thursday,4,115,93
1481609016438845441,2022-01-13 12:48:11,"Wakil Ketua Komisi III DPR, Desmond J Mahesa mengusir salah satu anggota Komnas Perempuan yang terlambat namun nekat masuk ruang rapat, Kamis (13/1). https://t.co/MibuJZYT1F https://t.co/iRsSgiipNG",34,17,4,4,2022-01-13,12,Thursday,4,38,21
1481608415000637441,2022-01-13 12:45:47,Pencuri itu membuat haru karena meninggalkan surat kepada pengelola masjid. Seperti apa isinya? https://t.co/47X3S444fF,15,1,7,1,2022-01-13,12,Thursday,4,22,2
1481607822030905346,2022-01-13 12:43:26,Saat ini emas digital memang sedang digandrungi karena kemudahan dan kecepatan dalam proses transaksi. Simak tips supaya nggak ketipu waktu beli emas digital. https://t.co/b2EaSgKUwl,10,2,0,0,2022-01-13,12,Thursday,4,10,2
1481607310233554954,2022-01-13 12:41:24,"Brasil mengalami banjir sangat luas setelah diguyur hujan deras yang menyebabkan 17.000 warganya dievakuasi. Selain banjir, hujan deras juga memicu longsor di kota Minas Gerais yang menewaskan sedikitnya 24 orang . https://t.co/aNLlj8jF6E",5,0,0,0,2022-01-13,12,Thursday,4,5,0
1481606546232643593,2022-01-13 12:38:22,Siapa bilang kalau cari cuan gak bisa dilakukan dari rumah? Sekarang ini sudah ada banyak usaha rumahan yang bisa kamu coba untuk menambah penghasilan loh. https://t.co/TxyGzeF1ZW,24,1,6,0,2022-01-13,12,Thursday,4,30,1
1481605235349114883,2022-01-13 12:33:09,"Ada 5 rumah makan yang menawarkan nasi Padang murah dengan rating tinggi di Jakarta Selatan. Hanya dengan membayar Rp 20.000-an, perut dijamin kenyang. https://t.co/Mw7WDDmKNs",45,3,10,7,2022-01-13,12,Thursday,4,55,10
1481604305710993409,2022-01-13 12:29:28,Nama Ghozali Everyday jadi sorotan dengan penjualan foto selfie non-fungible token (NFT) senilai miliaran rupiah. Pemuda itu akhirnya buka suara:  https://t.co/GYsI6bZlzt,156,24,37,16,2022-01-13,12,Thursday,4,193,40
1481603127086305283,2022-01-13 12:24:47,"Empat penumpang di dalamnya tewas saat sebuah Toyota Innova hitam tertabrak kereta api di perlintasan Desa Bayeman, Tongas, Probolinggo. https://t.co/ZlJfYzqu8t",5,0,5,0,2022-01-13,12,Thursday,4,10,0
1481602627645612033,2022-01-13 12:22:47,"Mobil angkutan umum jenis pete-pete terbakar di atas jembatan flyover Makassar, Sulawesi selatan. Seluruh penumpang dinyatakan selamat. https://t.co/THfuxEgBVd",4,0,1,0,2022-01-13,12,Thursday,4,5,0
1481601710296555522,2022-01-13 12:19:09,Perempuan di Bekasi dibunuh temannya sendiri. Korban dibunuh saat meminta pelaku mengeroknya. https://t.co/47UucSkeR3,30,11,5,1,2022-01-13,12,Thursday,4,35,12
1481601144602480649,2022-01-13 12:16:54,Wanita ini terjebak dan harus tinggal selama lebih dari seminggu bersama teman kencannya. Apakah hubungan mereka jadi lebih dekat? Ini ceritanya.... https://t.co/rGBpEvS9IC,11,0,3,0,2022-01-13,12,Thursday,4,14,0
1481600297227239425,2022-01-13 12:13:32,Ketua Komisi II DPR RI Ahmad Doli Kurnia memastikan akan mengagendakan penentuan jadwal Pemilu 2024 bulan ini. https://t.co/rxb7JT0Mex,11,0,2,0,2022-01-13,12,Thursday,4,13,0
1481600006230523910,2022-01-13 12:12:22,Mikel Arteta menanggapi absennya Mohamed Salah dan Sadio Mane saat Liverpool vs Arsenal. Ia menilai The Gunners juga punya masalah yang nyaris serupa.  https://t.co/6UL29657NV,6,0,0,1,2022-01-13,12,Thursday,4,6,1
1481598631589392384,2022-01-13 12:06:55,"Perhatian! Lowongan kerja sedang dibuka Unair di berbagai posisi mulai dari Bendahara, Pustakawan, hingga Editor. Apa saja syaratnya?

via: detikedu https://t.co/zy4xgdu608",22,0,3,0,2022-01-13,12,Thursday,4,25,0
1481597736302563330,2022-01-13 12:03:21,"Ada empat kombinasi vaksin booster COVID-19 versi Kemenkes. Khusus bagi penerima vaksin primer AstraZeneca, bisa divaksin booster Pfizer. https://t.co/mEOxs7xWSL",10,3,3,1,2022-01-13,12,Thursday,4,13,4
1481597397008539652,2022-01-13 12:02:00,Keempat pelaku mengaku mencari peserta judi online dengan bujuk rayu untuk diarahkan bergabung ke link situs judi atau room yang sudah mereka sediakan. https://t.co/12NSHdWAwL,11,0,0,1,2022-01-13,12,Thursday,4,11,1
1481597025812688897,2022-01-13 12:00:32,"Bupati Penajam Paser Utara Abdul Gafur Mas'ud memiliki kekayaan senilai Rp36,7 miliar. Dia terakhir kali melaporkan kekayaannya ke KPK pada 26 Februari 2021. #CNNIndoneisa #detikNetwork  https://t.co/YwvYYQjZnd",16,5,4,3,2022-01-13,12,Thursday,4,20,8
1481596231579279361,2022-01-13 11:57:22,Warga Sukabumi dikejutkan dengan temuan seekor ular di dalam rumah! https://t.co/iPtwZv1ohd,13,2,2,0,2022-01-13,11,Thursday,4,15,2
1481595695496839169,2022-01-13 11:55:15,Jokowi di Mandalika melakukan kunjungan kerja guna meninjau sejumlah fasilitas untuk MotoGP 2022. Jokowi berkunjung ke Mandalika bersama Iriana Joko Widodo. https://t.co/N0Rvc0hSVv,14,1,3,0,2022-01-13,11,Thursday,4,17,1
1481595210190802946,2022-01-13 11:53:19,Chelsea didesak agar segera menuntaskan negosiasi pembaruan kontrak Antonio Ruediger. Chelsea akan lebih repot jika harus merekrut pengganti Ruediger.  https://t.co/tBVIeYeXhl,12,0,1,0,2022-01-13,11,Thursday,4,13,0
1481594142211903488,2022-01-13 11:49:04,Jason Momoa dikenal sebagai salah satu aktor yang sangat sayang pada Lisa Bonet. Mereka pun punya kenangan manis yang membuat netizen baper. Ini kisahnya:  https://t.co/0v8xJcHNoI,12,1,1,1,2022-01-13,11,Thursday,4,13,2
1481594114017742850,2022-01-13 11:48:58,Keempat pelaku mengaku mencari peserta judi online dengan bujuk rayu untuk diarahkan bergabung ke link situs judi atau room yang sudah mereka sediakan. https://t.co/m0opZl5jWD,13,3,2,0,2022-01-13,11,Thursday,4,15,3
1481593298955476997,2022-01-13 11:45:43,"Beberapa hewan akan tidur panjang atau hibernasi selama musim dingin. Bagaimana ya mereka bisa bertahan tanpa makan? Cari tahu jawabannya yuk:

via: detikedu https://t.co/gFLc6KWd7M",11,0,2,0,2022-01-13,11,Thursday,4,13,0
1481591960607637508,2022-01-13 11:40:24,"Pasca Jason Momoa mengumumkan sudah berpisah dengan Lisa Bonet, Emilia Clarke justru jadi sasaran netizen. Lho kok?  https://t.co/V0YhTGOrFq",16,3,0,1,2022-01-13,11,Thursday,4,16,4
1481591184724312064,2022-01-13 11:37:19,"Pengungsi akibat erupsi Semeru di Lumajang, Jawa Timur masih mendapatkan bantuan logistik dari berbagai kalangan dan pemerintah. Kali ini DJ Firman berbagi di depan pengungsi:  https://t.co/usSdIZql0f",9,0,1,0,2022-01-13,11,Thursday,4,10,0
1481590596615778308,2022-01-13 11:34:59,Jason Momoa dan Lisa Bonet memutuskan untuk berpisah. Padahal keduanya sempat disebut sebagai pasangan paling romantis. #JasonMomoa #LisaBonet  https://t.co/h4w057IFpH,7,0,0,0,2022-01-13,11,Thursday,4,7,0
1481589860343422978,2022-01-13 11:32:03,"Untuk menghindari rasa bosan saat belajar, siswa perlu menghindari beberapa kesalahan yang mungkin terjadi. Apa saja kesalahan itu? Pahami ya! https://t.co/jNUfydTcm7",9,0,0,0,2022-01-13,11,Thursday,4,9,0
1481589489915080704,2022-01-13 11:30:35,"Kecepatan adalah indikator kepuasan pengunjung di restoran. Kalau kamu makan di restoran ini, pesanan makanan bakal disajikan dalam kisaran 13 detik saja! https://t.co/f26ptze8H3",11,3,0,0,2022-01-13,11,Thursday,4,11,3
1481588726744727555,2022-01-13 11:27:33,KPK menyita uang senilai Rp 1 miliar dalam OTT KPK Abdul Gafur Mas'ud. https://t.co/00dqjvhuhK,16,1,3,2,2022-01-13,11,Thursday,4,19,3
1481588432992448512,2022-01-13 11:26:23,Seorang tukang timbang ikan di Banyuwangi menyodomi kenalannya sendiri. Korban dianiaya sebelum disodomi. https://t.co/paCTkvn1uR,12,1,1,2,2022-01-13,11,Thursday,4,13,3
1481587107864981510,2022-01-13 11:21:07,"Berkat kesuksesan kariernya, Amanda Manopo mampu beli berbagai barang mewah. Seperti gaya saat ia naik moge, harga jaketnya puluhan juta rupiah. https://t.co/XbTtzWuwFc",9,2,1,0,2022-01-13,11,Thursday,4,10,2
1481586802226040835,2022-01-13 11:19:54,"Video polisi di Singkawang, Kalbar, bicara menggunakan bahasa China di ruang publik diviralkan. Polres Singkawang mengungkap fakta di balik video tersebut. https://t.co/1hoDBpAj60",36,19,7,1,2022-01-13,11,Thursday,4,43,20
1481586117942169600,2022-01-13 11:17:11,"Pabrik sepatu di Sidoarjo, PT Ode Cipta Semesta kebakaran. Api padam setelah petugas berjibaku sekitar 4 jam. https://t.co/TTqHWxetmR",14,0,1,0,2022-01-13,11,Thursday,4,15,0
1481585841474519041,2022-01-13 11:16:05,"Bagi pencinta kuliner tak ada salahnya mencicipi nasi daun jati khas Kudus, Jawa Tengah ini. Berbagai lauk tersedia untuk menemani nikmatnya nasi daun jati. https://t.co/YpydTMQHCk",11,0,4,0,2022-01-13,11,Thursday,4,15,0
1481585065075175427,2022-01-13 11:13:00,Rumah tangga Jason Momoa dan Lisa Bonet yang dijalin hampir 5 tahun ini berakhir. Keduanya memutuskan untuk berpisah. #JasonMomoa  https://t.co/gbm9bexwC2,8,0,0,1,2022-01-13,11,Thursday,4,8,1
1481584265536094209,2022-01-13 11:09:50,"Wali Kota Baubau, Sulawesi Tenggara, AS Tamrin meninggal dunia di Rumah Sakit Omni Pulomas Jakarta. https://t.co/X9jj6oDpO1",13,1,0,0,2022-01-13,11,Thursday,4,13,1
1481583883783217152,2022-01-13 11:08:19,"Video 61 detik yang diviralkan mirip Nagita Slavina, dilaporkan ke polisi. Memang apa isinya? https://t.co/uIq9y2WqaS",9,2,0,1,2022-01-13,11,Thursday,4,9,3
1481582897253523456,2022-01-13 11:04:23,Non fungible token (NFT) saat ini sedang booming di berbagai negara. Sebenarnya berapa sih harga NFT paling mahal yang pernah terjual? https://t.co/k52fRpLKHo,16,1,2,0,2022-01-13,11,Thursday,4,18,1
1481582282418925569,2022-01-13 11:01:57,"Sekarang investasi emas tak cuma bisa dilakukan secara fisik, misalnya membeli emas batangan atau perhiasan. Tapi juga ada emas digital. Prospeknya bagaimana? https://t.co/7moVaMkrFa",8,2,2,1,2022-01-13,11,Thursday,4,10,3
1481582233341374466,2022-01-13 11:01:45,"Pengrajin tempe di Kampung Barangbang, Kabupaten Lebak mengalami kerugian imbas banjir. Bahan baku berupa kedelai milik para perajin ikut terendam banjir. https://t.co/EMEa9mhSVN",7,0,0,0,2022-01-13,11,Thursday,4,7,0
1481581625838383108,2022-01-13 10:59:20,Komnas Perempuan mengungkap cerita di balik pengusiran oleh Komisi III DPR RI saat rapat kerja. Komnas Perempuan berbicara soal miskomunikasi. https://t.co/lATjQvm6jI,18,0,2,1,2022-01-13,10,Thursday,4,20,1
1481581382010916871,2022-01-13 10:58:22,Plt Juru Bicara KPK Ali Fikri menerangkan 11 orang yang kena OTT di wilayah Kaltim dan Jakarta. Sebanyak 7 orang ditangkap di Jakarta kini tengah diperiksa di KPK. https://t.co/j51DCdkBCW,4,0,0,0,2022-01-13,10,Thursday,4,4,0
1481580488670208000,2022-01-13 10:54:49,"Belakangan terungkap, HS dibunuh temannya sendiri, sesama perempuan berinisial RG. Berikut Kronologisnya https://t.co/aIrgNWFGTy",6,1,2,0,2022-01-13,10,Thursday,4,8,1
1481580467107287041,2022-01-13 10:54:44,Polisi menangkap pelaku pencurian motor milik Ketua Komisi A DPRD Kota Depok Hamzah. Salah satu pelaku ditembak karena mencoba kabur https://t.co/mvlfRVuj3h,0,0,1,1,2022-01-13,10,Thursday,4,1,1
1481579921323532293,2022-01-13 10:52:34,"Webometrics baru-baru ini merilis daftar perguruan tinggi swasta Indonesia terbaik edisi Januari 2022. Ada kampus incaranmu, detikers?

via: detikedu https://t.co/q12Ljkr7bx",22,3,12,3,2022-01-13,10,Thursday,4,34,6
1481578830066245637,2022-01-13 10:48:14,"#Mostpop Postingan seorang anak yang ibunya menjadi korban kecelakaan lalu lintas di Klaten, Jawa Tengah viral di media sosial. Begini kisahnya. https://t.co/Rq0EYWbrwX",30,1,9,2,2022-01-13,10,Thursday,4,39,3
1481578547475058688,2022-01-13 10:47:06,"Kecelakaan maut ini bermula saat J yang memboncengi F melewati Jalan Raya Siliwangi, Pamulang. Keduanya menaiki motor dari arah Pondok Benda menuju Pamulang. https://t.co/9bE6jwV7Ad",7,0,5,0,2022-01-13,10,Thursday,4,12,0
1481578347536818179,2022-01-13 10:46:19,"Istri Ardhito Pramono, Jeanneta Sanfadelia, menyambangi Polres Metro Jakarta Barat hari ini, Kamis (13/1). Jeanneta bungkam seribu bahasa ditemani dua orang pria. https://t.co/YcgwdHg0qK https://t.co/35RYUKnkh8",18,1,1,8,2022-01-13,10,Thursday,4,19,9
1481578046251577348,2022-01-13 10:45:07,Sosok Jeanetta Sanfadelia merupakan perempuan yang ada pada video musik Ardhito Pramono bertajuk Here We Go Again.  https://t.co/9UYQaufD60,22,0,0,2,2022-01-13,10,Thursday,4,22,2
1481577414002106369,2022-01-13 10:42:36,"Dalam Media Junket bersama media se-Asia, John Cena menceritakan bagaimana dirinya bisa memerankan karakter Peacemaker. Dimulai dari film The Suicide Squad dan berlanjut ke serial Peacemaker. https://t.co/lmpLkja6KU",5,0,1,0,2022-01-13,10,Thursday,4,6,0
1481576633681199105,2022-01-13 10:39:30,Deretan teka-teki ini berisi pertanyaan yang menguji kemampuan berpikir. Buktikan IQ kamu cukup tinggi dengan benar menjawabnya. https://t.co/nLKxa3jQC1,75,80,7,2,2022-01-13,10,Thursday,4,82,82
1481576118226280449,2022-01-13 10:37:27,"Tersangka kasus dugaan penyebaran berita bohong terkait cuitan Allahmu Lemah, Ferdinand Hutahaean, dipastikan dalam kondisi sehat. Polisi pun memeriksa kesehatan Ferdinand secara berkala. https://t.co/lSxUy9n1xm",5,2,0,1,2022-01-13,10,Thursday,4,5,3
1481576103286300674,2022-01-13 10:37:24,"KPK menyita uang senilai Rp 1 miliar dalam OTT KPK Bupati Penajam Paser Utara, Kalimantan Timur, Abdul Gafur Mas'ud. https://t.co/pFHmcISc2t",20,2,3,2,2022-01-13,10,Thursday,4,23,4
1481576102015508483,2022-01-13 10:37:23,"Aipda AS, polisi yang cueki laporan ojol hilang motor telah disidang kode etik. Dia disanksi hukuman demosi. https://t.co/o9R3Br5B5j",20,9,3,2,2022-01-13,10,Thursday,4,23,11
1481575765166731265,2022-01-13 10:36:03,Hasyakyla Utami diserang netizen karena dituduh meledek Fuji. Diketahui Fuji jadi pemeran utama film Bukan Cinderella. https://t.co/oqs7uiAQ7b,40,8,7,9,2022-01-13,10,Thursday,4,47,17
1481575747802251264,2022-01-13 10:35:59,Bagaimana jadinya jika acara saweran malah membuat pengantin wanita jadi korban dari tamu undangan yang sedang berebutan saweran? Kesal lihatnya! https://t.co/bAufjSL2gy,5,1,0,1,2022-01-13,10,Thursday,4,5,2
1481574938926587907,2022-01-13 10:32:46,"Gempa bumi magnitudo (M) 4,7 mengguncang Gorontalo. Pusat gempa berada di laut. https://t.co/zcYO6rPZtp",12,0,1,1,2022-01-13,10,Thursday,4,13,1
1481574046118649857,2022-01-13 10:29:13,"Indonesia mencatat 793 kasus baru COVID-19, Kamis (13/1/2022). DKI menyumbang jumlah kasus terbanyak dengan total 478 kasus. https://t.co/putFLPOQh2",5,0,1,1,2022-01-13,10,Thursday,4,6,1
1481573866598277122,2022-01-13 10:28:30,Jokowi meminta kesalahan itu tak terulang saat MotoGP. https://t.co/AVj0fqMPiY,13,0,1,0,2022-01-13,10,Thursday,4,14,0
1481573846767616001,2022-01-13 10:28:26,Motor Jokowi di Mandalika merupakan kendaraan custom. Dia juga berhasil mencuri perhatian rakyat dengan jaket yang dikenakan. Seperti apa momennya? https://t.co/ehyxNPEKrb,10,0,0,0,2022-01-13,10,Thursday,4,10,0
1481573076345184262,2022-01-13 10:25:22,Beberapa waktu lalu tim detikcom menyambangi kamar 308 di hotel Grand Inna Samudra Beach Sukabumi. Begini kesan setelah 5 menit berada di dalamnya. https://t.co/WVjTlgHutd,14,4,5,2,2022-01-13,10,Thursday,4,19,6
1481573047878434817,2022-01-13 10:25:15,Seorang pria tiba-tiba masuk ke Polres Lumajang dan melakukan percobaan penyerangan anggota polisi. Polisi menyebut pria ODGJ tersebut melakukan aksinya karena kehabisan obat. https://t.co/xMjpM88ceH,4,0,2,0,2022-01-13,10,Thursday,4,6,0
1481572544163590144,2022-01-13 10:23:15,"Rindu dengan Indonesia, seorang pria yang tinggal di Jerman ini memasak bakwan sendiri. Namun, ia malah kena omelan tetangga. Berikut kisahnya yang viral! https://t.co/w9xhvAXMSU",18,3,2,1,2022-01-13,10,Thursday,4,20,4
1481572255771598848,2022-01-13 10:22:06,"Pratama Arhan jadi sorotan usai tampil gemilang di Piala AFF 2020. Dengan banyaknya perhatian dari fans perempuan, begini respons sang kekasih:  https://t.co/mVJbHOu79H",14,0,0,0,2022-01-13,10,Thursday,4,14,0
1481571759044313093,2022-01-13 10:20:08,#Terpopuler Penemuan itu bermula saat warga Pedukuhan Kretek di Bantul hendak membangun lapangan bermain untuk anak-anak. Simak ceritanya: https://t.co/Wr9fZs5CC0,78,17,16,5,2022-01-13,10,Thursday,4,94,22
1481571734474137610,2022-01-13 10:20:02,Berbagai persiapan terus dilakukan jelang perlombaan MotoGP Mandalika 2022. Salah satunya persiapan terkait akomodasi. https://t.co/ao924Rw0fz,14,1,2,1,2022-01-13,10,Thursday,4,16,2
1481570423817097216,2022-01-13 10:14:49,"Helikopter medis yang akan ke luar negara AS terjatuh di dekat gereja wilayah Philadelphia, Pennsylvania, AS. Tak ada korban jiwa. Penyebab masih diselidiki. https://t.co/6aYVnUyqYg",5,0,0,0,2022-01-13,10,Thursday,4,5,0
1481569905183010816,2022-01-13 10:12:46,"Jika namamu tidak masuk dalam daftar siswa eligible SNMPTN 2022, jangan khawatir. Ada berbagai program seleksi masuk PTN yang sedang dan segera buka!

via: detikedu https://t.co/UXOpXAoZKw",5,0,2,0,2022-01-13,10,Thursday,4,7,0
1481569881682231297,2022-01-13 10:12:40,"Seorang warga yang hilang usai tenggelam di Sungai Celeng Bantul, Ngatijan (71) ditemukan tewas. Ngatijan ditemukan 6 kilometer dari lokasi kejadian. https://t.co/heO1TTJFl1",2,0,0,0,2022-01-13,10,Thursday,4,2,0
1481569880252076032,2022-01-13 10:12:40,Aksi pencurian tabung gas elpiji ukuran 3 kg di sebuah toko kelontong di Boyolali terekam kamera CCTV. Video aksi pencurian itu pun viral di media sosial. https://t.co/8cL2P9lYqb,4,0,1,0,2022-01-13,10,Thursday,4,5,0
1481569878901411841,2022-01-13 10:12:40,Kasus Ardhito Pramono terus bergulir dan ditindaklanjuti kepolisian. Dia sudah ditetapkan sebagai tersangka narkoba. https://t.co/AM9iZBVwu6,11,1,0,0,2022-01-13,10,Thursday,4,11,1
1481569580828999681,2022-01-13 10:11:28,Bali United mempunyai misi saat melawan Persib Bandung di lanjutan Liga 1 2022. Laskar Serdadu Tridatu ingin memangkas jarak dengan tim papan atas klasemen.  https://t.co/QBTKio8ttZ,7,0,0,0,2022-01-13,10,Thursday,4,7,0
1481568052839858184,2022-01-13 10:05:24,Ketua Dewan Kehormatan Partai Demokrat Hinca Panjaitan memastikan pihaknya akan terus mencari tahu kasus yang melibatkan Abdul Gafur dari penyidik KPK. https://t.co/vtysIrd6jk,6,0,0,0,2022-01-13,10,Thursday,4,6,0
1481567437552291842,2022-01-13 10:02:57,"Indonesia melaporkan 793 kasus COVID-19 pada Kamis (13/1/2022). Total kasus positif menjadi 4.268.890, sembuh 4.117.347, dan meninggal 144.155. https://t.co/6DFGFOAr9t",3,0,3,0,2022-01-13,10,Thursday,4,6,0
1481567063105748993,2022-01-13 10:01:28,Tim Penanggulangan Kebakaran dan Penyelamatan Jakarta Timur berhasil evakuasi Ular Sanca berukuran 3 meter di terjebak di atas pohon pada Kamis (13/1). Tidak ada korban jiwa dalam evakuasi ini. https://t.co/bni4ogcIYr,2,0,0,0,2022-01-13,10,Thursday,4,2,0
1481566211255193605,2022-01-13 09:58:05,"Bertambah! Warga Krukut, Jakarta Barat, yang positif Corona (COVID-19) menjadi 67 orang. https://t.co/wAYEFbiBoS",7,0,1,1,2022-01-13,9,Thursday,4,8,1
1481566198252945410,2022-01-13 09:58:02,Perkara bermula pada 1990 ketika Ng Je Ngay membeli rumah dari seorang bernama Oceng Lim. Tiba-tiba pada 2017 Ng Je Ngay dilaporkan atas dugaan penyerobotan lahan. https://t.co/nvImbQRZZr,7,3,2,0,2022-01-13,9,Thursday,4,9,3
1481565917628796930,2022-01-13 09:56:55,PP Perbasi berencana memproyeksikan sejumlah atlet Indonesia Patriots menuju SEA Games 2022. Komposisi akan ditambah pemain naturalisasi.  https://t.co/P4jXyI5BdM,4,0,0,0,2022-01-13,9,Thursday,4,4,0
1481565412731113477,2022-01-13 09:54:55,Komnas HAM menegaskan mereka menolak hukuman mati. https://t.co/mkeVek6Glx,46,73,5,9,2022-01-13,9,Thursday,4,51,82
1481565156878467073,2022-01-13 09:53:54,Kalina Oktarani ngaku sudah resmi cerai dari Vicky Prasetyo. Ia tak tahan cemburu terhadap teman kerja Vicky Prasetyo. https://t.co/ys7CeJIJ49,4,1,0,1,2022-01-13,9,Thursday,4,4,2
1481565141728739335,2022-01-13 09:53:50,Young Lex memberikan pengakuan soal pernah digerebek polisi saat razia narkoba. Hal tersebut terjadi saat di awal 2021. Ini kisahnya:  https://t.co/PfMBXCUNUN,3,0,0,0,2022-01-13,9,Thursday,4,3,0
1481564131631194113,2022-01-13 09:49:49,Presiden Jokowi menjajal Jalan Bypass Bandara Internasional Lombok-Mandalika menggunakan motor custom. Jokowi memberikan target pembangunan jalan bypass dari bandara menuju kawasan Mandalika selesai bulan depan. https://t.co/7C6xZ0EEqb,9,2,0,1,2022-01-13,9,Thursday,4,9,3
1481563456159596548,2022-01-13 09:47:08,"Polisi mengungkap 4 kasus prostitusi online di Pontianak, Kalbar. 27 Orang terjaring. https://t.co/1HatOsGYZi",1,0,0,1,2022-01-13,9,Thursday,4,1,1
1481562919829741570,2022-01-13 09:45:00,"Banjir dengan ketinggian capai 3 meter terjadi di Banjar, Kalimantan Selatan pada Rabu (12/1) akibat curah hujan tinggi. Menurut data Pusdalops BPBD Kabupaten Banjar, banjir merendam 2.008 rumah dan sedikitnya 3.727 warga terdampak. https://t.co/jHfI1lh4bP",7,0,6,1,2022-01-13,9,Thursday,4,13,1
1481562654535827459,2022-01-13 09:43:57,Kalina Oktarani mengungkapkan dirinya sudah bercerai dengan Vicky Prasetyo. Perceraian itu disebut-sebut karena hadirnya orang ketiga. https://t.co/eKSbR0NUWv,25,15,2,2,2022-01-13,9,Thursday,4,27,17
1481562150821064705,2022-01-13 09:41:57,Mau tahu lebih banyak soal wacana tarif KRL mau naik ini? Simak 3 fakta penting yang dirangkum detikcom di bawah ini. https://t.co/eR6v05yQAt,7,2,3,3,2022-01-13,9,Thursday,4,10,5
1481561591107756032,2022-01-13 09:39:44,Pernah lihat gedung yang bentuknya aneh? Pernah yang lihat bentuknya kayak binatang atau buku? Nih ada. https://t.co/XABPDxUAKC,4,0,2,0,2022-01-13,9,Thursday,4,6,0
1481561304347385861,2022-01-13 09:38:35,Menteri BUMN Erick Thohir membongkar modus korupsi pengadaan pesawat yang terjadi di dalam tubuh Garuda Indonesia. Ini katanya: https://t.co/BYhPMeHUoK,6,0,2,0,2022-01-13,9,Thursday,4,8,0
1481561063699238913,2022-01-13 09:37:38,#Foto Sebelum menikah biasanya para calon pengantin akan melakukan sesi pemotretan untuk pasfoto nikah. Ini beberapa pasfoto pasangan artis Indonesia. https://t.co/Ngc5KQAyvF,2,0,2,0,2022-01-13,9,Thursday,4,4,0
1481560806781337602,2022-01-13 09:36:37,Syarat vaksin ketiga atau vaksin booster menjadi informasi yang banyak dicari tahu masyarakat. Ini syarat penerima vaksin booster COVID-19 dari Kemenkes. https://t.co/y6rXTYtSGI,8,0,4,0,2022-01-13,9,Thursday,4,12,0
1481559877067718666,2022-01-13 09:32:55,Presiden Joko Widodo meninjau persiapan prokes Bandara Internasional Zainuddin Abdul Madjid di Kabupaten Lombok Tengah. Hal ini dilakukan untuk memastikan tamu-tamu yang hadir saat MotoGP Mandalika digelar terjamin keamanannya. https://t.co/fZLscrs1gV,3,1,0,0,2022-01-13,9,Thursday,4,3,1
1481559096205717506,2022-01-13 09:29:49,"Tukul Arwana sedang berjuang sembuh usai mengalami perdarahan otak. Kini, ia rutin menjalani fisioterapi. Lekas pulih Tukul Arwana.  https://t.co/WvodVlkSC1",470,32,34,8,2022-01-13,9,Thursday,4,504,40
1481558795558039554,2022-01-13 09:28:37,Young Lex marah bukan main karena terus disebut pakai narkoba. Ia kesal kepada netizen yang menghakiminya karena disebut belum terciduk karena narkoba. https://t.co/HuT9opc1rZ,26,4,2,5,2022-01-13,9,Thursday,4,28,9
1481558526111723527,2022-01-13 09:27:33,"Ada info vaksin booster COVID-19 lagi nih, lokasi di Bekasi dan sekitarnya. Yuk, simak jadwal, syarat, dan cara daftarnya. https://t.co/BroUQSqHMX",13,0,2,1,2022-01-13,9,Thursday,4,15,1
1481558506293583875,2022-01-13 09:27:28,Persib Bandung melawan Bali United di lanjutan Liga 1 2021/2022. Maung Bandung mempunyai respek besar untuk Laskar Serdadu Tridatu.  https://t.co/mZnC2FicPw,5,0,0,0,2022-01-13,9,Thursday,4,5,0
1481558215947173888,2022-01-13 09:26:19,Pelapor mengadukan video 61 detik yang ramai disebut mirip Nagita Slavina ke polisi. Ini alasan pelapor. https://t.co/FAQ0PJnTAe,12,9,3,1,2022-01-13,9,Thursday,4,15,10
1481557932852531200,2022-01-13 09:25:11,"Polri mengungkapkan akan mengubah kembali warna seragam satpam yang sebelumnya mirip polisi , keputusan ini disambut baik netizen karena sering terkecoh. https://t.co/9duLvSsUya",35,10,12,5,2022-01-13,9,Thursday,4,47,15
1481557645823725569,2022-01-13 09:24:03,KPK juga menyita sejumlah uang pecahan rupiah saat melakukan OTT. https://t.co/6dQ0kmaMLY,8,0,3,0,2022-01-13,9,Thursday,4,11,0
1481557636642488320,2022-01-13 09:24:01,Ketua DPRD DKI geram Sekda tak membawa data tunjangan gubernur dan wakil gubernur. Rapat ditunda sementara. https://t.co/GeLVuiIMWz,6,2,3,1,2022-01-13,9,Thursday,4,9,3
1481557377518350347,2022-01-13 09:22:59,"Ardhito Pramono ditetapkan sebagai tersangka atas kasus penyalahgunaan narkotika jenis ganja. Dalam rilis kasus narkoba hari ini, Kamis (13/1), polisi menjelaskan kronologi penangkapan musisi 26 tahun ini. https://t.co/7Wil1cjyLv",6,1,2,1,2022-01-13,9,Thursday,4,8,2
1481556894623928320,2022-01-13 09:21:04,Seorang pria tiba-tiba masuk ke Polres Lumajang dan mengacungkan pisau. Berikut kronologisnya! https://t.co/YC6KAqTOqZ,12,1,2,0,2022-01-13,9,Thursday,4,14,1
1481556557343215616,2022-01-13 09:19:43,"Pria tersebut menodongkan pisaunya ke polisi. Tak hanya itu, sang pria juga terlihat menantang polisi yang memakai seragam. https://t.co/27Ulvra5YW",12,1,3,2,2022-01-13,9,Thursday,4,15,3
1481556250919948289,2022-01-13 09:18:30,#Terpopuler Rizky Billar dan Lesti Kejora memperlihatkan wajah sang buah hati. Proses itu disiarkan langsung oleh salah satu stasiun televisi swasta. Ini potretnya:  https://t.co/UICoSEboCX,13,4,1,2,2022-01-13,9,Thursday,4,14,6
1481555332849672199,2022-01-13 09:14:51,"KPK menerangkan 7 orang diantaranya kini tengah diperiksa intensif di Gedung Merah Putih KPK, Jakarta Selatan. https://t.co/9wwdazDzM5",14,2,3,1,2022-01-13,9,Thursday,4,17,3
1481554790844973057,2022-01-13 09:12:42,Seragam Satpam disebut menimbulkan kebingungan di masyarakat lantaran warnanya terlalu mirip dengan seragam polisi. Nantinya Polri akan mengganti baju seragam Satpam. https://t.co/KuspSuZe5q,13,5,3,2,2022-01-13,9,Thursday,4,16,7
1481554771131699201,2022-01-13 09:12:38,Yusuf terpaksa mencuri karena terdesak kebutuhan membeli susu anaknya. Pada akhirnya kejaksaan Negeri Brebes menghentikan proses hukum. https://t.co/s88Lk3gAW3,212,25,37,6,2022-01-13,9,Thursday,4,249,31
1481554495981211649,2022-01-13 09:11:32,"Ilmuwan berhasil membuat nanoantenna yang dibuat oleh DNA. Ukurannya hanya 5 nanometer atau 0,0000005 cm. https://t.co/gO5w6UDwYP",9,0,1,2,2022-01-13,9,Thursday,4,10,2
1481554314044846082,2022-01-13 09:10:49,Polri mengatakan pengadaan seragam baru merupakan urusan satpam dan tempat kerja. https://t.co/1R3P7UDNPv,17,16,3,3,2022-01-13,9,Thursday,4,20,19
1481554299322880008,2022-01-13 09:10:45,Mahfud Md ikut angkat bicara perihal siapa yang bertanggung jawab dalam perkara proyek lama satelit Kemhan. https://t.co/bOtr2zOUhC,8,1,1,1,2022-01-13,9,Thursday,4,9,2
1481553796761276416,2022-01-13 09:08:45,"Zikri Daulay tengah berlibur ke Turki. Ia beralasan, perjalanannya itu memang sudah dijadwalkan jauh-jauh hari. #ZikriDaulay  https://t.co/KrTDBBI8QI",12,6,1,4,2022-01-13,9,Thursday,4,13,10
1481552452344496130,2022-01-13 09:03:25,"Masih ingatkah dengan sosok Pak Ogah? Pemeran dalam ""Si Unyil"" ini sedang membutuhkan bantuan dari #sahabatbaik. Bagi yang tergerak hatinya untuk membantu Pak Ogah, bisa berdonasi melalui platform @berbuatbaik_id. Donasi yang terkumpul akan disalurkan 100% tanpa potongan biaya. https://t.co/j6mej7wXLo",30,2,26,0,2022-01-13,9,Thursday,4,56,2
1481552270911279105,2022-01-13 09:02:41,Ini kriteria orang yang tidak boleh booster vaksin COVID-19. Hanya peserta yang sudah lolos skrining yang diberikan vaksin booster COVID-19. https://t.co/ZFZQ6fUiTe,5,0,4,0,2022-01-13,9,Thursday,4,9,0
1481552253467213829,2022-01-13 09:02:37,"Manajer Nagita Slavina, Lutfi berbagi cerita soal belum dikaruniai buah hati dari 12 tahun pernikahannya. Manajer Gigi ini diberikan program bayi tabung oleh Raffi Ahmad.  https://t.co/deDwE6k0lf",19,1,3,1,2022-01-13,9,Thursday,4,22,2
1481551914106081283,2022-01-13 09:01:16,Komedian Komeng jadi sorotan usai isi lawakannya dianggap merendahkan perempuan. Netizen ada yang pro dan kontra menilai lawakan yang dibawakan Komeng. #detikNetwork  https://t.co/KAaVDGBc0y,8,2,1,9,2022-01-13,9,Thursday,4,9,11
1481551898465480707,2022-01-13 09:01:13,"Diduga kebakaran karena korsleting listrik, ruko kantor bank di Pasar Kliwon, Kabupaten Kudus, Jawa Tengah terbakar hari ini.  https://t.co/H1Eeq6jwtS",2,0,2,0,2022-01-13,9,Thursday,4,4,0
1481551068286885889,2022-01-13 08:57:55,Ardhito Pramono ditetapkan sebagai tersangka kasus dugaan penyalahgunaan narkoba jenis ganja. Ini ungkapan penyesalan Ardhito Pramono:  https://t.co/aJwop0w6MJ,6,4,3,4,2022-01-13,8,Thursday,4,9,8
1481551049001517061,2022-01-13 08:57:50,Panitia dan pihak Pemprov DKI Jakarta mengebut pengerjaan trek street race. Bagaimana perkembangannya? https://t.co/dodwWFUNm2,3,0,1,0,2022-01-13,8,Thursday,4,4,0
1481550499283447809,2022-01-13 08:55:39,"Bagi penonton MotoGP Mandalika yang bingung dimana tempat untuk menginap, ada homestay di sekitar kawasan Mandalika. Tarifnya mulai Rp 150-300 ribu. https://t.co/1bIvFzCN1V",15,1,1,0,2022-01-13,8,Thursday,4,16,1
1481549656496775175,2022-01-13 08:52:18,#FOTO Segala aspek di kehidupan kita telah berubah secara dramatis antara masa lalu dan kini. Seperti terlihat pada foto perbandingan ini:   https://t.co/eUzCbW2AcK,14,2,3,0,2022-01-13,8,Thursday,4,17,2
1481548882052067328,2022-01-13 08:49:13,Kalina Oktarani mengaku sudah bercerai dengan Vicky Prasetyo. Ini yang dilakukan Vicky ketika Kalina minta cerai:  https://t.co/3v8El8DBlL,9,0,1,0,2022-01-13,8,Thursday,4,10,0
1481548530774859782,2022-01-13 08:47:50,"Tahun 2022 akan jadi tahun yang menarik untuk laptop, karena baik Intel maupun AMD sudah memamerkan jajaran prosesor laptop baru yang menjanjikan. https://t.co/e5ygoYgBQv",4,0,0,0,2022-01-13,8,Thursday,4,4,0
1481548301749178371,2022-01-13 08:46:55,"""Itu bukan Kadis Kesehatan. Acaranya bukan dalam jam kerja dan tidak di lingkungan kantor. Itu privasi masing-masing,"" kata Bupati Humbahas, Dosmar Banjarnahor. https://t.co/kx2HCTwhVh",81,48,15,13,2022-01-13,8,Thursday,4,96,61
1481548281989763072,2022-01-13 08:46:50,"Akses jalan permukiman warga di Pondok Bambu, Duren Sawit, Jakarta Timur ditutup tembok. Penutupan tembok yang dilakukan warga karena keluhan banjir yang tak kunjung diatasi. https://t.co/USJKwDs9zu",1,1,0,0,2022-01-13,8,Thursday,4,1,1
1481547695646986243,2022-01-13 08:44:31,"Infinix Note 11 Pro menawarkan baterai besar dengan layar yang lapang, namun seperti apa kemampuan yang dimiliki HP Rp 2 jutaan ini? Simak reviewnya di sini:  https://t.co/y0Qf9Jal9B",1,0,1,0,2022-01-13,8,Thursday,4,2,0
1481547437919637508,2022-01-13 08:43:29,Indonesia resmi melakukan program vaksinasi booster di tengah ancaman COVID-19 varian Omicron. Ibu hamil juga dapat mendapat booster dengan syarat berikut: https://t.co/SCijmdlhSn,10,1,1,1,2022-01-13,8,Thursday,4,11,2
1481547417417830400,2022-01-13 08:43:24,Cuitan Ardhito Pramono di tahun 2012 dan 2010 kembali viral usai dirinya diciduk polisi karena kasus narkoba pada Rabu (12/1). Ardhito ditangkap di rumahnya di kawasan Jakarta Timur. https://t.co/llwiFoWkXe,5,1,4,2,2022-01-13,8,Thursday,4,9,3
1481546885693325314,2022-01-13 08:41:18,Kesalahan pertama pria-wanita itu adalah berkendara tidak memakai helm. Polisi kini sedang menyelidiki video viral tersebut. https://t.co/UnQ11gYXOB,3,0,2,1,2022-01-13,8,Thursday,4,5,1
1481546866479312896,2022-01-13 08:41:13,Kemenkes memprediksi puncak Omicron tiba bulan depan dengan risiko kasus harian 50 ribu hingga 70 ribu kasus. Kasus aktif dinilai akan melambung tinggi. https://t.co/HeTwjFe607,148,156,60,68,2022-01-13,8,Thursday,4,208,224
1481546076331167746,2022-01-13 08:38:05,Kementerian Komunikasi dan Informatika menanggapi tentang dugaan kebocoran data pelamar PT Pertamina Training and Consulting. https://t.co/3gYaKDPOla,8,1,1,1,2022-01-13,8,Thursday,4,9,2
1481545832482717701,2022-01-13 08:37:06,"Terdakwa pemerkosa 13 santriwati di Bandung, Herry Wirawan dituntut hukuman kebiri kimia. Ini sejarah kebiri kimia:  https://t.co/hax3AMHwTA",6,2,4,1,2022-01-13,8,Thursday,4,10,3
1481545603595309058,2022-01-13 08:36:12,She's Nothing jadi lagu dari mood Zara Leola yang berhasil diterjemahkan Eka Gustiwana. https://t.co/rHTdirDXX5,1,0,0,0,2022-01-13,8,Thursday,4,1,0
1481545104775122945,2022-01-13 08:34:13,"Jeanneta Sanfadelia, sosok istri Ardhito Pramono yang tak pernah diketahui. Jeanneta juga beberapa kali terlibat dalam proyek Ardhito. Ini sosoknya:  https://t.co/nfBMuLnor0",74,9,10,44,2022-01-13,8,Thursday,4,84,53
1481544668768837632,2022-01-13 08:32:29,Kalina Oktarani membuat satu pengakuan soal cerai dari Vicky Prasetyo. Ia ngaku tidak mau menyesal soal keputusannya menikah dengan Vicky.  https://t.co/5k2mxeAfCB,1,2,2,1,2022-01-13,8,Thursday,4,3,3
1481544637391249408,2022-01-13 08:32:21,Transplantasi jantung babi ke manusia untuk pertama kalinya menjadi terobosan di dunia medis. Ini sosok Muhammad Mohiuddin di balik itu:  https://t.co/TJQ0TuTysX,114,25,27,10,2022-01-13,8,Thursday,4,141,35
1481544249174802432,2022-01-13 08:30:49,"Seorang nelayan di Kota Kendari, Sulawesi Tenggara (Sultra), Nasir Kambewa (50), ditemukan meninggal di perairan Kendari. Korban ditemukan setelah dilaporkan hilang empat hari yang lalu. https://t.co/DEtjlLW0gY",5,0,0,0,2022-01-13,8,Thursday,4,5,0
1481544231026106371,2022-01-13 08:30:45,"Nagita Slavina kembali diterpa isu tak sedap, yakni beredar video syur mirip Nagita Slavina. Ini reaksi Raffi Ahmad soal video mirip Nagita Slavina:  https://t.co/v7MSnVoPYy",8,1,2,0,2022-01-13,8,Thursday,4,10,1
1481543940008558592,2022-01-13 08:29:35,Petinggi WHO Mike Ryan membantah pernyataan Presiden Brasil yang mengatakan bahwa varian Omicron yang tersebar luas saat sekarang ini dapat mengakhiri pandemi. https://t.co/wzlHldkTl1,5,0,0,0,2022-01-13,8,Thursday,4,5,0
1481543337349988353,2022-01-13 08:27:12,"Makan di restoran, pengunjung ini dibuat kesal karena pelayan memasukkan menu yang tak dipesan ke dalam bon. Pihak restoran minta maaf dan beri penjelasan. https://t.co/AmKfux53D9",2,3,0,0,2022-01-13,8,Thursday,4,2,3
1481543041953501188,2022-01-13 08:26:01,"Istri Ardhito Pramono, Jeanneta Sanfadelia, menyambangi Polres Metro Jakarta Barat hari ini, Kamis (13/1). Jeanneta bungkam seribu bahasa ditemani dua orang pria. https://t.co/ByxBdidof8",2,0,3,3,2022-01-13,8,Thursday,4,5,3
1481542468055224322,2022-01-13 08:23:44,Klub Slovakia FK Senica memberi kode bakal merekrut pemain Indonesia lewat inisial huruf 'W'. Netizen di Indonesia menebak-nebak dengan menyebut Witan Sulaeman!  https://t.co/CShYdCzWcv,7,0,0,0,2022-01-13,8,Thursday,4,7,0
1481542223426691073,2022-01-13 08:22:46,"Dari rentetan hero di Mobile Legends, kira-kira apa ya yang menjadi langganan pick para pemain saat bermain di mode rank? Ini daftarnya:  https://t.co/eDjeBrR4S2",6,0,1,1,2022-01-13,8,Thursday,4,7,1
1481542203646357512,2022-01-13 08:22:41,"Warga Bogor merapat! Simak informasi vaksin booster COVID-19 di Bogor dan sekitarnya, lengkap dengan lokasi, syarat, dan cara daftarnya. https://t.co/WPUBOj8B9O",2,0,2,0,2022-01-13,8,Thursday,4,4,0
1481540817776951296,2022-01-13 08:17:11,Video 61 detik yang disebut mirip artis Nagita Slavina tersebar di media sosial. https://t.co/oa3B1Dxb2L,4,0,1,1,2022-01-13,8,Thursday,4,5,1
1481540363676524544,2022-01-13 08:15:23,Negara ini diprediksi jadi salah satu negara yang pertama keluar dari pandemi. Disebutkan alasannya karena imunitas warga sudah tinggi menghadapi Corona. https://t.co/wvuBQNQvlG,14,2,3,1,2022-01-13,8,Thursday,4,17,3
1481539786859233286,2022-01-13 08:13:05,"#Terpopuler Dayana, selebgram asal Kazakhstan jadi perhatian karena situasi negara tersebut yang mencekam. Banyak netizen khawatir dengannya. https://t.co/RMDtKgE5Nh",13,3,2,3,2022-01-13,8,Thursday,4,15,6
1481539764293705729,2022-01-13 08:13:00,Pemerintah memberikan kabar terkini soal vaksin Merah Putih buatan dalam negeri. Kira-kira sudah sampai mana dan kapan bisa mulai digunakan? https://t.co/zQyhHVheh7,3,0,0,1,2022-01-13,8,Thursday,4,3,1
1481539502329974785,2022-01-13 08:11:57,Waskita Karya melalui anak perusahaannya PT Waskita Toll Road telah menandatangani Perjanjian Jual Beli Bersyarat dengan PT Sarana Multi Infrastruktur (SMI). https://t.co/5Inz5RWKBX,5,0,2,0,2022-01-13,8,Thursday,4,7,0
1481539476069523458,2022-01-13 08:11:51,"Konami, perusahaan game populer ini baru saja terjun di dunia Non Fungible Token (NFT) dengan merilis NFT Castlevania. https://t.co/JSLfsVQt3F",6,0,0,0,2022-01-13,8,Thursday,4,6,0
1481539329562402816,2022-01-13 08:11:16,Ardhito Pramono positif menggunakan ganja melalui metode tes urine. Begini prosedur tes urine untuk mendeteksi penggunaan jenis narkoba: https://t.co/Tu8BmCuQJf,8,0,0,0,2022-01-13,8,Thursday,4,8,0
1481539119662698500,2022-01-13 08:10:26,Ardhito juga mengimbau generasi muda agar tidak terjebak dalam penggunaan narkotika. https://t.co/IOIY3N9BRw,6,0,0,0,2022-01-13,8,Thursday,4,6,0
1481538888376242179,2022-01-13 08:09:31,"Ardhito Pramono ditetapkan sebagai tersangka kasus narkoba. Ia ditangkap di rumahnya di kawasan Klender, Jakarta Timur pada Rabu (12/1). Dalam rilis kasus narkoba yang digelar polisi, begini penampakan Ardhito Pramono berbaju tahanan. https://t.co/4g4zgqedKI",8,3,2,0,2022-01-13,8,Thursday,4,10,3
1481538868864339968,2022-01-13 08:09:26,Ardhito Pramono pernah mengalami depresi. Ia bahkan mengaku pernah konsultasi ke rumah sakit jiwa. #ArdhitoPramono  https://t.co/JmLKZiQGY1,13,1,1,1,2022-01-13,8,Thursday,4,14,2
1481537474514268160,2022-01-13 08:03:54,"Internetan dan nonton tayangan hiburan jalan terus dengan Paket @IndiHome (dengan akses Disney+ Hotstar) mulai dari Rp300 ribuan!
-
Yuk, langganan sekarang! Klik https://t.co/a3rJPN3Kz0
-
#InternetnyaIndonesia
#AktivitasTanpaBatas https://t.co/f6D0CD3P7g",1,4,0,0,2022-01-13,8,Thursday,4,1,4
1481536632641757184,2022-01-13 08:00:33,"BUMN sektor peternakan, PT Berdikari (Persero) membuka lowongan kerja untuk lulusan SMK/D3. Berikut persyaratannya: https://t.co/PGG7x1zYA9",6,0,3,0,2022-01-13,8,Thursday,4,9,0
1481536600123363329,2022-01-13 08:00:25,"Liverpool bertekad melaju ke final Piala Liga Inggris pertama kalinya sejak 2016. Meski demikian, Jurgen Klopp menegaskan Arsenal bukan lawan yang mudah.  https://t.co/hq2hW1jLwv",3,0,0,1,2022-01-13,8,Thursday,4,3,1
1481536280450195456,2022-01-13 07:59:09,Ardhito Pramono resmi jadi tersangka kasus narkoba. Ia pun ditahan di Polres Metro Jakarta Barat dan terancam hukuman 4 tahun penjara. https://t.co/KzUjpu8btG,3,0,0,0,2022-01-13,7,Thursday,4,3,0
1481536261282308098,2022-01-13 07:59:04,"Jeanneta Sanfadelia, menjenguk suaminya usai ditangkap Polres Metro Jakarta Barat atas kasus narkoba. Sang istri mengungkap kondisi Ardhito:  https://t.co/sjRXmDsFOB",10,9,10,8,2022-01-13,7,Thursday,4,20,17
1481535946726199298,2022-01-13 07:57:49,"Wakil Ketua Komisi III DPR, Desmond J Mahesa mengusir salah satu anggota Komnas Perempuan yang terlambat namun nekat masuk ruang rapat, Kamis (13/1).  https://t.co/eWd4QNft1s",8,6,2,0,2022-01-13,7,Thursday,4,10,6
1481535457926303752,2022-01-13 07:55:53,Demokrat menyesalkan penangkapan kadernya itu. https://t.co/CrUMP0qWZ8,6,3,0,1,2022-01-13,7,Thursday,4,6,4
1481534834539442177,2022-01-13 07:53:24,"#Terpopuler Adik dari almarhum Bibi Ardiansyah, Fujianti Utami Putri segera melakukan debut dalam layar lebar melalui film Bukan Cinderella. https://t.co/q7yXZg99oW",5,0,0,0,2022-01-13,7,Thursday,4,5,0
1481534215317512192,2022-01-13 07:50:57,PP Perbasi mematok target medali perak bagi Timnas basket putra di SEA Games 2022. Tapi target itu masih sementara. Kenapa?  https://t.co/lCuCT4y4C7,3,0,1,0,2022-01-13,7,Thursday,4,4,0
1481533757475725316,2022-01-13 07:49:08,Mohammad Ahsan/Hendra Setiawan melanjutkan langkahnya ke perempatfinal India Open 2022. Ahsan/Hendra menang dua gim langsung atas wakil tuan rumah!  https://t.co/smOVJOqQvg,8,0,0,0,2022-01-13,7,Thursday,4,8,0
1481533339442065409,2022-01-13 07:47:28,Tempat istirahat dan pelayanan (TIP) atau rest area jalan tol diizinkan dilengkapi dengan fasilitas penginapan. https://t.co/orT8B4pOjE,36,11,4,2,2022-01-13,7,Thursday,4,40,13
1481532830375104521,2022-01-13 07:45:26,"Pilu, gara-gara ditipu cucu tirinya, nenek ini terancam diusir dari rumahnya sendiri. Bagaimana nasib Nenek Ellen yang hidup sebatang kara? https://t.co/rk9TlH3fti",11,1,5,2,2022-01-13,7,Thursday,4,16,3
1481531809615732736,2022-01-13 07:41:23,#Terpopuler Pak Ogah yang terbaring sakit sempat tidak mau berobat ke Rumah Sakit karena belum membayar BPJS selama 4 tahun.  https://t.co/85acQbrIci,50,9,10,1,2022-01-13,7,Thursday,4,60,10
1481531351090221057,2022-01-13 07:39:34,Bingung ingin pesan sate di ojek online dari warung yang mana ? Kamu bisa memilih beberapa warung sate dengan rating tinggi ini. https://t.co/tEqqabNtDb,6,0,0,1,2022-01-13,7,Thursday,4,6,1
1481530712989831168,2022-01-13 07:37:02,"Jika saat ini kamu masih bingung mencari undangan pernikahan, coba intip yuk beberapa inspirasi undangan pernikahan simple berikut: https://t.co/p7i27JzL8v",18,0,3,0,2022-01-13,7,Thursday,4,21,0
1481530436371234816,2022-01-13 07:35:56,Laga Piala Afrika 2022 antara Tunisia vs Mali diwarnai kontroversi. Sejumlah keputusan wasit Janny Sikazwe menyulut protes hingga bikin ricuh.  https://t.co/Buycqa5yQE,1,1,0,0,2022-01-13,7,Thursday,4,1,1
1481530099488935941,2022-01-13 07:34:35,Wanita ini menghabiskan dana Rp 273 jutaan untuk beli bulu mata palsu. Bukan sekadar untuk mempercantik diri tapi ada kondisi yang mengharuskan. https://t.co/KXIM7ZtrrW,7,1,1,0,2022-01-13,7,Thursday,4,8,1
1481529565495312385,2022-01-13 07:32:28,"Selain hobi berdonasi, ternyata IU juga hobi membaca buku lho. Apa saja buku favorit IU? Simak daftarnya ya:

via: detikedu https://t.co/VmgaNXFolA",13,0,1,1,2022-01-13,7,Thursday,4,14,1
1481529022819581953,2022-01-13 07:30:19,Seorang bocah SD di Kota Bekasi di-bully temannya. Perundungan itu terjadi disebut-sebut karena korban lebih jago bermain sepakbola ketimbang para pelaku. https://t.co/Y1NvkVe7Ih,26,2,6,2,2022-01-13,7,Thursday,4,32,4
1481529005912305667,2022-01-13 07:30:15,"Aksi warga Depok menggerebek panti pijat refleksi viral di media sosial. Lokasi itu diduga untuk menutupi kegiatan prostitusi. Pasalnya saat digerebek warga, ada terapis yang bugil. https://t.co/aPLXfverfV",5,0,0,1,2022-01-13,7,Thursday,4,5,1
1481528705914658817,2022-01-13 07:29:03,"Untuk meninjau kesiapan MotoGP Mandalika 2022, orang nomor satu di Indonesia ini menggunakan motor custom bertuliskan ""RI 1"" dan jaket ""G20"".  https://t.co/p3lYLNGtT6",27,2,2,0,2022-01-13,7,Thursday,4,29,2
1481528192468987905,2022-01-13 07:27:01,"Real Madrid sudah menjejak ke final Piala Super Spanyol. Pelatih El Real, Carlo Ancelotti, tak peduli siapapun yang akan menjadi lawan mereka di babak puncak.  https://t.co/5Z90kSc1dS",8,0,1,0,2022-01-13,7,Thursday,4,9,0
1481528171019530242,2022-01-13 07:26:56,Presiden Joko Widodo meninjau persiapan prokes Bandara Internasional Zainuddin Abdul Madjid di Kabupaten Lombok Tengah. https://t.co/PCBjt5whyx,5,0,0,1,2022-01-13,7,Thursday,4,5,1
1481527825219923973,2022-01-13 07:25:33,Polisi menetapkan Ardhito Pramono sebagai tersangka dan ditahan di kasus narkoba. Keluarga mengajukan permohonan rehabilitas. https://t.co/g1VNF1eyRW,8,0,1,1,2022-01-13,7,Thursday,4,9,1
1481527813282930688,2022-01-13 07:25:30,Ardhito Pramono dihadirkan saat rilis kasusnya di Polres Metro Jakarta Barat. Ia hanya senyum dan anggukan kepala usai dibekuk karena ganja. #ArdhitoPramono  https://t.co/gogIqUEsVl,3,1,0,1,2022-01-13,7,Thursday,4,3,2
1481527597158785024,2022-01-13 07:24:39,Para penggemar kopi tentu tidak asing dengan filter kopi kertas. Tapi kini ada alat penyaring kopi yang terbuat dari keramik dan diklaim lebih ramah lingkungan. https://t.co/SsU68WrsIh,9,1,3,1,2022-01-13,7,Thursday,4,12,2
1481527563948285958,2022-01-13 07:24:31,Ardhito Pramono ditetapkan sebagai tersangka kasus dugaan penyalahgunaan narkoba jenis ganja. Ia terancam hukuman maksimal 4 tahun penjara.  https://t.co/9EVs8dz0pF,7,8,1,1,2022-01-13,7,Thursday,4,8,9
1481527264105967619,2022-01-13 07:23:19,"Pihak kepolisian merilis kasus narkoba yang menjerat Ardhito Pramono. Kabid Humas Polda Metro Jaya mengatakan, ganja yang dimiliki Ardhito untuk digunakan sendiri. https://t.co/zfLK72LmCx",6,2,0,2,2022-01-13,7,Thursday,4,6,4
1481526953287073794,2022-01-13 07:22:05,"Oka Antara berbagi cerita spiritual tentang keyakinannya. Dia yang dididik dengan cara Hindu, menceritakan bagaimana keluarganya hidup dalam toleransi beragama. https://t.co/82uYIv1vg0",5,0,3,0,2022-01-13,7,Thursday,4,8,0
1481526423567441924,2022-01-13 07:19:59,Ardhito Pramono dijerat dengan Undang-Undang Narkotika. Dia terancam 4 tahun penjara. https://t.co/FNHL3v2xgn,28,8,1,8,2022-01-13,7,Thursday,4,29,16
1481526114237493252,2022-01-13 07:18:45,Sebuah kelompok pelindung hak konsumen di China mendesak masyarakat untuk memboikot promosi restoran cepat saji KFC. https://t.co/0l6ciag7Es,5,0,0,0,2022-01-13,7,Thursday,4,5,0
1481525802726572032,2022-01-13 07:17:31,Lee Sachi bicara soal statusnya yang jadi tersangka dalam kasus pencemaran nama baik. #LeeSachi  https://t.co/96ndZRy5Hc,8,0,0,1,2022-01-13,7,Thursday,4,8,1
1481525556541902849,2022-01-13 07:16:32,Musisi berusia 26 tahun itu diketahui sudah menggunakan ganja sejak tahun 2011. https://t.co/jcWmD4JeDu,13,5,0,2,2022-01-13,7,Thursday,4,13,7
1481525540775501825,2022-01-13 07:16:28,"Kepada polisi, Ardhito mengaku memakai ganja supaya fokus bekerja. https://t.co/Sk5mPAV5lX",6,4,0,7,2022-01-13,7,Thursday,4,6,11
1481525243915218945,2022-01-13 07:15:18,"Bintang film sekaligus musisi, Ardhito Pramono, ditangkap terkait kasus narkoba. Begini kronologi Ardhito Pramono diciduk polisi. https://t.co/p76s70YJPh",1,0,2,0,2022-01-13,7,Thursday,4,3,0
1481524717609750528,2022-01-13 07:13:12,"Setelah diluncurkan akhir tahun lalu di China, detikINET berkesempatan menggenggam Oppo Find N di Indonesia. Ini penampakannya:  https://t.co/sM5ZGBAN4t",4,1,1,1,2022-01-13,7,Thursday,4,5,2
1481524419587719172,2022-01-13 07:12:01,"Jejak Ardhito Pramono yang diduga memakai narkoba sudah terlacak dari salah satu tempat di Kebon Jeruk, Jakarta Barat. Begini kronologi penangkapannya:  https://t.co/GDxlgPnzaT",1,0,1,0,2022-01-13,7,Thursday,4,2,0
1481523945400672258,2022-01-13 07:10:08,Ardhito Pramono ditangkap polisi karena narkoba. Ia ditetapkan sebagai tersangka usai positif mengkonsumsi ganja. #ArdhitoPramono  https://t.co/SABLbZANhs,3,3,0,0,2022-01-13,7,Thursday,4,3,3
1481523921677692929,2022-01-13 07:10:02,El Salvador merugi karena harga Bitcoin yang anjlok belakangan ini. Negara itu menggunakan Bitcoin sebagai alat pembayaran. https://t.co/cGzix6HhHT,3,0,4,2,2022-01-13,7,Thursday,4,7,2
1481523416230506500,2022-01-13 07:08:02,Ardhito Pramono membeli ganja dari seorang pengedar berinisial I. https://t.co/Enqw4Iqgc1,18,12,3,1,2022-01-13,7,Thursday,4,21,13
1481523054958329857,2022-01-13 07:06:36,Wakil Menteri Agama mengatakan tak ada social distancing dalam penerbangan haji tahun 2022. https://t.co/ssehZOGpFL,12,4,0,0,2022-01-13,7,Thursday,4,12,4
1481522880441720832,2022-01-13 07:05:54,Salah satu kebijakan yang diapresiasi adalah masuknya tokoh-tokoh perempuan di kepengurusan. https://t.co/X3FxUOpnfA,4,0,0,0,2022-01-13,7,Thursday,4,4,0
1481522865077899264,2022-01-13 07:05:51,Minum es teh dalam kantong plastik besar viral di media sosial. Di Malaysia banyak pria pamer minum es tehukuran jumbo dan diunggah di TikTok. https://t.co/CZIKbx2C9d,2,0,1,1,2022-01-13,7,Thursday,4,3,1
1481522593689710593,2022-01-13 07:04:46,"Pemerintah belum mencabut larangan ekspor batu bara. Namun, 37 kapal pengangkut batu bara sudah diizinkan untuk berlayar ke negara tujuan ekspor. Kok bisa? https://t.co/0xjtXNXsG2",7,12,1,3,2022-01-13,7,Thursday,4,8,15
1481522046924476417,2022-01-13 07:02:35,Ardhito Pramono ditangkap karena narkoba. Ia dipamerkan polisi di depan media dengan baju tahanan. Ini potretnya:  https://t.co/RICdwYGk7w,7,5,2,2,2022-01-13,7,Thursday,4,9,7
1481522026510700548,2022-01-13 07:02:31,Ghozali Everyday menghebohkan media sosial Tanah Air. Hanya bermodal foto selfie yang dijadikan NFT koleksinya bernilai miliaran rupiah. Ini meme kocaknya:  https://t.co/maf6wqbUVn,9,1,2,2,2022-01-13,7,Thursday,4,11,3
1481521518257520641,2022-01-13 07:00:29,Warna seragam satuan pengamanan (Satpam) akan berubah dua kali dalam kurun dua tahun bila rencana perubahan terbaru dari Mabes Polri terealisasi. #CNNIndonesia #detiknetwork  https://t.co/zKZUjgzamh,5,3,0,1,2022-01-13,7,Thursday,4,5,4
1481520703719542784,2022-01-13 06:57:15,"""Yang bersangkutan sudah ditetapkan sebagai tersangka dan dilakukan penahanan di Polres Metro Jakarta Barat,"" kata Kombes Zulpan. https://t.co/v1jE4BN0t3",7,0,1,2,2022-01-13,6,Thursday,4,8,2
1481520637248212992,2022-01-13 06:56:59,Chelsea melaju ke final Piala Liga Inggris usai menyingkirkan Tottenham Hotspur. Thomas Tuchel menorehkan sebuah catatan spesial lewat keberhasilan Chelsea itu.  https://t.co/BRFIfvKZTd,5,0,0,0,2022-01-13,6,Thursday,4,5,0
1481520446495465474,2022-01-13 06:56:14,Amerika Serikat mencatatkan angka inflasi yang tinggi. Bahkan sudah berada di kisaran 7% dalam satu tahun terakhir. https://t.co/UczUAoHw05,3,0,3,2,2022-01-13,6,Thursday,4,6,2
1481520404892106752,2022-01-13 06:56:04,Polri mengungkap kondisi terkini Ferdinand di rutan. https://t.co/hOkSUlqoJo,2,0,0,0,2022-01-13,6,Thursday,4,2,0
1481520160032890885,2022-01-13 06:55:06,#Foto Megan Fox &amp; Machine Gun Kelly akhirnya resmi bertunangan pada 11 Januari 2022. Ini potret perjalanan cinta keduanya. 💍😍  https://t.co/0hvjauTnCl,12,1,2,2,2022-01-13,6,Thursday,4,14,3
1481520145923194880,2022-01-13 06:55:02,Mahfud Md mengungkap adanya proyek di Kemhan pada tahun 2015 yang membuat negara rugi hampir Rp 1 triliun. https://t.co/Wr3Bd2hkV9,9,1,6,2,2022-01-13,6,Thursday,4,15,3
1481519664740118531,2022-01-13 06:53:08,Polisi menangkap Ardhito Pramono terkait kasus narkoba dan menetapkan sebagai tersangka. https://t.co/mCoyRSH7YX,7,0,1,2,2022-01-13,6,Thursday,4,8,2
1481519646624948225,2022-01-13 06:53:03,"India melaporkan lebih dari 241 ribu kasus COVID-19, warga tetap nekat berkerumun di festival keagamaan. Kasus naik delapan kali lipat sejak awal tahun ini. https://t.co/x8Gf4cn7cd",9,2,2,0,2022-01-13,6,Thursday,4,11,2
1481519401891508224,2022-01-13 06:52:05,Bupati Penajam Paser Utara Abdul Gafur Masud terjaring operasi tangkap tangan (OTT) KPK. Abdul Gafur tercatat punya harta segini: https://t.co/Er85RvtErw,12,9,3,2,2022-01-13,6,Thursday,4,15,11
1481518271929233411,2022-01-13 06:47:35,"Manajemen restoran cepat saji, KFC Cabang Kota Palopo, Sulsel, digugat konsumennya Rp 4 miliar menyusul dugaan pembohongan publik. Begini ceritanya: https://t.co/bZGgAs4Ih6",17,5,6,2,2022-01-13,6,Thursday,4,23,7
1481517987714813958,2022-01-13 06:46:28,Jokowi berharap homestay itu dapat terisi penuh saat penyelenggaraan MotoGP 2022. https://t.co/NVzCmy5Pfc,12,0,2,0,2022-01-13,6,Thursday,4,14,0
1481517362646069251,2022-01-13 06:43:59,NFT tengah menjadi tren saat ini. Merek fesyen ternama GAP pun tak mau ketinggalan dan terjun ke aset kripto tersebut. https://t.co/YniAymD8Tc,9,0,1,0,2022-01-13,6,Thursday,4,10,0
1481517348062380036,2022-01-13 06:43:55,"Harga Bitcoin diproyeksi melesat ke level US$ 75.000 atau setara Rp 1,06 miliar (kurs Rp 14.200). Apa pemicunya? https://t.co/IgK8p8ZdcN",11,3,5,0,2022-01-13,6,Thursday,4,16,3
1481516432819163136,2022-01-13 06:40:17,Alat tes COVID-19 buatan BRIN dapat izin edar. Alat tes ini disebut bisa mendeteksi varian Corona termasuk Delta dan Omicron. https://t.co/JbLxJf2X2n,11,0,2,0,2022-01-13,6,Thursday,4,13,0
1481516083479781378,2022-01-13 06:38:54,Ada cerita menarik di balik jaket G20 yang dipakai Jokowi itu. Simak di sini. https://t.co/kYKxYC8gii,6,1,0,0,2022-01-13,6,Thursday,4,6,1
1481515775986970625,2022-01-13 06:37:40,Seorang penumpang berulah saat pesawat baru saja boarding. Dia menerobos kokpit pesawat. Dan juga dia merusak alat kendali pesawat. Parah! https://t.co/y8nuxm9igF,1,0,0,1,2022-01-13,6,Thursday,4,1,1
1481515475129573378,2022-01-13 06:36:29,"Mantan istri Wang Leehom, Lee Jinglei, tak kunjung memberikan bukti ke polisi atas tudingan perselingkuhan mantan suaminya.  https://t.co/gdOLEs8Eyq",1,0,0,0,2022-01-13,6,Thursday,4,1,0
1481514976531595264,2022-01-13 06:34:30,"Penyanyi Ardhito Pramono diamankan oleh Polres Metro Jakarta Barat, Rabu (12/1/2021). Ardhito dijenguk sang istri usai ditangkap karena dugaan kasus narkoba. https://t.co/05ptYoM2Vr",30,30,5,18,2022-01-13,6,Thursday,4,35,48
1481514758583037953,2022-01-13 06:33:38,Ardhito Pramono menyimpan banyak cerita dalam kehidupannya. Musisi dan aktor itu pernah mengalami depresi hingga menyalahgunakan obat-obatannya. https://t.co/vfY3H7k8o8,12,0,6,5,2022-01-13,6,Thursday,4,18,5
1481514757307965447,2022-01-13 06:33:38,"NFT atau non-fungible token semakin hari semakin tenar, termasuk di Indonesia. Begini cara buatnya di OpenSea. https://t.co/jbLLWpA7S0",8,1,4,0,2022-01-13,6,Thursday,4,12,1
1481514348287864833,2022-01-13 06:32:00,"Dari daftar item barang bukti terlihat ada kertas papir, ganja, dan pil Alprazolam. https://t.co/LSsztGREcP",2,1,1,4,2022-01-13,6,Thursday,4,3,5
1481514327203065859,2022-01-13 06:31:55,Pria tersebut menodongkan pisaunya ke polisi dan terlihat menantang polisi yang memakai seragam. https://t.co/WTaRaz1Dh2,8,0,0,0,2022-01-13,6,Thursday,4,8,0
1481513926546399232,2022-01-13 06:30:19,"Polisi menangkap Ardhito Pramono di kediamannya di kawasan Jakarta Timur pada Rabu (12/1). Saat diamankan, ia sedang mengkonsumsi ganja. #ArdhitoPramono  https://t.co/b4JyJJloiV",9,1,0,0,2022-01-13,6,Thursday,4,9,1
1481513180786577408,2022-01-13 06:27:22,"Klasemen Liga Inggris Usai West Ham Vs Norwich, MU Kian Jauh dari 4 Besar  https://t.co/blLQe6XmaV",0,1,0,0,2022-01-13,6,Thursday,4,0,1
1481512689155325956,2022-01-13 06:25:24,"Ardhito Pramono mengenal ganja sejak 2011. Sempat berhenti, dia kembali terjerumus narkoba pada 2020. #ArdhitoPramono  https://t.co/DaE4Iln3Y1",17,8,4,1,2022-01-13,6,Thursday,4,21,9
1481512424826097664,2022-01-13 06:24:21,"Usai sukses menghadirkan Galaxy S21 FE, Samsung memastikan akan membawa banyak handphone dan tablet baru ke Indonesia. Apakah selanjutnya Galaxy S22?  https://t.co/SV5atOVuzx",4,0,0,1,2022-01-13,6,Thursday,4,4,1
1481512405532352514,2022-01-13 06:24:17,Ada fakta baru yang terungkap usai penangkapan Ardhito Pramono. Ia ternyata sudah memiliki istri bernama Jeanneta Sanfadelia. Ini sosoknya:  https://t.co/EANRWwuRsM,2020,204,199,379,2022-01-13,6,Thursday,4,2219,583
1481511621679890440,2022-01-13 06:21:10,"Adik mendiang Vanessa Angel, Mayang dan Chika, sempat merasa insecure. Keduanya akhirnya memutuskan ke psikolog. https://t.co/BsHgcoEtfH",8,4,0,0,2022-01-13,6,Thursday,4,8,4
1481511140597325825,2022-01-13 06:19:15,"Malang menjadi kota termacet keempat di Indonesia, Dishub Kota Malang menyebut, kemacetan di wilayahnya hanya terjadi di jam tertentu saja. https://t.co/AbKoL31znz",8,1,1,2,2022-01-13,6,Thursday,4,9,3
1481511125304893441,2022-01-13 06:19:12,Eks penyidik KPK AKP Robin Pattuju divonis 11 tahun penjara terkait kasus suap. KPK pun mengapresiasi majelis hakim atas vonis tersebut. https://t.co/mVKUMmdO7s,9,0,2,0,2022-01-13,6,Thursday,4,11,0
1481510814582546433,2022-01-13 06:17:57,Nikita Willy tengah melakukan baby moon dengan sang suami. Potret resor tempatnya menginap pun mencuri perhatian. Tertarik untuk menginap? https://t.co/BdyHijuKVR,8,0,1,1,2022-01-13,6,Thursday,4,9,1
1481510788879818763,2022-01-13 06:17:51,"Wakil Ketua PAC PDIP Kecamatan Temanggung, Fajar Nugroho, tiba-tiba mengembalikan bantuan dari Gubernur Jawa Tengah, Ganjar Pranowo. Dia kesal karena kunjungan Ganjar saat memberikan bantuan diunggah ke YouTube.  https://t.co/K9TeRrLLJV",2,2,0,1,2022-01-13,6,Thursday,4,2,3
1481510510277365761,2022-01-13 06:16:45,Presiden Jokowi meyakini Sirkuit Mandalika yang menjadi tempat penyelenggaraan berbagai perlombaan balap motor bisa memberi dampak pada perekonomian setempat. https://t.co/ilIexVj0iZ,6,1,0,0,2022-01-13,6,Thursday,4,6,1
1481509967257608192,2022-01-13 06:14:35,"Webometrics menyusun daftar universitas terbaik di Indonesia dari 2.592 kampus.  Ada pilihan kamu, detikers?

via: detikedu https://t.co/X0TIngfwfO",7,0,0,0,2022-01-13,6,Thursday,4,7,0
1481509263566647298,2022-01-13 06:11:48,Ardhito Pramono ditangkap polisi terkait kasus narkoba. Begini penampakan Ardhito Pramono mengenakan baju tahanan! https://t.co/NMMA9aJyCB,10,1,3,0,2022-01-13,6,Thursday,4,13,1
1481509110143197185,2022-01-13 06:11:11,Polisi menangkap Ardhito Pramono terkait dugaan penyalahgunaan narkoba. Ia dihadirkan polisi di depan awak media. #ArdhitoPramono  https://t.co/t5iLtUJqvZ,7,2,1,0,2022-01-13,6,Thursday,4,8,2
1481509084687998977,2022-01-13 06:11:05,Karim Benzema tampil menawan mengantarkan Real Madrid menumbangkan Barcelona di Piala Super Spanyol. Ia menyumbang satu gol dan satu assist.  https://t.co/AshAjWIlRH,7,0,1,0,2022-01-13,6,Thursday,4,8,0
1481509083463270402,2022-01-13 06:11:05,Hal yang bikin aneh karena terkadang NFT yang dijual sesuatu yang aneh dan tidak masuk akal jika dijual dengan harga yang mahal. https://t.co/6JQkWd9MLi,14,0,4,1,2022-01-13,6,Thursday,4,18,1
1481508677655965696,2022-01-13 06:09:28,Alexis Sanchez membawa Inter Milan menjadi juara Piala Super Italia. Nerazzurri disebut pemain asal Chile itu masih haus gelar juara.  https://t.co/X3GBWDR4t9,9,0,1,0,2022-01-13,6,Thursday,4,10,0
1481508102226731008,2022-01-13 06:07:11,Pelatih Inter Milan Simone Inzaghi melanjutkan catatan apik saat berjumpa Juventus di Piala Super Italia. Ia mengatakan laga melawan Juventus selalu sulit.  https://t.co/fZCDJkoHKT,7,0,0,0,2022-01-13,6,Thursday,4,7,0
1481507830431633409,2022-01-13 06:06:06,"Hingga siang ini, kemacetan lalu lintas masih terjadi di Jl TB Simatupang, Jakarta. #detikcomdoyourmagic https://t.co/sW6VNlGtHX",6,2,2,3,2022-01-13,6,Thursday,4,8,5
1481507818159149057,2022-01-13 06:06:03,Pemprov DKI mencatat peningkatan jumlah kasus aktif Corona yang kini berjumlah 2.752 orang. Mayoritas punya riwayat perjalanan ke luar negeri. https://t.co/eJ2sbukX5r,4,1,10,1,2022-01-13,6,Thursday,4,14,2
1481507111884492800,2022-01-13 06:03:15,"Sudah tiba di Indonesia, keluarga Bunga Zainal jalani karantina mandiri di hotel sesuai dengan aturan pemerintah Indonesia. #BungaZainal   https://t.co/3kNMgoOmSD",8,2,2,0,2022-01-13,6,Thursday,4,10,2
1481507037443993601,2022-01-13 06:02:57,Sekarang ini kehadiran NFT alias non-fungible token sudah semakin populer di kalangan masyarakat global. Cara buatnya gimana sih? https://t.co/L1HcsaMvwL,16,0,6,0,2022-01-13,6,Thursday,4,22,0
1481505447505166337,2022-01-13 05:56:38,"Di mana-mana, mimin jadi melihat wajahnya Ghozali...

Sumber foto: Twitter https://t.co/l9Gz8TcOG5",31,3,4,1,2022-01-13,5,Thursday,4,35,4
1481505443927240704,2022-01-13 05:56:37,"Nambah lagi, Kemenkes RI memperbarui daftar kombinasi vaksin COVID-19 booster bagi penerima vaksin primer AstraZeneca. Berikut daftar terbarunya: https://t.co/nyyLYLmEHh",2,0,1,0,2022-01-13,5,Thursday,4,3,0
1481505203354542082,2022-01-13 05:55:40,"Bisnis penukaran uang kripto menjadikan pria ini makin tajir, bahkan sudah masuk dalam jajaran orang paling kaya di dunia. Dialah sang pendiri dan CEO Binance. https://t.co/6NoY8sRvyy",14,1,2,2,2022-01-13,5,Thursday,4,16,3
1481504941747363841,2022-01-13 05:54:37,"Viral siswa SD di Barru, Sulsel lolos dari penculikan anak oleh dua orang tak dikenal. Bagaimana ceritanya? https://t.co/P499uJfyuc",4,0,2,0,2022-01-13,5,Thursday,4,6,0
1481504290493640704,2022-01-13 05:52:02,Acara bridal shower di Bogor ini mendadak viral. Karena wajah calon pengantin merah dan tidak bisa hilang. Padahal pagi harinya langsung resepsi. Hiks.... https://t.co/04M6j7g0vv,4,2,4,6,2022-01-13,5,Thursday,4,8,8
1481503592007843840,2022-01-13 05:49:15,"Setelah setahun lebih kerap tampil bersama dan selalu terlihat mesra, Megan Fox dan Machine Gun Kelly akhirnya resmi tunangan pada 11 Januari. Selamat! https://t.co/a9ZU0zpBzV",15,5,6,4,2022-01-13,5,Thursday,4,21,9
1481502739154849795,2022-01-13 05:45:52,"Segala foto maupun video yang diunggah Nicholas Saputra jadi hal yang dinantikan penggemarnya, termasuk foto secangkir kopi ini:  https://t.co/v125zF6X33",17,1,1,3,2022-01-13,5,Thursday,4,18,4
1481501951305175042,2022-01-13 05:42:44,"Kasus COVID-19 yang terdeteksi di Tianjin, China, kebanyakan menimpa anak-anak. Lebih dari setengah dari 40 kasus infeksi COVID menimpa anak SMP dan SD. https://t.co/Durn7lsHwn",29,0,3,0,2022-01-13,5,Thursday,4,32,0
1481501742005198849,2022-01-13 05:41:54,Herry Wirawan terdakwa pemerkosa 13 santri di Bandung dijatuhkan hukuman kebiri kimia oleh PN Bandung. Apa itu kebiri kimia dan bagaimana efeknya? https://t.co/1oydKG146f,2,2,0,1,2022-01-13,5,Thursday,4,2,3
1481501712653471745,2022-01-13 05:41:47,Ardhito Pramono hanya bisa terdiam sambil menunduk dan langsung masuk ke ruangan kesehatan usai ditangkap polisi karena kasus narkoba. Ia diciduk polisi pada Rabu (12/1) di rumahnya di kawasan Jakarta Timur. https://t.co/3c5XPu3S7a,5,1,0,0,2022-01-13,5,Thursday,4,5,1
1481501155079467009,2022-01-13 05:39:34,Amerika Serikat mengalami inflasi tertinggi dalam empat dekade yakni sebesar 7% dan jadi ancaman terbesar terhadap ekonomi. Kenaikan harga-harga mulai dikeluhkan warga AS karena sejumlah harga bahan pokok melonjak drastis. https://t.co/fgrIojn3YG,6,0,5,1,2022-01-13,5,Thursday,4,11,1
1481500608519712769,2022-01-13 05:37:24,Pakar transportasi ITS menilai sampling penelitian Surabaya kota termacet di Indonesia adalah ruas jalan. Bukan jumlah kendaraan yang mengalami kemacetan. https://t.co/cp9ZHkWbxi,10,3,2,0,2022-01-13,5,Thursday,4,12,3
1481500068247220224,2022-01-13 05:35:15,Fosil naga laut (ichthyosaurus) terbesar dan terlengkap ditemukan di Inggris. Begini penampakan fosil tersebut! https://t.co/TGzZw8c4r9,3,0,0,0,2022-01-13,5,Thursday,4,3,0
1481499055754784769,2022-01-13 05:31:14,Wasit pada laga Tunisia vs Mali di Piala Afrika 2021 menjadi sorotan. Ada 6 keputusannya yang menjadi sorotan.  https://t.co/Ku7RDgmsK3,2,0,0,0,2022-01-13,5,Thursday,4,2,0
1481498644457172992,2022-01-13 05:29:36,Keluarga Ardhito Pramono datang ke Polres Metro Jakarta Barat usai Ardhito Pramono ditangkap terkait kasus narkoba. https://t.co/mBch7lpXIU,364,171,70,250,2022-01-13,5,Thursday,4,434,421
1481498431646580736,2022-01-13 05:28:45,"Perusahaan penasihat kewarganegaraan dan tempat tinggal global, Henley &amp; Partners, merilis studi tentang kasta paspor di dunia. Yuk, lihat daftarnya: https://t.co/2d1wHpwMhK",4,0,1,0,2022-01-13,5,Thursday,4,5,0
1481498129149140996,2022-01-13 05:27:33,"Carlo Ancelotti tak sepakat dengan Xavi yang menyebut Barcelona mendominasi Madrid di Piala Super Spanyol. Meski demikian, Ancelotti mengakui Barca main bagus.  https://t.co/dNF4KsUECb",8,0,1,0,2022-01-13,5,Thursday,4,9,0
1481497965655207938,2022-01-13 05:26:54,Pengawal mobil jenazah disergap polisi di Lamongan. Kok bisa? https://t.co/9nFu29cZRB,3,4,1,0,2022-01-13,5,Thursday,4,4,4
1481497946747285505,2022-01-13 05:26:50,"Pasien COVID-19 Wisma Atlet terus meningkat, kini total orang yang dirawat melampaui 2.200 kasus. Berikut laporan detail per hari ini: https://t.co/LG4j7waktf",3,1,8,2,2022-01-13,5,Thursday,4,11,3
1481497623844503557,2022-01-13 05:25:33,"KPK melakukan operasi tangkap tangan (OTT) di Kabupaten Penajam Paser Utara, Kalimantan Timur (Kaltim). Adalah Bupati Penajam Paser Utara Abdul Gafur Masud terkait dugaan korupsi suap dan gratifikasi. https://t.co/FNjPSqPtma",11,0,0,1,2022-01-13,5,Thursday,4,11,1
1481497064509001728,2022-01-13 05:23:19,"Manchester United kini masih tertahan di peringkat 7 klasemen Liga Inggris. Bagi Cristiano Ronaldo, posisi itu tak bisa diterimanya!  https://t.co/s8WVzBi8L9",16,10,3,2,2022-01-13,5,Thursday,4,19,12
1481497044699303936,2022-01-13 05:23:14,"Bupati Penajam Paser Utara Abdul Gafur Masud ditangkap KPK dalam operasi tangkap tangan. Selain Abdul Gafur, ada 10 orang lain yang terjaring OTT KPK. https://t.co/A83C9tW0WG",7,2,3,0,2022-01-13,5,Thursday,4,10,2
1481496848997175299,2022-01-13 05:22:28,Aksi pria tendang dan membuang sesajen di lokasi erupsi. Hingga kini pria yang sudah dilaporkan ke polisi belum juga diamankan. https://t.co/FbME9OqBNZ,1,4,2,1,2022-01-13,5,Thursday,4,3,5
1481496481471381508,2022-01-13 05:21:00,"Juventus kalah dari Inter Milan di ajang Piala Super Italia. Bek Bianconeri, Leonardo Bonucci, sempat terlibat keributan dengan staf lawan.  https://t.co/eBC6yfh1Xz",4,1,0,1,2022-01-13,5,Thursday,4,4,2
1481496242597371910,2022-01-13 05:20:03,"West Ham United berhasil menembus 4 besar klasemen Liga Inggris usai meraih kemenangan 2-0 atas Norwich City. Menurut sang Manajer, David Moyes, hasil ini menunjukkan bahwa skuadnya sudah tampil konsisten.  https://t.co/6B0NmKM9aX",3,0,0,1,2022-01-13,5,Thursday,4,3,1
1481496230664495104,2022-01-13 05:20:00,BMKG memprakirakan wilayah Jabodetabek akan mengalami puncak musim hujan pada periode Januari 2022. BMKG juga mengidentifikasi adanya sirkulasi siklonik di Samudera Hindia selatan Jawa yang dapat mempengaruhi pembentukan awan hujan di wilayah Jabodetabek. https://t.co/aRmHnR7Hx5,7,0,1,1,2022-01-13,5,Thursday,4,8,1
1481495756200632320,2022-01-13 05:18:07,Kasus Omicron terus meningkat di dunia dan Indonesia. Eks Petinggi WHO ungkap cara mengendalikan Omicron di Indonesia. https://t.co/viStHuuLMu,2,0,0,1,2022-01-13,5,Thursday,4,2,1
1481495738618109952,2022-01-13 05:18:03,"Pelatih Juventus, Massimiliano Allegri, mengatakan sepakbola diciptakan oleh setan. Kelakar Allegri ini muncul usai timnya kalah dramatis dari Inter Milan.  https://t.co/PjeYMeY2hF",4,0,0,0,2022-01-13,5,Thursday,4,4,0
1481495734755246080,2022-01-13 05:18:02,"Pertumbuhan investor kripto semakin hari terus bertambah. Sayangnya dengan pertumbuhan investor yang tinggi juga diikuti berbagai modus penipuan aset kripto, hingga investasi abal-abal kripto. Simak selengkapnya di d'Mentor: https://t.co/2crUFnfvAN",1,0,2,0,2022-01-13,5,Thursday,4,3,0
1481495506098573314,2022-01-13 05:17:08,"Hamil duluan, sebanyak 266 remaja di Ponorogo mengajukan dispensasi nikah di kantor Pengadilan Agama (PA) https://t.co/mQOrMWLkhB",343,125,112,202,2022-01-13,5,Thursday,4,455,327
1481495198597328896,2022-01-13 05:15:54,"Jerinx SID mengaku kapok bermain media sosial untuk kritik sosial, lantaran banyak orang yang memanfaatkan situasi. Jerinx akan fokuskan akun medsosnya hanya untuk pekerjaan. https://t.co/Qt4NorOrlo",15,0,2,2,2022-01-13,5,Thursday,4,17,2
1481495181933305856,2022-01-13 05:15:50,Eric Cantona mengecam perlakuan Qatar kepada para pekerja pembangunan stadion Piala Dunia 2022. King Eric berikrar tak mau menonton turnamen akbar tersebut!  https://t.co/wuAoBVZ6HT,14,4,3,0,2022-01-13,5,Thursday,4,17,4
1481494426023301121,2022-01-13 05:12:50,"Antonio Conte harus mengakui ketangguhan Thomas Tuchel, usai Tottenham Hotspur disingkirkan Chelsea dari Piala Liga Inggris. The Blues dinilai layak ke final!  https://t.co/BlQQneRum5",6,0,1,0,2022-01-13,5,Thursday,4,7,0
1481494174956412928,2022-01-13 05:11:50,Perasaan Xavi Hernandez campur aduk usai Barcelona dikalahkan Real Madrid di Piala Super Spanyol. Dia memuji penampilan Barcelona meski kalah dari Madrid.  https://t.co/A8FihxH3uk,8,2,0,0,2022-01-13,5,Thursday,4,8,2
1481493670155145217,2022-01-13 05:09:50,"Program guru penggerak angkatan 6 telah dibuka. Pada angkatan ini akan direkrut sebanyak 8000 guru. Simak ketentuannya di sini ya!

via: detikedu https://t.co/PvPlUDOxIE",9,0,0,0,2022-01-13,5,Thursday,4,9,0
1481493191312519169,2022-01-13 05:07:56,"Dirjen WHO, Tedros Adhanom Ghebreyesus mengatakan jika gejala varian baru Omicron lebih ringan dibandingkan gejala varian Delta. Namun, Omicron tetap berbahaya, terutama bagi orang yang belum divaksinasi Covid-19. https://t.co/Qu2eXHJdot",3,0,0,0,2022-01-13,5,Thursday,4,3,0
1481493172224204800,2022-01-13 05:07:51,Lukas Lucky Ngalngola alias Bruder Angelo didakwa perkara pelecehan seksual terhadap 3 anak di panti asuhan yang dikelolanya di Depok. https://t.co/Koaq4BPYd1,5,1,2,2,2022-01-13,5,Thursday,4,7,3
1481492621843435521,2022-01-13 05:05:40,Ardhito Pramono ditangkap polisi karena kasus ganja. Polisi menemukan jejak digital Ardhito Pramono transaksi narkoba. https://t.co/83IdArd1jh,7,2,1,2,2022-01-13,5,Thursday,4,8,4
1481491806994980864,2022-01-13 05:02:26,"Seiring dengan meningkatnya aktivitas investasi aset kripto. Beberapa modus kejahatan pun muncul mengintai para 'pemainnya', salah satunya penipuan aset kripto. https://t.co/Z0BudkEx1X",7,1,2,0,2022-01-13,5,Thursday,4,9,1
1481490840082165769,2022-01-13 04:58:35,Lukas Lucky Ngalngola alias Bruder Angelo didakwa perkara pelecehan seksual terhadap 3 anak di panti asuhan yang dikelolanya di Depok. https://t.co/H99q4IznPL,12,2,3,0,2022-01-13,4,Thursday,4,15,2
1481490741444907019,2022-01-13 04:58:12,"Eksklusif! Tonton Klip She's Nothing dari Zara Leola di Sini
https://t.co/bqS76vvWaA",2,0,0,0,2022-01-13,4,Thursday,4,2,0
1481490202979966976,2022-01-13 04:56:03,Real Madrid berhasil menyingkirkan Barcelona di Piala Super Spanyol dengan skor 3-2. Kemenangan ini melanjutkan tren positif El Real atas Blaugrana dalam dua tahun terakhir.  https://t.co/6FtP4h2rwT,3,0,0,0,2022-01-13,4,Thursday,4,3,0
1481490080330092544,2022-01-13 04:55:34,Di jadwal Liga 1 hari ini ada dua pertandingan yang dimainkan. Persib Bandung vs Bali United dan Arema FC vs PSS Sleman yang menjadi sajiannya.  https://t.co/AC8T2sNziv,57,1,5,0,2022-01-13,4,Thursday,4,62,1
1481489691849498624,2022-01-13 04:54:01,Menko Marves Luhut Binsar Pandjaitan memprediksi puncak kasus Omicron terjadi awal Februari. Ia pun menyebut Indonesia jauh lebih siap dalam menghadapinya. https://t.co/m7gGSBvUtc,2,5,0,1,2022-01-13,4,Thursday,4,2,6
1481489174612127747,2022-01-13 04:51:58,Nobu sempat mengalami keterpurukan akibat kasus video syur dengan Gisella Anastasia. Rupanya hal itu jadi beban hidup yang berat bagi Nobu. https://t.co/A6s6Hj0fjm,15,10,4,5,2022-01-13,4,Thursday,4,19,15
1481488639242776579,2022-01-13 04:49:50,"Ayah Li Yundi, pianis asal China, terancam di denda hingga Rp 6,3 miliar. #LiYundi  https://t.co/AJ1yn1pQGA",4,0,0,0,2022-01-13,4,Thursday,4,4,0
1481487661563064324,2022-01-13 04:45:57,Menkomarinves Luhut Binsar Pandjaitan mengatakan pemerintah akan membentuk badan layanan umum (BLU) batu bara. Berikut fakta-faktanya: https://t.co/y43Pj5Be2B,3,1,1,2,2022-01-13,4,Thursday,4,4,3
1481487317235818498,2022-01-13 04:44:35,Lukas Lucky Ngalngola alias Bruder Angelo didakwa perkara pelecehan seksual terhadap 3 anak di panti asuhan yang dikelolanya di Depok. https://t.co/ADwDye2AY3,6,1,2,3,2022-01-13,4,Thursday,4,8,4
1481487126508281856,2022-01-13 04:43:50,"Sosok Nur Chamin, menjadi viral usai beredar video ketika ia menghadiahi anak dan keluarganya 3 unit mobil mewah. Duitnya dari mana? https://t.co/IfTkH405SI",4,1,0,0,2022-01-13,4,Thursday,4,4,1
1481486774379724806,2022-01-13 04:42:26,"Nasib PT Garuda Indonesia (Persero) Tbk kurang mujur. Kabar terbaru, perusahaan dihadapkan pada masalah dugaan korupsi pengadaan pesawat. https://t.co/GVvVAwHpN5",23,2,9,2,2022-01-13,4,Thursday,4,32,4
1481485822968881156,2022-01-13 04:38:39,Taqy Malik melelang jam tangan mewah kesayangannya. Hal itu diniatkan untuk membantu pembangunan masjid di Yogyakarta. https://t.co/72gsBuf56e,10,0,0,0,2022-01-13,4,Thursday,4,10,0
1481485573395447810,2022-01-13 04:37:40,Pimpinan Komisi III DPR RI mengusir pihak Komnas Perempuan dari rapat kerja. Pihak Komnas Perempuan diusir karena datang rapat terlambat. https://t.co/dUBzBHV4sB,9,4,5,3,2022-01-13,4,Thursday,4,14,7
1481485065108566016,2022-01-13 04:35:38,"Ardhito Pramono dahulu pernah jadi pecandu. Akan tetapi, pada 2019 dia mengaku sudah 4 tahun bersih dari narkoba. #ArdhitoPramono  https://t.co/0wAtlrkwHk",7,0,0,0,2022-01-13,4,Thursday,4,7,0
1481484601646272517,2022-01-13 04:33:48,Abdul Gafur Mas'ud beserta 10 orang lainnya ditangkap KPK dan mengamankan sejumlah uang saat melakukan OTT. https://t.co/hsJ7ia7nH4,7,0,2,2,2022-01-13,4,Thursday,4,9,2
1481484077542907905,2022-01-13 04:31:43,"Ternyata ekonomi hingga pendidikan di suatu wilayah mumpuni, tidak menjamin masyarakatnya bahagia. Hal ini yang terjadi pada Provinsi-provinsi di Jawa. https://t.co/aornaVVuQp",7,0,4,0,2022-01-13,4,Thursday,4,11,0
1481483321645412354,2022-01-13 04:28:43,Gafur sempat menjadi perhatian KPK karena sempat membangun rumah dinas Rp 34 miliar. Simak lagi ceritanya: https://t.co/WhQNahwJl1,12,0,4,0,2022-01-13,4,Thursday,4,16,0
1481482815929827332,2022-01-13 04:26:42,Menko Maritim dan Investasi Luhut Binsar Pandjaitan memastikan kebijakan larangan ekspor batu bara belum dicabut. https://t.co/HQKMhZ0NiN,2,1,2,0,2022-01-13,4,Thursday,4,4,1
1481482061638733830,2022-01-13 04:23:42,"Kelompok warga Nduga dan Lanny Jaya yang terlibat bentrokan di Wamena, Papua sepakat damai hari ini. https://t.co/4Gz8Van5VB",21,0,7,2,2022-01-13,4,Thursday,4,28,2
1481481866230353920,2022-01-13 04:22:56,KPK juga mengamankan sejumlah uang saat melakukan OTT. https://t.co/kTw2Q4UfVx,13,0,2,0,2022-01-13,4,Thursday,4,15,0
1481481400763228161,2022-01-13 04:21:05,Harga emas Antam hari ini naik lagi. Jadi berapa sekarang? https://t.co/qkyyVXgUpZ,11,0,1,2,2022-01-13,4,Thursday,4,12,2
1481481178142101509,2022-01-13 04:20:12,Jokowi tampak mengenakan jaket bertema G20 dan mengendarai motor Kawasaki W175 custom. Mantap! https://t.co/9imCGJ2URo,16,7,0,0,2022-01-13,4,Thursday,4,16,7
1481481144088633348,2022-01-13 04:20:03,Tahun 2021 industri otomotif mulai bangkit. Berikut merek mobil paling laris 2021. https://t.co/SjXSCMskK1,2,0,0,0,2022-01-13,4,Thursday,4,2,0
1481480676268466177,2022-01-13 04:18:12,"Penggalangan dana untuk rumah anak mediang Bibi Ardiansyah dan Vanessa Angel, Gala Sky Andriansyah tuai polemik. Rumahnya tak jadi disita negara. https://t.co/4wQtY0SsSG",6,8,2,0,2022-01-13,4,Thursday,4,8,8
1481480646056980480,2022-01-13 04:18:05,"Kekasih Adam Deni, Elsya Rosana, jadi saksi di sidang kasus pengancaman, Rabu (12/1). Pengacara Jerinx akan laporkan Elsya karena diduga memberikan kesaksian palsu. https://t.co/NYhSycFkLa",2,0,0,0,2022-01-13,4,Thursday,4,2,0
1481479638404763653,2022-01-13 04:14:05,Pemerintah menetapkan 3 syarat kepada perusahaan yang akan mengekspor batu bara. Apa saja? https://t.co/TUV4khqnfs,2,1,2,1,2022-01-13,4,Thursday,4,4,2
1481478874219298819,2022-01-13 04:11:02,Wakil Menteri Perdagangan Jerry Sambuaga membagikan tips buat kalian yang ingin investasi kripto. Caranya begini nih. https://t.co/6M3WXW973r,9,1,1,0,2022-01-13,4,Thursday,4,10,1
1481478383028551682,2022-01-13 04:09:05,Pegokar cilik Qarrar Firhand Ali makin serius dengan keinginannya berkarier di Italia. Dia pun berangkat ke Negeri Pizza setelah mendapat restu dari IMI.  https://t.co/03YFgIek7p,5,0,0,0,2022-01-13,4,Thursday,4,5,0
1481477369789661186,2022-01-13 04:05:04,"SMA Taruna Nusantara masih membuka pendaftaran siswa baru sampai 16 Januari 2022. Simak syarat-syaratnya yuk! 

via: detikedu https://t.co/meV0sfjkZB",16,2,3,4,2022-01-13,4,Thursday,4,19,6
1481476243631620097,2022-01-13 04:00:35,Oka Antara menceritakan toleransi yang ada di keluarga besarnya nih. Salah satunya saat sang Bunda memutuskan untuk pindah agama dari Islam ke Hindu. #detiknetwork  https://t.co/H2Y5DpR2J4,29,1,4,4,2022-01-13,4,Thursday,4,33,5
1481475459141484545,2022-01-13 03:57:28,"Menurut Kemdikbud, kurikulum prototipe diperlukan sekolah sebagai salah satu opsi untuk mengatasi krisis belajar. Ini penjelasannya.

via: detikedu https://t.co/evzx8A7ShO",7,0,1,0,2022-01-13,3,Thursday,4,8,0
1481474957192355844,2022-01-13 03:55:28,"Preman yang menghadang truk tangki di Batu Bara, Sumut ditangkap. Preman itu ditangkap usai aksinya viral. https://t.co/nbqQ6Juaws",6,0,0,1,2022-01-13,3,Thursday,4,6,1
1481474955938312199,2022-01-13 03:55:28,Yamaha diprediksi akan merilis skuter matik (skutik) bongsor Yamaha XMAX 2022 terbaru. https://t.co/NNen2o7svs,7,0,0,1,2022-01-13,3,Thursday,4,7,1
1481474409189855232,2022-01-13 03:53:18,Bupati Penajam Paser Utara Abdul Gafur Mas'ud terjaring OTT KPK. Ada sejumlah kontroversi yang dibuat Abdul Gafur. Apa saja? https://t.co/PNWgfeJL7O,6,2,2,1,2022-01-13,3,Thursday,4,8,3
1481473873761685506,2022-01-13 03:51:10,"Jalan TB Simatupang, Jakarta Selatan, yang mengarah ke flyover TB Simatupang macet parah pagi ini. Simak pantauannya: https://t.co/FlOJfZHkyZ",8,2,0,2,2022-01-13,3,Thursday,4,8,4
1481473399830589441,2022-01-13 03:49:17,Sedang ramai di media sosial (medsos) sebuah video ZX-25R ramah lingkungan dan bebas pajak.  https://t.co/ZADLvAkT9H,8,0,0,0,2022-01-13,3,Thursday,4,8,0
1481472353305509888,2022-01-13 03:45:08,"Hanya karena permohonan pinjamannya ditolak oleh bank, pria ini nekat membakar kantor bank tersebut. Ini alasan pinjaman sang pria ditolak... https://t.co/Ho9f1gLKBl",12,9,5,2,2022-01-13,3,Thursday,4,17,11
1481471843148214273,2022-01-13 03:43:06,"Pertumbuhan investor kripto semakin hari terus bertambah. Sayangnya diikuti berbagai modus penipuan aset kripto, hingga investasi abal-abal kripto. https://t.co/lU3cpBptpn",0,0,1,0,2022-01-13,3,Thursday,4,1,0
1481471346098028545,2022-01-13 03:41:07,Saat ini Abdul Gafur sudah berada di Gedung Merah Putih KPK. Abdul Gafur kini masih diperiksa intensif. https://t.co/L90sVPDcMW,8,2,2,1,2022-01-13,3,Thursday,4,10,3
1481470612631654402,2022-01-13 03:38:13,"Ghozali Everyday hebohkan media sosial. Hanya bermodal foto selfie yang dijadikan NFT di OpenSea, koleksinya kini bernilai miliar rupiah. Wow! https://t.co/Fis8qaynVr",106,17,17,7,2022-01-13,3,Thursday,4,123,24
1481470585364492293,2022-01-13 03:38:06,"Hai Cancer, persiapkan diri kamu untuk selalu memperhitungkan kemungkinan terburuk. Gimana ya kata ramalan zodiak lainnya hari ini? #ZodiakHariIni https://t.co/icHZfyRRw2",3,0,1,0,2022-01-13,3,Thursday,4,4,0
1481469956021788675,2022-01-13 03:35:36,"Selain Abdul Gafur, ada 10 orang lain yang juga terjaring OTT KPK. https://t.co/D6vuTJ7wIh",7,1,1,0,2022-01-13,3,Thursday,4,8,1
1481469954516045824,2022-01-13 03:35:36,"Sering dibicarakan karena steaknya mahal, resto Salt Bae juga dikeluhkan harga kopinya senilai Rp 973 ribu. Menu ini dinilai sebagai kopi termahal di London. https://t.co/p4gju19wsx",10,0,1,0,2022-01-13,3,Thursday,4,11,0
1481469213843804165,2022-01-13 03:32:39,Kalina Oktarani akhirnya berikan pengakuan soal sudah resmi bercerai dari Vicky Prasetyo. Ia menjelaskan jika semua ini adalah kesalahannya. https://t.co/BKEGhPAyUG,36,25,8,3,2022-01-13,3,Thursday,4,44,28
1481468469816311811,2022-01-13 03:29:42,West Ham United meraih kemenangan 2-0 atas Norwich City di pekan ke-21 Liga Inggris. Hasil tersebut mengantarkan The Hammers kembali ke empat besar klasemen.  https://t.co/CBCCSHIQKo,8,0,0,0,2022-01-13,3,Thursday,4,8,0
1481467476491837443,2022-01-13 03:25:45,Ustaz Abdul Somad bicara soal pandangan Islam tentang transplantasi rambut yang dilakukan beberapa artis. Ini kata ustaz: https://t.co/ZOP1EUNLmB,12,8,3,1,2022-01-13,3,Thursday,4,15,9
1481466738646654977,2022-01-13 03:22:49,Penjualan mobil sepanjang tahun 2021 mencatatkan tren positif. https://t.co/0aAYmjh2CR,5,4,1,0,2022-01-13,3,Thursday,4,6,4
1481465741371228160,2022-01-13 03:18:51,Cuitan Ardhito Pramono yang menyindir orang pakai narkoba dan menabrak 9 orang pada 2012 jadi viral di linimasa Twitter. https://t.co/DaGnRfvuRO,10,2,4,2,2022-01-13,3,Thursday,4,14,4
1481465240160288776,2022-01-13 03:16:52,Januari baru berjalan 12 hari namun sudah ada tiga artis yang ditangkap narkoba. Ini daftarnya: https://t.co/Xn1B0EVKnz,12,3,2,1,2022-01-13,3,Thursday,4,14,4
1481464240288505858,2022-01-13 03:12:53,West Bandits Combiphar Solo tak cuma menjunjung tinggi sportivitas saat tampil di IBL 2022 ini. Mereka juga ingin ikut mengkampanyekan gaya hidup sehat.  https://t.co/YEVt5snrlp,4,0,0,0,2022-01-13,3,Thursday,4,4,0
1481463745922703360,2022-01-13 03:10:55,"Terbaru, muncul pengembang kripto lokal $VCG, token lokal yang berbasis game. Token ini laris manis saat presale pada Jumat, 7 Januari 2022 lalu. https://t.co/eCHnhLI2ip",10,1,1,1,2022-01-13,3,Thursday,4,11,2
1481462612827193345,2022-01-13 03:06:25,"Honda Thailand memperkenalkan Honda Super Cub 110 2022, motor bebek bergaya klasik ini mengusung mesin 110 cc yang iritnya kebangetan. https://t.co/jRCVVjaxy7",43,3,12,7,2022-01-13,3,Thursday,4,55,10
1481461589119324168,2022-01-13 03:02:21,Target tinggi dicanangkan Dewa United Surabaya di Indonesia Basketball League (IBL) musim 2022. Mereka ingin jadi juara!  https://t.co/MjhgwcHaeE,3,0,0,0,2022-01-13,3,Thursday,4,3,0
1481461556785385479,2022-01-13 03:02:14,"Jangan ditiru kelakuan turis ini. Akibat ulah vandalisme mereka, peninggalan kuno pun rusak selamanya. Haduh! https://t.co/RwoCZNdee6",6,0,0,0,2022-01-13,3,Thursday,4,6,0
1481460009322098690,2022-01-13 02:56:05,Yusuf Mansur kembali digugat. Tidak tanggung-tanggung. Angka gugatan yang disodorkan Rp 98 triliun! https://t.co/UaebskgxhI,455,134,86,28,2022-01-13,2,Thursday,4,541,162
1481459794288521217,2022-01-13 02:55:13,"Menunggu penerbangan pesawat memang kadang membosankan. Tapi di bandara ini, traveler bisa berenang di infinity pool. Wuih, keren! https://t.co/Oyf6IymX6l",7,0,1,0,2022-01-13,2,Thursday,4,8,0
1481459020644892673,2022-01-13 02:52:09,#Foto Sejumlah artis Korea ini tak ragu memamerkan foto tanpa make up di Instagram. Seperti apa ya penampilan alami mereka? https://t.co/USix85c36E,7,1,0,1,2022-01-13,2,Thursday,4,7,2
1481457910295240706,2022-01-13 02:47:44,Berikut ini daftar kode bank di Indonesia untuk keperluan transfer uang: https://t.co/EwWG0Ve7A8,11,1,3,1,2022-01-13,2,Thursday,4,14,2
1481456891779858433,2022-01-13 02:43:41,"Inspiratif! Berawal dari menjajakan koran di jalan, kini ia bisa memiliki bisnis fashion yang cukup sukses. Seperti apa kisahnya? https://t.co/poH4SD4vSk",13,0,3,0,2022-01-13,2,Thursday,4,16,0
1481456092446171137,2022-01-13 02:40:31,Kalina Oktarani membenarkan sudah cerai dari Vicky Prasetyo. https://t.co/vhS0XTJx79,94,81,11,20,2022-01-13,2,Thursday,4,105,101
1481455853396008962,2022-01-13 02:39:34,Berbagai publik figur mulai melirik pengembangan aset kripto. Salah satu yang terbaru adalah Anang Hermansyah dengan nama token ASIX. https://t.co/8rPloSzA9L,15,6,2,1,2022-01-13,2,Thursday,4,17,7
1481455358145093646,2022-01-13 02:37:36,Industri pelayaran semakin terombang-ambing di lautan. Beberapa perusahaan pesiar pun batal untuk berlayar karena Omicron. https://t.co/6VcT16DsQL,10,0,0,0,2022-01-13,2,Thursday,4,10,0
1481454537617588227,2022-01-13 02:34:20,Penjual makanan dan pelayan restoran ini bikin pengunjung salah fokus karena tampilan fisiknya. Mereka semua adalah pria atletis bertubuh kekar! https://t.co/BQV5YW8rVU,6,1,0,0,2022-01-13,2,Thursday,4,6,1
1481453546994388995,2022-01-13 02:30:24,"Usai pulang liburan dari Turki untuk menemui keluarga besan Gen Halilintar, Ashanty terpapar Corona untuk kedua kalinya. Begini kondisi terkini Ashanty: https://t.co/q3VujeTKFl",10,8,0,2,2022-01-13,2,Thursday,4,10,10
1481452594233061376,2022-01-13 02:26:37,Harga minyak diprediksi akan menguat tahun ini. Sejumlah analis memproyeksikan hal ini karena kapasitas produksi dan investasi tidak sama dengan tahun lalu. https://t.co/568FkCX21h,6,1,2,1,2022-01-13,2,Thursday,4,8,2
1481451286889476101,2022-01-13 02:21:25,Roy Kiyoshi mengaku jangan terlalu berlebihan dalam memperlakukan boneka kesayangan. Bahkan menjadikannya seperti makhluk hidup.  https://t.co/ardEQePSqb,19,4,3,1,2022-01-13,2,Thursday,4,22,5
1481450275017797635,2022-01-13 02:17:24,"Berikut bocoran lengkap harga dan varian Fortuner 2.8 VRZ, dengan harga termahal Rp 684 juta. https://t.co/2MvJw5rnt4",26,4,8,1,2022-01-13,2,Thursday,4,34,5
1481449779573972993,2022-01-13 02:15:26,Kabar duka datang dari penyanyi Ronnie Spector yang meninggal dunia di usia 78 tahun. https://t.co/K1G2F9oWYs,13,0,1,0,2022-01-13,2,Thursday,4,14,0
1481448723288936449,2022-01-13 02:11:14,Cristiano Ronaldo angkat suara soal kinerja Ralf Rangnick di Manchester United sejauh ini. Sang manajer interim dinilai masih butuh waktu.  https://t.co/lKm1Rg1aix,5,0,0,0,2022-01-13,2,Thursday,4,5,0
1481447450581909508,2022-01-13 02:06:10,Jakarta tengah bersiap buat Formula E. Maserati bakal mengikuti kompetisi ABB FIA Formulai E pada tahun 2023. https://t.co/SOCTsQ5kdV,8,0,0,0,2022-01-13,2,Thursday,4,8,0
1481446082538315780,2022-01-13 02:00:44,Vaksin booster adalah suntikan vaksin dosis ketiga yang diberikan untuk memperkuat antibodi dalam melawan virus corona penyebab Covid-19. Terdapat beberapa hal yang harus dipersiapkan sebelum vaksin booster. #CNNIndonesia #detiknetwork  https://t.co/MjDwHKaNn1,2,0,2,0,2022-01-13,2,Thursday,4,4,0
1481446081422630917,2022-01-13 02:00:44,Kasus pria aniaya anak tiri ini ditangani Unit Perlindungan Perempuan dan Anak (PPA) Polres Sukabumi. https://t.co/OMim64r6OC,1,1,0,0,2022-01-13,2,Thursday,4,1,1
1481445766686248962,2022-01-13 01:59:29,DPR memastikan segera menetapkan AKD yang membahas RUU TPKS. Penentuan itu dilakukan dalam rapim dan Bamus pada Kamis besok. https://t.co/nXA2i657Tv,4,0,1,0,2022-01-13,1,Thursday,4,5,0
1481445519226462208,2022-01-13 01:58:30,Pemerintah memprediksi puncak gelombang kasus Omicron terjadi Februari. Pimpinan Komisi IX menilai kampanye hidup sehat dan peningkatan imunitas perlu dilakukan https://t.co/IUKSKF5qnJ,4,0,1,0,2022-01-13,1,Thursday,4,5,0
1481445498200510464,2022-01-13 01:58:25,Warna seragam satpam akan diubah dari cokelat muda menjadi krem karena dinilai terlalu mirip polisi. Kompolnas setuju soal pergantian warna seragam satpam itu. https://t.co/IqR9Lf9Dxr,31,21,4,11,2022-01-13,1,Thursday,4,35,32
1481445240477298694,2022-01-13 01:57:23,"Wakil Ketua PAC PDIP Temanggung, Fajar Nugroho, mengembalikan bantuan dari Gubernur Jawa Tengah Ganjar Pranowo. Dia kesal bantuan itu dipakai pencitraan. https://t.co/MmyRA7SsfH",147,14,24,5,2022-01-13,1,Thursday,4,171,19
1481444989964107785,2022-01-13 01:56:24,Pakar IDI Zubairi Djoerban mendorong pemerintah serius menangani varian Omicron di Indonesia. Penanganan di awal lebih baik daripada kelabakan. https://t.co/0Dyh9CORYk,4,0,0,0,2022-01-13,1,Thursday,4,4,0
1481444967608377350,2022-01-13 01:56:18,"Tikus bernama Magawa ini mampu memeriksa lapangan hanya dalam 20 menit, sementara manusia dengan detektor baru bisa melakukannya dalam sehari hingga empat hari. https://t.co/qUelNDXvPt",43,1,11,3,2022-01-13,1,Thursday,4,54,4
1481444667480756224,2022-01-13 01:55:07,Panglima TNI Jenderal Andika Perkasa merespons soal kekosongan jabatan Pangkostrad. https://t.co/vHdLQA1t7e,8,0,3,0,2022-01-13,1,Thursday,4,11,0
1481444656512655363,2022-01-13 01:55:04,Aksi pencurian motor di SPBU Probolinggo terekam kamera CCTV. Pelaku diduga merupakan sepasang kekasih. https://t.co/P3UiQohim9,1,0,1,1,2022-01-13,1,Thursday,4,2,1
1481444404141379588,2022-01-13 01:54:04,Presiden Kazakhstan mengatakan bahwa kontingen pasukan pimpinan Rusia segera meninggalkan negara Asia Tengah tersebut. Misi telah selesai. https://t.co/MAx4uXJyT3,3,1,0,0,2022-01-13,1,Thursday,4,3,1
1481444385120210944,2022-01-13 01:53:59,"Jerinx 'SID' menjalani sidang kasus pengancaman terhadap Adam Deni. Dalam sidang itu, jaksa memutar rekaman telepon antara Jerinx dengan Adam Deni. https://t.co/K72LV0rji9",1,0,1,0,2022-01-13,1,Thursday,4,2,0
1481444361137229824,2022-01-13 01:53:54,"Sebanyak 150 rumah warga di Rangkasbitung, Kabupaten Lebak, Banten, terendam banjir akibat hujan deras. Rumah itu tersebar di dua kecamatan. https://t.co/g74xA7kPMM",0,0,0,0,2022-01-13,1,Thursday,4,0,0
1481444132342190086,2022-01-13 01:52:59,"Ada beberapa orang yang bisa menghadapi risiko tinggi jika terkena varian Omicron, mengalami sakit parah, dan bahkan bisa meninggal dunia. https://t.co/20v6xZsBtS",7,0,3,1,2022-01-13,1,Thursday,4,10,1
1481444111194406912,2022-01-13 01:52:54,Seorang balita diduga menjadi korban penganiayaan ayah tirinya di Kota Sukabumi. Video penangkapan pria berusia 25 tahun itu viral di media sosial. https://t.co/kTvzhdhYGQ,5,0,2,0,2022-01-13,1,Thursday,4,7,0
1481443866473635845,2022-01-13 01:51:56,"Sebanyak 266 remaja di Ponorogo mengajukan dispensasi nikah di kantor Pengadilan Agama (PA). Penyebabnya, karena sudah hamil duluan. https://t.co/WzdCmiYHoQ",13,3,7,8,2022-01-13,1,Thursday,4,20,11
1481443850019389440,2022-01-13 01:51:52,Panglima TNI Jenderal Andika Perkasa menyatakan perpindahan 2 skuadron ke Lanud Husein Sastranegara imbas revitalisasi Bandara Halim perlu ekstra energi. https://t.co/0PCTZRICHT,1,0,0,0,2022-01-13,1,Thursday,4,1,0
1481443663519625216,2022-01-13 01:51:07,Puncak gelombang kasus Omicron diprediksi terjadi pada awal Februari. Epidemiolog menyebut potensi adanya gelombang ketiga sulit dihindari. https://t.co/jF5wcc0rDf,7,5,0,0,2022-01-13,1,Thursday,4,7,5
1481443643621883904,2022-01-13 01:51:03,"Menurut lembaga THE WUR, terdapat 10 kampus Indonesia yang dikategorikan terbaik dalam bidang ekonomi dan bisnis. Kampus mana saja ya itu?

via: detikedu https://t.co/KAoQ3MTir0",4,0,0,1,2022-01-13,1,Thursday,4,4,1
1481443246278688768,2022-01-13 01:49:28,Piala Afrika 2021 berlangsung di tengah ancaman bersenjata. Kelompok separatis Kamerun menyerbu kota penyelenggara turnamen akbar di Benua Hitam.  https://t.co/VSRhmYHpEv,11,1,1,0,2022-01-13,1,Thursday,4,12,1
1481443231263080452,2022-01-13 01:49:24,Juergen Klopp bicara soal situasi kontrak Mohamed Salah di Liverpool. Apa katanya?  https://t.co/ty1GAJGQn3,7,0,0,1,2022-01-13,1,Thursday,4,7,1
1481441795837935623,2022-01-13 01:43:42,"Bupati Penajam Paser Utara Abdul Gafur Mas'ud terjaring operasi tangkap tangan (OTT) KPK. Abdul Gafur tercatat punya harta Rp 36,7 miliar. https://t.co/xW3HkMDHE1",104,34,33,33,2022-01-13,1,Thursday,4,137,67
1481440277827043331,2022-01-13 01:37:40,Presiden Jokowi bersama Iriana Joko Widodo bertolak menuju NTT. Jokowi diagendakan meninjau sejumlah fasilitas bandara untuk MotoGP 2022 hingga kawasan UMKM. https://t.co/77w5evFDzy,8,3,1,1,2022-01-13,1,Thursday,4,9,4
1481439760514224133,2022-01-13 01:35:37,Inter Milan berhasil menjuarai Piala Super Italia usai menumbangkan Juventus dengan skor 2-1. Gol kemenangan Inter dicetak Alexis Sanchez di ujung laga.  https://t.co/2pFLYgRXUE,5,0,0,1,2022-01-13,1,Thursday,4,5,1
1481439743112011786,2022-01-13 01:35:33,Tujuh pemain yang tampil di turnamen India Open 2022 dilaporkan positif COVID-19. Mereka dipastikan tak bisa tampil dan langsung dinyatakan gugur.  https://t.co/WW6LQRQxFY,3,1,0,0,2022-01-13,1,Thursday,4,3,1
1481439481316229120,2022-01-13 01:34:30,"Hubungan Andrea Agnelli dengan ultras Juventus belum berakhir. Teranyar, suporter garis keras Bianconeri itu membuat spanduk yang berharap pria 46 itu cepat mati.  https://t.co/po478oB5yc",0,2,1,0,2022-01-13,1,Thursday,4,1,2
1481438977618030592,2022-01-13 01:32:30,Tujuh pemain yang tampil di turnamen India Open 2022 dilaporkan positif COVID-19. Mereka dipastikan tak bisa tampil dan langsung dinyatakan gugur. https://t.co/WWBl8xpUGR,5,0,1,0,2022-01-13,1,Thursday,4,6,0
1481438633416704000,2022-01-13 01:31:08,Inter Milan berhasil memenangi Piala Super Italia 2021. Nerazzurri menundukkan Juventus 2-1 lewat perpanjangan waktu.   https://t.co/Bvk6MMBDq4,3,0,0,0,2022-01-13,1,Thursday,4,3,0
1481438611971219460,2022-01-13 01:31:03,KPK melakukan operasi tangkap tangan (OTT) terhadap Bupati Penajam Paser Utara Abdul Gafur Mas'ud. OTT tersebut terkait dugaan suap. https://t.co/7M0wAKWguc,13,3,3,5,2022-01-13,1,Thursday,4,16,8
1481437626355929089,2022-01-13 01:27:08,"Chelsea mengalahkan tuan rumah Tottenham Hotspur 1-0 di semifinal Piala Liga Inggris leg kedua. Unggul agregat 3-0, The Blues melaju ke final.  https://t.co/9VKIMoC0TQ",8,1,0,0,2022-01-13,1,Thursday,4,8,1
1481437509032857601,2022-01-13 01:26:40,"Ada momen kocak di Piala Afrika 2021yakni saat panitia salah memutar lagu kebangsaan sampai dua kali, dan akhirnya meminta pemain bernyanyi sendiri.  https://t.co/gKOpqSkDMY",4,1,2,0,2022-01-13,1,Thursday,4,6,1
1481436822177988613,2022-01-13 01:23:56,"KPK melakukan operasi tangkap tangan di Penajam Paser Utara, Kalimantan Timur (Kaltim). KPK mengamankan Bupati Penajam Paser Utara Abdul Gafur Mas'ud. https://t.co/IIK5jSb2yC",20,8,7,5,2022-01-13,1,Thursday,4,27,13
1481436584922824709,2022-01-13 01:23:00,"Cristiano Ronaldo dan Lionel Messi masih bersinar di usia yang tidak lagi muda. Juergen Klopp meyakini, Mohamed Salah bisa selanggeng dua megabintang itu.  https://t.co/BV6ftU0yFq",10,1,0,0,2022-01-13,1,Thursday,4,10,1
1481436088073924615,2022-01-13 01:21:01,Chelsea bisa melaju ke final Piala Liga Inggris 2021/2022 setelah The Blues sukses menyingkirkan Tottenham Hotspur di semifinal. https://t.co/ldAQYoce1J,4,0,0,0,2022-01-13,1,Thursday,4,4,0
1481435511382286338,2022-01-13 01:18:44,Pemerintah pusat telah mencabut izin usaha empat perusahaan di bidang perkebunan dan kehutanan di Sulawesi Tengah (Sulteng). https://t.co/wHd6k1kMwx,5,0,1,0,2022-01-13,1,Thursday,4,6,0
1481434860602417153,2022-01-13 01:16:09,"Aksi tak biasa dilakukan striker Lincoln City, Chris Maguire. Ia merayakan gol tepat di depan muka mantan pelatihnya di Sunderland, Lee Johnson.  https://t.co/DZNdp1wWTV",2,0,0,0,2022-01-13,1,Thursday,4,2,0
1481434102721138688,2022-01-13 01:13:08,"KPK kembali melakukan operasi tangkap tangan (OTT). Kali ini, OTT dilakukan di Penajam Paser Utara, Kalimantan Timur (Kaltim) https://t.co/nsn50HqhF9",7,3,3,0,2022-01-13,1,Thursday,4,10,3
1481433614822879237,2022-01-13 01:11:12,Laga Piala Afrika 2022 antara Tunisia vs Mali diwarnai kekeliruan wasit. Pengadil lapangan dua kali meniup pluit akhir pertandingan sebelum waktunya. Duh!  https://t.co/bnTxDtt3OI,3,3,0,0,2022-01-13,1,Thursday,4,3,3
1481432607464300556,2022-01-13 01:07:11,Ardhito Pramono ditangkap polisi karena terjerat kasus narkoba. Ardhito Pramono diciduk di rumahya dengan barang bukti sabu. https://t.co/vT4BVIDw3x,20,16,4,7,2022-01-13,1,Thursday,4,24,23
1481432372520402945,2022-01-13 01:06:15,Sejumlah pebulutangkis unggulan bertumbangan di ajang Seleksi Nasional 2022. Mereka menyerah dari pebulutangkis peringkat rendah.  https://t.co/zPjeuP5wY3,10,0,0,0,2022-01-13,1,Thursday,4,10,0
1481431875801526272,2022-01-13 01:04:17,Inter Milan berhasil memenangi Piala Super Italia 2021. Nerazzurri menundukkan Juventus 2-1 lewat perpanjangan waktu.  https://t.co/AZ6r2gccnu,5,0,1,0,2022-01-13,1,Thursday,4,6,0
1481431017122676738,2022-01-13 01:00:52,Polemik Novak Djokovic memasuki babak baru. Petenis Serbia itu baru saja mengakui kalau dia positif COVID-19 saat melakukan wawancara bulan lalu.  https://t.co/2pnDpHDeDX,5,0,0,1,2022-01-13,1,Thursday,4,5,1
1481430839078625284,2022-01-13 01:00:10,Pemerintah memperkirakan puncak gelombang kasus akibat Omicron akan terjadi awal Februari. Luhut pun mengungkapkan penyebab lonjakan kasus Omicron tersebut. https://t.co/5gxeY8hPN9,6,3,1,0,2022-01-13,1,Thursday,4,7,3
1481430819575107589,2022-01-13 01:00:05,Pemerintah melaporkan kasus harian positif Corona sebanyak 646 kasus. Provinsi yang melaporkan kasus tertinggi dalam 24 jam terakhir adalah DKI Jakarta. https://t.co/ebuJFNs8hm,3,0,1,0,2022-01-13,1,Thursday,4,4,0
1481430571456860161,2022-01-13 00:59:06,Sejumlah peristiwa terjadi di Jabar hari ini. Mulai dugaan aksi perpeloncoan yang dialami 3 siswa Ciamis dan ratusan ulama siap jadi penjamin Habib Bahar. https://t.co/vvwvhilnKO,6,3,0,0,2022-01-13,0,Thursday,4,6,3
1481430251829964801,2022-01-13 00:57:50,Piala Afrika 2021 berlangsung di tengah ancaman bersenjata. Kelompok separatis Kamerun menyerbu kota penyelenggara turnamen akbar di Benua Hitam. https://t.co/TAhXWaek9J,6,1,1,0,2022-01-13,0,Thursday,4,7,1
1481429995142668290,2022-01-13 00:56:49,Kasus akun Pemkot Depok meretweet unggahan soal cari keluarga polisi penembak FPI berbuntut panjang. Babak baru muncul setelah akun tersebut disebut dibajak. https://t.co/BQowAqtGjE,6,6,1,1,2022-01-13,0,Thursday,4,7,7
1481429513229774849,2022-01-13 00:54:54,Vaksin booster untuk siapa saja mulai dicari tahu. Ini syarat vaksin yang ditetapkan pemerintah. https://t.co/8COOjccIAT,3,0,3,1,2022-01-13,0,Thursday,4,6,1
1481429175668031491,2022-01-13 00:53:33,"Pengusaha asal Indonesia, Anindya Bakrie, punya misi besar dengan klub Inggris Oxford United FC. Anindya dan para petinggi klub ingin membangun stadion baru. https://t.co/RBXfiMbFiB",14,2,3,0,2022-01-13,0,Thursday,4,17,2
1481428686016499712,2022-01-13 00:51:37,"WHO kembali menyampaikan kabar nggak enak soal varian Omicron. Meski gejalanya lebih ringan dibanding Delta, Omicron tetap jadi ancaman bagi kelompok tertentu. https://t.co/o7mg4vhTu1",5,0,2,2,2022-01-13,0,Thursday,4,7,2
1481428454784520196,2022-01-13 00:50:41,Bukan rahasia lagi bahwa Massimiliano Allegri menolak Real Madrid demi kembali ke Juventus. Allegri rupanya sudah sangat dekat dari kursi pelatih Madrid. https://t.co/NVXwF0ZsVg,3,0,1,0,2022-01-13,0,Thursday,4,4,0
1481428434958098434,2022-01-13 00:50:37,Puncak gelombang kasus Omicron diprediksi terjadi pada awal Februari. Epidemiolog menyebut potensi adanya gelombang ketiga sulit dihindari. https://t.co/KqkNoFC7jO,4,4,2,3,2022-01-13,0,Thursday,4,6,7
1481427345227632641,2022-01-13 00:46:17,Hujan deras yang mengguyur Tangsel tadi malam memicu longsor. Material longsor menimbun dua motor milik warga dan menutup akses jalan. https://t.co/dtUkMSzk5S,5,2,2,0,2022-01-13,0,Thursday,4,7,2
1481426875658477576,2022-01-13 00:44:25,"Terawan menerima gelar Profesor Kehormatan dari Universitas Pertahanan. Dalam pidatonya, Terawan bicara membanggakan Vaksin Nusantara. https://t.co/2KzcExPmUn",21,3,3,1,2022-01-13,0,Thursday,4,24,4
1481426858696654849,2022-01-13 00:44:21,Seorang bocah SD di Bekasi jadi korban bullying sejumlah anak SMP. Alasannya diduga karena korban lebih jago bermain bola. https://t.co/idlHU77mk0,15,4,5,4,2022-01-13,0,Thursday,4,20,8
1481426341165780994,2022-01-13 00:42:17,"Lagi-lagi, Korea Utara menguji coba alat utama sistem persenjataan bikinan mereka sendiri. Lagi-lagi pula, aktivitas Korut bikin Paman Sam terganggu. https://t.co/Jfo6h4XOg6",8,1,0,0,2022-01-13,0,Thursday,4,8,1
1481426323906117633,2022-01-13 00:42:13,"Begini cara daftar booster COVID-19 bagi yang tidak punya e-tiket PeduliLindungi. Simak, biar nggak sampai salah ya! https://t.co/sFxBwrGWOD",6,0,7,0,2022-01-13,0,Thursday,4,13,0
1481425023315361794,2022-01-13 00:37:03,"Sulistyawati disekap di dalam kamar oleh perempuan inisial F. Wanita asal Tangerang, Banten ini disekap lantaran tidak bisa melunasi utang Rp 1,6 juta. https://t.co/Vvg1gtvnbW",4,0,0,0,2022-01-13,0,Thursday,4,4,0
1481424547454795777,2022-01-13 00:35:10,"2 kereta mengalami insiden tabrakan di Liberia. Imbas insiden tersebut, 2 orang yang merupakan karyawan tewas serta 4 orang lainnya luka-luka. https://t.co/mxnBe5fOEI",3,0,0,0,2022-01-13,0,Thursday,4,3,0
1481424054510927876,2022-01-13 00:33:12,Adam Deni Gearaka menyebut fans band Superman Is Died (SID) yang dikenal dengan sebutan Outsiders barbar. Hal itu disampaikan oleh Adam Deni di persidangan. https://t.co/GlCpv1fnbE,6,2,0,2,2022-01-13,0,Thursday,4,6,4
1481423556433088516,2022-01-13 00:31:14,"Komedian lawas Bob Saget ditemukan meninggal di usia 65 tahun. Penyebab pasti belum terungkap, tetapi petunjuk ini mengarah pada dugaan serangan jantung. https://t.co/r2gaw8ZDGS",8,0,0,0,2022-01-13,0,Thursday,4,8,0
1481423310709825544,2022-01-13 00:30:15,Juergen Klopp bicara soal situasi kontrak Mohamed Salah di Liverpool. Apa katanya? https://t.co/lVZjpuYaR9,8,1,0,0,2022-01-13,0,Thursday,4,8,1
1481422885352792078,2022-01-13 00:28:34,Seorang driver ojol yang kehilangan motornya dicueki saat melapor ke polisi di Bogor. Kompolnas menilai anggota SPKT perlu diajari bersikap ramah dan berempati. https://t.co/QNKKLG6IuA,110,28,28,6,2022-01-13,0,Thursday,4,138,34
1481422481978187781,2022-01-13 00:26:57,"Seorang remaja berinisial MR di Depok, Jawa Barat, terlibat aksi tawuran hingga mengalami luka bacok di bagian tangan dan perut. https://t.co/S2OVUnpuiQ",6,0,0,0,2022-01-13,0,Thursday,4,6,0
1481420965531856896,2022-01-13 00:20:56,"Seorang wanita di Kota Bekasi, Jawa Barat, diduga menjadi korban pembunuhan. Teka-teki pembunuhan itu tengah diusut polisi. https://t.co/PqfSrt1BGA",6,0,1,0,2022-01-13,0,Thursday,4,7,0
1481420942660222981,2022-01-13 00:20:50,"Banjir kembali terjadi di Penajam Paser Utara, Kalimantan Timur (Kaltim). Banjir merendam setidaknya merendam permukiman di dua kecamatan. https://t.co/X6xDyzMulA",23,5,4,1,2022-01-13,0,Thursday,4,27,6
1481420729669275653,2022-01-13 00:20:00,"Tikus bernama Magawa ini mampu memeriksa lapangan hanya dalam 20 menit, sementara manusia dengan detektor baru bisa melakukannya dalam sehari hingga empat hari. https://t.co/1XGYc6jR67",18,0,0,0,2022-01-13,0,Thursday,4,18,0
1481420248087678979,2022-01-13 00:18:05,"Kabar datang dari jagat Bollywood. Kediaman salah satu bintangnya, Shah Rukh Khan, mengalami teror bom. Waduh...  https://t.co/slcbAYDn0Q",15,1,3,1,2022-01-13,0,Thursday,4,18,2
1481419532057165825,2022-01-13 00:15:14,"Di tengah gegap gempita penayangan film tersebut, novelis di balik serial Dear Nathan, Erisca Febriani sedang menulis novel lainnya berjudul Galileo Club. https://t.co/ShcvVCI5zL",5,0,0,0,2022-01-13,0,Thursday,4,5,0
1481419021052518403,2022-01-13 00:13:12,"Polri bakal mengganti warna seragam Satpam dari cokelat muda menjadi warna krem. Alasannya, warna seragam satpam saat ini terlalu mirip dengan seragam polisi https://t.co/SXftw9FX5n",83,106,21,41,2022-01-13,0,Thursday,4,104,147
1481418537814175746,2022-01-13 00:11:17,"Jelang penayangannya film Scream, detikcom berkesempatan berbincang dengan tiga pemeran utamanya. Simak obrolan dengan pemain OG Scream di sini: #Scream  https://t.co/YuH4iYT18w",6,1,0,1,2022-01-13,0,Thursday,4,6,2
1481417748441882627,2022-01-13 00:08:09,Masa operasi Satgas Nemangkawi yang biasa memburu anggota teroris KKB akan digantikan oleh Operasi Damai Cartenz. Operasi itu akan membina orang asli Papua. https://t.co/mA4ai6aeBo,12,3,1,0,2022-01-13,0,Thursday,4,13,3
1481416717347831810,2022-01-13 00:04:03,"Roy Kiyoshi berkomentar soal ramainya spirit doll. Menurut Roy, dirinya bukan tipe yang mengorangkan boneka. https://t.co/WvUP5kme22",6,0,0,0,2022-01-13,0,Thursday,4,6,0
1481416289251999744,2022-01-13 00:02:21,Charly sempat tidak dilayani dengan baik saat hendak lapor kehilangan motor di Polsek Cileungsi. https://t.co/4AL8aMJn34,38,13,11,1,2022-01-13,0,Thursday,4,49,14
1481415298485997569,2022-01-12 23:58:25,Warga Temanggung itu mengembalikan bantuan dari Ganjar Pranowo karena emoh dijadikan bahan pencitraan https://t.co/r7HolERMKz,51,25,9,4,2022-01-12,23,Wednesday,3,60,29
1481414793026277382,2022-01-12 23:56:24,"Pelaku membunuh korbannya yang masih bocah itu dengan cara sadis, hanya demi menguasai ponsel korban. https://t.co/iCimiEO06O",8,1,0,2,2022-01-12,23,Wednesday,3,8,3
1481414016723525635,2022-01-12 23:53:19,"Pelaku pembunuhan bocah 9 tahun di Desa Wanaraja, Kecamatan Wanayasa, Banjarnegara merupakan sepupu korban. Begini kesehariannya. https://t.co/fC9cmIiN79",5,1,0,1,2022-01-12,23,Wednesday,3,5,2
1481413493844852739,2022-01-12 23:51:14,"Pertemuan Menteri Pertahanan Prabowo Subianto dengan para senior TNI, seperti Hendropriyono hingga Agum Gumelar, berlangsung hangat. https://t.co/5N8IuWXISf",19,8,3,1,2022-01-12,23,Wednesday,3,22,9
1481412718846427136,2022-01-12 23:48:10,PM Inggris Boris Johnson mengakui dirinya menghadiri bahkan menggelar pesta pada tahun 2020. Johnson mengakui kesalahannya dan meminta maaf. https://t.co/riYZ0bqp9H,6,0,3,1,2022-01-12,23,Wednesday,3,9,1
1481412432019005440,2022-01-12 23:47:01,"Vaksinasi booster COVID-19 sudah dimulai. Karena menyasar prioritas lansia, kapan usia 18 tahun ke atas boleh disuntik vaksin booster? Begini kata Kemenkes. https://t.co/nWueaRt6jC",3,1,1,0,2022-01-12,23,Wednesday,3,4,1
1481411104597475328,2022-01-12 23:41:45,Sebuah panti pijat refleksi yang diduga menjadi lokasi prostitusi membuat gempar usai digerebek warga. Terapis dalam keadaan bugil turut diamankan warga. https://t.co/xdUshpv3As,15,3,0,0,2022-01-12,23,Wednesday,3,15,3
1481410620104839171,2022-01-12 23:39:49,Hakim mencecar Adam Deni karena mengaku ketakutan saat ditelepon I Gede Aryastina alias Jerinx 'SID'. Seperti apa? https://t.co/8CdRpkPW8E,9,0,1,0,2022-01-12,23,Wednesday,3,10,0
1481409616684720132,2022-01-12 23:35:50,"Dua bulan sudah kursi Pangkostrad kosong. Nama-nama potensial muncul, salah satunya adalah menantu Luhut. Ada pula nama-nama lain. Siapa paling potensial? https://t.co/cot7pArLrE",7,6,1,0,2022-01-12,23,Wednesday,3,8,6
1481408239447285764,2022-01-12 23:30:22,"AKP Stepanus Robin Pattuju, dinyatakan bersalah bersalah menerima suap dari sejumlah orang yang totalnya Rp 11,538 miliar. Dia pun divonis 11 tahun penjara. https://t.co/t0RJHJR2Ct",9,4,0,1,2022-01-12,23,Wednesday,3,9,5
1481407696490438657,2022-01-12 23:28:12,Inter Milan berhasil memenangi Piala Super Italia 2021. Nerazzurri menundukkan Juventus 2-1 lewat perpanjangan waktu. https://t.co/a6qlYE53N9,14,0,0,1,2022-01-12,23,Wednesday,3,14,1
1481407208512528387,2022-01-12 23:26:16,"Panglima TNI Jenderal Andika Perkasa angkat bicara soal pengangkatan Mayjen TNI Untung sebagai Pangdam Jaya. Masalahnya, Mayjen Untung merupakan eks Tim Mawar. https://t.co/mf4jp1emH5",9,1,4,0,2022-01-12,23,Wednesday,3,13,1
1481406206967173126,2022-01-12 23:22:17,"Vaksinasi booster COVID-19 dimulai hari ini menyasar prioritas lansia. Jika belum punya e-ticket di PeduliLindungi, tetap bisakah disuntik booster di Puskesmas? https://t.co/EXaNghmebo",8,1,1,1,2022-01-12,23,Wednesday,3,9,2
1481405415510450184,2022-01-12 23:19:08,Bek veteran Spanyol Sergio Ramos begitu 'bermasalah' di Paris St. Germain. Ternyata Ramos bukanlah bek tengah incaran utama PSG di musim panas lalu. https://t.co/RdZQrDaOox,10,0,1,0,2022-01-12,23,Wednesday,3,11,0
1481404381216096258,2022-01-12 23:15:02,Nama Gubernur Khofifah masuk sebagai salah satu Ketua Bidang di PBNU. Bagaimana respons Khofifah? https://t.co/pePIxgtWHW,8,0,0,0,2022-01-12,23,Wednesday,3,8,0
1481403073343930368,2022-01-12 23:09:50,"E-ticket vaksin booster COVID-19 bisa diperoleh di PeduliLindungi, lengkap dengan jadwal dan lokasinya. Begini cara mengeceknya. https://t.co/YWTa9s98Ty",15,1,5,0,2022-01-12,23,Wednesday,3,20,1
1481402611681091589,2022-01-12 23:08:00,DPRD DKI Jakarta akan memanggil Pasar Jaya soal pembangunan Pasar Inpres Pasar Minggu setelah terbakar. Komisi B ingin mengetahui proses pembangunan tersebut. https://t.co/XTIXQetWrV,5,0,0,0,2022-01-12,23,Wednesday,3,5,0
1481401574886883328,2022-01-12 23:03:53,"Ada banyak kekhawatiran di antara para orang tua yang menemani anaknya vaksin, salah satunya, apakah setelah vaksin boleh minum es? Simak di sini:  https://t.co/R47GpQ96V7",3,1,1,0,2022-01-12,23,Wednesday,3,4,1
1481400927139598338,2022-01-12 23:01:18,"Tidur telanjang mungkin asing bagi sebagian orang, namun hal ini bisa membantu meningkatkan kualitas kesehatan tubuh, mental, hingga seks lho. https://t.co/wFSjRCh01H",35,4,10,3,2022-01-12,23,Wednesday,3,45,7
1481400907929640961,2022-01-12 23:01:14,Jaksa memutar rekaman percakapan telepon antara Adam Deni dan I Gede Aryastina alias Jerinx 'SID'. Seperti apa isinya? https://t.co/hqnf34yMTN,3,1,2,0,2022-01-12,23,Wednesday,3,5,1
1481398945578459138,2022-01-12 22:53:26,"Elektabilitas Dedi Mulyadi menyalip Ketum Golkar Airlangga Hartarto versi survei Indikator Politik Indonesia, ini kata pakar politik Unwir https://t.co/ZkYaX1nIz0",28,21,10,9,2022-01-12,22,Wednesday,3,38,30
1481397922122055681,2022-01-12 22:49:22,"Otoritas Prancis memerintahkan penutupan sebuah masjid di Cannes, French Riviera, terkait dengan pernyataan anti-semitisme yang disampaikan di masjid itu. https://t.co/y4Pyvve7Om",16,6,7,1,2022-01-12,22,Wednesday,3,23,7
1481396921776459788,2022-01-12 22:45:23,Ketum PBNU KH Yahya Cholil Staquf resmi menunjuk Saifullah Yusuf sebagai Sekjen Periode 2022-2027. Saat ini Gus Ipul menjabat periode 2021-2024. https://t.co/WBJB9jHruD,7,1,1,0,2022-01-12,22,Wednesday,3,8,1
1481396165325299717,2022-01-12 22:42:23,Polisi ungkap motif pelaku pembunuhan sadis bocah 9 tahun di Banjarnegara adalah ingin kuasai ponsel korban. Pelaku kecanduan game online dan ponselnya rusak. https://t.co/Ifu67NlkUd,12,3,2,0,2022-01-12,22,Wednesday,3,14,3
1481395303769120774,2022-01-12 22:38:58,Final Piala Super Italia 2021 antara Inter Milan vs Juventus berakhir 1-1 setelah 90 menit. Laga dilanjutkan ke fase perpanjangan waktu. https://t.co/uk36GtbkLG,6,1,0,0,2022-01-12,22,Wednesday,3,6,1
1481395065708851206,2022-01-12 22:38:01,"Komnas HAM tidak setuju dengan tuntutan hukuman mati yang dijatuhkan kepada Herry Wirawan, terdakwa kasus pemerkosaan 13 santri di Bandung, Jawa Barat. https://t.co/Srsw60VEQz",515,941,92,370,2022-01-12,22,Wednesday,3,607,1311
1481393565708263431,2022-01-12 22:32:03,Chelsea bisa melaju ke final Piala Liga Inggris 2021/2022. Itu setelah The Blues sukses menyingkirkan Tottenham Hotspur di semifinal. https://t.co/klvVPGJNgd,6,0,0,0,2022-01-12,22,Wednesday,3,6,0
1481392975666192386,2022-01-12 22:29:43,Geng Kapak (GPX) bersama detikcom menggelar Esports Talent Hunt (ETH) 2022. Ayo ikutan!  https://t.co/DmosrBTcuE,7,0,1,0,2022-01-12,22,Wednesday,3,8,0
1481392171899043842,2022-01-12 22:26:31,Courteney Cox memerankan Gale Weathers Scream (1996) dan film-film sekuelnya. Main di proyek film seram tak membuatnya kehilangan kenikmatan nonton horor. https://t.co/ZUmuInLrVg,5,0,0,0,2022-01-12,22,Wednesday,3,5,0
1481391119397179392,2022-01-12 22:22:20,Polri mengatakan warna seragam satpam yang mirip dengan polisi kerap membuat masyarakat kebingungan. https://t.co/m6tHdD6NAU,79,66,15,23,2022-01-12,22,Wednesday,3,94,89
1481390036503441413,2022-01-12 22:18:02,Pelaku yang kecanduan game online itu ingin memiliki ponsel korban. Rencana pembunuhan pun disusun. https://t.co/uXiVwrQ5ui,6,0,0,1,2022-01-12,22,Wednesday,3,6,1
1481389015613980674,2022-01-12 22:13:58,"Weight training atau latihan beban memiliki banyak manfaat yang baik bagi kesehatan tubuh. Selain memperkuat otot, juga efektif melatih jantung. https://t.co/DASQJQiPzN",5,0,0,0,2022-01-12,22,Wednesday,3,5,0
1481387858497875977,2022-01-12 22:09:22,Film Mass jadi suguhan yang menarik bagi para pecinta genre drama keluarga. Ada emosi yang kuat yang dihadirkan para pemainnya. https://t.co/qrGKnFi9uy,3,0,0,0,2022-01-12,22,Wednesday,3,3,0
1481387056454582272,2022-01-12 22:06:11,Artis Ita Rahma ngaku pernah ditawari narkoba. Ia pun ngeri dan mending minum sampai tepar. https://t.co/SQbxbc05Sg,15,0,0,7,2022-01-12,22,Wednesday,3,15,7
1481385754446254080,2022-01-12 22:01:01,Ketum PBNU Gus Yahya Staquf telah mengumumkan daftar pengurus PBNU periode 2022-2027. Ada sederet kejutan yang mewarnai kepengurusan baru ini. https://t.co/lO5xaWxuJK,8,0,0,0,2022-01-12,22,Wednesday,3,8,0
1481384745648939011,2022-01-12 21:57:00,Pakar WHO menyebut vaksin booster COVID-19 asli bukan strategi yang tepat untuk melawan varian yang muncul seperti Omicron. Mereka menyarankan ada vaksin baru. https://t.co/bhgr9ACTal,6,5,1,4,2022-01-12,21,Wednesday,3,7,9
1481383821211799569,2022-01-12 21:53:20,"Menteri Perdagangan Muhammad Lutfi mengungkapkan akan ada 1,2 miliar liter minyak goreng dengan harga Rp 14 ribu per liter yang akan disebar ke masyarakat. https://t.co/rVP9bNQ0BM",14,8,1,3,2022-01-12,21,Wednesday,3,15,11
1481381611589492741,2022-01-12 21:44:33,Barcelona dan Real Madrid tampil sengit dan imbang 2-2 dalam 2x45 menit laga Piala Super Spanyol. Duel El Clasico lanjut ke babak tambahan. https://t.co/934sxmUo13,8,0,0,0,2022-01-12,21,Wednesday,3,8,0
1481381593268817921,2022-01-12 21:44:29,"BMKG) mengeluarkan prakiraan cuaca untuk wilayah DKI Jakarta. BMKG memprediksi wilayah Jaksel, Jakbar, Kepulauan Seribu, dan Jakut bakal diguyur hujan hari ini. https://t.co/tVq3MQ2jeq",4,0,1,0,2022-01-12,21,Wednesday,3,5,0
1481381127495589890,2022-01-12 21:42:38,"Janda bos Playboy, Crystal Hefner, kini sudah tak mau lagi berpose telanjang. Ia pun berencana membuang semua implan di tubuhnya itu dan jadi lebih jujur. https://t.co/cbpK3mx9nL",21,1,2,0,2022-01-12,21,Wednesday,3,23,1
1481380006681063427,2022-01-12 21:38:10,"Seorang di Sumut, Argentina Maradona Sinaga, lulus tes CPNS di lingkungan Kejati Sumut. Maradona lulus dengan formasi Analis Rancangan Naskah Perjanjian. https://t.co/F5dL08VI2y",27,6,6,1,2022-01-12,21,Wednesday,3,33,7
1481378891424018434,2022-01-12 21:33:45,Balai Besar Karantina Pertanian Surabaya menggagalkan penyelundupan satwa burung dari Kalimantan Tengah. Beberapa diantaranya mati. https://t.co/aFG8zobZSn,8,2,4,1,2022-01-12,21,Wednesday,3,12,3
1481377824305033216,2022-01-12 21:29:30,"PT Garuda Indonesia Tbk (GIAA) pada hari ini, Rabu (12/1/202) kembali melayani penerbangan umrah bagi jamaah Indonesia. https://t.co/nnp0z2ciwG",42,3,11,1,2022-01-12,21,Wednesday,3,53,4
1481376828237434883,2022-01-12 21:25:33,Pemerintah melangsungkan program vaksinasi booster COVID-19 bagi kelompok prioritas hari ini Rabu (12/1/2022). Bagaimana dengan efek sampingnya? https://t.co/3Q7X4lYeY7,2,0,1,0,2022-01-12,21,Wednesday,3,3,0
1481375590770958342,2022-01-12 21:20:38,Kapolri Jenderal Listyo Sigit Prabowo menggelar anev bersama seluruh jajaran. Sigit meminta jajaran Polri tidak antikritik dan memperbaiki koreksi masyarakat. https://t.co/lKXsdxw6J7,11,2,2,1,2022-01-12,21,Wednesday,3,13,3
1481373370499350528,2022-01-12 21:11:48,"Wacana penghapusan BBM jenis Premium santer terdengar belum lama ini. Kabar yang berkembang, Premium akan dihapus pada tahun 2022. https://t.co/HuOu9t5T9U",4,1,0,0,2022-01-12,21,Wednesday,3,4,1
1481371746485813260,2022-01-12 21:05:21,Kembalinya anime Attack on Titan menghiasi jagat maya. Salah satu ilustratornya pun mengunggah sketsa Mikasa Ackerman. https://t.co/39iZWloNL6,8,0,1,1,2022-01-12,21,Wednesday,3,9,1
1481370380627550211,2022-01-12 20:59:55,Polri akan segera mengubah warna seragam satpam dari cokelat muda menjadi krem karena dinilai terlalu mirip polisi. Kapan seragam baru itu diberlakukan? https://t.co/JfLLfHlvEL,208,194,22,60,2022-01-12,20,Wednesday,3,230,254
1481369128447492096,2022-01-12 20:54:57,Telkom membidik digitalisasi di bidang transportasi logistik. Logee Trans jadi senjata Telkom dalam melakukan transformasi digital di sektor tersebut. https://t.co/mbkv6M5MxA,4,0,0,0,2022-01-12,20,Wednesday,3,4,0
1481366604281692160,2022-01-12 20:44:55,Saat itu kedatangan masyarakat tidak terbendung begitupun dengan ibu-ibu yang membawa anaknya. Sehingga aksi turun ke kolam ikan yang dilakukan anak-anak tidak dapat dihindarkan. https://t.co/FAdBaeQ3Oa,7,0,1,0,2022-01-12,20,Wednesday,3,8,0
1481365625217896451,2022-01-12 20:41:02,Bayern Munich menjadi satu-satunya tim jawara liga top Eropa yang meraih keuntungan di tengah pandemi musim lalu. Hal ini terungkap berdasarkan riset terbaru. https://t.co/519ulUfGR9,6,0,1,0,2022-01-12,20,Wednesday,3,7,0
1481363604918128640,2022-01-12 20:33:00,"AS Roma dalam tren terburuk dalam 43 tahun terakhir. Pelatih Jose Mourinho jadi sorotan, tapi sepertinya nggak bakal buru-buru kena pecat tuh! https://t.co/Etb1qTcxHz",9,0,0,0,2022-01-12,20,Wednesday,3,9,0
1481362254666862600,2022-01-12 20:27:38,Seorang pejabat tinggi penjara Sri Lanka dijatuhi hukuman mati. Dia dihukum mati atas pembunuhan 27 narapidana dengan hukuman mati. https://t.co/1h1zCLLs4q,9,0,0,0,2022-01-12,20,Wednesday,3,9,0
1481361277465284610,2022-01-12 20:23:45,TNI AD kembali membuka rekrutmen untuk Tamtama dan Bintara gelombang I tahun 2022. Ini syarat dan ketentuannya buat lulusan SMP-SMA. Gas daftar! https://t.co/EZt0DrdEXN,22,1,3,0,2022-01-12,20,Wednesday,3,25,1
1481360205820616707,2022-01-12 20:19:30,Pengemudi ojol bernama Charly sempat cekcok dengan oknum Polsek Cileungsi saat membuat surat laporan kehilangan. Charly menjelaskan kronologinya. https://t.co/ATSe6N0pXb,19,0,1,2,2022-01-12,20,Wednesday,3,20,2
1481358790603726853,2022-01-12 20:13:52,Awal tahun 2022 dibuka dengan pengungkapan sejumlah kasus penyalahgunaan narkoba. Kasus terbaru yang terungkap melibatkan penyanyi Ardhito Pramono. https://t.co/gq4hM4FuK2,7,0,0,0,2022-01-12,20,Wednesday,3,7,0
1481357559328038919,2022-01-12 20:08:59,"Melihat kecepatan penularan Omicron yang luar biasa cepat, WHO memprediksi setengah populasi di Eropa akan terinfeksi dalam beberapa minggu ke depan. https://t.co/FQawrEgDMM",8,2,4,1,2022-01-12,20,Wednesday,3,12,3
1481356334213828612,2022-01-12 20:04:07,SBY dan Prabowo turut hadir dalam pemberian gelar profesor kehormatan untuk Terawan. Bagaimana potret kebersamaan mereka? https://t.co/e8GU2cTol4,15,2,5,1,2022-01-12,20,Wednesday,3,20,3
1481354862852030467,2022-01-12 19:58:16,Bagaimana kualifikasi seseorang sebagai pecandu atau korban penyalahgunaan narkoba? https://t.co/O0TVzTzvfu,1,0,0,0,2022-01-12,19,Wednesday,3,1,0
1481353622986412040,2022-01-12 19:53:20,Sekeluarga di Pemalang membuat gempar karena ketahuan sudah dua kali menyimpan mayat anggota keluarganya dalam rumahnya. Seperti apa kisah lengkapnya? https://t.co/GaAUmMZMhi,8,3,3,1,2022-01-12,19,Wednesday,3,11,4
1481349991880921092,2022-01-12 19:38:54,"Warga Desa Dusun Banjar Negoro A, Desa Sidodadi Ramunia, Kecamatan Beringin, itu mengaku tidak kepikiran soal 'hadiah' ini. Apa katanya? https://t.co/CtvgW8BF0r",4,0,1,0,2022-01-12,19,Wednesday,3,5,0
1481349210893168643,2022-01-12 19:35:48,Pedagang korban kebakaran Pasar Minggu telah menempati tempat relokasi selama 9 bulan. Pedagang mengeluh sepi. #detikcomdoyourmagic https://t.co/UqplScZWpJ,1,0,0,0,2022-01-12,19,Wednesday,3,1,0
1481347447385636865,2022-01-12 19:28:48,"Eks penyidik KPK AKP Stepanus Robin kecewa permohonan justice collaboratornya ditolak karena tidak relevan. Menurut Robin, JC nya relevan dengan perkara ini. https://t.co/8DQu8GjfLH",4,0,0,1,2022-01-12,19,Wednesday,3,4,1
1481346466690043911,2022-01-12 19:24:54,Seorang warga menjadi korban penodongan orang tak dikenal di Dago Bandung. Disebut-sebut pelakunya menggunakan senjata laras pendek. https://t.co/rBsPymyfdx,5,0,1,0,2022-01-12,19,Wednesday,3,6,0
1481342516234534919,2022-01-12 19:09:12,"Aksi tak biasa dilakukan striker Lincoln City, Chris Maguire. Ia merayakan gol tepat di depan muka mantan pelatihnya di Sunderland, Lee Johnson. https://t.co/VYB3uIsXVR",4,0,0,1,2022-01-12,19,Wednesday,3,4,1
1481342005238247424,2022-01-12 19:07:10,Dinas Kesehatan DKI Jakarta menargetkan 8 juta warga disuntik vaksin booster. Mereka yang menjadi target yakni lansia hingga warga yang memiliki komorbid. https://t.co/LHNUsIzLNm,7,0,1,0,2022-01-12,19,Wednesday,3,8,0
1481340998164914183,2022-01-12 19:03:10,"#FOTO Crystal Hefner, janda bos Playboy Hugh Hefner, kini sudah tak mau lagi tampil bugil dalam pemotretan. Ia pun mencopot imej seksi yang ada di dirinya. Ini sosoknya:  https://t.co/hwAkCCMJsW",5,0,0,0,2022-01-12,19,Wednesday,3,5,0
1481339610911420417,2022-01-12 18:57:39,"Aset PT Timor Putra Nasional (TPN) milik Hutomo Mandala Putra alias Tommy Soeharto yang dilelang dengan harga Rp 2,4 triliun tak laku. Ini faktanya: https://t.co/NXitlpHHqw",3,1,2,0,2022-01-12,18,Wednesday,3,5,1
1481337723860525056,2022-01-12 18:50:09,Penunjukan Mayjen TNI Untung Budiharto jadi Pangdam Jaya menuai sorotan lantaran latar belakang sebagai eks tim Mawar. Panglima TNI Jenderal Andika buka suara. https://t.co/sJIHcs6zRX,19,2,3,0,2022-01-12,18,Wednesday,3,22,2
1481336075805200386,2022-01-12 18:43:37,"Arsenal berencana rekrut striker Fiorentina, Dusan Vlahovic. Andai gagal, The Gunners sudah punya rencana cadangan! https://t.co/loQzyzYBh3",3,0,2,0,2022-01-12,18,Wednesday,3,5,0
1481333947359506434,2022-01-12 18:35:09,Novelis Erisca Febriani menegaskan tidak akan melanjutkan cerita karakter Nathan dan Salma. Tapi menulis karakter pendukung lainnya. https://t.co/1pkCbTfEfw,17,0,2,1,2022-01-12,18,Wednesday,3,19,1
1481333037891829760,2022-01-12 18:31:32,Dewi Nur Hasanah gadis remaja asal Banjarnegara yang menghilang usai pamit nonton kuda lumping akhirnya pulang ke rumah. Ke mana saja dia? #detiktif https://t.co/6FcRojkMpu,18,1,2,0,2022-01-12,18,Wednesday,3,20,1
1481331865290170378,2022-01-12 18:26:53,Warga Kabupaten Bogor yang positif terinfeksi virus corona  varian omicron sering bepergian ke Jakarta dengan transportasi umum. Warga tersebut merupakan pasien omicron pertama di Bogor. #CNNIndonesia #detiknetwork  https://t.co/yL4SNu8vtO,6,0,1,0,2022-01-12,18,Wednesday,3,7,0
1481331285968707584,2022-01-12 18:24:35,Hari Dharma Samudera diperingati pada tanggal 15 Januari tiap tahunnya. Bagaimana sejarah awal terbentuknya? https://t.co/AbNk3Lv3vu,1,0,0,0,2022-01-12,18,Wednesday,3,1,0
1481330070618836997,2022-01-12 18:19:45,Polda Jabar menganggap kasus polisi 'cueki' laporan ojol sebagai bahan koreksi. Polda Jabar sampaikan terima kasih ke masyarakat atas saran dan kritikannya. https://t.co/VXqpN8xYQO,18,10,2,3,2022-01-12,18,Wednesday,3,20,13
1481328958742347779,2022-01-12 18:15:20,"Hakim menyebut AKP Robin bersama Maskur Husain terbukti menerima suap totalnya Rp 11 miliar dan USD 36 ribu atau sekitar Rp 11,5 miliar. https://t.co/tpdI4buZXk",3,2,2,0,2022-01-12,18,Wednesday,3,5,2
1481326719432900612,2022-01-12 18:06:26,"Chinese New Year 2022 tinggal beberapa minggu lagi. Perayaan Chinese New Year ini diperingati di China dan sejumlah negara di Asia, termasuk Indonesia. https://t.co/ghTvZUY6Q9",5,0,1,0,2022-01-12,18,Wednesday,3,6,0
1481325987358986240,2022-01-12 18:03:31,"Jalan rusak di Klaten, Jawa Tengah sempat viral di media sosial. Kerusakan jalan yang dibuat gambar burung itu pun akhirnya ditambal, hari ini. https://t.co/Y9Lv0yxVym",2,0,0,0,2022-01-12,18,Wednesday,3,2,0
1481324604912246790,2022-01-12 17:58:02,"Sebuah tugu di Temanggung, Jawa Tengah, disebut sebagai Titik Nol Kilometer Pulau Jawa. Tugu tersebut dikenal bernama Tugu Sepuser. Penasaran? https://t.co/rsBl20Krp0",18,0,5,0,2022-01-12,17,Wednesday,3,23,0
1481323292921376776,2022-01-12 17:52:49,Sejumlah politisi masuk kepengurusan PBNU era Gus Yahya Staquf. Apa maksud dan tujuan Gus Yahya Staquf menggandeng politisi masuk kepengurusan PBNU? https://t.co/YRaHTvIF7c,7,4,0,0,2022-01-12,17,Wednesday,3,7,4
1481322499329638409,2022-01-12 17:49:40,HF dikenal sopan tapi jarang bersosialisasi dan sering bepergian. https://t.co/QKeiyM67Dz,7,1,2,0,2022-01-12,17,Wednesday,3,9,1
1481321329475338243,2022-01-12 17:45:01,"Cuitan Ferdinand soal 'Allahmu lemah' dinilai polisi sebagai berita bohong. Lantas, bagaimana cara membuktikan bahwa 'Allahmu lemah' adalah suatu kebohongan? https://t.co/MirKw7VYce",39,15,7,4,2022-01-12,17,Wednesday,3,46,19
1481319815675584520,2022-01-12 17:39:00,Gus Yahya mengajak sejumlah tokoh perempuan dalam kepengurusan PBNU. Hal tersebut baru pertama kalinya terjadi. https://t.co/6dS5mLi1fl,13,0,2,0,2022-01-12,17,Wednesday,3,15,0
1481319008251129864,2022-01-12 17:35:47,Hanung Bramantyo sudah selesai menjalani operasi saraf kejepit. Begini kondisi Hanung Bramantyo:  https://t.co/4Qfufen83p,6,0,0,2,2022-01-12,17,Wednesday,3,6,2
1481317770461687810,2022-01-12 17:30:52,Ortu ojol di Bogor klarifikasi narasi anaknya dipukul saat lapor di Polsek Cileungsi. Sang ortu membantah Charly dipukul. https://t.co/Qv97doWITl,45,42,7,20,2022-01-12,17,Wednesday,3,52,62
1481316605414023175,2022-01-12 17:26:14,Kota Makassar menjadi satu-satunya wilayah yang memenuhi syarat pelaksanaan vaksinasi booster di Sulsel. #Makassar #Booster https://t.co/UyW4hGBVRQ,3,0,0,0,2022-01-12,17,Wednesday,3,3,0
1481315678347055107,2022-01-12 17:22:33,Siapa Herry Wirawan? Dia adalah terdakwa kasus pemerkosaan terhadap 13 santriwati di Bandung. Berikut fakta-fakta soal kasusnya! https://t.co/GKLv0NdTsV,11,2,4,1,2022-01-12,17,Wednesday,3,15,3
1481314613845241861,2022-01-12 17:18:20,Kementerian Agama mendukung tuntutan tersebut. https://t.co/YNlDsW1Kq9,13,0,2,0,2022-01-12,17,Wednesday,3,15,0
1481313681183068163,2022-01-12 17:14:37,"Ketua Umum PBNU Gus Yahya, mengumumkan daftar nama pengurus PBNU periode 2022-2027 hari ini. Simak daftar lengkap nama-namanya: https://t.co/73eEesXJex",8,0,2,1,2022-01-12,17,Wednesday,3,10,1
1481312725124931588,2022-01-12 17:10:49,Umat Islam diwajibkan untuk makan makanan halal dan thoyib atau baik. Ternyata ada pengaruh besar dari makanan terhadap sifat dan akhlak manusia. https://t.co/K1nDMjWv3O,13,3,4,1,2022-01-12,17,Wednesday,3,17,4
1481311891200921604,2022-01-12 17:07:30,Seorang pemobil Febi Khairunisa (21) tewas dalam kecelakaan maut di tol Palembang-Kayu Agung akibat menghindari jalan berlubang. Pihak keluarga buka suara. https://t.co/6lkWyQtuF5,13,1,7,4,2022-01-12,17,Wednesday,3,20,5
1481309917306920960,2022-01-12 16:59:40,"Presiden Kazakhstan, Kassym-Jomart Tokayev muncul ke publik untuk pertama kalinya setelah kerusuhan yang terjadi di negara tersebut. https://t.co/ZVgaubKumh",9,0,1,0,2022-01-12,16,Wednesday,3,10,0
1481309681150832640,2022-01-12 16:58:44,Jaksa federal UEA mengumumkan bahwa orang-orang yang mengejek aturan pandemi Corona kini bisa terancam hukuman penjara. https://t.co/vb1CeA4yt9,35,1,12,5,2022-01-12,16,Wednesday,3,47,6
1481309650826010624,2022-01-12 16:58:36,BMKG meminta wilayah Jabodetabek mewaspadai peningkatan curah hujan selama 3 hari ke depan. https://t.co/NpdqApiBc2,9,0,6,2,2022-01-12,16,Wednesday,3,15,2
1481307617796497414,2022-01-12 16:50:32,"Proyek ini tak kunjung direalisasi lantaran terkendala sejumlah hal, salah satunya pembebasan lahan. https://t.co/FKJLempzgI",7,0,0,1,2022-01-12,16,Wednesday,3,7,1
1481307596816625667,2022-01-12 16:50:27,"Suami pernah tertangkap polisi karena narkoba dan judi, dia sekarang bertambah brutal dengan memukuli saya di depan anak-anak. Saya sampai depresi &amp; minum obat. #detikNetwork  https://t.co/lTiqR9Quyx",2,0,3,2,2022-01-12,16,Wednesday,3,5,2
1481307066258145288,2022-01-12 16:48:20,"Ayam geprek salah satu hidangan favorit yang banyak dipesan via aplikasi ojek online. Kalau ingin menikmatinya, berikut 5 ayam geprek dengan rating tertinggi. https://t.co/kXSZItgMgS",6,0,1,0,2022-01-12,16,Wednesday,3,7,0
1481306195033919488,2022-01-12 16:44:52,"Vaksinasi booster COVID-19 dimulai hari ini. Khusus wilayah Jakarta Barat, ini daftar lokasi vaksin booster COVID-19. Yuk merapat biar Omicron cepat tamat! https://t.co/UhjsP0BPDg",9,1,3,0,2022-01-12,16,Wednesday,3,12,1
1481305391946473474,2022-01-12 16:41:41,Hampir 1 juta umat Hindu diperkirakan akan berkumpul di tepi Sungai Gangga pada hari Jumat (14/1) dan Sabtu (15/1) untuk melakukan ritual mandi suci. https://t.co/YYl6UK2NaD,89,54,27,38,2022-01-12,16,Wednesday,3,116,92
1481304730139824140,2022-01-12 16:39:03,Supaya otak bisa cepat memecahkan masalah maka pikiran perlu dilatih. Salah satu caranya bisa dengan teka-teki ini. https://t.co/JYJKmCS2y7,16,9,1,3,2022-01-12,16,Wednesday,3,17,12
1481303654699356167,2022-01-12 16:34:47,Kamu salah satu yang sering merasa kesulitan menulis caption Instagram? Jika iya coba lihat nih sederet quotes bijak singkat berikut. https://t.co/tpHDgkK4vF,11,2,3,1,2022-01-12,16,Wednesday,3,14,3
1481302609805946895,2022-01-12 16:30:38,"Baru-baru ini, Adam Deni sempat melontarkan pernyataan bahwa Jerinx SID sempat ingin bunuh diri setelah pihaknya melaporkan terkait kasus pengancaman. Bagaimana respons Jerinx? https://t.co/qhqhWtoWb7",11,2,1,1,2022-01-12,16,Wednesday,3,12,3
1481302084246982658,2022-01-12 16:28:32,Polisi menangkap dua pelaku penganiayaan yang mengakibatkan meninggalnya Shendi Herdianto (16). Korban berstatus pelajar itu disangka anggota geng motor. https://t.co/QLrA4xxPD6,4,0,0,0,2022-01-12,16,Wednesday,3,4,0
1481301472604299267,2022-01-12 16:26:06,RI telah lebih mempersiapkan antisipasi serangan varian baru. Dari jumlah tempat tidur hingga obat anti virus. Berikut persiapannya: https://t.co/9uT8dt25nu,6,0,1,0,2022-01-12,16,Wednesday,3,7,0
1481299970632425474,2022-01-12 16:20:08,"Kebakaran gorong-gorong sempat terajdi di Jalan Raya Mangga Besar, Sawah Besar, Jakarta Pusat. Kebakaran diduga akibat pipa gas bocor yang ada di lokasi. https://t.co/UWa3jS3MBo",9,3,0,0,2022-01-12,16,Wednesday,3,9,3
1481299059814109184,2022-01-12 16:16:31,Seorang anggota TNI asal Bondowoso tewas setelah mobil yang ditumpanginya tertimpa pohon. Pohon tumbang setelah terjadi hujan deras disertai angin kencang. https://t.co/1Tb9Ca1qWP,5,0,0,0,2022-01-12,16,Wednesday,3,5,0
1481298398363926543,2022-01-12 16:13:54,"Meski sudah sekitar 2,5 bulan disimpan, mayat SAR (14), tidak mengeluarkan bau busuk. Tokoh agama setempat mengungkap kondisi mayat remaja perempuan itu. https://t.co/KKjk2JlZMr",22,0,3,0,2022-01-12,16,Wednesday,3,25,0
1481297366997155840,2022-01-12 16:09:48,"Terungkap! Lokasi pembangunan Kereta Cepat Jakarta-Bandung ternyata ada yang berada di kawasan tanah lempung. Alhasil, Menko Kemaritiman dan Investasi Luhut Binsar Pandjaitan meninjau tanah proyek tersebut. https://t.co/2ff3BnFkKz",17,6,6,6,2022-01-12,16,Wednesday,3,23,12
1481296631710560259,2022-01-12 16:06:52,"Seorang pria yang hendak salat subuh di Koja, Jakut dijambret oleh sekelompok orang. Korban bahkan sempat diacungkan celurit. https://t.co/O1Lf92pUrh",13,0,1,1,2022-01-12,16,Wednesday,3,14,1
1481295581884694529,2022-01-12 16:02:42,"Penyebab kematian komedian Bob Saget belum secara resmi diungkap. Namun polisi menemukan tanda-tanda kegawatdaruratan, tepatnya stroke dan serangan jantung. https://t.co/MjNIv3ThRA",9,0,3,0,2022-01-12,16,Wednesday,3,12,0
1481294667199168514,2022-01-12 15:59:04,"Yuk merapat! Ini informasi vaksin booster COVID-19 di Jakarta Pusat yang tersedia mulai hari ini. Lengkap dengan lokasi, syarat, dan cara daftarnya: https://t.co/RptsncowoT",15,0,6,1,2022-01-12,15,Wednesday,3,21,1
1481294304475766787,2022-01-12 15:57:37,Penampakan tanggul Sungai Citarum yang longsor pada Selasa (11/1) malam. Musim penghujan membuat debit air di Sungai Citarum meningkat drastis. https://t.co/tS2RDbbJ5X,5,0,2,0,2022-01-12,15,Wednesday,3,7,0
1481293532610576384,2022-01-12 15:54:33,Berikut model mobil Ford yang akan mengiasi jalan Indonesia lagi! https://t.co/S2xyCbLqeF,6,0,1,0,2022-01-12,15,Wednesday,3,7,0
1481292925736783878,2022-01-12 15:52:09,"Vaksinasi booster COVID-19 dimulai hari ini, Rabu (12/1/2022). Kemenkes sebut stok booster di RI amat memadai, non-lansia bakal ikut disuntik booster? https://t.co/r3kd3YqB6i",3,2,1,0,2022-01-12,15,Wednesday,3,4,2
1481292112062816263,2022-01-12 15:48:55,Menko Marves Luhut Binsar Pandjaitan sampaikan prediksi puncak kasus Omicron di Indonesia. Luhut menyebut hal itu akan terjadi di awal Februari. https://t.co/HQTnmUL5TN,46,44,7,11,2022-01-12,15,Wednesday,3,53,55
1481292086615887874,2022-01-12 15:48:49,Ardhito Pramono jadi perbincangan publik usai terjerat kasus narkoba. Lihat lagi sederet kontroversi yang pernah dilakukan oleh musisi jazz tersebut. https://t.co/dHZGz2ZVHw,10,0,2,1,2022-01-12,15,Wednesday,3,12,1
1481290212160454657,2022-01-12 15:41:22,"BPBD Kabupaten Bekasi, Jawa Barat memperbaiki tanggul Sungai Citarum yang longsor hingga menimpa tiga rumah warga https://t.co/0164tfps0C",4,1,0,0,2022-01-12,15,Wednesday,3,4,1
1481289647762386948,2022-01-12 15:39:07,Dewi Lestari tak serta-merta menerima tawaran kenaikan jabatan itu. https://t.co/oMJ2AGUVWG,20,3,1,2,2022-01-12,15,Wednesday,3,21,5
1481288976615026688,2022-01-12 15:36:27,Berikut bocoran mobil Ford yang akan muncul di tahun ini! https://t.co/UGh8IjXTli,11,0,2,0,2022-01-12,15,Wednesday,3,13,0
1481287956509954048,2022-01-12 15:32:24,Korea Selatan merilis nilai reputasi iklan 10 girl group di bulan Januari 2022. BLACKPINK berada di nomor 1 dan di posisi kedua ada IVE yang merupakan idol baru Starship Entertainment. https://t.co/7zVommzBMh,5,0,0,0,2022-01-12,15,Wednesday,3,5,0
1481287650279665667,2022-01-12 15:31:11,"Anggota Komisi I DPR Fraksi PDIP, TB Hasanuddin mempertanyakan lamanya kekosongan jabatan Pangkostrad TNI. Apa katanya? https://t.co/vqkoXoRMzy",6,0,2,1,2022-01-12,15,Wednesday,3,8,1
1481286822105956354,2022-01-12 15:27:54,"Vaksinasi booster vaksin COVID-19 dimulai hari ini. Khusus Jakarta Timur, ini daftar lokasi vaksin booster untuk 18 tahun ke atas sampai lansia. https://t.co/z12CngCIE5",8,1,1,0,2022-01-12,15,Wednesday,3,9,1
1481286202070376461,2022-01-12 15:25:26,"Kredit berisiko BNI per November 2021 tercatat sebesar 25,18%, turun dari posisi Desember 2020 yaitu 28,74%. https://t.co/kTlqsfGkkv",6,0,0,0,2022-01-12,15,Wednesday,3,6,0
1481285516322562048,2022-01-12 15:22:42,"Adam Deni hadir sebagai saksi di persidangan kasus pengancaman oleh Jerinx, Rabu (12/1). Sidang berlangsung memanas saat pengacara Jerinx melontarkan pertanyaan terkait mediasi kepada Adam Deni. https://t.co/4E4tUwztJe",5,0,0,0,2022-01-12,15,Wednesday,3,5,0
1481285088692289538,2022-01-12 15:21:00,Peyek kacang selalu enak buat camilan atau lauk pelengkap pecel. Bikin peyek memang perlu kesabaran. Coba saja resep peyek kacang renyah dan gurih ini. https://t.co/uGOrtwnglx,26,1,4,1,2022-01-12,15,Wednesday,3,30,2
1481284333298139143,2022-01-12 15:18:00,"Liburan bersama teman di Situ Cileunca, Pangalengan, Jabar, sekelompok orang ini mengalami getok harga saat makan di warung. Begini ceritanya: https://t.co/Qc6oakqJrx",30,30,4,4,2022-01-12,15,Wednesday,3,34,34
1481283927029465094,2022-01-12 15:16:23,"Polda Sumut menangkap 63 pelaku curat, curas, hingga curanmor dalam kurun waktu 9 hari. Para pelaku kejahatan itu diciduk lantaran telah meresahkan warga. https://t.co/dodYhQbumy",6,0,1,0,2022-01-12,15,Wednesday,3,7,0
1481283614906142725,2022-01-12 15:15:09,"Tak hanya memiliki area yang luas, di Pondok Kolam Sangabut keluarga juga bisa menikmati aneka hidangan ditemani sejuknya suasana alam. https://t.co/l8tkxQuVfq",5,0,0,0,2022-01-12,15,Wednesday,3,5,0
1481283285627985920,2022-01-12 15:13:50,"Kalau masih bingung mau masak apa hari ini, cobalah buat tumisan buncis dan ayam yang sederhana ini. Rasanya gurih pedas dengan renyah buncis yang segar. https://t.co/KgglvvGmz8",15,0,0,1,2022-01-12,15,Wednesday,3,15,1
1481283275561840643,2022-01-12 15:13:48,Berikut 3 fakta terkait kasus-kasus korupsi Emirsyah Satar di Garuda Indonesia. https://t.co/5VPZU3HgBv,11,5,3,1,2022-01-12,15,Wednesday,3,14,6
1481282968844914693,2022-01-12 15:12:35,Apa alasan Jaksa turut memberikan tuntutan kebiri kimia kepada Herry? https://t.co/utp3HchkER,15,5,0,1,2022-01-12,15,Wednesday,3,15,6
1481282629693546498,2022-01-12 15:11:14,Sidang lanjutan perwalian Gala Sky Ardiansyah kembali digelar di Pengadilan Agama Jakarta Barat. Mediasi pun gagal tercapai dalam sidang hari ini. https://t.co/u3ZAPBbWnX,13,0,3,1,2022-01-12,15,Wednesday,3,16,1
1481282615407693824,2022-01-12 15:11:11,Sepak terjang Ardhito Pramono di dunia musik dan film sebelum terjerat hukum akibar gunakan ganja. #ArdhitoPramono  https://t.co/QcVSTpnOYy,12,3,2,4,2022-01-12,15,Wednesday,3,14,7
1481281973029163014,2022-01-12 15:08:37,Dua orang guru di Medan menghina seorang siswa. Insiden tersebut sampai di telinga Wakil Ketua DPRD Medan Ihwan Ritonga. https://t.co/kPgBR4Y4VE,40,26,13,7,2022-01-12,15,Wednesday,3,53,33
1481281294663307264,2022-01-12 15:05:56,Program vaksinasi lanjutan atau vaksinasi booster resmi dimulai hari ini. Cek lokasi dan syarat vaksin booster untuk warga Jakarta Utara. https://t.co/u6cmann1Ho,3,1,1,0,2022-01-12,15,Wednesday,3,4,1
1481280386638430212,2022-01-12 15:02:19,#Terpopuler Anies Baswedan menganggarkan Rp 197 miliar untuk program penyaring sampah. Program ini ditargetkan selesai Juni 2022. Seperti apa? https://t.co/cSuMbsI6aj,12,5,2,3,2022-01-12,15,Wednesday,3,14,8
1481279627813429250,2022-01-12 14:59:18,"Ancilla Irish Gabriella (25), peserta meditation camp di Tangsel yang dilaporkan hilang sudah ditemukan. Simak keterangan polisi: https://t.co/EWcTy8Afdj",18,4,4,1,2022-01-12,14,Wednesday,3,22,5
1481279279816232969,2022-01-12 14:57:55,Pemerkosaan yang dilakukan Herry Wirawan kepada 13 santriwati ini tak kenal waktu. Dia bisa melakukan kapan saja. https://t.co/7lZcyzcVGB,15,8,5,3,2022-01-12,14,Wednesday,3,20,11
1481278676704632837,2022-01-12 14:55:32,"Adam Deni hadir sebagai saksi di persidangan kasus pengancaman oleh Jerinx, Rabu (12/1). Sidang berlangsung memanas saat pengacara Jerinx melontarkan pertanyaan terkait mediasi kepada Adam Deni. https://t.co/c6Ztd9flb2 https://t.co/4Wn0fCEqV5",13,0,0,0,2022-01-12,14,Wednesday,3,13,0
1481278285820616713,2022-01-12 14:53:58,"#Terpopuler Nia Ramadhani dan Ardi Bakrie divonis menjalani pidana penjara selama 1 tahun. Padahal, dalam tuntutannya, Nia dan Ardi dituntut rehabilitasi 1 tahun. https://t.co/JOQyfCUr0q",18,2,3,2,2022-01-12,14,Wednesday,3,21,4
1481276762613026822,2022-01-12 14:47:55,"Gempa bumi yang pusatnya berada di darat terjadi dua kali di Halmahera Utara, Maluku Utara. Gempa masing-masing berkekuatan magnitudo (M) 2,7 dan M 3,1. https://t.co/8TAXYSzbGU",16,0,1,0,2022-01-12,14,Wednesday,3,17,0
1481276508706586630,2022-01-12 14:46:55,"Warga Depok cari lokasi vaksin booster COVID-19? Cek di sini untuk jadwal, lokasi, dan cara daftar vaksin Booster COVID-19 di Depok dan sekitarnya. https://t.co/it2Ds4kpcA",12,0,2,0,2022-01-12,14,Wednesday,3,14,0
1481275579307540484,2022-01-12 14:43:13,Sejumlah supermarket di Amerika Serikat (AS) mengalami kekurangan stok setelah banyak karyawan yang positif Covid-19 varian omicron yang mengganggu distribusi.  https://t.co/TrVQNS4yoc,12,0,6,1,2022-01-12,14,Wednesday,3,18,1
1481274777323163652,2022-01-12 14:40:02,KPK telah memeriksa tersangka Jumhana Lutfi dan Lai Bui Min terkait kasus dugaan suap yang menjerat Wali Kota Bekasi nonaktif Rahmat Effendi sebagai tersangka. https://t.co/aKs8wEVclU,6,0,3,0,2022-01-12,14,Wednesday,3,9,0
1481273829318144001,2022-01-12 14:36:16,"Jasad perempuan lanjut usia ditemukan mengambang di aliran Sungai Cikaso atau tepatnya di Kampung Cilele, Kecamatan Pabuaran, Kabupaten Sukabumi. https://t.co/tfLh6zDb4K",7,0,1,0,2022-01-12,14,Wednesday,3,8,0
1481273826713481221,2022-01-12 14:36:15,Ketua Umum Partai Golkar Airlangga Hartarto mendatangi Kantor DPD Golkar Jatim. Airlangga juga mengadakan pertemuan tertutup dengan Gubernur Khofifah. https://t.co/obfPMmIkJz,11,0,1,1,2022-01-12,14,Wednesday,3,12,1
1481273334616801280,2022-01-12 14:34:18,#Terpopuler HF dan istrinya mengundurkan diri sebagai pengajar di ponpes itu sejak beberapa bulan lalu. https://t.co/5CJU5GB6Ox,20,8,3,0,2022-01-12,14,Wednesday,3,23,8
1481271706421444611,2022-01-12 14:27:50,Teleskop luar angkasa James Webb telah sukses membuka cermin raksasa berlapis emas pada Sabtu (8/1) lalu. Terbukanya cermin menjadi penanda bahwa ini merupakan manuver terakhir dari proses deployment.  https://t.co/6qkHFJwB4j,9,0,2,0,2022-01-12,14,Wednesday,3,11,0
1481271389013397504,2022-01-12 14:26:34,Ardhito Pramono ditangkap polisi karena kasus narkoba. Polisi memiliki minimal 2 alat bukti dalam penangkapan Ardhito Pramono ini. https://t.co/zXUyO1MQCE,15,2,4,4,2022-01-12,14,Wednesday,3,19,6
1481271109798580228,2022-01-12 14:25:27,Tata cara mandi junub bagi wanita yang benar dapat mengacu pada sunnah-sunnah yang dijelaskan dalam sabda Rasulullah SAW. Apakah boleh menggelung rambut? https://t.co/jiOiVKrGBJ,28,0,2,0,2022-01-12,14,Wednesday,3,30,0
1481270157519503365,2022-01-12 14:21:40,"UU Kejaksaan digugat ke MK terkait kewenangan mengajukan Peninjauan Kembali (PK). Padahal, UU Kejaksaan belum sebulan diketok. https://t.co/mv67nP2KUw",9,0,2,0,2022-01-12,14,Wednesday,3,11,0
1481269597928050690,2022-01-12 14:19:27,"Zara Leola kembali merilis single, kali ini bertajuk She's Nothing dan berkolaborasi dengan Satria, Eka Gustiwana, dan Enda Ungu. https://t.co/DpONnPiPxo",8,0,0,0,2022-01-12,14,Wednesday,3,8,0
1481269303215280128,2022-01-12 14:18:17,Begini sosok elite PDIP yang kini memimpin Himpunan Pengusaha Muda Indonesia itu. https://t.co/b1nhnw2XdO,19,1,3,2,2022-01-12,14,Wednesday,3,22,3
1481268058824089603,2022-01-12 14:13:20,Seorang pilot lolos dari maut setelah pesawatnya mendarat darurat dan ditabrak kereta. Hii! Bagaimana kejadiannya? https://t.co/zHQo7XxI0n,17,0,0,0,2022-01-12,14,Wednesday,3,17,0
1481268045180018695,2022-01-12 14:13:17,"Adopsi spirit dolls atau boneka arwah mendadak jadi tren yang banyak diperbincangkan. Menariknya, boneka yang umumnya berperawakan anak-anak itu ternyata butuh perawatan serupa mengurus bayi. Simak selengkapnya di sini: https://t.co/eo8vFK0ggv",5,1,0,0,2022-01-12,14,Wednesday,3,5,1
1481266795071918098,2022-01-12 14:08:19,Vaksin Pfizer termasuk salah satu vaksin COVID-19 yang paling banyak dicari. Ini efek sampingnya dari vaksin Pfizer:  https://t.co/yBxXZltFiA,15,0,3,3,2022-01-12,14,Wednesday,3,18,3
1481266257936764932,2022-01-12 14:06:11,"Menjelang verifikasi parpol tahap pertama, DPW Gelora Jawa Barat mendatangi Komisi Pemilihan Umum (KPU) Jabar di Jalan Garut, Kota Bandung. https://t.co/JpdcpsNGwj",9,1,1,0,2022-01-12,14,Wednesday,3,10,1
1481266023168892929,2022-01-12 14:05:15,"Sidang kasus pengancaman yang dilakukan Jerinx terhadap Adam Deni digelar secara offline di Pengadilan Negeri Jakarta Pusat, Rabu (12/1). Saat tiba di pengadilan Jerinx mengaku siap mengahadapi persidangan. https://t.co/OXAKgRg6Eu",13,0,2,0,2022-01-12,14,Wednesday,3,15,0
1481266001442394114,2022-01-12 14:05:09,Aktor sekaligus musisi Ardhito Pramono ditangkap polisi terkait penyalahgunaan narkoba jenis ganja. Bagaimana ciri-ciri kecanduan ganja? Berikut ulasannya: https://t.co/ZGMjGnAoA8,52,8,5,13,2022-01-12,14,Wednesday,3,57,21
1481265452101820416,2022-01-12 14:02:59,"Menkes RI Budi Gunadi Sadikin menyebutkan ciri-ciri varian Omicron yang telah masuk ke Indonesia. Terbilang lebih ringan, namun penularannya lebih cepat. https://t.co/h9rXYF6cem",9,0,4,0,2022-01-12,14,Wednesday,3,13,0
1481265434007687171,2022-01-12 14:02:54,"Sesosok mayat gadis remaja SAR (14) disimpan keluarganya di dalam rumah, Pemalang selama 2,5 bulan. Apa yang membuat tetangga curiga awalnya? https://t.co/ubhkJbRYxg",15,1,5,1,2022-01-12,14,Wednesday,3,20,2
1481264268590948356,2022-01-12 13:58:16,Kini sudah banyak tempat download MP3 yang pastinya legal. Ini dafar situs download lagu MP3 gratis dan legal:  https://t.co/dAyTRYHr4E,45,0,16,3,2022-01-12,13,Wednesday,3,61,3
1481263646466580483,2022-01-12 13:55:48,"Battle Royale garapan Krafton, PUBG: Battlegrounds, resmi ditawarkan gratis untuk gamer PC dan konsol di seluruh dunia. Pemain bisa langsung menikmati di Steam. https://t.co/fyUPIyuziQ",24,2,7,3,2022-01-12,13,Wednesday,3,31,5
1481263624475791361,2022-01-12 13:55:43,"Pihak LTMPT menegaskan baju seperti apa yang diperkenankan dipakai sebagai syarat pasfoto akun 2022. Simak ya, begini ketentuannya:

via: detikedu https://t.co/TZ6hGDaakL",6,0,1,1,2022-01-12,13,Wednesday,3,7,1
1481263243003846663,2022-01-12 13:54:12,Non Fungible Token (NFT) kini tengah tren di masyarakat seiring dengan perkembangan teknologi. SuperlativeSS mengajak seniman memasarkan karya dengan NFT. https://t.co/lnFQsITPpI,22,1,4,0,2022-01-12,13,Wednesday,3,26,1
1481263219759005699,2022-01-12 13:54:06,Bayern Munich menghentikan spekulasi terkait masa depan Kingsley Coman. Bayern resmi mengumumkan kontrak baru Coman yang berlaku sampai 2027. https://t.co/IlFwLLmWJe,12,0,1,0,2022-01-12,13,Wednesday,3,13,0
1481262911297314821,2022-01-12 13:52:53,"Galery Non-Fungible Token (NFT) pertama di Indonesia dibuka di Kuta, Kabupaten Badung, Bali. Galeri ini menawarkan karya seni fisik sebagai aset digital. https://t.co/sk0MkwRjNU",35,1,4,1,2022-01-12,13,Wednesday,3,39,2
1481262885212987396,2022-01-12 13:52:47,Ketua Umum PBNU Yahya Cholil Staquf memiliki alasan tersendiri mengapa ada sejumlah nama politikus yang masuk dalam kepengurusan PBNU periode 2022-2029.  https://t.co/r47zPbEoQP,11,3,0,0,2022-01-12,13,Wednesday,3,11,3
1481262038605303814,2022-01-12 13:49:25,Tencent kabarnya akan mengakuisisi vendor ponsel gaming Black Shark. Akuisisi ini jadi langkah Tencent untuk mewujudkan ambisi mereka membangun metaverse. https://t.co/DpBvezKFSZ,19,0,0,1,2022-01-12,13,Wednesday,3,19,1
1481261136444071940,2022-01-12 13:45:50,"Desa Kedungboto, Kecamatan Beji, Kabupaten Pasuruan, masih tergenang banjir. Banjir di desa ini sudah berlangsung selama dua hari. https://t.co/nCF1kQ54ZH",22,0,1,0,2022-01-12,13,Wednesday,3,23,0
1481261134464401411,2022-01-12 13:45:49,Menaker Ida Fauziyah mengungkap anjungan ini merupakan labour center pertama dengan fasilitas yang didesain untuk mendekatkan pelayanan ketenagakerjaan https://t.co/Yv10v8e9nq,11,0,1,0,2022-01-12,13,Wednesday,3,12,0
1481260557432934401,2022-01-12 13:43:32,Apple mengungkap pemasukan para pengembang aplikasi di App Store saat ini sudah mencapai lebih dari USD 260 miliar sejak App Store pertama dibuka pada 2008. https://t.co/SWAWmu0FJ2,18,0,3,0,2022-01-12,13,Wednesday,3,21,0
1481260264171450375,2022-01-12 13:42:22,Syarat vaksin ke 3 perlu diketahui usai pemerintah memulai program vaksinasi booster hari ini. Berikut beberapa hal yang perlu diperhatikan. https://t.co/UYoSuNrtMY,19,1,4,2,2022-01-12,13,Wednesday,3,23,3
1481260247582973956,2022-01-12 13:42:18,Almarhumah Mbah Wiro merupakan generasi kedua penjual Jadah Tempe Mbah Carik Kaliurang. Lantas siapa yang akan meneruskan usaha jadah tempe ini? https://t.co/LOwBSuELWV,17,1,2,0,2022-01-12,13,Wednesday,3,19,1
1481259882284302338,2022-01-12 13:40:51,Tabrak lari yang menewaskan pesepeda Suginah (60) di Klaten sempat viral usai curahan hati anak korban beredar. Pengemudi telah diamankan. https://t.co/3Vmnxp0vRT,39,1,13,1,2022-01-12,13,Wednesday,3,52,2
1481259558723014658,2022-01-12 13:39:33,"#Terpopuler Ubedillah Badrun jadi sorotan pasca melaporkan dua anak Presiden RI, Gibran Rakabuming Raka dan Kaesang Pangarep ke KPK. Ini sosoknya. https://t.co/LUlGuREwVC",81,7,10,6,2022-01-12,13,Wednesday,3,91,13
1481259536656781318,2022-01-12 13:39:28,"Vaksin booster diberikan gratis dan kalian bisa daftar di PeduliLindungi, begini caranya:  https://t.co/jZ7evMc9DW",39,1,18,3,2022-01-12,13,Wednesday,3,57,4
1481257924697763840,2022-01-12 13:33:04,"Petugas telah berhasil mengevakuasi batu besar yang sempat menutupi sebagian Jalan Cadas Pangeran, Kabupaten Sumedang. https://t.co/AEWn8TODrz",17,0,3,0,2022-01-12,13,Wednesday,3,20,0
1481257010570092545,2022-01-12 13:29:26,Video memperlihatkan seorang sopir truk tangki bermuatan minyak kelapa sawit dihadang sekelompok pria diduga preman viral di medsos. https://t.co/vPijCGRjM1,23,0,6,0,2022-01-12,13,Wednesday,3,29,0
1481254213091049477,2022-01-12 13:18:19,"Curah hujan tinggi di Rangkasbitung, Lebak, Banten, menyebabkan banjir. Ketinggian air 30 hingga 70 sentimeter. https://t.co/sNdY5oZtrS",33,1,2,1,2022-01-12,13,Wednesday,3,35,2
1481253549455589381,2022-01-12 13:15:41,Apakah menyelamatkan nyawa manusia dengan cara ini benar-benar tidak boleh dilakukan? https://t.co/UWAa4N3uU6,14,1,2,1,2022-01-12,13,Wednesday,3,16,2
1481253231053443072,2022-01-12 13:14:25,HIVE jadi sebuah studio webtoon tempat para komikus Indonesia bisa bekerja sama dengan Redice Studio dalam memproduksi webtoon. https://t.co/lPsutgDi8n,29,1,7,1,2022-01-12,13,Wednesday,3,36,2
1481252410995654658,2022-01-12 13:11:09,"Mendaki Gunung Api Purba Nglanggeran memberikan sensasi tersendiri. Di balik terjalnya medan, ada pemandangan rupawan di sepanjang jalan. Indah yaa! https://t.co/Tw6sNSzCV8",28,1,4,2,2022-01-12,13,Wednesday,3,32,3
1481251471467368451,2022-01-12 13:07:25,"Mayat pria ditemukan mengambang di Bendungan Lahor, Kabupaten Blitar. Pria tersebut merupakan warga Kabupaten Malang. https://t.co/BIjnlEL1aG",13,0,1,0,2022-01-12,13,Wednesday,3,14,0
1481250924991549447,2022-01-12 13:05:15,"""Disimpan di kamar rumah, jenazahnya. Ya kondisinya sudah seperti itu. Itupun pihak keluarga masih meyakini masih hidup,"" ungkap Camat Moga, Umroni. https://t.co/3CQB8SooP7",41,10,11,3,2022-01-12,13,Wednesday,3,52,13
1481248970190037001,2022-01-12 12:57:29,"Hujan deras mengguyur Kota Rangkasbitung, Lebak. Akibatnya beberapa ruas jalan dan pemukiman warga terendam banjir. https://t.co/HRQ8hljXOh",13,1,3,1,2022-01-12,12,Wednesday,3,16,2
1481248967904178176,2022-01-12 12:57:28,"Warga Perumahan Kompleks Askrindo Bintaro, Jaksel mengatakan banjir akibat luapan saluran air sudah jarang terjadi. Hal itu terjadi usai pengerukan got. https://t.co/dp4hYrOcez",17,5,3,0,2022-01-12,12,Wednesday,3,20,5
1481248624726224897,2022-01-12 12:56:07,"Setelah keluhannya tentang hotel isolasi yang bobrok viral, WNA asal AS kini bisa mandi air panas. Kamar hotel juga sudah dibersihkan. Dia pun merasa bersyukur. https://t.co/gC7hQcSVWw",17,5,0,1,2022-01-12,12,Wednesday,3,17,6
1481248322237181954,2022-01-12 12:54:54,Tarif KRL Commuter Line akan naik dari Rp 3.000 jadi Rp 5.000 untuk 25 kilometer (km) pertama. Anker menjerit-jerit.  https://t.co/1Paun0BNe1,90,49,43,68,2022-01-12,12,Wednesday,3,133,117
1481248063117303811,2022-01-12 12:53:53,Gempa dengan kekuatan 3.2 magnitudo dan kedalaman 31 kilometer mengguncang Kota Sukabumi. https://t.co/Q4Fgme6eXO,17,0,9,0,2022-01-12,12,Wednesday,3,26,0
1481247583397892096,2022-01-12 12:51:58,"#Terpopuler Setelah kejeblos dan bertemu kambing saat meninjau venue Formula E di Anco, Giring kembali melontarkan kritik. Kali ini soal komitmen fee Rp 560 M. https://t.co/1nTBx6ccJD",17,27,3,4,2022-01-12,12,Wednesday,3,20,31
1481247563835711490,2022-01-12 12:51:54,Gempa berkekuatan magnitude 7.0 mengguncang Haiti pada 12 Januari 2010 lalu. Sedikitnya 230.000 jiwa tewas dan lebih dari 1 juta orang kehilangan tempat tinggal. https://t.co/21hLafB6po,10,0,4,0,2022-01-12,12,Wednesday,3,14,0
1481246277270749189,2022-01-12 12:46:47,"Arus lalu lintas di kawasan Jalan Cadas Pangeran, Sumedang mulai dapat dilalui dua arus kendaraan pasca longsor yang terjadi di kawasan tersebut. https://t.co/wdS3xrpucE",11,1,3,0,2022-01-12,12,Wednesday,3,14,1
1481245428767199237,2022-01-12 12:43:25,"Manajer Chelsea Thomas Tuchel tak peduli dengan apa yang Romelu Lukaku lakukan. Sebab, Tuchel cuma butuh gol-gol Lukaku untuk membantu The Blues menang. https://t.co/3yciOzxJba",17,2,0,0,2022-01-12,12,Wednesday,3,17,2
1481244517391081476,2022-01-12 12:39:47,"Sebuah video yang menunjukkan aksi diduga pungli oleh seorang pria di Medan, Sumut, viral di medsos. Ini kata si perekam video. https://t.co/fjQnCpnnOw",7,1,0,0,2022-01-12,12,Wednesday,3,7,1
1481243916720615425,2022-01-12 12:37:24,"Detik-detik kecelakaan melibatkan sepeda motor dengan truk tronton di Kabupaten Kudus, Jawa Tengah terekam kamera CCTV dan viral di media sosial. https://t.co/wJvyM5ZpbU",7,0,0,0,2022-01-12,12,Wednesday,3,7,0
1481243598758760448,2022-01-12 12:36:08,"Sejumlah anak artis ini punya anak unik. Nama anak mereka ternyata gabungan dari nama orangtuanya, termasuk baby Leslar. Siapa saja ya? https://t.co/w2jVys1KTW",15,2,2,1,2022-01-12,12,Wednesday,3,17,3
1481243033547026434,2022-01-12 12:33:54,Warga menggerebek panti pijat plus-plus di Depok yang diduga jadi tempat prostitusi. Warga menyamar sebelum gerebek tempat itu. https://t.co/muA2Y0lHFQ,52,35,9,7,2022-01-12,12,Wednesday,3,61,42
1481242753262669831,2022-01-12 12:32:47,Pengalaman menarik dirasakan Diana Kruger saat terlibat proyek bersama Quentin Tarantino. Begini kisahnya:  https://t.co/07dSNmsR3w,11,0,0,1,2022-01-12,12,Wednesday,3,11,1
1481242737777258497,2022-01-12 12:32:43,Anak Alya Rohali lulus dari Fakultas Hukum dengan nilai terbaik. Wii selamat!  https://t.co/9ZwbdAjJny,51,0,2,3,2022-01-12,12,Wednesday,3,53,3
1481242077237239811,2022-01-12 12:30:06,"Anggota DPR Andi Yuliani Paris menyindir Kepala BRIN Laksana Tri Handoko. Andi menyebut Handoko seperti ayah almarhumah Vanessa Angel, Doddy Soedrajat. https://t.co/Lb8lHKXbxF",11,3,3,5,2022-01-12,12,Wednesday,3,14,8
1481241533789708290,2022-01-12 12:27:56,Maximillian White saat ini menjadi orang kaya raya berkat usaha ganja. https://t.co/4MIUPSDeod,57,9,29,6,2022-01-12,12,Wednesday,3,86,15
1481240603459571716,2022-01-12 12:24:14,"Eks penyidik KPK, AKP Robin divonis 11 tahun bui dan denda Rp 500 juta karena menerima suap sebanyak Rp 11,538 miliar. KPK menyatakan putusan sesuai fakta. https://t.co/vaRDdmzz16",16,11,3,3,2022-01-12,12,Wednesday,3,19,14
1481239860346245124,2022-01-12 12:21:17,"Calon mahasiswa perlu tahu nih! Di antara banyaknya jurusan kuliah, ada jurusan kuliah yang dikenal paling mahal di Indonesia. Jurusan apa saja tuh?

via: detikedu https://t.co/MULIixDcHU",15,2,2,1,2022-01-12,12,Wednesday,3,17,3
1481239843288109056,2022-01-12 12:21:13,"Inilah syarat-syarat pasfoto LTMPT 2022 plus untuk yang behijab. Apa saja yang boleh dan tidak boleh dilakukan ya? Simak yuk!

via: detikedu https://t.co/PrRyGnsXVr",6,0,2,0,2022-01-12,12,Wednesday,3,8,0
1481239310858919937,2022-01-12 12:19:06,"BPS mencatat semua Provinsi di Jawa memiliki tingkat kebahagiaan yang rendah. Padahal IPM yang terdiri dari kesehatan, pendidikan, ekonomi paling tinggi. https://t.co/Er5A2UXkpB",13,4,8,2,2022-01-12,12,Wednesday,3,21,6
1481238615283965955,2022-01-12 12:16:20,Bintang reality TV Kim Kardashian dan legenda tinju Floyd Mayweather Jr digugat oleh warga New York. Kenapa? https://t.co/JefE5E7fOs,9,2,1,2,2022-01-12,12,Wednesday,3,10,4
1481238282709217283,2022-01-12 12:15:01,"Bagaimana ramalan zodiak kesehatan Virgo hingga Aries di 2022? Yuk, lihat ramalan zodiak kesehatan 2022 menurut pakar tarot. https://t.co/9u04Uzq4kX",4,0,1,1,2022-01-12,12,Wednesday,3,5,1
1481237194635423746,2022-01-12 12:10:41,"PDSS adalah pangkalan data yang berisikan nilai rapor dan rekam jejak kinerja sekolah. Berikut adalah hal-hal yang perlu diperhatikan dalam PDSS.

via: detikedu https://t.co/RwBbJGwXcR",8,0,1,0,2022-01-12,12,Wednesday,3,9,0
1481236890162507777,2022-01-12 12:09:29,"3 rumah tertimpa longsor usai tanggul Sungai Citarum di Desa Lenggah Jaya, Kabupaten Bekasi jebol akibat hujan deras. Tidak ada korban jiwa dari insiden ini https://t.co/mWVVs9urhI",8,0,1,0,2022-01-12,12,Wednesday,3,9,0
1481236665456906243,2022-01-12 12:08:35,"Penggalangan dana Gala Sky menuai reaksi dari Denny Sumargo, karena dianggap terlalu mendewakan anak mendiang Vanessa Angel tersebut. Sebagai orang yang menginisiasi donasi tersebut, bagaimana respons Marissya Icha? https://t.co/etffd76K0N",2,0,0,0,2022-01-12,12,Wednesday,3,2,0
1481235875489107975,2022-01-12 12:05:27,Seragam satpam yang saat ini berwarna cokelat muda akan berubah menjadi warna krem. https://t.co/LxQiCRYxER,323,270,86,109,2022-01-12,12,Wednesday,3,409,379
1481235861035491335,2022-01-12 12:05:23,"Sebuah video yang memperlihatkan banjir di jalan raya di kawasan hutan Baluran, Situbondo viral. Ternyata video tersebut hoaks. https://t.co/9E4MnvnShm",8,1,2,0,2022-01-12,12,Wednesday,3,10,1
1481235575487217667,2022-01-12 12:04:15,"Aset milik Tommy Soeharto yang dilelang atas nama PT Timor Putra Nasional (TPN) dengan harga Rp 2,4 triliun nggak laku. Kemahalan apa ya? https://t.co/8OI4a2omEy",12,8,1,2,2022-01-12,12,Wednesday,3,13,10
1481235343206666245,2022-01-12 12:03:20,"#Terpopuler Selama berpacaran, pelaku melancarkan bujuk rayu agar korban mau berhubungan badan. Korban pun dijanjikan jika hamil akan dinikahi. https://t.co/CXzc3SnRTk",10,2,4,4,2022-01-12,12,Wednesday,3,14,6
1481235314803097600,2022-01-12 12:03:13,"Ketegangan dan tone dari Scream (2022) terasa seperti film pertamanya yang dirilis 1996. Sebagai fans franchise ini, kamu akan dapat apa yang kamu harapkan! #Scream  https://t.co/bNwhnze2zH",15,1,4,0,2022-01-12,12,Wednesday,3,19,1
1481234928259981314,2022-01-12 12:01:41,Perhatian! Garuda Indonesia kembali melayani penerbangan umrah bagi jamaah Indonesia mulai hari ini. Penerbangan dua kali dalam sepekan. https://t.co/QvZFFABkti,9,0,3,0,2022-01-12,12,Wednesday,3,12,0
1481234902867656712,2022-01-12 12:01:35,"Berdasarkan penelusuran Ubedilah Badrun, bisnis Gibran dan Kaesang punya kaitan dengan perusahaan yang diduga terlibat dalam kasus pembakaran hutan, yakni PT BMH. #CNNIndonesia #detikNetwork  https://t.co/JJJ4Aou4up",58,5,23,4,2022-01-12,12,Wednesday,3,81,9
1481233836499419143,2022-01-12 11:57:21,Ardhito Pramono ditangkap terkait narkoba oleh Polres Metro Jakarta Barat. Ia pun tak banyak bicara saat masuk ke ruang kesehatan. https://t.co/b2Br9NvQow,41,7,2,9,2022-01-12,11,Wednesday,3,43,16
1481233300232589315,2022-01-12 11:55:13,Hingga saat ini masih banyak orang yang bertanya-tanya apakah sekolah akan ditutup lagi 2022? https://t.co/8AyXUSmBDO,13,4,0,1,2022-01-12,11,Wednesday,3,13,5
1481233275075141636,2022-01-12 11:55:07,Sejumlah benda purbakala ditemukan warga di area persawahan sekitar lereng Gunung Kelud. Benda-benda tersebut diduga peninggalan dari era kerajaan Singasari. https://t.co/fjTQfybwH4,21,0,5,0,2022-01-12,11,Wednesday,3,26,0
1481232990604824583,2022-01-12 11:53:59,Gelaran tari Samba dalam acara Festival Musim Dingin Jazan di Arab Saudi tuai pro dan kontra. Sebab pakaian penari perempuan dinilai terlalu minim. https://t.co/CdnTPUvnfN,6,3,3,1,2022-01-12,11,Wednesday,3,9,4
1481232333491556354,2022-01-12 11:51:22,"Batu sebesar mobil jatuh hingga menutupi setengah badan jalan. Akibatnya, arus lalu lintas di kawasan Cadas Pangeran Sumedang diberlakukan buka tutup. https://t.co/YMs6PXSjLY",18,0,2,2,2022-01-12,11,Wednesday,3,20,2
1481231720640823296,2022-01-12 11:48:56,Samsung baru merilis Galaxy S21 FE di Indonesia dengan harga Rp 9 juta (8/128GB) dan Rp 10 juta (8/256GB). Ini para pesaingnya di kelas harga itu:  https://t.co/m6iSjY6g5u,19,0,3,1,2022-01-12,11,Wednesday,3,22,1
1481231704102686722,2022-01-12 11:48:52,"Herry Wirawan, guru dan pimpinan ponpes di Bandung, dituntut hukuman mati terkait aksi kejinya memperkosa 13 santri. Berikut fakta-faktanya: https://t.co/PuzlgWlaKC",18,3,1,2,2022-01-12,11,Wednesday,3,19,5
1481231405505986562,2022-01-12 11:47:41,#FOTO Model Shakilla Kaif merayakan hari ulang tahun yang ke-23 secara besar-besaran. Acaranya berlangsung di Bali. Ini potretnya:  https://t.co/HN7EhuGwDP,14,2,1,1,2022-01-12,11,Wednesday,3,15,3
1481231134264643584,2022-01-12 11:46:37,Diskon pajak penjualan atas barang mewah (PPnBM) untuk mobil baru sudah berakhir. Diskon PPnBM 100% untuk mobil baru hanya berlaku sampai Desember 2021. https://t.co/zq8NGS1DwE,10,0,3,0,2022-01-12,11,Wednesday,3,13,0
1481231112668168193,2022-01-12 11:46:31,Polisi menangkap artis Ardhito Pramono yang berprofesi sebagai penyanyi sekaligus bintang film. Netizen masih ramai membahasnya hingga jadi trending topic. https://t.co/jaevEjBa3O,16,3,2,5,2022-01-12,11,Wednesday,3,18,8
1481230554506964998,2022-01-12 11:44:18,"Ardhito Pramono ditangkap polisi karena ganja. Polisi akan mengungkap penangkapan itu besok, Kamis (13/1/2022). #ArdhitoPramono  https://t.co/mMrSPMSrLJ",31,3,7,8,2022-01-12,11,Wednesday,3,38,11
1481229596993409024,2022-01-12 11:40:30,Ternyata ada wilayah yang memiliki tingkat kemiskinan tinggi tapi indeks kebahagiaannya juga tinggi. Di mana itu? https://t.co/pHBXoIw5o3,22,2,6,2,2022-01-12,11,Wednesday,3,28,4
1481229344986910720,2022-01-12 11:39:30,Series Layangan Putus jadi sorotan. Bahkan soundtracknya berjudul Sahabat Dulu yang dipopulerkan Prinsa Mandagie ikut trending. #LayanganPutus  https://t.co/ue6Dqndt1R,11,0,1,0,2022-01-12,11,Wednesday,3,12,0
1481229332395798529,2022-01-12 11:39:27,"Setelah viral lakukan promosi dengan pelayan pria atletis telanjang dada, sebuah restoran di Singapura didatangi polisi. Dua alasan ini menjadi penyebabnya. https://t.co/XxhkmBzF0p",8,3,0,0,2022-01-12,11,Wednesday,3,8,3
1481229005500125184,2022-01-12 11:38:09,Wali Kota Bogor Bima Arya menanggapi santai hasil penelitian tersebut. https://t.co/HhGjzHARO5,6,1,0,0,2022-01-12,11,Wednesday,3,6,1
1481228980858544134,2022-01-12 11:38:03,Jantung babi yang satu ini bukan disiapkan untuk diolah menjadi makanan lezat. Tetapi dijadikan transplantasi untuk pasien penyakit jantung. https://t.co/Ju1UQRCh1z,53,13,11,8,2022-01-12,11,Wednesday,3,64,21
1481227517335851011,2022-01-12 11:32:14,Kota Almaty menjadi wilayah paling terdampak kerusuhan di Kazakhstan. Kini situasi mulai kondusif. Aaktivitas warga mulai berangsur normal. https://t.co/rXJ8t2AZrm,8,0,1,0,2022-01-12,11,Wednesday,3,9,0
1481226946721861635,2022-01-12 11:29:58,"Jacqueline Fernandez sedang jadi perbincangan setelah ketahuan, sang kekasih adalah penipu kelas kakap di India. Ini potretnya:  https://t.co/9DcBF7AFMf",9,0,1,0,2022-01-12,11,Wednesday,3,10,0
1481226929105784835,2022-01-12 11:29:54,"Seorang pria mengaku mengalami efek samping jangka panjang akibat infeksi COVID-19, atau sering disebut long Covid. Hal ini menyebabkan penisnya menyusut. https://t.co/eaIH4bOi4u",7,2,3,1,2022-01-12,11,Wednesday,3,10,3
1481226690907054082,2022-01-12 11:28:57,Menteri Koordinator Kemaritiman dan Investasi Luhut Binsar Pandjaitan mengungkap kondisi tanah lempung di proyek Kereta Cepat Jakarta Bandung. https://t.co/vuvvmP6BwF,24,23,4,3,2022-01-12,11,Wednesday,3,28,26
1481226671680376832,2022-01-12 11:28:53,Oknum polisi diduga nyuekin laporan ojol yang hilang motor di Polsek Cileungsi. Kapolres Bogor AKBP Iman Imanuddin meminta maaf atas kejadian itu. https://t.co/lqb8xQw0Ue,95,61,11,14,2022-01-12,11,Wednesday,3,106,75
1481226407426543618,2022-01-12 11:27:50,Korea Utara terkenal sebagai negara yang punya sistem pemerintahan super ketat. Namun netizen baru saja dihebohkan dengan kabar adanya gerai KFC di Korea Utara. https://t.co/han40ZhtlJ,7,0,3,0,2022-01-12,11,Wednesday,3,10,0
1481226166816157698,2022-01-12 11:26:52,"Selama ini, Nagita Slavina selalu menarik perhatian dengan penampilannya. Kali ini, ia menyebut tas yang dikenakannya adalah KW. Ternyata ini faktanya:  https://t.co/boCpajcJw2",7,2,1,6,2022-01-12,11,Wednesday,3,8,8
1481225838192304129,2022-01-12 11:25:34,Tim Penyalin Cahaya melakukan investigasi soal adanya dugaan salah satu krunya melakukan pelecehan seksual. #PenyalinCahaya  https://t.co/3F4YC88BN8,5,0,4,0,2022-01-12,11,Wednesday,3,9,0
1481225260720664576,2022-01-12 11:23:16,Serial Flora yang merupakan karakter spin off di Turn On telah tayang. Erika Carlina diketahui kembali memainkan peran tersebut.  https://t.co/hlqnJ47qDS,4,0,2,0,2022-01-12,11,Wednesday,3,6,0
1481225237404520456,2022-01-12 11:23:11,Shin Tae-yong menyebutkan weight training masih jadi kelemahan pemain Indonesia. Apa itu dan bagaimana manfaatnya bagi pemain timnas? https://t.co/cnykEhjbJy,10,2,3,0,2022-01-12,11,Wednesday,3,13,2
1481224986715209729,2022-01-12 11:22:11,"Biasa tampil dengan rambut pendek, penampilan baru Yuni Shara ini cukup mencuri atensi. Rambutnya terlihat lebih panjang dari biasanya. Penasaran seperti apa? https://t.co/WE1EV17gZE",4,1,2,0,2022-01-12,11,Wednesday,3,6,1
1481224659240722439,2022-01-12 11:20:53,"Hingga saat ini, PPKM Jakarta Januari 2022 masih berstatus level 2. Begini aturannya: https://t.co/Tmb0PGAIcA",12,0,2,0,2022-01-12,11,Wednesday,3,14,0
1481224015566061575,2022-01-12 11:18:19,"BKF memperkirakan defisit APBN di 2022 bisa lebih rendah dari target yang telah ditetapkan, yakni dari 4,85% menjadi hanya 4,3% terhadap PDB. https://t.co/Y39rsyPh8B",4,0,4,0,2022-01-12,11,Wednesday,3,8,0
1481223996402249729,2022-01-12 11:18:15,"Ardhito Pramono ternyata bukan pertama memakai narkoba. Di masa lalu, dirinya juga pernah jadi pemakai. Ini kisahnya:  https://t.co/cT2GghtzAJ",24,6,10,2,2022-01-12,11,Wednesday,3,34,8
1481223681674203138,2022-01-12 11:17:00,"Vaksinasi booster COVID-19 dimulai hari ini. Diberikan secara gratis dan akan menyasar masyarakat usia 18 tahun ke atas, bakal jadi aturan wajib? https://t.co/9wfMexxexR",12,1,3,0,2022-01-12,11,Wednesday,3,15,1
1481223383492841476,2022-01-12 11:15:49,Herry Wirawan memerkosa 13 santriwati hingga hamil dan melahirkan. Agama disebut jadi kedok Herry melampiaskan nafsu bejatnya. https://t.co/rlqt6anT02,14,6,6,2,2022-01-12,11,Wednesday,3,20,8
1481223098510848000,2022-01-12 11:14:41,"11 Laga tanpa cetak gol, sepertinya memang ada yang salah dengan Marcus Rashford. Apakah penyerang Manchester United ini lagi kurang percaya diri?  https://t.co/lMGBmn7YK5",4,1,1,1,2022-01-12,11,Wednesday,3,5,2
1481223076213936131,2022-01-12 11:14:35,"Bermain tebak-tebakan tidak hanya untuk keseruan saja, bisa juga melatih kecerdasan berpikir logika. Buat yang stres, manjur juga buat refreshing. https://t.co/BX0xLBNApP",4,0,2,0,2022-01-12,11,Wednesday,3,6,0
1481222229056790534,2022-01-12 11:11:13,"Vaksin booster COVID-19 mulai diberikan kepada para lansia di Sleman, Yogyakarta. Ratusan dosis vaksin booster tersebut diberikan secara gratis. https://t.co/wHt3GPdbpE",15,1,4,0,2022-01-12,11,Wednesday,3,19,1
1481221389138944003,2022-01-12 11:07:53,"Indonesia mencatat sebanyak 646 kasus baru COVID-19, Rabu (12/1/2022). DKI menyumbang kasus terbanyak dengan jumlah 412. https://t.co/hSrOgbZAGj",12,0,4,2,2022-01-12,11,Wednesday,3,16,2
1481220753915793411,2022-01-12 11:05:22,"Program vaksin booster dimulai hari ini dan gratis! Nah, lalu kalau ada yang pengen bisa milih, bakalan ada vaksin booster berbayar? Ini kata Kemenkes https://t.co/swStuwpF7O",12,2,5,0,2022-01-12,11,Wednesday,3,17,2
1481220172375629827,2022-01-12 11:03:03,Polisi telah memediasi para pihak di kasus bullying atau perundungan yang membuat tulang paha siswa SMP di Banyuwangi dilaporkan ke polisi. Apa hasil mediasi? https://t.co/TyAUx4UScM,20,12,5,8,2022-01-12,11,Wednesday,3,25,20
1481219925297483782,2022-01-12 11:02:04,Ujian berat bakal dihadapi PSS Sleman saat melawan Arema FC di lanjutan BRI Liga 1. Pelatih Super Elja I Putu Gede Swisantoso bereuni dengan mantan timnya.  https://t.co/mWrtOYHRjg,13,0,2,5,2022-01-12,11,Wednesday,3,15,5
1481219542730878978,2022-01-12 11:00:33,Kinerja PT Garuda Indonesia (Persero) Tbk cukup memprihatinkan. Perusahaan ini kena dugaan korupsi pengadaan pesawat di tengah utang yang menggunung. https://t.co/7Qm5xqUwGW,27,11,12,5,2022-01-12,11,Wednesday,3,39,16
1481219229470834690,2022-01-12 10:59:18,"Video pria bertelanjang dada membuat onar di jalanan Kemang, Jaksel viral di medsos. Pria tersebut mengganggu para pengendara sepeda motor yang melintas. https://t.co/YF3wIbi5g0",7,1,2,0,2022-01-12,10,Wednesday,3,9,1
1481219042694287365,2022-01-12 10:58:34,"Belakangan Christian Pulisic lagi diutak-atik posisinya oleh manajer Chelsea Thomas Tuchel. Sejauh ini, performa Pulisic memuaskan.  https://t.co/h03ExriXfR",6,0,0,0,2022-01-12,10,Wednesday,3,6,0
1481219000474472450,2022-01-12 10:58:24,"Buat masyarakat KTP Non-DKI merapat! Ada kabar baik nih. Bisa ikut vaksin booster COVID-19 loh. Syaratnya? Gampang, Simak berikut ini: https://t.co/qBwlXKsQXq",9,0,9,0,2022-01-12,10,Wednesday,3,18,0
1481218708244766722,2022-01-12 10:57:14,"Biasanya pembuatan kaldu rumit, namun kini kamu bisa menikmati kaldu dengan sangat praktis. Tinggal menyeduhnya seperti kopi, secangkir kaldu bisa dinikmati! https://t.co/PG22Y6YufE",5,0,2,1,2022-01-12,10,Wednesday,3,7,1
1481218689118744576,2022-01-12 10:57:09,Ajang Oscar 2022 akan kembali menghadirkan sosok host seperti yang dilakukan sebelum 2018. Namun siapakah yang didapuk untuk memandu acara itu?🤔 https://t.co/mDoxRYA2nW,5,1,1,0,2022-01-12,10,Wednesday,3,6,1
1481217664680927232,2022-01-12 10:53:05,Ardhito Pramono ditangkap karena narkoba. Ia tampak tertunduk saat diperiksa polisi. Ini potretnya: #ArdhitoPramono  https://t.co/c3vcxPGFpG,19,4,5,3,2022-01-12,10,Wednesday,3,24,7
1481217652181901316,2022-01-12 10:53:02,Polisi mengungkap kronologi penangkapan Ardhito Pramono. Seperti apa? https://t.co/dGZJ77qU3g,16,2,7,0,2022-01-12,10,Wednesday,3,23,2
1481217327299452930,2022-01-12 10:51:45,"Pria asal Sukaraja berinisial R hanyut saat memancing di Sungai Ciapus, Dramaga, Kabupaten Bogor. Jasadnya ditemukan oleh tim SAR gabungan di Sungai Cisadane. https://t.co/34op22PHtR",3,0,1,0,2022-01-12,10,Wednesday,3,4,0
1481216325255053315,2022-01-12 10:47:46,"Hari ini dilaporkan ada tambahan 646 kasus positif COVID-19 di Indonesia. Selain itu, ada 314 orang di Indonesia yang sembuh dari COVID-19. https://t.co/91Zw0has6E",7,1,5,0,2022-01-12,10,Wednesday,3,12,1
1481216026809446400,2022-01-12 10:46:35,"Indonesia melaporkan 646 kasus COVID-19 pada Rabu (12/1/2022). Total kasus positif menjadi 4.268.097, sembuh 4.116.962, dan meninggal 144.150. https://t.co/JWRJN0oRL4",1,0,1,0,2022-01-12,10,Wednesday,3,2,0
1481215724731437056,2022-01-12 10:45:23,Aksi bullying terhadap bocah laki-laki di Bekasi viral. Tindakan perundungan itu bahkan direkam sendiri oleh para pelaku. https://t.co/Y4kgtKDlYt,14,1,1,0,2022-01-12,10,Wednesday,3,15,1
1481215483311529990,2022-01-12 10:44:25,"Ardhito Pramono ditangkap polisi karena penyalahgunaan narkoba. Saat dites urine, Ardhito Pramono positif ganja. #ArdhitoPramono  https://t.co/bl1Y7lv3b2",16,2,3,2,2022-01-12,10,Wednesday,3,19,4
1481214660317749253,2022-01-12 10:41:09,"Sebanyak 16 orang tewas terbakar ketika sebuah taksi minibus dan sebuah SUV bertabrakan di jalan raya di Provinsi Limpopo, timur laut Afrika Selatan. https://t.co/5y6fbN949m",4,1,1,1,2022-01-12,10,Wednesday,3,5,2
1481213566090977283,2022-01-12 10:36:48,"Tanggul Sungai Citarum di Desa Lenggah Jaya, Cabangbungin, Kabupaten Bekasi, longsor. Sempat menimpa 3 rumah. Begini kondisinya. https://t.co/QaVBsLnZyY",3,0,0,0,2022-01-12,10,Wednesday,3,3,0
1481213290021851138,2022-01-12 10:35:42,"Menurut Bos Ducati, Luigi Dall'Igna, untuk saat ini motor listrik masih tertinggal jauh secara teknologi dari motor konvensional bermesin pembakaran dalam. https://t.co/8ATk2FAI2w",16,2,0,0,2022-01-12,10,Wednesday,3,16,2
1481212962887061504,2022-01-12 10:34:24,"Sengketa keluarga penuh dengan cerita, salah satunya soal hibah di internal keluarga. Bagaimana bila ada pihak yang menggugat belakangan hari? #detiksAdvocate https://t.co/OCren5Ok7z",3,1,0,0,2022-01-12,10,Wednesday,3,3,1
1481212510262939650,2022-01-12 10:32:36,"Sanca kembang berukuran 3 meter lebih tak sengaja terciduk ekskavator yang digunakan membersihkan sampah sungai di Desa Kedawung Kulon, Kecamatan Grati, Kabupaten Pasuruan. Ular itu terangkat ekskavator bercampur sampah kayu. https://t.co/RMU3ItWYYH https://t.co/clgwtWRBOT",8,0,1,1,2022-01-12,10,Wednesday,3,9,1
1481212130686865411,2022-01-12 10:31:06,Dede diberikan sepeda baru dan modal usaha. https://t.co/9jdIg0mPcj,17,4,0,1,2022-01-12,10,Wednesday,3,17,5
1481212109593755648,2022-01-12 10:31:01,Inter Milan akan bertemu Juventus pada ajang Piala Super Italia 2021. Berikut 18 fakta terkait duel kedua raksasa Italia tersebut.  https://t.co/eDFkRaVOfH,2,0,0,0,2022-01-12,10,Wednesday,3,2,0
1481211847395229696,2022-01-12 10:29:58,"Di tengah kabar penangkapannya, Ardhito Pramono baru saja menggelar gala premier film Dear Nathan: Thank You Salma pekan lalu. Bagaimana nasib filmnya?  https://t.co/ByfGAMHWvI",7,2,0,2,2022-01-12,10,Wednesday,3,7,4
1481211828776669188,2022-01-12 10:29:54,Cristiano Ronaldo dan Zlatan Ibrahimovic sama-sama pegang rekor sebagai pemain yang sudah jebolin 80 klub. Siapa pesaing terdekatnya?  https://t.co/nyaRgStXnI,11,0,2,1,2022-01-12,10,Wednesday,3,13,1
1481211561549221888,2022-01-12 10:28:50,Real Madrid berhasil kembali ke jalur kemenangan usai menelan kekalahan mengejutkan. Gelandang Madrid Toni Kroos mewanti-wanti timnya agar menjaga konsistensi.  https://t.co/rVBlHOdz4M,6,0,0,0,2022-01-12,10,Wednesday,3,6,0
1481211548152569857,2022-01-12 10:28:47,Banyak pihak yang mempertanyakan legalitas Yayasan Bisa Bersama Gala yang dibuat oleh Marissya Icha. Marissya sebut yayasan tersebut sudah memiliki kejelasan hukum. https://t.co/s24DGf1phF,1,0,0,0,2022-01-12,10,Wednesday,3,1,0
1481211236322881536,2022-01-12 10:27:32,Sarjono mengadu kepada Ombudsman Republik Indonesia (ORI) Kantor Perwakilan Daerah Istimewa Yogyakarta (DIY). Penyebabnya sang anak yang bernama Shela Nur Fa’iza patah semangat karena termakan janji bonus yang tak kunjung turun.  https://t.co/2aINBoBif6,37,5,9,0,2022-01-12,10,Wednesday,3,46,5
1481211210930479110,2022-01-12 10:27:26,"Instagram Ardhito Pramono langsung diserbu penggemar usai kabar dirinya tertangkap karena ganja. Ada yang memberi semangat, ada yang masih denial.  https://t.co/HHY2sdVPHE",5,1,0,3,2022-01-12,10,Wednesday,3,5,4
1481210935759060993,2022-01-12 10:26:21,Persija Jakarta kalah 1-2 dari Persipura Jayapura pada pekan ke-19 BRI Liga 1 2021. Pelatih Angelo Alessio sadar dirinya mulai tidak dipercaya The Jakmania.  https://t.co/0goGFEAZTe,6,0,0,0,2022-01-12,10,Wednesday,3,6,0
1481210617725915140,2022-01-12 10:25:05,"Ponpes Darunnajah 4 di Kecamatan Padarincang, Kabupaten Serang terbakar. Kebakaran diduga akibat korsleting listrik. https://t.co/9GrsShP9HA",4,2,2,0,2022-01-12,10,Wednesday,3,6,2
1481210616601788417,2022-01-12 10:25:05,"Ardhito Pramono dinyatakan positif narkoba usai diciduk polisi. Kini, Ardhito Pramono diperiksa intensif. https://t.co/FPFWCkIpKg",11,1,3,1,2022-01-12,10,Wednesday,3,14,2
1481210020050186243,2022-01-12 10:22:42,"Real Madrid memiliki rekor pertemuan superior atas rival abadinya, Barcelona. Akankah statistik itu berlanjut saat kedua tim berduel di Piala Super Spanyol?  https://t.co/wMoMoSmwK6",6,1,0,1,2022-01-12,10,Wednesday,3,6,2
1481210004170588161,2022-01-12 10:22:39,"Kondisi Tukul Arwana berangsur membaik. Namun karena belum pulih total, berat badan Tukul Arwana mengalami penurunan. #TukulArwana  https://t.co/s8joeEO4vq",4,0,0,0,2022-01-12,10,Wednesday,3,4,0
1481209670287122432,2022-01-12 10:21:19,"Sebelum PON XX berlangsung, banyak pihak yang pesimis dengan kemampuan Papua menggelar perhelatan besar itu.  https://t.co/4KYyaQzqeu",1,0,0,0,2022-01-12,10,Wednesday,3,1,0
1481208245758869515,2022-01-12 10:15:39,Klub Korea Jeonnam Dragons bantah kabar bakal mendatangkan pemain Timnas Indonesia Alfeandra Dewangga. Sejauh ini kabar tersebut ternyata masih rumor belaka.  https://t.co/qPXnsoA8UG,8,1,0,0,2022-01-12,10,Wednesday,3,8,1
1481208224745500675,2022-01-12 10:15:34,"Ardhito Pramono ditangkap polisi terkait kasus narkoba. Kini, Ardhito Pramono menjalani pemeriksaan kesehatan di Polres Metro Jakarta Barat. https://t.co/2qH5BWOJce",3,1,1,1,2022-01-12,10,Wednesday,3,4,2
1481207411037851649,2022-01-12 10:12:20,Nganjuk pada Selasa (11/1) banjir. Pengamat pembangunan menilai banjir yang hampir terjadi setiap tahun menandakan Pemkab Nganjuk lalai dalam perencanaan. https://t.co/JrD3hhYSWW,4,1,1,0,2022-01-12,10,Wednesday,3,5,1
1481206896468144133,2022-01-12 10:10:18,"Pelatih Barcelona, Xavi Hernandez, mempunyai banyak pengalaman di El Clasico. Dia pun mengungkap bahwa laga Los Cules dengan Real Madrid susah diprediksi.  https://t.co/qNw0oebJSB",2,0,0,0,2022-01-12,10,Wednesday,3,2,0
1481206877207904260,2022-01-12 10:10:13,PT Garuda Indonesia (Persero) akan melakukan pengurangan jumlah armada pada tahun ini sebagai bagian untuk memperbaiki kinerja perusahaan. https://t.co/4e0RDHBMcd,7,1,2,0,2022-01-12,10,Wednesday,3,9,1
1481204890085072897,2022-01-12 10:02:19,"Tempat ibadah Budha, Islam, dan agama lainnya mudah ditemukan di Indonesia. Sudah tahu namanya? Buat yang belum, baca tulisan ini ya. https://t.co/Xs755rjhZp",8,0,1,1,2022-01-12,10,Wednesday,3,9,1
1481204863799283712,2022-01-12 10:02:13,"Catat! Ini informasi vaksin booster COVID-19 DKI Jakarta yang tersedia mulai hari ini. Lengkap dengan lokasi, syarat, dan cara daftarnya, yuk mari diserbu. https://t.co/y9fj7oMWHa",6,0,3,0,2022-01-12,10,Wednesday,3,9,0
1481204302429491205,2022-01-12 09:59:59,"Sebuah panti pijat refleksi di Sawangan, Depok, digerebek warga. Panti pijat tersebut diduga menjadi sarang prostitusi. https://t.co/3vIeAFOtzz",12,2,2,2,2022-01-12,9,Wednesday,3,14,4
1481203460007768065,2022-01-12 09:56:38,Begini kisah dibalik istri sah yang mengunggah momen saat suaminya sunmori dengan pelakor. https://t.co/Vtt3Au7Fru,9,0,3,3,2022-01-12,9,Wednesday,3,12,3
1481202841146515457,2022-01-12 09:54:11,"Kota Surabaya dan Malang masuk menjadi kota termacet di dunia. Bahkan, Kota Surabaya menduduki peringkat pertama sebagai kota termacet! #Surabaya https://t.co/H4iciZIqF1",197,79,68,43,2022-01-12,9,Wednesday,3,265,122
1481202316355252227,2022-01-12 09:52:06,Pihak Adam Deni menyebut Jerinx 'SID' sempat tertekan dan hendak mencoba bunuh diri karena terjerat kasus pengancaman kepada Adam Deni ini. Apa respons Jerinx? https://t.co/TYwQp5rx21,12,2,1,0,2022-01-12,9,Wednesday,3,13,2
1481202297527017473,2022-01-12 09:52:01,Baliho Ridwan Kamil for Presiden 2024 mulai terpasang di sejumlah daerah. RK pun mengaku tak tahu terkait siapa pihak yang memasang baliho tersebut. https://t.co/cUow4Szz1e,4,4,0,1,2022-01-12,9,Wednesday,3,4,5
1481201741462974464,2022-01-12 09:49:49,Musisi muda Ardhito Pramono dibekuk lantaran diduga menyalahgunakan narkotika. Ardhito ditangkap karena ganja sepulang dari nge dj. #ArdhitoPramono  https://t.co/2ZcaqXZS57,20,4,4,3,2022-01-12,9,Wednesday,3,24,7
1481201726820601858,2022-01-12 09:49:45,Turki mencatat 74.266 kasus baru COVID-19 dalam tempo 24 jam. Pertimbangkan lagi ya buat liburan ke sana! https://t.co/svWNp34st1,39,13,9,5,2022-01-12,9,Wednesday,3,48,18
1481201132936609792,2022-01-12 09:47:24,Polisi menangkap artis berinisial AP terkait kasus narkoba. AP adalah Ardhito Pramono. Kejadian ini langsung ramai dibahas di linimasa. https://t.co/zCQaPz05FX,18,6,1,6,2022-01-12,9,Wednesday,3,19,12
1481201109087793152,2022-01-12 09:47:18,Direktorat Jenderal Kekayaan Negara Kementerian Keuangan melaporkan bahwa aset milik Hutomo Mandala Putra alias Tommy Soeharto yang dilelang tidak ada peminat. https://t.co/KdwVt5flti,17,5,3,0,2022-01-12,9,Wednesday,3,20,5
1481200419258916865,2022-01-12 09:44:33,"Tukul Arwana sedang berjuang sembuh usai mengalami perdarahan otak. Kini, ia rutin menjalani fisioterapi. Lekas pulih Tukul Arwana...  https://t.co/6CzfAJb70N",311,24,23,8,2022-01-12,9,Wednesday,3,334,32
1481200400288169984,2022-01-12 09:44:29,Seorang pekerja Perusahaan PT Angkasa Raya di Jambi tenggelam di Sungai Batanghari saat sedang memperbaiki mesin kapal. Petugas masih melakukan pencarian. https://t.co/u5sHQOCrWf,4,0,0,0,2022-01-12,9,Wednesday,3,4,0
1481199873022177280,2022-01-12 09:42:23,Bidang tanah itu merupakan sebagian besar dari lahan terakhir di kawasan Beverly Hills yang belum dikembangkan. https://t.co/gSShAGvyXO,4,0,0,0,2022-01-12,9,Wednesday,3,4,0
1481199622810918920,2022-01-12 09:41:24,"Hujan deras membuat baliho berukuran jumbo roboh siang ini. Baliho setinggi belasan meter tersebut berlokasi di simpang empat Jalan Affandi, Sleman. https://t.co/qsCBHUPi4y",9,2,0,3,2022-01-12,9,Wednesday,3,9,5
1481199048824610818,2022-01-12 09:39:07,Biang kerok tanah proyek kereta cepat Jakarta-Bandung runtuh akhirnya terungkap. Apakah proyek pembangunan tunnel alias terowongan terhambat? https://t.co/RjCo6zRuuh,3,1,0,1,2022-01-12,9,Wednesday,3,3,2
1481198746327298049,2022-01-12 09:37:55,Jerinx 'SID' memiliki harapan besar usai bebas dari penjara. Salah satu keinginan Jerinx adalah meninggalkan dunia media sosial. https://t.co/pwdXxaRsXQ,145,58,30,17,2022-01-12,9,Wednesday,3,175,75
1481198253819506689,2022-01-12 09:35:57,"Haji Faisal, ayah Bibi Ardiansyah, menyebut ada banyak kerugian karena mediasi untuk hak asuh Gala Sky gagal.  https://t.co/GzfcNaXG1h",3,1,1,0,2022-01-12,9,Wednesday,3,4,1
1481197751668989954,2022-01-12 09:33:57,Ardhito Pramono ditangkap polisi terkait penyalahgunaan narkoba jenis ganja. Begini penampakan Ardhito Pramono setelah diciduk polisi:  https://t.co/aFMfPIxtx5,12,5,3,5,2022-01-12,9,Wednesday,3,15,10
1481197242577006592,2022-01-12 09:31:56,Ardhito Pramono ditangkap polisi terkait penyalahgunaan narkoba jenis ganja. Begini penampakan Ardhito Pramono setelah diciduk polisi. https://t.co/P79eTA63xL,10,2,3,9,2022-01-12,9,Wednesday,3,13,11
1481196716296708096,2022-01-12 09:29:51,Hasil tes urine Ardhito dinyatakan positif narkoba. https://t.co/Cq7Kyx2BD4,81,20,17,30,2022-01-12,9,Wednesday,3,98,50
1481196303765934084,2022-01-12 09:28:12,"Mohamed Salah diharapkan bisa membawa Mesir berjaya di Piala Afrika 2021. Tapi, baru laga pertama, Raja Mesir sudah dibuat mati kutu oleh Nigeria.  https://t.co/kid3Wqzp1C",5,0,2,0,2022-01-12,9,Wednesday,3,7,0
1481195694635503618,2022-01-12 09:25:47,"Ardhito Pramono adalah musisi dan aktor yang bertalenta. Di saat kariernya makin menanjak, Ardhito ditangkap karena ganja. Ini profil Ardito Pramono:  https://t.co/P5XHKBPdNg",30,1,3,11,2022-01-12,9,Wednesday,3,33,12
1481195184541024256,2022-01-12 09:23:45,Luhut Panjaitan memprediksi Indonesia akan dihantam gelombang ketiga COVID-19 akibat varian Omicron pada Februari. Ini strategi yang dipersiapkan pemerintah. https://t.co/nRhrUI1Trz,7,2,3,1,2022-01-12,9,Wednesday,3,10,3
1481194685200838658,2022-01-12 09:21:46,"Anies Baswedan mengakui dirinya sempat melakukan kontrak politik dengan warga Kampung Guji Baru, Jakarta Barat. Apa isi kontrak politik itu? https://t.co/KGhB6O2KW7",10,2,3,0,2022-01-12,9,Wednesday,3,13,2
1481194500458487812,2022-01-12 09:21:02,Seorang influencer melakukan prosedur suntik yang diklaim bisa bikin awet muda. Sayangnya setelah itu ia wajahnya malah seperti menua 20 tahun. Duh! https://t.co/07QrQICvRd,9,0,4,1,2022-01-12,9,Wednesday,3,13,1
1481194057162493957,2022-01-12 09:19:17,"Akun Instagram Dayana menghilang usai mengomentari suasana mencekam di negaranya, Kazakhstan. Foto-fotonya di Instagram dirindukan banyak orang....  https://t.co/6P2oKYECcR",6,0,2,1,2022-01-12,9,Wednesday,3,8,1
1481193564268904449,2022-01-12 09:17:19,Honda menyebut jumlah pemesanan mereka anjlok sampai 50%. Berikut penyebabnya! https://t.co/w3IcCBmWAp,7,0,1,2,2022-01-12,9,Wednesday,3,8,2
1481192972653846529,2022-01-12 09:14:58,"Bila awalnya tarif KRL untuk 25 km pertama hanya Rp 3.000, rencananya dinaikkan menjadi Rp 5.000, atau tepatnya naik Rp 2.000. https://t.co/JNOTPapqi8",44,29,44,70,2022-01-12,9,Wednesday,3,88,99
1481192153158242313,2022-01-12 09:11:43,Sosok Ojek Online (Ojol) bersepeda ontel menjadi perhatian Kapolres Karawang setelah aksinya viral di media sosial. Siapakah dia? https://t.co/jlVY7NQ9p7,27,3,4,1,2022-01-12,9,Wednesday,3,31,4
1481191409327689735,2022-01-12 09:08:45,"Jurusan farmasi bisa jadi pertimbangan karena memiliki prospek pekerjaan yang menjanjikan. Apa saja prospek pekerjaan itu ya?

via: detikedu https://t.co/Cw4TcJQOQ8",6,0,0,0,2022-01-12,9,Wednesday,3,6,0
1481190940341673984,2022-01-12 09:06:54,Harga minyak goreng di pasaran masih terbilang tinggi. Gerindra mempertanyakan hal itu. https://t.co/dr5e9p2V3r,5,4,1,0,2022-01-12,9,Wednesday,3,6,4
1481190916639674370,2022-01-12 09:06:48,Nindy Ayunda sepertinya sudah move on dari Askara Parasady Harsono. Ada sosok pria misterius yang kini membuat Nindy Ayunda bahagia. Ini potretnya:  https://t.co/OaJwQFO6NG,1,0,0,0,2022-01-12,9,Wednesday,3,1,0
1481190031742099456,2022-01-12 09:03:17,Pemprov DKI mulai melakukan vaksinasi dosis ketiga atau vaksinasi booster hari ini. Warga domisili luar bisa ikut divaksin di Jakarta. Ini syaratnya: https://t.co/JZnWNWsXix,10,1,1,0,2022-01-12,9,Wednesday,3,11,1
1481190012880400386,2022-01-12 09:03:12,Doddy Sudrajat tetap ingin hak perwalian Gala Sky. Mereka pun sudah mengajukan persyaratan untuk perdamaian dengan Faisal. #DoddySudrajat  https://t.co/DIMYNw3F4i,2,0,0,0,2022-01-12,9,Wednesday,3,2,0
1481189756570677248,2022-01-12 09:02:11,#Foto BKSDA Sumatera Barat berhasil menyelamatkan seekor harimau Sumatera. Harimau itu kini diobservasi di pusat rehabilitasi. Ini penampakannya.  https://t.co/hJNryn5SQ9,7,0,2,0,2022-01-12,9,Wednesday,3,9,0
1481189740326146051,2022-01-12 09:02:07,"Kehidupan anak artis memang menarik untuk dibahas. Apalagi seperti mereka yang jarang tersorot, seperti Nasywa anak Desy Ratnasari dan Sammy Hamzah nih. #detikNetwork  https://t.co/pcivhMnMSy",5,0,0,0,2022-01-12,9,Wednesday,3,5,0
1481189557454446593,2022-01-12 09:01:24,"Mohamed Salah ternyata mengaku ingin bertahan lebih lama di Liverpool. Namun, pemain asal Mesir itu punya permintaan yang nggak aneh-aneh, apa itu?  https://t.co/VYoABXz9eD",4,0,0,0,2022-01-12,9,Wednesday,3,4,0
1481189556296822787,2022-01-12 09:01:24,Ardhito Pramono ditangkap polisi terkait penyalahgunaan narkoba di rumahnya di Jaktim. Polisi menyita barang bukti ganja dari Ardhito Pramono. https://t.co/QkcYxx8NCO,19,13,10,8,2022-01-12,9,Wednesday,3,29,21
1481189170106281990,2022-01-12 08:59:51,Serial Layangan Putus berhasil mencetak rekor yakni disaksikan 15 juta kali hanya dalam 1 hari saja. Wow!  https://t.co/hVJgi1phaS,11,0,2,3,2022-01-12,8,Wednesday,3,13,3
1481188882465136640,2022-01-12 08:58:43,"Real Madrid mendapat pujian tinggi dari pelatih Barcelona, Xavi Hernandez, menjelang duel di Piala Super Spanyol.  https://t.co/yEIZlJutp8",4,0,0,0,2022-01-12,8,Wednesday,3,4,0
1481188414640775174,2022-01-12 08:56:51,Ardhito Pramono diamankan polisi karena diduga menyalahgunakan ganja. Ia ditangkap di rumahnya di kawasan Jakarta Timur. Ini pro kontra Ardhito Pramono:  https://t.co/wvMyh5y2E3,14,3,2,8,2022-01-12,8,Wednesday,3,16,11
1481188114169307136,2022-01-12 08:55:40,"Di mana saja lokasi vaksin booster Tangerang? Cek di sini untuk mengetahui syarat, biaya, hingga cara mendaftar vaksin booster di Tangerang. https://t.co/utN0yMMoYi",6,0,1,0,2022-01-12,8,Wednesday,3,7,0
1481188096930684930,2022-01-12 08:55:36,Pemerintah hari ini 12/1 resmi memulai pelaksanaan program vaksinasi booster Covid-19. Pelaksanaan program vaksinasi booster disambut antusiasi masyarakat Kebayoran Baru.  https://t.co/vxhOoh2Vbm,0,0,0,1,2022-01-12,8,Wednesday,3,0,1
1481187825689186304,2022-01-12 08:54:31,"Mohamed Salah mengakui kariernya di Chelsea berantakan karena tekanan hebat saat itu. Tapi, lewat performanya saat ini, Salah sudah membayar tuntas.  https://t.co/0CbiDMyGlu",7,0,1,0,2022-01-12,8,Wednesday,3,8,0
1481187597665935360,2022-01-12 08:53:37,"Tanggul sungai Citarum di wilayah Lenggah Jaya, Cabangbungin, Bekasi, Jawa Barat jebol pada Selasa (11/1) malam. Akibat dari tanggul jebol tersebut, tiga rumah tertimpa longsor dengan kondisi rusak parah. https://t.co/d1yv4J5tEM",2,0,1,0,2022-01-12,8,Wednesday,3,3,0
1481187343499468800,2022-01-12 08:52:36,"Tiga pemuda di Yogyakarta yakni Venzha Christ, Erix Soekamti dan Grayce Soba membangun simulasi analog hidup di Mars. Keren!  https://t.co/APRTGJDor4",19,0,3,3,2022-01-12,8,Wednesday,3,22,3
1481186820859772930,2022-01-12 08:50:31,"Vaksinasi booster baru dimulai hari ini. Kalau dosis 1-2 pakai Sinovac, vaksin COVID-19 mana yang boleh jadi booster? Begini kata Kemenkes: https://t.co/M0W1jbZ7eg",14,1,3,1,2022-01-12,8,Wednesday,3,17,2
1481186571693051911,2022-01-12 08:49:32,Menkes Budi Gunadi Sadikin mewanti-wanti agar seluruh warga waspada terhadap penularan Omicron. Terlebih varian ini menyebar dengan sangat cepat. https://t.co/gXikqWWWKT,4,1,0,0,2022-01-12,8,Wednesday,3,4,1
1481186015897341959,2022-01-12 08:47:19,"Tahun ini, D.O EXO akan membintangi drakor True Sword Battle. Sambil menunggu penayangannya, inilah deretan drakor D.O yang patut ditonton. Apa saja ya? https://t.co/gGxXWaYcoT",150,5,52,2,2022-01-12,8,Wednesday,3,202,7
1481185489445167107,2022-01-12 08:45:14,"Dunia Metaverse diprediksi lepas landas tahun 2022 ini dengan dukungan dari perusahaan teknologi kelas kakap seperti Meta, Google, Microsoft, sampai Apple. https://t.co/ghG3l6v8J2",4,0,3,0,2022-01-12,8,Wednesday,3,7,0
1481184987508527107,2022-01-12 08:43:14,Eks penyidik KPK AKP Robin Pattuju divonis bersalah karena menerima suap dari sejumlah orang berkaitan dengan perkara hukum di KPK. Apa pertimbangan hakim? https://t.co/hibYRtTNAR,5,0,0,2,2022-01-12,8,Wednesday,3,5,2
1481184561136607235,2022-01-12 08:41:33,"Ini lokasi vaksin booster COVID-19 di Semarang yang tersedia mulai hari ini. Buruan kepoin, jangan sampai ketinggalan! Lengkap dengan syarat dan cara daftar: https://t.co/Pd2DLtLIwp",5,0,3,0,2022-01-12,8,Wednesday,3,8,0
1481184538436984833,2022-01-12 08:41:27,"Deddy Corbuzier ternyata jadi salah satu orang beruntung di Indonesia yang memiliki mobil mewah asal Italia, Ferrari Roma. Nggak mau kalah, pria ini juga punya Ferrari Roma.  https://t.co/Brq8OtoLPW",5,1,2,0,2022-01-12,8,Wednesday,3,7,1
1481183589232431106,2022-01-12 08:37:41,"Untuk pertama kalinya dalam sejarah medis, seorang pasien menerima transplantasi jantung babi. Dokter menyebut ini terobosan untuk solusi krisis organ. https://t.co/gNNkC7C4Ze",141,33,40,14,2022-01-12,8,Wednesday,3,181,47
1481183011207094272,2022-01-12 08:35:23,Keran ekspor batu bara yang dibuka kembali jadi angin segar bagi perusahaan atau emiten batu bara. Apa jadinya kalau nggak dibuka? https://t.co/ZGVD3X7VQQ,8,0,2,0,2022-01-12,8,Wednesday,3,10,0
1481182987597275137,2022-01-12 08:35:17,"Ardhito Pramono ditangkap karena narkoba. Membintangi film yang sama, Jefri Nichol juga pernah terjerat narkoba. https://t.co/OWtdotoL7l",28,2,7,11,2022-01-12,8,Wednesday,3,35,13
1481182394887647233,2022-01-12 08:32:56,"Niat hati ingin makan jagung bakar di kawasan Puncak, 3 wanita ini malah kena getok biaya parkir di warung makan. Baru turun mobil langsung ditagih Rp 30.000. https://t.co/nLJiQkRr5v",14,9,8,0,2022-01-12,8,Wednesday,3,22,9
1481182373135933440,2022-01-12 08:32:51,Indonesia Basketball League (IBL) 2022 akhirnya dapat dihadiri penonton secara langsung. Berapa harga tiketnya?  https://t.co/jolPBMB02U,2,0,2,0,2022-01-12,8,Wednesday,3,4,0
1481182098207686661,2022-01-12 08:31:45,Armand Maulana menangis dengar lagu Sampai Akhir Zaman ciptaan HIndia dan Rayhan Noor. https://t.co/E354TDA7FI,7,0,1,0,2022-01-12,8,Wednesday,3,8,0
1481182080587419656,2022-01-12 08:31:41,"Agar stamina dan energi tetap terjaga setelah vaksinasi booster Covid-19, dianjurkan mengonsumsi makanan dan minuman sehat. Apa saja ya? https://t.co/ObCelLUsB9",4,1,4,0,2022-01-12,8,Wednesday,3,8,1
1481181491191287811,2022-01-12 08:29:21,"Kebiri kimia adalah salah satu tuntutan hukuman terhadap Herry Wirawan, terdakwa pemerkosa 13 santriwati di Bandung. Begini prosedurnya:  https://t.co/TfIfA2lis8",28,7,0,0,2022-01-12,8,Wednesday,3,28,7
1481181467090821120,2022-01-12 08:29:15,"Persib Bandung akan melawan tim kuat, Bali United, di lanjutan BRI Liga 1 2021/2022. Maung Bandung tak cuma mewaspadai Ilija Spasojevic di laga itu.  https://t.co/iOLQC2rOZ2",5,0,0,0,2022-01-12,8,Wednesday,3,5,0
1481180905368604675,2022-01-12 08:27:01,Menteri Koordinator Bidang Kemaritiman dan Investasi Luhut Binsar Pandjaitan mengatakan ketidakpastian menaungi perekonomian di tahun 2022. https://t.co/4IrcRsAhDg,1,2,0,0,2022-01-12,8,Wednesday,3,1,2
1481180633737093121,2022-01-12 08:25:56,"Jerzy Dudek, eks kiper Real Madrid ini kenang kisahnya di Liga Spanyol. Satu hal yang selalu Dudek ingat, kala Lionel Messi selalu galak sama Ramos dan Pepe!  https://t.co/OskPINYKCL",6,0,0,0,2022-01-12,8,Wednesday,3,6,0
1481180621808484354,2022-01-12 08:25:53,"Pengumuman! Kamu sedang mencari pekerjaan? Shopee tengah membuka banyak lowongan kerja, nih. Cek yuk! https://t.co/jW8oOoUX6S",57,8,24,4,2022-01-12,8,Wednesday,3,81,12
1481180352303480836,2022-01-12 08:24:49,"Kader PDIP, Nasyirul Falah Amru atau Gus Falah, masuk kepengurusan PBNU era Gus Yahya Staquf. Gus Falah didapuk jadi wakil bendahara. https://t.co/uHnfK68wGc",2,2,1,1,2022-01-12,8,Wednesday,3,3,3
1481180083335405572,2022-01-12 08:23:45,Baru-baru ini aksi pelemparan batu kepada pengguna jalan terjadi di ruas Jalan Tol Belawan-Medan-Tj Morawa (Belmera). https://t.co/i95Suwbz8y,3,0,0,0,2022-01-12,8,Wednesday,3,3,0
1481180057599160324,2022-01-12 08:23:39,Ardhito Pramono membuat heboh setelah dikabarkan ditangkap oleh polisi gegara kasus narkoba. Lawan main Jefri Nichol itu tengah disibukkan dengan film baru. Ini potretnya:  https://t.co/5daApapA2l,24,4,4,3,2022-01-12,8,Wednesday,3,28,7
1481179499010084864,2022-01-12 08:21:26,"Indonesia Patriots diharapkan tampil baik di setiap laga IBL 2022. Catatan musim lalu, jadi modal mereka agar tak sekadar numpang lewat.  https://t.co/xNKk6TOCsq",4,1,0,0,2022-01-12,8,Wednesday,3,4,1
1481178931315331076,2022-01-12 08:19:10,"Majelis Hakim Pengadilan Negeri Jakarta Timur menolak eksepsi atau nota keberatan Eks Sekretaris FPI, Munarman dalam kasus dugaan terorisme. Sidang berlanjut ke tahap pemeriksaan saksi dari penuntut umum. https://t.co/aCDkQ8eqal",35,3,6,5,2022-01-12,8,Wednesday,3,41,8
1481177505222516737,2022-01-12 08:13:30,"Kerap kali, suporter sepakbola rusuh dan saling baku hantam di luar stadion. Kalau di Italia ini, justru di atas kapal!  https://t.co/b0SIYyP5Wu",37,7,20,5,2022-01-12,8,Wednesday,3,57,12
1481176904237465601,2022-01-12 08:11:07,"Pemain sepak bola Indonesia, Pratama Arhan menarik perhatian para wanita karena aksinya di lapangan hijau. Sang kekasih pun mengaku tak cemburu jika sang kekasih banyak yang suka!  https://t.co/p0WRzqfp90",19,1,5,1,2022-01-12,8,Wednesday,3,24,2
1481176373809061889,2022-01-12 08:09:01,"Setiap tahun, selalu ada petarung baru yang mencuri perhatian di UFC. Tahun 2022 ini, setidaknya siap-siap melihat 10 petarung ini!  https://t.co/QQjv8Nh252",5,0,2,0,2022-01-12,8,Wednesday,3,7,0
1481176364426629122,2022-01-12 08:08:58,"⚡️ “detiktif” by @detikcom 

#detiktif adalah program jurnalisme kolaboratif yang melibatkan peran serta pembaca detikcom atau detikers. Pembaca bisa terlibat aktif memberikan informasi suatu isu yang sedang diberitakan #detiktif. 

Selengkapnya di: https://t.co/MTF8X8xFtm",2,0,2,0,2022-01-12,8,Wednesday,3,4,0
1481175599561551874,2022-01-12 08:05:56,"Bersiap menjadi tuan rumah Olimpiade, China sangat mewaspadai kasus baru corona. Strategi 'nol-COVID' masih dipertahankan dengan menerapkan lockdown terarah.  https://t.co/qGWlwVv68P",2,0,1,0,2022-01-12,8,Wednesday,3,3,0
1481175598273896449,2022-01-12 08:05:56,Pelaku beraksi dengan mengaku dukun pengobatan alternatif. Begini tampangnya: https://t.co/0sjfbQdC0V,6,0,2,0,2022-01-12,8,Wednesday,3,8,0
1481174942687416322,2022-01-12 08:03:19,Polisi saat ini masih mengembangkan keterangan Ardhito Pramono. https://t.co/GkTMxfpCX8,9,0,2,0,2022-01-12,8,Wednesday,3,11,0
1481174316293177344,2022-01-12 08:00:50,Ardhito Pramono ditangkap polisi karena narkoba. Ia diamankan di kediamannya. #ArdhitoPramono  https://t.co/l7LaKHXIKm,126,32,24,60,2022-01-12,8,Wednesday,3,150,92
1481174313864777731,2022-01-12 08:00:49,"Begini penampilan Nia Ramadhani saat menghadiri sidang putusan atas kasus narkoba di Pengadilan Negeri Jakarta Pusat pada Selasa, 11 Januari 2022. https://t.co/f4kdqmnw7S",3,2,1,0,2022-01-12,8,Wednesday,3,4,2
1481173980258226181,2022-01-12 07:59:30,"Anies mengunggah momen saat menyambangi Kampung Guji Baru, Jakbar. Anies mengakui saat masa kampanye lalu sempat meneken kontrak politik dengan warga di sana. https://t.co/5nzhuwo7VL",7,5,1,0,2022-01-12,7,Wednesday,3,8,5
1481173741036048388,2022-01-12 07:58:33,Calon suami Melanie Putria sudah diperbolehkan pulang ke rumah usai operasi tumor otak. https://t.co/FIQV5VbBkS,5,0,1,0,2022-01-12,7,Wednesday,3,6,0
1481173260154904577,2022-01-12 07:56:38,Rencana PP PBSI untuk membentuk desentralisasi Pelatnas akhirnya terwujud. Sumatra Utara menjadi lokasi khusus wilayah bagian barat Indonesia.  https://t.co/onxcJFLBSA,2,0,1,0,2022-01-12,7,Wednesday,3,3,0
1481173232434790408,2022-01-12 07:56:32,"Sesosok mayat gadis remaja SAR (14) ditemukan disimpan dalam rumahnya di Pemalang, selama dua bulan. Polisi mengungkap hasil pemeriksaan. https://t.co/cgkJ4azXmh",8,1,1,0,2022-01-12,7,Wednesday,3,9,1
1481172681907187716,2022-01-12 07:54:20,RSDC Wisma Atlet menambah ruang isolasi pasien untuk menghadapi gelombang omicron. https://t.co/BpgWRr4JIv,13,1,7,2,2022-01-12,7,Wednesday,3,20,3
1481172652014321665,2022-01-12 07:54:13,"Beredar video hoaks, terkait pesawat Garuda Indonesia yang kesulitan melakukan pendaratan. Kebenarannya ialah itu salah satu cuplikan dari game X-Plane 11. Duh! https://t.co/Q07rw7sdr0",14,8,3,3,2022-01-12,7,Wednesday,3,17,11
1481172133610991617,2022-01-12 07:52:10,"Saldo dana haji yang dikelola BPKH pada tahun 2021 sebesar Rp 158,88 triliun atau meningkat 9,64% meningkat dibandingkan tahun 2020 sebesar Rp 144,91 triliun. https://t.co/sXWbdEBOhE",8,10,3,3,2022-01-12,7,Wednesday,3,11,13
1481171997438746625,2022-01-12 07:51:37,Kasat Narkoba Polres Metro Jakarta Barat AKBP Danang Setiyo membenarkan aktor film layar lebar yang ditangkap karena narkoba jenis ganja adalah Ardhito Pramono. https://t.co/yusBPUVRHH,253,58,45,66,2022-01-12,7,Wednesday,3,298,124
1481171813258383360,2022-01-12 07:50:53,Angel Lelga heran kerap diminta jadi duta produk dan klinik kecantikan. Ia lalu bagikan rahasianya ini:  https://t.co/DbJb0OkjxJ,0,0,0,0,2022-01-12,7,Wednesday,3,0,0
1481170266302648320,2022-01-12 07:44:44,"Polisi kembali menangkap artis terkait dugaan penyalahgunaan narkoba. Kali ini, artis yang diamankan berinisial AP adalah Ardhito Pramono.  https://t.co/ILLT8yS5QD",584,144,163,416,2022-01-12,7,Wednesday,3,747,560
1481169765574090756,2022-01-12 07:42:45,Polisi menangkap artis inisial AP terkait kasus narkoba. AP adalah Ardhito Pramono. https://t.co/rbDFgYxP1R,7968,1412,1628,3607,2022-01-12,7,Wednesday,3,9596,5019
1481169745567260674,2022-01-12 07:42:40,"Meski jumlah kasus Corona dan rawat inap mencetak rekor tertinggi, AS disebut mendekati 'ambang' transisi menuju kehidupan dengan Corona yang bisa dikendalikan. https://t.co/HwFQhvZxOx",5,0,1,0,2022-01-12,7,Wednesday,3,6,0
1481169216137015301,2022-01-12 07:40:34,Warga twitter dihebohkan dengan penampakan es krim yang mirip dengan sup ayam. Bukan sup ayam sungguhan ternyata ini nama asli makanan tersebut. https://t.co/NQUC6Z8Eff,9,0,1,1,2022-01-12,7,Wednesday,3,10,1
1481168947558899712,2022-01-12 07:39:30,#Foto Sejumlah artis Korea menyihir netizen dengan kecantikannya. Inilah deretan artis Korea yang dinilai paling cantik saat ini. Ada idola kamu? https://t.co/jMrGOiozmK,6,0,0,0,2022-01-12,7,Wednesday,3,6,0
1481168480909074438,2022-01-12 07:37:39,"Momentum digitalisasi jadi peluang baru bagi UMKM untuk tetap bertahan, bahkan bangkit dan berkembang di sepanjang tahun 2021 yang didera pandemi. https://t.co/OdEvSfAtFN",3,1,2,0,2022-01-12,7,Wednesday,3,5,1
1481168459690086401,2022-01-12 07:37:34,Agenda sidang mediasi hak perwalian Gala Sky Ardiansyah berlanjut hari ini. Ternyata ini alasan Doddy Sudrajat nggak hadir sidang perwalian Gala Sky:  https://t.co/m2y1KgB0vc,2,1,3,0,2022-01-12,7,Wednesday,3,5,1
1481167941114732546,2022-01-12 07:35:30,Induk perusahaan Facebook Meta akan mewajibkan seluruh karyawannya di Amerika Serikat untuk vaksinasi booster COVID-19 sebelum kembali berkeja di kantor. https://t.co/UqikY0CrG9,15,0,4,0,2022-01-12,7,Wednesday,3,19,0
1481166973887455232,2022-01-12 07:31:39,"Baca berita selengkapnya ""Orang RI Lebih Bahagia Tinggal di Rumah Dinas dari Milik Sendiri"" di sini. https://t.co/mLxiE6gMBj",2,0,2,2,2022-01-12,7,Wednesday,3,4,2
1481166784036491265,2022-01-12 07:30:54,"Nilai kepuasan penduduk atau orang yang tinggal di suatu rumah ini berdasarkan beberapa variabel, yaitu status penguasaan bangunan tempat tinggal yang ditempati, jenis lantai terluas, jenis dinding terluas, atap terluas, dan sumber penerangan utama yang digunakan.",1,1,1,0,2022-01-12,7,Wednesday,3,2,1
1481166694865600517,2022-01-12 07:30:33,"Orang yang tinggal di rumah kontrak/sewa dengan nilai kepuasan terhadap rumah dan fasilitas rumah sebesar 71,48%. Pada urutan terakhir adalah nilai kepuasan orang yang tinggal di tempat tinggal dengan status bebas sewa sebesar 70,48%.",0,1,0,0,2022-01-12,7,Wednesday,3,0,1
1481166657439547392,2022-01-12 07:30:24,"Polisi mengungkap AP adalah seorang pemain film, penyanyi sekaligus penulis lagu. https://t.co/9MJWyf0730",119,78,22,34,2022-01-12,7,Wednesday,3,141,112
1481166601420701703,2022-01-12 07:30:11,"Sementara itu, orang yang bertempat di rumah milik sendiri ada di urutan kedua dengan nilai kepuasan terhadap rumah dan fasilitas rumah sebesar 74,01%.",0,1,0,0,2022-01-12,7,Wednesday,3,0,1
1481166557589946369,2022-01-12 07:30:00,"Sudimah Wiro Sartono, pengusaha kuliner legendaris yang dikenal dengan sebutan Jadah Tempe Mbah Carik tutup usia. Begini sosok legenda jadah tempe Kaliurang itu: https://t.co/BbTL38woGA",8,1,5,0,2022-01-12,7,Wednesday,3,13,1
1481166507438911488,2022-01-12 07:29:48,"Sementara itu, orang yang bertempat di rumah milik sendiri ada di urutan kedua dengan nilai kepuasan terhadap rumah dan fasilitas rumah sebesar 74,01%.",0,1,0,0,2022-01-12,7,Wednesday,3,0,1
1481166452166123520,2022-01-12 07:29:35,Kasus penyalahgunaan narkoba di kalangan artis kembali terjadi. Polisi kali ini mengamankan bintang film inisial AP terkait kasus narkoba. https://t.co/ineVQAjFut,6,5,2,0,2022-01-12,7,Wednesday,3,8,5
1481166438039961603,2022-01-12 07:29:32,"Dari data yang dirilis oleh BPS, dikutip Rabu (12/1/2022), nilai kepuasan orang yang tinggal di rumah dinas mencapai 79,95%. Angka itu merupakan nilai kepuasan terhadap rumah dan fasilitasnya.",0,1,0,0,2022-01-12,7,Wednesday,3,0,1
1481166371191128065,2022-01-12 07:29:16,"Dalam Publikasi Indeks Kebahagiaan 2021, orang Indonesia ternyata lebih senang tinggal di rumah dinas.",3,1,0,0,2022-01-12,7,Wednesday,3,3,1
1481166267893825537,2022-01-12 07:28:51,"Tempat tinggal di Indonesia dibagi ke dalam beberapa jenis, mulai dari milik sendiri, kontrak, bebas sewa hingga rumah dinas.",2,1,0,0,2022-01-12,7,Wednesday,3,2,1
1481165806557876225,2022-01-12 07:27:01,"Founder and Chairman CT Corpora sekaligus Ultimate Shareholder Allo Bank, Chairul Tanjung menjamin harga saham Allo Bank akan terjaga. https://t.co/Ydrxm4B9PA",4,0,2,0,2022-01-12,7,Wednesday,3,6,0
1481165786240716802,2022-01-12 07:26:56,Untuk menangkap siaran TV digital diperlukan TV dan STB yang mendukung Digital Video Broadcasting-Second Generation Terrestrial. Ini penjelasan DVB-T2:  https://t.co/0GqjwK9JUb,5,0,2,0,2022-01-12,7,Wednesday,3,7,0
1481165453498413060,2022-01-12 07:25:37,"BPS baru saja merilis indeks kebahagiaan pada akhir tahun lalu.

Dilihat dari kondisi rumah yang mereka tempati, ternyata mayoritas masyarakat Indonesia paling bahagia tinggal di rumah dinas.

#THREAD https://t.co/tr8PRHZkAd",13,4,6,4,2022-01-12,7,Wednesday,3,19,8
1481165274292400129,2022-01-12 07:24:54,Indra Lesmana dan Aksan Sjuman membesut brand audio bernama LSR. Speaker studio monitor Java Series jadi produk perdananya.  https://t.co/M8PzlG7xZr,4,0,1,0,2022-01-12,7,Wednesday,3,5,0
1481164412257976322,2022-01-12 07:21:29,Lagi jadi tren nih! Dunia metaverse kini sudah semakin populer dan banyak diminati banyak orang. Begini faktanya: https://t.co/a1Uv8uvwr2,15,3,7,6,2022-01-12,7,Wednesday,3,22,9
1481164390053339141,2022-01-12 07:21:23,Kasus penyalahgunaan narkoba di kalangan artis kembali terjadi. Polisi kali ini mengambil bintang film inisial AP terkait kasus narkoba. https://t.co/Xl7VH3fch8,41,35,4,22,2022-01-12,7,Wednesday,3,45,57
1481163875869417473,2022-01-12 07:19:21,Giliran Zikri Daulay bicara soal hubungannya dengan Ayu Aulia. Zikri Daulay juga kembali meminta maaf. https://t.co/HRgNgoEHz1,3,0,1,0,2022-01-12,7,Wednesday,3,4,0
1481163849835364354,2022-01-12 07:19:15,"Heboh di media sosial gangster menyatroni sebuah klinik di Tigaraksa, Kabupaten Tangerang, Banten. Sambil menggunakan senjata tajam berupa celurit, mereka melakukan pencurian terhadap 2 orang remaja. https://t.co/f8QusAAtCT",4,0,2,0,2022-01-12,7,Wednesday,3,6,0
1481163191803600898,2022-01-12 07:16:38,Pemerintah hari ini memberikan vaksin booster COVID-19 untuk masyarakat. Ada beberapa hal yang dipersiapkan sebelum menerima vaksin. Apa saja? https://t.co/JAP8vYJqNS,1,0,2,0,2022-01-12,7,Wednesday,3,3,0
1481163132949118979,2022-01-12 07:16:24,Aset PT Timor Putra Nasional (TPN) milik Hutomo Mandala Putra alias Tommy Soeharto yang dilelang nggak laku! https://t.co/dJlNLtI0zH,25,21,3,3,2022-01-12,7,Wednesday,3,28,24
1481162513446285313,2022-01-12 07:13:56,"Setelah sempat melandai sejak awal pekan ini, hari ini harga emas batangan 24 karat tersebut naik Rp 6.000. Jadi segini harganya kalau mau beli: https://t.co/8z5meJUJKi",5,1,2,1,2022-01-12,7,Wednesday,3,7,2
1481161953158610944,2022-01-12 07:11:42,"Menteri Koordinator Bidang Maritim dan Investasi Luhut Binsar Pandjaitan menyebut Tidak menutup kemungkinan varian Omicron akan menimbulkan gelombang baru, termasuk di Indonesia.  https://t.co/EoCjsOv15A",3,0,1,2,2022-01-12,7,Wednesday,3,4,2
1481161706084651010,2022-01-12 07:10:44,Etalase di sejumlah supermaket AS tampak kosong dari bahan makanan. Warga pun kesulitan mendapat bahan makanan imbas lonjakan kasus COVID-19 dan cuaca buruk. https://t.co/tius1Ymz1m,8,0,3,0,2022-01-12,7,Wednesday,3,11,0
1481161201300250635,2022-01-12 07:08:43,Vaksin booster COVID-19 mulai diberikan kepada lansia di Sukabumi hari ini. Jenis vaksin yang diberikan yakni AstraZeneca. https://t.co/aqHJvkDFtK,12,0,1,0,2022-01-12,7,Wednesday,3,13,0
1481160963713908741,2022-01-12 07:07:47,Kehadiran konektivitas 5G memungkinkan penggunaan teknologi digital yang kian canggih. Jaringan internet 5G membuat aktivitas mobile selangkah lebih maju. https://t.co/dJCsT7F5gr,5,0,1,0,2022-01-12,7,Wednesday,3,6,0
1481160437974642690,2022-01-12 07:05:41,"Setiap bulan, wanita pada usia produktif akan mengalami siklus haid. Ternyata saat periode ini, wanita terlihat lebih gemuk dan mengalami kenaikan berat badan. https://t.co/ZzCw4ypSDZ",4,1,1,0,2022-01-12,7,Wednesday,3,5,1
1481160211037573120,2022-01-12 07:04:47,"BPKH telah resmi menjadi pemegang saham mayoritas PT Bank Muamalat Indonesia Tbk. Kini BPKH memiliki 82,7% saham Bank Muamalat. https://t.co/FtlMpMOtNc",7,0,1,0,2022-01-12,7,Wednesday,3,8,0
1481159665752887299,2022-01-12 07:02:37,"Epidemiolog Dicky Budiman memprediksi gelombang ketiga pandemi COVID-19 pertama kali akan menerpa Jawa-Bali, diikuti Sumatera atau Sulawesi. https://t.co/30ve7RGIwS",4,0,1,0,2022-01-12,7,Wednesday,3,5,0
1481159052583444484,2022-01-12 07:00:11,"Kementerian Kesehatan memulai program penyuntikan vaksin booster COVID-19, Rabu 12 Januari 2022. Simak informasi jadwal, lokasi, cek tiket, dan jenis vaksin: https://t.co/kZcacN1P1d",8,0,4,1,2022-01-12,7,Wednesday,3,12,1
1481158440143794178,2022-01-12 06:57:45,"Surah Al Maidah ayat 2-3 mencakup sejumlah aturan dan makanan yang diharamkan dalam Islam. Ini bacaan lengkap surah Al Maidah ayat 2-3 beserta latin dan artinya.

via: detikedu https://t.co/DIvJENVeB9",16,2,3,1,2022-01-12,6,Wednesday,3,19,3
1481157947891896324,2022-01-12 06:55:48,"Eks Menkes Terawan Agus Putranto memperoleh gelar Profesor Kehormatan Ilmu Pertahanan Bidang Kedokteran Militer, Fakultas Kedokteran Militer dari Unhan. https://t.co/guB2sD8Hii",38,0,3,0,2022-01-12,6,Wednesday,3,41,0
1481157697235992580,2022-01-12 06:54:48,"Pemberian booster vaksin mulai dilakukan di fasilitas kesehatan hari ini. Jika belum dapat tiket di PeduliLindungi, boleh nggak sih datang langsung? https://t.co/uSGenqS0Lz",5,0,2,0,2022-01-12,6,Wednesday,3,7,0
1481156842780860421,2022-01-12 06:51:24,"Viral di media sosial cerita soal driver ojol yang dipukul dan dicueki oleh oknum polisi di Polsek Cileungsi, Bogor. Kini oknum tersebut sudah diproses hukum. https://t.co/0hNgfxVUEb",41,9,15,8,2022-01-12,6,Wednesday,3,56,17
1481156823214399488,2022-01-12 06:51:19,"Take-Two Interactive mengumumkan rencananya untuk mengakuisisi Zynga, pengembang berbagai game mobile seperti FarmVille senilai USD 12,7 miliar. https://t.co/7Mzbiea0Rz",0,0,0,0,2022-01-12,6,Wednesday,3,0,0
1481155790408986625,2022-01-12 06:47:13,"Mengawali 2022, LG menghadirkan jajaran AC New Hercules di pasar Indonesia. Penyejuk ruangan ini diklaim bisa hemat listrik sehingga tak bikin boncos. https://t.co/EHuM27G0Gw",1,1,1,0,2022-01-12,6,Wednesday,3,2,1
1481155553648955393,2022-01-12 06:46:17,"Pihak kepolisian tidak masalah jika mobil menggunakan roof box, asalkan.. https://t.co/Kv30qwxuFX",4,1,1,1,2022-01-12,6,Wednesday,3,5,2
1481155246462283776,2022-01-12 06:45:03,H Faisal masih buka pintu damai soal kasus perwalian Gala Sky. Hal itu terjadi usai mediasi gagal. https://t.co/4eceRyYzFt,4,1,0,0,2022-01-12,6,Wednesday,3,4,1
1481155231786405888,2022-01-12 06:45:00,"Beberapa hobi tidak hanya sebatas hiburan tapi bisa dijadikan peluang menghasilkan cuan lho. Apa saja hobi itu?

via: detikedu https://t.co/JbTbJluTH7",2,1,0,0,2022-01-12,6,Wednesday,3,2,1
1481154551700987904,2022-01-12 06:42:18,Sel T tingkat tinggi dari virus Corona flu biasa dapat memberikan perlindungan terhadap COVID-19. Ini penjelasannya:  https://t.co/gD6BKUUe3J,4,0,3,0,2022-01-12,6,Wednesday,3,7,0
1481154375963881479,2022-01-12 06:41:36,Karyawan Garuda tergabung Serikat Karyawan PT Garuda Indonesia mendukung langkah Menteri BUMN Erick Thohir membongkar dugaan korupsi di Garuda Indonesia. https://t.co/EWahVfX3NB,6,1,0,1,2022-01-12,6,Wednesday,3,6,2
1481154352748322816,2022-01-12 06:41:30,Generasi GIGIH membuka pendaftaran untuk peserta yang ingin menjadi talenta teknologi Indonesia sampai 23 Januari 2022. https://t.co/TH27xNO7zw,1,0,0,0,2022-01-12,6,Wednesday,3,1,0
1481153955828805632,2022-01-12 06:39:56,Berikut cara merawat AC mobil! https://t.co/1h98nhB14B,9,0,4,0,2022-01-12,6,Wednesday,3,13,0
1481153936530841601,2022-01-12 06:39:51,"Saat masuk di Garuda, Emirsyah harus menangani keuangan perusahaan yang di ambang kebangkrutan. Seperti apa rekam jejaknya? https://t.co/hCTr4iXa1o",1,0,1,0,2022-01-12,6,Wednesday,3,2,0
1481153701763035141,2022-01-12 06:38:55,"Presiden Jokowi memberi tambahan Penyertaan Modal Negara (PMN) untuk PT PLN (Persero) sebesar Rp 4,2 triliun. https://t.co/xjHEVdpF6N",2,0,0,0,2022-01-12,6,Wednesday,3,2,0
1481153678266580997,2022-01-12 06:38:50,Otoritas Hak Cipta di China mengumumkan untuk platform musik digital tidak lagi diizinkan untuk menandatangani kesepakatan hak cipta eksklusif. https://t.co/rIgWm8cKRe,4,0,0,1,2022-01-12,6,Wednesday,3,4,1
1481153434095173637,2022-01-12 06:37:51,Nindy Ayunda mendapat pesta kejutan dari seorang pria yang diketahui bernama Dito. Ini pria misterius pemikat hati Nindy Ayunda:  https://t.co/3FFAzquNb2,3,0,0,0,2022-01-12,6,Wednesday,3,3,0
1481153417674375169,2022-01-12 06:37:47,Mantan penyidik KPK AKP Stepanus Robin Pattuju alias Robin hari ini menjalani sidang vonis kasus suap. Robin berharap keadilan. https://t.co/p4SQfB63t5,3,0,2,0,2022-01-12,6,Wednesday,3,5,0
1481153121795645442,2022-01-12 06:36:37,Vivo memastikan kehadiran jagoan baru yang akan berlaga di pasar Indonesia 2022 ini. Ponsel tersebut bernama Vivo V23 5G dan akan membawa tampilan unik. https://t.co/KecBw6g8YA,4,0,1,0,2022-01-12,6,Wednesday,3,5,0
1481153106180202496,2022-01-12 06:36:33,"Virus corona varian omricon sudah masuk ke Jawa Barat, salah satu keluarga di Kabupaten Bandung terpapar virus ini. Pemerintah Kota Bandung pastikan akan mengantisipasi terjadinya penyebaran varian omicron ini di Kota Bandung. https://t.co/4GuOgJXrGW",3,0,1,2,2022-01-12,6,Wednesday,3,4,2
1481152890072932352,2022-01-12 06:35:42,Satu unit Jeep Wrangler Rubicon tengah dilelang negara. Seperti ini kondisinya. https://t.co/JZFH58QZNB,19,0,0,1,2022-01-12,6,Wednesday,3,19,1
1481152866647748612,2022-01-12 06:35:36,"Mau kuliah di jurusan manajemen? Sebelum menentukan kampus, cek dulu daftar universitas dengan jurusan manajemen terbaik di Indonesia berikut ya!

via: detikedu https://t.co/PKWEzMtDkR",4,0,0,0,2022-01-12,6,Wednesday,3,4,0
1481152638087479296,2022-01-12 06:34:42,"Berita terpopuler: Ada menu ayam bakar ini jadi viral karena harganya yang mahal. Lalu ada efek makan mie instan setiap hari, sampai buah untuk melancarkan BAB. https://t.co/E6ECOFseZv",5,0,0,0,2022-01-12,6,Wednesday,3,5,0
1481152621171949568,2022-01-12 06:34:38,"Jeff Bezos, pendiri Amazon dan orang terkaya kedua dunia, belakangan serius menggarap bisnis luar angkasa. Hal ini dipandang mencemaskan.  https://t.co/JuB84oweAb",12,0,4,0,2022-01-12,6,Wednesday,3,16,0
1481152356515467264,2022-01-12 06:33:34,Layanan ini termasuk upgrade untuk meningkatkan performa mobil. https://t.co/B8Q3i6KKXm,3,1,0,0,2022-01-12,6,Wednesday,3,3,1
1481152333803585538,2022-01-12 06:33:29,"Cut Meyriska kini tengah mengandung anak kedua. Rupanya, ia baru tahu sedang hamil setelah janin di kandungannya berumur 2 bulan. #CutMeyriska  https://t.co/UAh4egllRj",7,1,0,0,2022-01-12,6,Wednesday,3,7,1
1481149275606298627,2022-01-12 06:21:20,Mantan penyidik KPK AKP Stepanus Robin Pattuju alias Robin divonis 11 tahun penjara dan denda Rp 500 juta subsider 6 bulan kurungan. https://t.co/nttlMtPb7g,10,2,4,0,2022-01-12,6,Wednesday,3,14,2
1481148276837650435,2022-01-12 06:17:22,"Awal tahun 2022, Mitsubishi secara resmi meluncurkan Vision Ralliart Concept. Berikut tampang konsep yang serba hitam ini! https://t.co/Fzql2gDxaM",7,0,0,0,2022-01-12,6,Wednesday,3,7,0
1481148056280125443,2022-01-12 06:16:29,"Teh kombucha memiliki banyak manfaat kesehatan untuk tubuh. Namun, di balik manfaatnya itu terselip keraguan soal kehalalan mengonsumsi teh kombucha. https://t.co/Xxy0WB6YzB",6,1,0,0,2022-01-12,6,Wednesday,3,6,1
1481148033094008834,2022-01-12 06:16:24,Berikut syarat untuk bisa kamu menonton langsung MotoGP 2022 di Mandalika. https://t.co/Q4rVas9jEH,8,0,0,0,2022-01-12,6,Wednesday,3,8,0
1481147438354284547,2022-01-12 06:14:02,Peneliti mengungkap hal baru tentang helm bertanduk yang identik dengan Viking. Ternyata helm ini telah ada sejak zaman perunggu lho. https://t.co/eS85Yb1adT,8,0,1,1,2022-01-12,6,Wednesday,3,9,1
1481147190026321920,2022-01-12 06:13:03,TNI AL berhasil menangkap 3 kapal ikan ilegal berbendera Vietnam di Laut Natuna Utara. Ikan seberat hampir 1 ton berhasil disita. https://t.co/KTOms63O4n,6,1,1,0,2022-01-12,6,Wednesday,3,7,1
1481147174083829761,2022-01-12 06:12:59,"Foto ini sebenarnya biasa saja, tapi ketika ditilik terasa menakutkan dan mengerikan, berani untuk melihatnya? https://t.co/nq6lUBTEyA",3,0,0,1,2022-01-12,6,Wednesday,3,3,1
1481146946924556288,2022-01-12 06:12:05,Grandmaster tari berprestasi ini viral karena kisah cinta dengan muridnya sendiri yang berusia 11 tahun lebih muda. Seperti apa ya cerita cinta mereka? https://t.co/Tk6UXyAN6F,1,0,0,0,2022-01-12,6,Wednesday,3,1,0
1481146927349653506,2022-01-12 06:12:00,"Changpeng Zhao sendiri merupakan seorang pendiri dan CEO Binance, salah satu platform bursa mata uang kripto terbesar di dunia. https://t.co/92G3PSz4UM",4,1,0,0,2022-01-12,6,Wednesday,3,4,1
1481146401706975239,2022-01-12 06:09:55,#Foto Sejumlah selebriti melakukan pemotretan bayi mereka yang baru lahir dengan pakaian tradisional. Intip potret gemas 7 bayi ini yuk! https://t.co/675COQZGSv,2,0,1,0,2022-01-12,6,Wednesday,3,3,0
1481145870489997313,2022-01-12 06:07:48,Kapolres Karawang AKBP Aldi Subartono saat ini tengah memburu seorang ojol yang memakai sepeda ontel. Ada apa gerangan ? https://t.co/d8QIQQJjva,25,7,2,0,2022-01-12,6,Wednesday,3,27,7
1481145396185419777,2022-01-12 06:05:55,"Menjelang balapan MotoGP mendatang di Kawasan Mandalika, hotel-hotel sudah hampir ludes. Penginapannya bagus? https://t.co/2KlyXCbuJH",29,6,0,0,2022-01-12,6,Wednesday,3,29,6
1481145375838945281,2022-01-12 06:05:50,"Kim Sejeong diketahui membintangi sebuah drama berjudul 'The Office Blind Date'. Demi perannya itu, Kim Sejeong menjalani diet. Apa saja yang ia makan? https://t.co/CsWafC4jbF",62,0,13,0,2022-01-12,6,Wednesday,3,75,0
1481144878281146369,2022-01-12 06:03:51,"Vaksin Corona yang spesifik mengincar varian Omicron mungkin akan siap pada bulan Maret, salah satunya buatan Pfizer. https://t.co/mPjSNQUhjg",5,0,0,0,2022-01-12,6,Wednesday,3,5,0
1481144350801285120,2022-01-12 06:01:46,"Hanya dalam dua hari, Galaxy S21 FE langsung ludes dipesan di Indonesia. Tak heran kalau penjualan ponsel ini diklaim lebih baik dari pendahulunya. #GalaxyS21FE  https://t.co/mB11Ox5uZl",5,0,0,0,2022-01-12,6,Wednesday,3,5,0
1481144332463878145,2022-01-12 06:01:41,"""Kita harus tetap waspada dan hati-hati, kita harus siaga namun tidak perlu panik,"" kata Budi. https://t.co/gjNF7wYsmr",7,2,1,0,2022-01-12,6,Wednesday,3,8,2
1481143703024672769,2022-01-12 05:59:11,"NJKB Ford Bronco sudah ketahuan, kapan dijual? https://t.co/EGaaSNlm6S",6,1,2,0,2022-01-12,5,Wednesday,3,8,1
1481143460807774210,2022-01-12 05:58:14,Luhut Binsar Pandjaitan memprediksi puncak kasus varian Omicron di Indonesia terjadi awal Februari mendatang. Bagaimana prediksi dan skenarionya? https://t.co/l0UJRujF6j,54,79,7,13,2022-01-12,5,Wednesday,3,61,92
1481143229269557248,2022-01-12 05:57:18,Aset debitur dana Bantuan Likuiditas Bank Indonesia (BLBI) milik Hutomo Mandala Putra alias Tommy Soeharto dilelang hari ini. Mau ikutan? https://t.co/aw1L8ukDz6,27,3,1,4,2022-01-12,5,Wednesday,3,28,7
1481142980488667136,2022-01-12 05:56:19,PT Allo Bank Indonesia Tbk (BBHI) belakangan ini tengah menarik perhatian para pelaku pasar modal. Berikut fakta-fakta yang perlu kamu tahu: https://t.co/uPabS15HDQ,2,0,0,0,2022-01-12,5,Wednesday,3,2,0
1481142961433980940,2022-01-12 05:56:14,Marissya Icha sudah bicara langsung dengan Kemensos soal penggalangan donasi rumah Gala Sky. Marissya berharap tak ada lagi pihak yang bikin gaduh. https://t.co/IVlAlhojxM,0,0,0,0,2022-01-12,5,Wednesday,3,0,0
1481142467495972864,2022-01-12 05:54:17,Sempat dilarikan ke RS dan menjalani operasi kini kondisi pelawak Tukul Arwana sedang dalam proses penyembuhan intensif di rumahnya. Lekas pulih Tukul Arwana...  https://t.co/7RiuS24qdw,25,2,1,0,2022-01-12,5,Wednesday,3,26,2
1481142446780305410,2022-01-12 05:54:12,Tukul Arwana masih menjalani terapi agar kesehatannya pulih seperti sedia kala. Ini kondisi terkini Tukul Arwana:  https://t.co/Snog7f26ua,7,0,0,0,2022-01-12,5,Wednesday,3,7,0
1481142209286127618,2022-01-12 05:53:15,"Kopi panas dan es kopi sama-sama jadi favorit banyak orang, namun dari sisi nutrisi, mana sih yang lebih sehat? Begini penjelasan ilmiahnya. https://t.co/WPeJ8maQAg",8,1,0,1,2022-01-12,5,Wednesday,3,8,2
1481142192584409088,2022-01-12 05:53:11,Hanung Bramantyo jalani operasi saraf kejepit hari ini. Hal itu disampaikan Zaskia Adya Mecca. Lekas pulih Hanung Bramantyo...  https://t.co/G4k77MpVt7,5,0,1,0,2022-01-12,5,Wednesday,3,6,0
1481141988770684928,2022-01-12 05:52:23,"Jika tak banyak punya waktu untuk membuat sarapan, bikin saja orak-arik telur. Bisa dipadukan dengan tomat, jamur atau kucai. Nih, resepnya: https://t.co/f4l7IgfHLe",6,0,1,1,2022-01-12,5,Wednesday,3,7,1
1481141644753883139,2022-01-12 05:51:01,"Majelis Hakim Pengadilan Negeri Jakarta Timur menolak eksepsi Eks Sekretaris FPI, Munarman dan penasihat hukumnya dalam kasus dugaan terorisme. Munarman meminta jaksa untuk menyerahkan BAP para saksi sebelum sidang digelar. https://t.co/PKWZU2dglk",1,1,1,0,2022-01-12,5,Wednesday,3,2,1
1481141627003588610,2022-01-12 05:50:56,"SMA Pradita Dirgantara buka penerimaan peserta didik baru tahun 2022/2023, uang sekolah gratis hingga fasilitas asrama. Cek yuk syarat dan jalurnya:

via: detikedu https://t.co/76UDqDW4uQ",6,0,2,0,2022-01-12,5,Wednesday,3,8,0
1481141394571935748,2022-01-12 05:50:01,"Nia Ramadhani, Ardi Bakrie, dan Zen Vivanto divonis 1 tahun penjara di kasus narkoba. Apakah Nia Ramadhani dkk langsung ditahan di penjara? https://t.co/L9OjLm006h",3,3,2,3,2022-01-12,5,Wednesday,3,5,6
1481141372581203968,2022-01-12 05:49:56,Berikut bocoran mobil Ford yang akan muncul di tahun ini! https://t.co/2aP4QsQ855,9,0,0,0,2022-01-12,5,Wednesday,3,9,0
1481139827068309504,2022-01-12 05:43:47,"Melesaknya sejumlah lembaga riset ke dalam BRIN dianggap menggiring langkah penelitian Indonesia menuju kesuraman.

Baca selengkapnya di https://t.co/QzTav2LRME https://t.co/oGEPe63irp",11,1,7,3,2022-01-12,5,Wednesday,3,18,4
1481139480463613952,2022-01-12 05:42:25,Kementerian Kesehatan mencatat penambahan 92 kasus Omicron. Total pasien Omicron di Indonesia yang dilaporkan sejauh ini berjumlah 506 orang. https://t.co/Me3AlbIrZD,2,0,4,1,2022-01-12,5,Wednesday,3,6,1
1481139221486256128,2022-01-12 05:41:23,"Hadir sejak 2016, alasan Maya mengembangkan resep keluarganya karena ingin menjual makanan jenis ayam berbeda dari makanan-makanan ayam yang tren saat ini. https://t.co/d9SyARYDm2",7,0,3,0,2022-01-12,5,Wednesday,3,10,0
1481138671579541505,2022-01-12 05:39:12,Kasus Omicron di Indonesia mengalami peningkatan. Kemenkes menyebut kasus Omicron di RI sudah mulai mendominasi. https://t.co/TSSqJ5x7vd,7,0,2,2,2022-01-12,5,Wednesday,3,9,2
1481138095231840257,2022-01-12 05:36:54,Menteri BUMN Erick Thohir menyerahkan bukti dugaan korupsi ke Kejaksaan Agung (Kejagung). Bagaimana kinerja keuangan Garuda Indoneisa? https://t.co/SwoB65HNm6,13,4,2,1,2022-01-12,5,Wednesday,3,15,5
1481137608671567872,2022-01-12 05:34:58,PN Jakarta Selatan menggelar sidang pemeriksaan saksi ahli dalam kasus Unlawful Killing laskar FPI. Saksi ahli dari Pindad mengungkap hasil pemeriksaan barang bukti senjata dan peluru dalam insiden pembunuhan laskar FPI di KM 50. https://t.co/xhwmpUhMyG,7,1,5,0,2022-01-12,5,Wednesday,3,12,1
1481137352043110401,2022-01-12 05:33:57,Kaka Nia Ramadhani ikut sedih mendengar vonis yang dibacakan hakim untuk sang adik. Thalita Nugroho ungkap penyesalannya:  https://t.co/a3QXq5zCPD,2,1,1,0,2022-01-12,5,Wednesday,3,3,1
1481136866112024576,2022-01-12 05:32:01,"Marissya Icha sebut Medina Zein sampaikan permintaan maaf kepada dirinya, usai jadi tersangka atas pencemaran nama baik yang ia laporkan. Atas hal tersebut, Marissya bersikeras tak akan mencabut laporan. https://t.co/RYgwaEMbxz",4,0,1,0,2022-01-12,5,Wednesday,3,5,0
1481136280842997760,2022-01-12 05:29:42,Sean Gelael meresmikan kepindahannya ke tim juara FIA WEC 2021 WRT. Pebalap Indonesia itu berharap bisa mengulang sukses WRT musim lalu.  https://t.co/XeT5kYbcIW,7,1,0,0,2022-01-12,5,Wednesday,3,7,1
1481136260580364290,2022-01-12 05:29:37,"Wali Kota Sukabumi, Achmad Fahmi geram lantaran kolam di alun-alun Sukabumi yang tak jauh berada dari Masjid Agung beralih fungsi. Kolam ikan itu justru dipakai untuk berenang anak-anak. https://t.co/ZQBTT9iS4p",4,4,1,1,2022-01-12,5,Wednesday,3,5,5
1481135743338749955,2022-01-12 05:27:34,"""Tidak ada alasan dan harapan harga gas bisa turun dalam waktu dekat,"" https://t.co/Syy6fS19y1",3,1,0,0,2022-01-12,5,Wednesday,3,3,1
1481135726964228105,2022-01-12 05:27:30,"Bagi kamu yang baru saja lulus Sarjana (S1) dan segera ingin berkarir, perhatikan informasi lowongan pekerjaan yang satu ini. Begini cara daftarnya: https://t.co/CclWiWUcTY",12,0,2,0,2022-01-12,5,Wednesday,3,14,0
1481134959318478853,2022-01-12 05:24:27,Google menuding Apple mengambil keuntungan dari bullying dan peer pressure di iMessage untuk membuat pengguna Android beralih ke iPhone. https://t.co/3k9txCZSCf,5,1,0,0,2022-01-12,5,Wednesday,3,5,1
1481134393439698946,2022-01-12 05:22:12,"Mohamed Salah menyatakan keinginan untuk bertahan di Liverpool lebih lama. Salah nggak minta aneh-aneh, sepertinya sih cuma kenaikan gaji dengan angka segini.  https://t.co/RZVFPwNw75",8,1,0,0,2022-01-12,5,Wednesday,3,8,1
1481134375471362048,2022-01-12 05:22:07,Wanna One akan kembali menyapa fans dengan formasi penuh lewat perilisan lagu. Mereka dikonfirmasi akan merilis Beautiful (Part III) pada 27 Januari. #WannaOne  https://t.co/zSYmIudkXO,9,1,2,0,2022-01-12,5,Wednesday,3,11,1
1481133858833772545,2022-01-12 05:20:04,"Baru-baru ini, pemerintah Inggris mendapatkan sejumlah tekanan untuk menaikkan pajak pada perusahaan minyak dan gas (migas), seperti BP dan Shell. https://t.co/w0fZ2IpOCW",3,0,0,1,2022-01-12,5,Wednesday,3,3,1
1481133090269503488,2022-01-12 05:17:01,Adam Deni menyebut Jerinx tertekan sampai berniat bunuh diri setelah ia laporkan ke polisi. Pengacara membantah. https://t.co/kM9OAzRu9y,5,1,0,0,2022-01-12,5,Wednesday,3,5,1
1481133070170439680,2022-01-12 05:16:56,Proses bersih-bersih di PT Garuda Indonesia (Persero) Tbk terus dilakukan. Begini fakta-faktanya: https://t.co/Q0iWcmwPGB,5,0,1,1,2022-01-12,5,Wednesday,3,6,1
1481132778897002498,2022-01-12 05:15:47,Target operasi kereta LRT Jabodebek untuk masyarakat umum molor lagi. Kapan rencananya? https://t.co/pD0csu32ub,3,0,2,0,2022-01-12,5,Wednesday,3,5,0
1481132416098086915,2022-01-12 05:14:20,Ketua Umum PBNU Yahya Cholil Staquf mengumumkan kepengurusan PBNU periode 2022-2027. Said Aqil Siroj dan adiknya masuk kepengurusan. https://t.co/1Ig97Z1MvR,4,2,0,0,2022-01-12,5,Wednesday,3,4,2
1481131944423346176,2022-01-12 05:12:28,"Pola makan merupakan salah satu faktor yang bisa mempengaruhi berat badan. Agar berat badan bisa turun, bisa mengikuti tips diet menurut Chef Eddrian Tjhia ini. https://t.co/nRPOD8leEx",5,0,0,0,2022-01-12,5,Wednesday,3,5,0
1481131369967280128,2022-01-12 05:10:11,"Rory Asyari menggaet Bubah Alfian untuk bisnis baru. Bernama Sleep Project, mereka berniat membantu pengrajin batik. https://t.co/0qgub2fUPo",2,0,1,1,2022-01-12,5,Wednesday,3,3,1
1481130862632648704,2022-01-12 05:08:10,"Vaksinasi booster COVID-19 dimulai hari ini, salah satunya di Puskesmas Kramat Jati, Jaktim. Sudah lama menanti-nanti booster, begini testimoni para lansia: https://t.co/RzMa9Kl3C3",5,1,3,0,2022-01-12,5,Wednesday,3,8,1
1481130551725670404,2022-01-12 05:06:56,"""Banyak yang kita anggap tidak dijalankan sesuai prosedur lah, kita menduga seperti itu, tapi show must go on jadi kita lanjut,"" kata kuasa hukum Munarman. https://t.co/iCRrf1R8ui",0,0,0,0,2022-01-12,5,Wednesday,3,0,0
1481130534697058304,2022-01-12 05:06:52,"Hayo tebak, kira-kira berapa gaji lulusan baru untuk pengacara? https://t.co/G6f2Zu4swJ",2,0,1,0,2022-01-12,5,Wednesday,3,3,0
1481130029312524293,2022-01-12 05:04:51,Presiden Jokowi secara resmi mengumumkan vaksin booster gratis. Vaksin apa saja yang termasuk dalam vaksin booster gratis? Ini daftarnya:   https://t.co/h0jEg3xAgu,4,1,1,0,2022-01-12,5,Wednesday,3,5,1
1481130014229868545,2022-01-12 05:04:48,Philippe Coutinho begitu senang bisa bereuni dengan Steven Gerrard di Aston Villa. Ia mengaku Gerrard adalah sosok yang dikaguminya.  https://t.co/ZOKNO71Yrp,4,0,0,0,2022-01-12,5,Wednesday,3,4,0
1481129776668725251,2022-01-12 05:03:51,"Viral di media sosial gangster mendatangi sebuah klinik di Tigaraksa, Kabupaten Tangerang, Banten. Kelompok diduga gangster itu terlihat membawa senjata tajam. https://t.co/ZvtDfUFh0A",2,0,2,0,2022-01-12,5,Wednesday,3,4,0
1481129523508879362,2022-01-12 05:02:51,"Rumah tangga yang nyaris hancur karena perselingkuhan bak 'layangan putus' bisa kembali. Akan tetapi, pasti terlihat tak sempurna. Ini kata ustaz:  https://t.co/OEjnjQlqN9",10,0,0,1,2022-01-12,5,Wednesday,3,10,1
1481129243434233856,2022-01-12 05:01:44,Laga Piala Super Italia nanti malam akan mempertemukan Inter Milan dengan Juventus. Berikut ini jadwal Piala Super Italia.  https://t.co/rrnpSmjnfE,1,0,0,0,2022-01-12,5,Wednesday,3,1,0
1481128941272322049,2022-01-12 05:00:32,Juventus akan menghadapi Inter Milan di Piala Super Italia tanpa Wojciech Szczesny di bawah mistar gawang karena terkendala protokol COVID-19.  https://t.co/xpVW37fT9o,1,1,0,0,2022-01-12,5,Wednesday,3,1,1
1481128929939406849,2022-01-12 05:00:29,"Pemeriksaan seorang pasien suspek COVID varian omicron di Krukut, Jakarta Barat sudah selesai. Hasilnya pasien tersebut terkonfirmasi positif omicron. https://t.co/exnnQCrL2V",3,1,1,0,2022-01-12,5,Wednesday,3,4,1
1481128285933383687,2022-01-12 04:57:56,"""Benda itu pada dasarnya adalah struktur buatan yang dibangun oleh peradaban pintar dengan tujuan barangkali untuk mengumpulkan energi,"" kata NASA.  https://t.co/PVF53NtG6m",15,1,3,1,2022-01-12,4,Wednesday,3,18,2
1481127993745494016,2022-01-12 04:56:46,"Barcelona tertinggal jauh dari Real Madrid di klasemen LaLiga. Meski demikian, perbedaan itu dinilai tak akan berpengaruh di El Clasico di Piala Super Spanyol.  https://t.co/diatyZozuZ",5,0,0,1,2022-01-12,4,Wednesday,3,5,1
1481127768339402752,2022-01-12 04:55:52,Mardani H Maming merupakan mantan bupati Tanah Bumbu. Dia merupakan politikus PDIP yang sempat disebut Sekjen PDIP kader potensial. https://t.co/ZThZVDLBKd,7,1,2,0,2022-01-12,4,Wednesday,3,9,1
1481126738646159360,2022-01-12 04:51:47,Pelatih Real Madrid Carlo Ancelotti memuji perkembangan Barcelona bersama Xavi Hernandez. Ancelotti juga terkesan dengan para pemain muda Barcelona.  https://t.co/gjd5CsNlPU,7,1,0,2,2022-01-12,4,Wednesday,3,7,3
1481126541606408192,2022-01-12 04:51:00,PBNU mengumumkan kepengurusan baru di bawah kepemimpinan Ketum PBNU Gus Yahya Staquf. Gus Ipul ditunjuk menjadi Sekjen PBNU. https://t.co/kGCD1SZoc6,9,1,1,0,2022-01-12,4,Wednesday,3,10,1
1481125713961005062,2022-01-12 04:47:42,Giring PSI mengkritik commitment fee Formula E senilai Rp 560 M. Ketua Pelaksana Formula E merespons. https://t.co/25eJ11m1hR,3,3,0,0,2022-01-12,4,Wednesday,3,3,3
1481125382799736843,2022-01-12 04:46:23,"Mohamed Salah dan Liverpool belum menemukan kata sepakat untuk perpanjangan kontrak. Bagi Salah, 'bolanya' kini ada di pihak klub!  https://t.co/cUcoOGThto",2,0,1,0,2022-01-12,4,Wednesday,3,3,0
1481125202415267840,2022-01-12 04:45:40,"Belum lama ini viral pernyataan pengamat yang mengatakan bahwa mobil yang menggunakan roof box akan ditilang karena dianggap menyalahi aturan. Tapi menurut pihak kepolisian, tidak masalah jika mobil pribadi menggunakan roof box. https://t.co/6sVimSnN28",6,1,0,0,2022-01-12,4,Wednesday,3,6,1
1481124715540451330,2022-01-12 04:43:44,"Doni Salmanan mempersembahkan sebuah video klip untuk sang istri, Dinan Nurfajrina. Video klip itu diberi judul Hari Indah Tak Berujung.  https://t.co/0f9BbidDqX",24,4,1,9,2022-01-12,4,Wednesday,3,25,13
1481124228808257545,2022-01-12 04:41:48,Pendiri Signal Moxie Marlinspike mundur dari jabatannya sebagai CEO. Co-founder WhatsApp Brian Acton akan mengisi posisinya untuk sementara. https://t.co/tLywAKaQcN,9,0,0,1,2022-01-12,4,Wednesday,3,9,1
1481123496101093376,2022-01-12 04:38:54,Ashanty masih jalani isolasi di salah satu rumah sakit karena positif COVID-19. Ini kondisi Ashanty isolasi di hari keenam:  https://t.co/p0H5OKzery,8,1,2,1,2022-01-12,4,Wednesday,3,10,2
1481123486047387650,2022-01-12 04:38:51,"Pratama Arhan jadi sorotan usai tampil gemilang di Piala AFF 2020. Dengan banyaknya perhatian dari fans perempuan, begini respons sang kekasih:  https://t.co/GooMCBv5sq",9,0,0,0,2022-01-12,4,Wednesday,3,9,0
1481122641276817410,2022-01-12 04:35:30,IU memamerkan kado manis pemberian Lee Do Hyun. Keduanya bertemu kembali setelah dipasangkan dalam drama Korea Hotel del Luna. https://t.co/4UkTd9juaZ,4,0,0,0,2022-01-12,4,Wednesday,3,4,0
1481122054795632640,2022-01-12 04:33:10,WHO memperingatkan agar tidak menyamakan varian Omicron layaknya flu biasa. Belum ada bukti pasti yang menunjukkan Omicron tidak menyebabkan gejala parah. https://t.co/Mkn08MKK8A,14,5,6,2,2022-01-12,4,Wednesday,3,20,7
1481121487524450311,2022-01-12 04:30:55,"BKSDA Sumatra Barat berhasil menyelamatkan seekor harimau Sumatra (Panthera tigris sumaterae). Saat ini, harimau itu tengah diobservasi. https://t.co/q9hOCYQNNz",11,0,2,0,2022-01-12,4,Wednesday,3,13,0
1481121004453777408,2022-01-12 04:29:00,Kementerian Kominfo tengah mengkaji mematikan layanan 3G. Ini perjalanan 3G di Indonesia yang akan memasuki masa pensiunnya: #3G  https://t.co/xeiWVNFg5i,3,0,0,0,2022-01-12,4,Wednesday,3,3,0
1481120811700338689,2022-01-12 04:28:14,Nama Emirsyah Satar kembali terseret dalam kasus dugaan korupsi di PT Garuda Indonesia Tbk (GIAA). Apa saja kasusnya sebelum ini? https://t.co/NU1aDiSml0,3,1,2,0,2022-01-12,4,Wednesday,3,5,1
1481120799952191489,2022-01-12 04:28:11,"Pihak kepolisian tidak masalah jika mobil menggunakan roof box, asalkan.. https://t.co/fCREv68tah",4,0,1,1,2022-01-12,4,Wednesday,3,5,1
1481120342538133505,2022-01-12 04:26:22,Tak tega melihat ibunya masak seharian di dapur demi menjamu tamu-tamu yang akan datang ke rumahnya. Bocah ini langsung labrak tamu yang makan di rumahnya. https://t.co/h4n0gaKUnI,154,18,46,12,2022-01-12,4,Wednesday,3,200,30
1481120319872065538,2022-01-12 04:26:16,Agenda sidang hak perwalian Gala Sky Ardiansyah kembali digelar. Sidang lanjutan masih beragendakan mediasi.  https://t.co/TYT5iL3kQf,1,1,0,0,2022-01-12,4,Wednesday,3,1,1
1481119817511931907,2022-01-12 04:24:17,Menteri BUMN Erick Thohir mendatangi Kejaksaan Agung untuk memberikan bukti-bukti terkait dugaan korupsi di PT Garuda Indonesia Tbk (GIAA). https://t.co/lQ82Dm5tJe,13,3,1,2,2022-01-12,4,Wednesday,3,14,5
1481119574984695811,2022-01-12 04:23:19,"Sanca kembang berukuran 3 meter lebih tak sengaja terciduk ekskavator yang digunakan membersihkan sampah sungai di Desa Kedawung Kulon, Kecamatan Grati, Kabupaten Pasuruan. Ular itu terangkat ekskavator bercampur sampah kayu. https://t.co/ZFN89fwaiR",3,0,0,2,2022-01-12,4,Wednesday,3,3,2
1481119304292704258,2022-01-12 04:22:14,"Kepala Seksi Jaminan Sosial Dinsos Sinjai Abdul Haddar (57) dilaporkan tewas, sementara empat pegawai lainnya luka-luka dalam insiden tersebut. https://t.co/eAMOU5K4P5",6,0,1,0,2022-01-12,4,Wednesday,3,7,0
1481119280401981440,2022-01-12 04:22:08,Presiden Jokowi resmi melantik sejumlah dubes RI hari ini. Salah satu yang dilantik yakni Gubernur Lemhanas Letjen (Purn) TNI Agus Widjojo. https://t.co/cp5EDb4QTJ,3,3,0,0,2022-01-12,4,Wednesday,3,3,3
1481118445366304771,2022-01-12 04:18:49,"Setelah sempat laris tak bersisa di program early bird, Samsung Galaxy S21 FE sudah dijual kembali. Ini spesifikasi, harga dan bonus yang ditawarkan:  https://t.co/oZA9ctUND7",0,0,1,0,2022-01-12,4,Wednesday,3,1,0
1481117905244807172,2022-01-12 04:16:41,"Saat Lesti Kejora dan Rizky Billar menikah, Tukul Arwana jadi saksi dari keduanya. Lesti Kejora nangis saat mengingat Tukul Arwana. https://t.co/yuqS7YKrvl",7,1,2,6,2022-01-12,4,Wednesday,3,9,7
1481117168158887940,2022-01-12 04:13:45,Dua orang polisi dari Los Angeles Police Department dipecat karena keasyikan bermain Pokemon Go saat bertugas. Mereka malah mau menangkap Snorlax. https://t.co/7o27PliP8M,40,15,8,8,2022-01-12,4,Wednesday,3,48,23
1481116427537027073,2022-01-12 04:10:48,Kurs dolar Amerika Serikat (AS) terhadap rupiah pagi ini kembali melemah. Begini pergerakannya: https://t.co/KpjPygn4Gv,1,4,0,0,2022-01-12,4,Wednesday,3,1,4
1481115369993551880,2022-01-12 04:06:36,"Ketika sedang jalan-jalan di Times Square, New York, Bella Shofie melihat wajahnya terpampang nyata di billboard iklan. Bella Shofie girang bukan main. https://t.co/GnTfDb6QjO",16,5,0,1,2022-01-12,4,Wednesday,3,16,6
1481114675916034050,2022-01-12 04:03:51,Kota termacet di Indonesia ternyata bukan Jakarta. Apa kota yang termacet di Indonesia? https://t.co/NCbyg8crvz,9,3,4,6,2022-01-12,4,Wednesday,3,13,9
1481114626850967562,2022-01-12 04:03:39,"Kisah wanita asal Bandung, Cassamira, viral karena memutuskan untuk menjadi IRT. Ia ternyata malah bahagia menjalankan perannya. #detiknetwork  https://t.co/wkFo1cTh7Y",54,6,9,6,2022-01-12,4,Wednesday,3,63,12
1481113112984145922,2022-01-12 03:57:38,"Awal tahun 2022, Mitsubishi secara resmi meluncurkan Vision Ralliart Concept. Berikut tampang mobil SUV konsep yang serba hitam ini! https://t.co/BWxrXyaXsU",5,0,3,2,2022-01-12,3,Wednesday,3,8,2
1481112501093912578,2022-01-12 03:55:12,"Sidang vonis kasus narkoba Nia Ramadhani-Ardi Bakrie sudah digelar pada Selasa (11/1). Nia, Ardi, dan sopir mereka mendapat hukuman satu tahun penjara. https://t.co/0PnWIxPNLH",3,2,3,0,2022-01-12,3,Wednesday,3,6,2
1481112306033508353,2022-01-12 03:54:26,"Gelandang Real Madrid, Toni Kroos, menegaskan tak ada yang favorit di laga El Clasico. Ia menilai duel nanti selayaknya laga final untuk Barcelona dan Madrid.  https://t.co/yoiF5GBmfX",3,0,0,0,2022-01-12,3,Wednesday,3,3,0
1481112288459436034,2022-01-12 03:54:21,Chelsea kencang dikabarkan akan mendatangkan pemain di bursa transfer Januari ini. Manajer The Blues Thomas Tuchel menegaskan tak ada tekanan untuk merekrut.  https://t.co/VnS5o0PFWm,1,0,0,0,2022-01-12,3,Wednesday,3,1,0
1481111560118484994,2022-01-12 03:51:28,"Mesir mengawali kiprah di Piala Afrika 2021 dengan takluk 0-1 dari Nigeria. Sementara, juara bertahan, Aljazair, tertahan 0-0 oleh Sierra Leone.  https://t.co/9OYHhWZ0mc",4,0,1,0,2022-01-12,3,Wednesday,3,5,0
1481111558960914437,2022-01-12 03:51:28,Jay Park dikabarkan akan membentuk agensi baru. Ia disebut akan mendebutkan grup idola lewat agensi tersebut. #JayPark  https://t.co/DG2jW8HvN9,4,0,1,0,2022-01-12,3,Wednesday,3,5,0
1481111225060761603,2022-01-12 03:50:08,Catsuit diprediksi bakal mendominasi tren fashion 2022. Intip yuk tips padu-padan catsuit untuk memaksimalkan gayamu. https://t.co/TWn8Dy0GDG,0,0,0,0,2022-01-12,3,Wednesday,3,0,0
1481110523064516612,2022-01-12 03:47:21,Scream akan tayang di bioskop mulai 12 Januari 2022. Simak deretan fakta menariknya berikut ini: #Scream  https://t.co/zSoGfXsG8J,5,1,0,0,2022-01-12,3,Wednesday,3,5,1
1481110117579993097,2022-01-12 03:45:44,Penerima dosis lengkap vaksin Sinovac akan bisa menerima booster Pfizer atau AstraZeneca. Jenis vaksin ketiga yang diberikan ditentukan oleh petugas kesehatan. https://t.co/RBTqeLLcYK,8,1,1,0,2022-01-12,3,Wednesday,3,9,1
1481109574606282753,2022-01-12 03:43:34,Juventus tak bisa memainkan tim terbaiknya saat melawan Inter Milan di laga Piala Super Italia. Beberapa pemain belum sepenuhnya fit untuk menjalani laga ini.  https://t.co/5wOvf09u6b,2,0,0,0,2022-01-12,3,Wednesday,3,2,0
1481109555744583681,2022-01-12 03:43:30,Siapa yang zodiaknya Gemini? Masih banyak hal yang harus diperbaiki terutama dalam penyusunan anggaran belanja kamu nih. Lihat yuk kata zodiak lainnya: https://t.co/CMvl8O7j7b,3,0,0,0,2022-01-12,3,Wednesday,3,3,0
1481109245957447680,2022-01-12 03:42:16,Tottenham Hotspur melakukan pendekatan ke Manchester United untuk transfer Jesse Lingard. Kontak telah terjalin antara kedua klub.  https://t.co/3mIVRu5HCb,2,1,1,1,2022-01-12,3,Wednesday,3,3,2
1481109230371454978,2022-01-12 03:42:12,Wang Leehom dan Show Luo akhirnya terbebas dari daftar hitam yang dibuat oleh pemerintah China. https://t.co/eEo1wMg1zt,1,0,0,1,2022-01-12,3,Wednesday,3,1,1
1481108369482166275,2022-01-12 03:38:47,"Pengumuman! Undip membuka lowongan dosen di 10 fakultas dan 1 sekolah vokasi. Simak ketentuannya yuk: 

via: detikedu https://t.co/bAlAX6Lrid",10,1,1,2,2022-01-12,3,Wednesday,3,11,3
1481107587026366467,2022-01-12 03:35:41,#FOTO Tukul Arwana saat ini dalam proses penyembuhan usai menjalani operasi pendarahan di otak. Ini dia potret terbarunya:  https://t.co/QgpQUCna4X,0,0,0,0,2022-01-12,3,Wednesday,3,0,0
1481106507676725250,2022-01-12 03:31:23,"Program vaksinasi booster Covid-19 gratis dimulai hari ini, Rabu (12/1). Pemerintah menggunakan 3 kombinasi vaksin dengan masing-masing takaran yakni setengah dosis vaksin. Berikut skema vaksinasi booster di Indonesia: https://t.co/QLsa1KJ3xP",2,0,0,0,2022-01-12,3,Wednesday,3,2,0
1481105012608671747,2022-01-12 03:25:27,"Ubud tak hanya cocok untuk healing, tapi juga untuk solo traveler. Namanya kembali masuk 10 besar destinasi terbaik dunia untuk pejalan solo. Wih! https://t.co/TLtGNrBIzP",17,1,1,0,2022-01-12,3,Wednesday,3,18,1
1481104693464023040,2022-01-12 03:24:11,"Kalau kamu bisa menjawab teka-teki ini kurang dari 5 menit dan benar, tandanya kemampuan berpikir kamu luar biasa. https://t.co/r3KlkN9mZF",432,630,56,22,2022-01-12,3,Wednesday,3,488,652
1481104512878272512,2022-01-12 03:23:28,Korban tewas akibat banjir dan tanah longsor di Jayapura bertambah. Kini total korban jiwa menjadi delapan orang. https://t.co/ADUi91cGcf,13,0,2,0,2022-01-12,3,Wednesday,3,15,0
1481103960618455041,2022-01-12 03:21:16,Berikut ini 5 lokasi SIM keliling di wilayah DKI Jakarta untuk hari Rabu (12/1/2022). https://t.co/aiZwzCqUnS,2,0,0,0,2022-01-12,3,Wednesday,3,2,0
1481103582430703620,2022-01-12 03:19:46,"Roger Danuarta dan Cut Meyriska kembali dipersatukan dalam sebuah film. Kali ini, mereka akan membintangi Ada Mertua di Rumahku. https://t.co/w7nDHAUhhd",6,0,0,1,2022-01-12,3,Wednesday,3,6,1
1481103071866408961,2022-01-12 03:17:44,Salah satu penulis skenario Penyalin Cahaya hilang dari credit title. Nama Henricus Pria kini hilang dan hanya tertulis Wregas Bhanuteja. #PenyalinCahaya  https://t.co/KqYNy28OCt,6,0,1,0,2022-01-12,3,Wednesday,3,7,0
1481102368242638848,2022-01-12 03:14:56,Menteri Keuangan Sri Mulyani Indrawati memperpanjang pemberian insentif pajak bagi barang yang diperlukan untuk penanganan pandemi COVID-19. https://t.co/8l9y1kGbrn,3,0,1,0,2022-01-12,3,Wednesday,3,4,0
1481102051035783171,2022-01-12 03:13:41,"#Terpopuler Postingan seorang anak yang ibunya menjadi korban kecelakaan lalu lintas di Klaten, Jawa Tengah viral di media sosial. Begini kisahnya. https://t.co/EWiAtSX2Ne",58,1,27,1,2022-01-12,3,Wednesday,3,85,2
1481101281536188421,2022-01-12 03:10:37,"Kisah kelahiran Nabi Muhammad SAW digambarkan dengan sejumlah kisah kehilangan 3 sosok penting dalam hidupnya. Simak kisah lengkapnya yuk.

via: detikedu https://t.co/7Cq7yWP5pK",10,0,5,0,2022-01-12,3,Wednesday,3,15,0
1481100784423280644,2022-01-12 03:08:39,"Konsep student loan atau pinjaman pelajar diterapkan di sebagian negara di dunia. Sistem ini pertama digunakan di akhir abad ke-11. Sudah tahu sejarahnya?

via: detikedu https://t.co/p2nFQOmXXJ",6,1,2,0,2022-01-12,3,Wednesday,3,8,1
1481100259778568196,2022-01-12 03:06:34,Bank Dunia memperkirakan pertumbuhan ekonomi global ke depan akan suram karena ancaman varian baru COVID-19. Begini ramalannya: https://t.co/o9gvfG9inH,6,1,1,0,2022-01-12,3,Wednesday,3,7,1
1481099581089845248,2022-01-12 03:03:52,Vaksin booster COVID-19 dimulai Rabu (12/1/2022) dengan prioritas lansia dan kelompok rentan. Kick off antara lain dilakukan di Puskesmas Kramat Jati. https://t.co/RzYUsr5aMe,3,0,0,0,2022-01-12,3,Wednesday,3,3,0
1481099023293550592,2022-01-12 03:01:39,"Vaksinasi lanjutan atau #booster di #Banten baru bisa didapatkan di Kabupaten Tangerang, Kota Tangerang, Tangerang Selatan dan Kabupaten Serang. https://t.co/Ng53ke9KVM",9,0,2,0,2022-01-12,3,Wednesday,3,11,0
1481098452373233664,2022-01-12 02:59:23,Nia Ramadhani dan Ardi Bakrie divonis satu tahun penjara. Hakim menilai terdakwa telah terbukti melakukan tindak pidana penyalahgunaan narkotika. #NiaRamadhani  https://t.co/cihVSjze84,10,1,0,0,2022-01-12,2,Wednesday,3,10,1
1481097461410185218,2022-01-12 02:55:26,"Tampil simple dengan mengenakan kemeja dan celana panjang, siapa sangka jika tas selempang yang dikenakan Nagita Slavina ternyata seharga mobil. Wow! https://t.co/5yXccbT5co",22,4,0,0,2022-01-12,2,Wednesday,3,22,4
1481096285805551618,2022-01-12 02:50:46,Seorang penyanyi asal Taiwan kini menuai sorotan setelah lama tak muncul. Ternyata kini ia sudah beralih profesi jadi teknisi AC. Ini sosoknya:   https://t.co/7STg1EAR8r,16,1,0,1,2022-01-12,2,Wednesday,3,16,2
1481094176628514820,2022-01-12 02:42:23,Pengadilan Seoul menyetujui produsen mobil listrik Edison Motors Co mengakuisisi SsangYong Motor Co yang bermasalah secara finansial. https://t.co/WyghpZDqhE,5,0,2,0,2022-01-12,2,Wednesday,3,7,0
1481094173113602048,2022-01-12 02:42:22,"Pembangunan Jakarta International Stadium telah mencapai 93,85 persen. Ditarget rampung Maret 2022, yuk lihat bagian dalam JIS yang keren dan bikin kagum.  https://t.co/O9CQpI83Sb",64,17,14,7,2022-01-12,2,Wednesday,3,78,24
1481093010997878784,2022-01-12 02:37:45,Salah satu film yang akhirnya harus menunda penayangannya adalah Trah 7. Film horor ini menunda penayangannya hingga 2 tahun karena pandemi. #Trah7   https://t.co/tEY6yRAUcs,10,0,1,0,2022-01-12,2,Wednesday,3,11,0
1481091931501387785,2022-01-12 02:33:28,"Putri Desy Ratnasari, Nasywa Nathania, mengaku kerap tidak nyaman saat mengetahui siapa orang tuanya. https://t.co/QVllwNYtWD",7,0,1,0,2022-01-12,2,Wednesday,3,8,0
1481090764402794499,2022-01-12 02:28:50,"Kejutan hadir di persidangan Nia Ramadhani dan Ardi Bakrie. Dituntut rehabilitasi, pasangan suami istri itu akhirnya divonis 1 tahun bui. https://t.co/ryTWGxp2LK",162,52,22,7,2022-01-12,2,Wednesday,3,184,59
1481089735011487745,2022-01-12 02:24:44,The Raid jadi salah satu film Indonesia yang sukses dan dilirik Amerika Serikat sebagai sajian yang menawan. Film ini bakal dibuat versi barunya. #TheRaid  https://t.co/jVeQ37p4cT,38,15,17,4,2022-01-12,2,Wednesday,3,55,19
1481088440552857603,2022-01-12 02:19:36,"Selebgram asal Kazakhstan, Dayana, curhat soal kondisi mencekam di negaranya di media sosialnya. Namun kini, akunnya menghilang. https://t.co/EVDLURifAg",19,3,2,0,2022-01-12,2,Wednesday,3,21,3
1481087110291632139,2022-01-12 02:14:19,Tukul Arwana hingga kini masih jalani terapi untuk memulihkan kesehatan. Sang anak menangis saat mengingat pertama kali sang ayah pendarahan otak...  https://t.co/d1RBXXGzPM,32,4,2,0,2022-01-12,2,Wednesday,3,34,4
1481085552724258820,2022-01-12 02:08:07,"#Foto Meski sudah dipersiapkan jadi ratu Norwegia, Putri Ingrid Alexandra aktif mencoba berbagai pekerjaan, tukang cuci piring hingga copilot. Lihat potretnya yuk. https://t.co/0zC6I33KYl",15,2,3,1,2022-01-12,2,Wednesday,3,18,3
1481083647742599171,2022-01-12 02:00:33,"Untuk meringan gejala, Anda bisa mengonsumsi sejumlah makanan. Terdapat makanan yang baik dikonsumsi saat terinfeksi Covid-19 Omicron. #CNNIndonesia #detiknetwork  https://t.co/yUKDE4qDrS",12,1,3,0,2022-01-12,2,Wednesday,3,15,1
1481081719646298112,2022-01-12 01:52:53,"Kepala Dinas Kesehatan DKI, Widyastuti, sudah memastikan kesiapan seluruh puskesmas di DKI Jakarta untuk melayani vaksinasi Corona dosis ketiga atau booster yang direncanakan digelar hari ini, Rabu (12/1). https://t.co/t5bCmpvlGT",4,1,3,0,2022-01-12,1,Wednesday,3,7,1
1481080670659219462,2022-01-12 01:48:43,Kepala Dinas Pendidikan Kota Makassar buka suara terkait video perkelahian siswi SMPN 21 yang viral di media sosial. Ia menyebut permasalahan tersebut sudah diselesaikan dengan para orang tua siswi. https://t.co/nBsjNzdCvL,7,0,2,0,2022-01-12,1,Wednesday,3,9,0
1481079348954341376,2022-01-12 01:43:28,Menko Marves Luhut Binsar Pandjaitan sampaikan prediksi puncak kasus Omicron di Indonesia. Luhut menyebut hal itu akan terjadi di awal Februari. https://t.co/GdwJ3FXQV2,7,23,2,3,2022-01-12,1,Wednesday,3,9,26
1481078519446872067,2022-01-12 01:40:10,"Ledakan dahsyat terjadi di sebuah rumah di Pandeglang, Banten, dan membuat pemilik rumah, Ulung (38), tewas. Berikut fakta-fakta kejadian tersebut: https://t.co/E2vgNjoGJs",3,1,1,0,2022-01-12,1,Wednesday,3,4,1
1481076518742900739,2022-01-12 01:32:13,"Vaksin booster COVID-19 untuk umum (non nakes) dimulai hari ini, Rabu (12/1/2022). Catat yang boleh dan tak boleh dilakukan sebelum-sesudah vaksin. https://t.co/ERNTQPbDSi",7,1,2,0,2022-01-12,1,Wednesday,3,9,1
1481075354911617027,2022-01-12 01:27:36,"Sebenarnya, kolam di alun-alun kota bukan untuk kolam renang. Namun, itulah yang terjadi di Sukabumi dan bikin geram wali kota. Waduh! https://t.co/YpF5OIth0E",73,24,15,12,2022-01-12,1,Wednesday,3,88,36
1481074310068453383,2022-01-12 01:23:27,"Vaksin booster COVID-19 untuk umum (non nakes) dimulai hari ini, Rabu (12/1/2022). Catat yang boleh dan tak boleh dilakukan sebelum-sesudah vaksin. https://t.co/FKNPNTJ1zG",4,0,11,0,2022-01-12,1,Wednesday,3,15,0
1481072979056463873,2022-01-12 01:18:09,Kapolri meminta daerah yang cakupan vaksinasinya melebihi 70% untuk segera melakukan percepatan vaksinasi terhadap lansia dan anak. Terutama dengan masuknya varian Omicron ke Indonesia. https://t.co/yT8fw4v3OJ,4,0,4,0,2022-01-12,1,Wednesday,3,8,0
1481071922918133761,2022-01-12 01:13:58,"Jika detikers bingung ingin berkuliah di jurusan apa, kalian dapat memilih jurusan yang memiliki prospek kerja tinggi. Jurusan apa saja ya?

via: detikedu https://t.co/muip5YBg3a",16,1,5,1,2022-01-12,1,Wednesday,3,21,2
1481071044077277188,2022-01-12 01:10:28,"Menkes bolehkan penerima vaksin Sinovac divaksin booster Pfizer dan AstraZeneca lantaran stok terbatas, hal ini juga sudah sesuai kajian para ahli. https://t.co/4rOee7lXog",8,0,5,0,2022-01-12,1,Wednesday,3,13,0
1481070239655866378,2022-01-12 01:07:16,Musisi Hindia bersama Rayhan Noor jadi komposer pada lagu Sampai Akhir Zaman yang dipopulerkan Armand Maulana. Ternyata Hindia sampai jongkok ciptakan lagu untuk Armand Maulana. https://t.co/8lfwkU6MJf,9,2,1,0,2022-01-12,1,Wednesday,3,10,2
1481069423578558464,2022-01-12 01:04:02,"Keren banget! Tahukah kamu, jika tokoh-tokoh MCU berikut ini berhasil kuliah di universitas top dunia. Kira-kira universitas mana saja ya? https://t.co/464P67Osp9",6,0,2,0,2022-01-12,1,Wednesday,3,8,0
1481068328307380231,2022-01-12 00:59:41,"Meski sudah sekitar 2,5 bulan disimpan di rumah oleh keluarganya, mayat SAR (14), bocah perempuan asal Kabupaten Pemalang, tidak mengeluarkan bau. https://t.co/9HikBpuZcO",19,3,4,2,2022-01-12,0,Wednesday,3,23,5
1481068047926448139,2022-01-12 00:58:34,"Varian Omicron berpotensi menggeser dominasi varian Delta, Indonesia kini mencatat 414 kasus Omicron. Gejala apa saja yang muncul saat terinfeksi Omicron? https://t.co/UBfyJnGOOO",7,1,5,0,2022-01-12,0,Wednesday,3,12,1
1481067683496013827,2022-01-12 00:57:07,Masa jabatan Walkot Tasikmalaya akan berakhir tahun ini. Situasi ini akan membuat jabatan Walkot Tasikmalaya akan disandang Pjs atau Plt selama 2 tahun lebih. https://t.co/NBcbpnzl3T,4,1,1,0,2022-01-12,0,Wednesday,3,5,1
1481067662625193985,2022-01-12 00:57:02,Program vaksin booster akan dilangsungkan besok Rabu (12/1). Program booster dilakukan dengan tiga regime berdasarkan hasil riset dan ketersediaan vaksin. https://t.co/WszypPmwEI,4,0,3,0,2022-01-12,0,Wednesday,3,7,0
1481067383431249926,2022-01-12 00:55:55,Pria yang disebut-sebut warga NTB itu ternyata pernah mengajar di sebuah pondok pesantren di Magelang. Istrinya juga pernah mengajar di pesantren itu. https://t.co/cQGkyuh6vT,6,3,1,2,2022-01-12,0,Wednesday,3,7,5
1481067365324496900,2022-01-12 00:55:51,Pemerintah memprediksi puncak kasus Omicron di Indonesia terjadi awal Februari. Kasus omicron di Jakarta diperkirakan bisa capai 21 ribu dalam satu hari. https://t.co/WttH9pTPLQ,16,4,5,3,2022-01-12,0,Wednesday,3,21,7
1481067342612291589,2022-01-12 00:55:46,"Dua putra Presiden Joko Widodo (Jokowi), Gibrang Rakabuming dan Kaesang Pangarep dilaporkan ke KPK oleh Ubedillah Badrun. Siapa sebenarnya Ubedillah? https://t.co/t1Vnip98Ft",94,60,20,10,2022-01-12,0,Wednesday,3,114,70
1481067341354082308,2022-01-12 00:55:45,Polisi mengusut retweet akun resmi Pemkot Depok soal penembakan laskar FPI. Polisi menilai aksi retweet akun Pemkot Depok sudah meresahkan. https://t.co/09hSdhEufC,12,9,3,3,2022-01-12,0,Wednesday,3,15,12
1481066815107313667,2022-01-12 00:53:40,Vaksinasi booster dimulai hari ini. Epidemiolog mendorong vaksinasi booster ini dikebut bagi kelompok rentan sehingga menekan penularan Omicorn. https://t.co/p8WtmSuoI5,5,0,1,0,2022-01-12,0,Wednesday,3,6,0
1481066799760396289,2022-01-12 00:53:36,"DPRD DKI meminta penjelasan Kemendagri soal efisiensi 73 PASK, termasuk pengadaan lahan Kantor Kecamatan Mampang Prapatan yang hilang di Raperda DKI 2022. https://t.co/HzGKXP9CX5",2,0,1,0,2022-01-12,0,Wednesday,3,3,0
1481066539919069186,2022-01-12 00:52:34,"Vagina gatal bisa dipicu daerah sensitif mengering atau ada iritasi kimia. Tetapi, jangan khawatir! Ini 6 cara alami ini untuk mengatasi gatal pada vagina. https://t.co/76yAvxIDyK",5,1,1,1,2022-01-12,0,Wednesday,3,6,2
1481066282304823299,2022-01-12 00:51:33,Kiper Inter Milan Samir Handanovic tak terganggu dengan kabar transfer Andre Onana. Handanovic siap bersaing dengan Onana. https://t.co/MIUKlRXyyI,3,0,0,0,2022-01-12,0,Wednesday,3,3,0
1481066265670209538,2022-01-12 00:51:29,Gelandang legendaris Manchester United Paul Scholes masih bingung Ralf Rangnick bisa menjadi manajer 'Setan Merah'. Sesulit itukah MU merekrut manajer top? https://t.co/kCtJRbbhMv,4,1,0,0,2022-01-12,0,Wednesday,3,4,1
1481065842183966727,2022-01-12 00:49:48,"Video pemandu lagu atau LC di tempat karaoke di Purworejo, Jawa Tengah, viral di media sosial lantaran berpakaian mirip seragam SMA. Lalu seperti apa faktanya? https://t.co/MHbmOOhrrR",5,5,2,5,2022-01-12,0,Wednesday,3,7,10
1481065017663528964,2022-01-12 00:46:31,Kemenkes RI mengumumkan 3 versi kombinasi vaksin booster COVID-19. Ketiganya sudah berdasarkan riset dan menyesuaikan ketersediaan stok vaksin. https://t.co/lIqKAfL6S2,7,0,5,1,2022-01-12,0,Wednesday,3,12,1
1481064999124668421,2022-01-12 00:46:27,Kemenkes mengungkap prediksi puncak gelombang Corona varian Omicron di Indonesia terjadi pada Februari mendatang. Kasus harian diprediksi mencapai 60 ribu. https://t.co/p1J1ps2Xmh,45,32,13,15,2022-01-12,0,Wednesday,3,58,47
1481064724661944323,2022-01-12 00:45:21,Vaksin booster COVID-19 dimulai hari ini. Vaksin booster gratis untuk seluruh masyarakat dengan lansia menjadi kelompok prioritas. Bisa pilih vaksin booster? https://t.co/OQ7aMvJBFJ,7,0,2,1,2022-01-12,0,Wednesday,3,9,1
1481064706836213761,2022-01-12 00:45:17,"Rumah yang menyimpan mayat SAR (14), bocah perempuan asal Kabupaten Pemalang yang meninggal 2,5 bulan lalu, ternyata terpencil di daerah pegunungan. https://t.co/fiHqKc4cue",4,0,2,0,2022-01-12,0,Wednesday,3,6,0
1481063095007072256,2022-01-12 00:38:53,Belum tahu bagaimana cara daftar vaksin booster untuk COVID-19? Berikut panduannya dan sekaligus cek tiket vaksin di aplikasi PeduliLindungi. https://t.co/V5UQ32oZGJ,29,3,14,3,2022-01-12,0,Wednesday,3,43,6
1481062219815268359,2022-01-12 00:35:24,Eks penyidik KPK AKP Stepanus Robin Pattuju alias Robin hari ini akan menghadapi sidang putusan kasus suap. Robin akan divonis bersama rekannya Maskur Husain. https://t.co/uI5yiUjyAB,3,2,0,0,2022-01-12,0,Wednesday,3,3,2
1481060603959689227,2022-01-12 00:28:59,BMKG memprakirakan Jawa Tengah akan diguyur hujan hingga malam nanti. Berikut ini prakiraan cuaca Jawa Tengah 12 Januari 2022 selengkapnya: https://t.co/oX8IHkH4z6,9,3,3,0,2022-01-12,0,Wednesday,3,12,3
1481060094255288326,2022-01-12 00:26:57,"Artis Vicky Prasetyo dilaporkan oleh mantan istrinya, Vivi Paris ke Polda Metro Jaya. Vicky Prasetyo diduga menggelapkan uang ratusan juta milik Vivi. https://t.co/mVLyPWK3IX",10,4,2,1,2022-01-12,0,Wednesday,3,12,5
1481059527684509696,2022-01-12 00:24:42,"Delapan ekor domba milik warga Pancoran Mas, Depok, dicuri dini hari tadi. Pelaku hanya menyisakan jeroan di dalam kandang. https://t.co/GWnWwkl3VF",12,10,5,3,2022-01-12,0,Wednesday,3,17,13
1481058782050410500,2022-01-12 00:21:45,"Di balik bentuknya yang unik dan rasanya yang manis, buah tin mengandung banyak nutrisi penting yang bagus untuk kesehatan tubuh. https://t.co/r6QnxxpvY1",9,1,6,1,2022-01-12,0,Wednesday,3,15,2
1481058254549565442,2022-01-12 00:19:39,Menteri Koordinator Bidang Kemaritiman dan Investasi Luhut Binsar Pandjaitan memperkirakan puncak kasus Omicron terjadi awal Februari mendatang. https://t.co/oxZkZVK7mx,12,18,9,5,2022-01-12,0,Wednesday,3,21,23
1481057694790389768,2022-01-12 00:17:25,Chelsea datang ke semifinal leg II Piala Liga Inggris dengan modal besar. Thomas Tuchel tak mau hal itu justru mengganggu fokus The Blues. https://t.co/wF7mMoLd5K,5,0,1,0,2022-01-12,0,Wednesday,3,6,0
1481057174000488453,2022-01-12 00:15:21,"Menkes menyebut mayoritas pasien Omicron RI tidak memerlukan perawatan serius di RS. Perawatan di rumah tak bisa sembarangan, begini catatan eks petinggi WHO. https://t.co/Ubv0dDLyNA",6,0,0,1,2022-01-12,0,Wednesday,3,6,1
1481056362125795331,2022-01-12 00:12:08,Ulah jahat Fikri Hidayat (27) dibongkar polisi. Lelaki tersebut melakoni aksi penipuan dan penggelapan. Modusnya mengaku sebagai pejabat BPK Jabar. https://t.co/0IH7mHDVNk,3,1,1,0,2022-01-12,0,Wednesday,3,4,1
1481055841692364800,2022-01-12 00:10:04,"Seorang pemotor diserang dua pria saat melintas di sekitar Desa Cikadongdong, Kabupaten Tasikmalaya. Salah satu pelakunya bertato mawar. https://t.co/gkP8vAxm9i",3,0,0,0,2022-01-12,0,Wednesday,3,3,0
1481054490598031360,2022-01-12 00:04:41,"Para wakil rakyat terus melangkah membuat aturan yang sudah disorot Presiden Jokowi, yakni RUU TPKS. Jokowi sudah meminta RUU itu segera disahkan. https://t.co/CWIgChA1LM",5,0,2,0,2022-01-12,0,Wednesday,3,7,0
1481054217808879618,2022-01-12 00:03:36,Kasus positif Omicron di DKI Jakarta hingga saat ini tercatat ada 498 orang. Kasus Omicron didominasi oleh pelaku perjalanan dari luar negeri. https://t.co/AngxsCsI1d,16,8,10,4,2022-01-12,0,Wednesday,3,26,12
1481053451287207944,2022-01-12 00:00:34,"Omicron nanjak terus, Kemenkes RI prediksi puncaknya terjadi di minggu pertama atau kedua Februari. Pakar menyebut jumlah kasus bisa tembus 70 ribu sehari. https://t.co/1luPn9ieHl",90,78,38,31,2022-01-12,0,Wednesday,3,128,109
1481052801753128961,2022-01-11 23:57:59,"Booster vaksin COVID-19 mulai diberikan besok. Bakal hanya diberikan setengah dosis dan beda merek dari dosis 1-2, ternyata ini penyebabnya menurut Menkes. https://t.co/dyAy8hfzQV",11,2,2,1,2022-01-11,23,Tuesday,2,13,3
1481052033423757319,2022-01-11 23:54:56,"Jaksa menghadirkan dua ahli pidana dalam sidang kasus penembakan laskar FPI di Km 50, Tol Jakarta-Cikampek. Dua ahli itu mempunyai pendapat yang berbeda. https://t.co/1l9DOfL3DU",15,4,5,0,2022-01-11,23,Tuesday,2,20,4
1481051245779554311,2022-01-11 23:51:48,"Taeyeon SNSD bakal kembali merilis lagu baru. Berjudul Can't Control Myself, lagu tersebut dirilis sebagai pembuka dari album yang akan dirilis selanjutnya. https://t.co/gUTmzNJd9X",21,1,1,1,2022-01-11,23,Tuesday,2,22,2
1481050913494253568,2022-01-11 23:50:29,Mantan sopir Heru Rusiyanto warga Kudus membuat alat fogging portabel. Alat tersebut pun laris manis diburu pembeli saat musim penghujan. https://t.co/muGrCgWU1Y,9,0,2,0,2022-01-11,23,Tuesday,2,11,0
1481050374069014533,2022-01-11 23:48:20,Epidemiolog memprediksi gelombang Omicron terjadi di bulan Februari hingga Maret. Berpotensi lebih parah dari gelombang Delta? https://t.co/qfnYysscCk,40,46,24,15,2022-01-11,23,Tuesday,2,64,61
1481049883368992771,2022-01-11 23:46:23,"Gelandang Real Madrid, Toni Kroos, menegaskan tak ada yang favorit di laga El Clasico. Ia menilai duel nanti selayaknya laga final untuk Barcelona dan Madrid. https://t.co/i1mNVSM15Z",4,0,0,0,2022-01-11,23,Tuesday,2,4,0
1481049334883962882,2022-01-11 23:44:12,Barcelona tampaknya masih mencari pemain baru pada bursa transfer musim dingin tahun ini. Ada Oscar yang dikaitkan dengan Blaugrana. https://t.co/7xpWVPrqFH,8,2,0,0,2022-01-11,23,Tuesday,2,8,2
1481048532853444609,2022-01-11 23:41:01,Warga Palestina memenuhi loket perpanjangan kartu identitas di Kota Gaza (3/1). Israel menerbitkan kartu identitas bagi warga Palestina yang tanahnya diserobot. https://t.co/9xWkfZZt9d,15,0,1,0,2022-01-11,23,Tuesday,2,16,0
1481047689051750403,2022-01-11 23:37:40,"Setiap tahun, selalu ada petarung baru yang mencuri perhatian di UFC. Tahun 2022 ini, setidaknya siap-siap melihat 10 petarung ini! https://t.co/itZ5yhMJio",5,1,1,0,2022-01-11,23,Tuesday,2,6,1
1481047087303245826,2022-01-11 23:35:16,"Warga Kabupaten Pemalang, Jawa Tengah dihebohkan dengan adanya jasad bocah yang diawetkan dan disimpan keluarganya berbulan-bulan di dalam rumah. https://t.co/5cFmOJ6rlV",98,7,18,10,2022-01-11,23,Tuesday,2,116,17
1481046314884513796,2022-01-11 23:32:12,Pembelajaran tatap muka di SMAN 71 Duren Sawit dihentikan sementara. Hal ini setelah ada temuan ibu dan anak di Jatinegara terkonfirmasi Omicron. https://t.co/af7xRsq94v,17,5,5,3,2022-01-11,23,Tuesday,2,22,8
1481044929912745984,2022-01-11 23:26:42,Kabar baik mengenai vaksinasi COVID-19 dosis ketiga (booster) datang dari Presiden Joko Widodo (Jokowi). Vaksinasi booster dipastikan bakal gratis. https://t.co/VYa6flh1Od,24,0,5,2,2022-01-11,23,Tuesday,2,29,2
1481044628401012737,2022-01-11 23:25:30,Marissya Icha memberikan rincian dana donasi untuk Gala Sky. Begini penjelasannya:  https://t.co/MiOSf67j6W,6,3,2,3,2022-01-11,23,Tuesday,2,8,6
1481043008543932418,2022-01-11 23:19:04,"Cak tiket, jadwal, dan lokasi vaksin booster COVID-19 dosis ke-3 untuk umum bisa dilakukan di PeduliLindungi. Gratis untuk semua lho! Begini caranya. https://t.co/9GApuCBudC",6,0,6,1,2022-01-11,23,Tuesday,2,12,1
1481042232518053889,2022-01-11 23:15:59,Vaksin COVID-19 produksi Pfizer-BioNTech sudah didistribusikan secara bertahap di Indonesia pada 20 Agustus 2021. Ini penggunaan vaksin Pfizer:  https://t.co/dSFRRS60u9,7,0,1,1,2022-01-11,23,Tuesday,2,8,1
1481041103759769601,2022-01-11 23:11:30,HF dan istrinya mengundurkan diri sebagai pengajar di ponpes itu sejak beberapa bulan lalu. https://t.co/zK2WNsIxGS,31,20,4,4,2022-01-11,23,Tuesday,2,35,24
1481039973830770688,2022-01-11 23:07:00,"Kasis Corona harian di AS kembali memecahkan rekor. Negeri Paman Sam itu melaporkan 1,35 juta kasus baru virus Corona dalam sehari di wilayahnya. https://t.co/vcTm5LN5EX",16,3,6,4,2022-01-11,23,Tuesday,2,22,7
1481039449261854721,2022-01-11 23:04:55,"Ilmuwan Prancis menyebut varian Omicron 105 persen lebih menular dibanding Delta, varian Corona yang jadi biang kerok lonjakan kasus COVID-19. Apa risikonya? https://t.co/aYYeSWx84s",7,1,5,1,2022-01-11,23,Tuesday,2,12,2
1481038613764788228,2022-01-11 23:01:36,Juventus tak bisa memainkan tim terbaiknya saat melawan Inter Milan di laga Piala Super Italia. Beberapa pemain belum sepenuhnya fit untuk menjalani laga ini. https://t.co/smxeEaD2Ue,9,0,0,0,2022-01-11,23,Tuesday,2,9,0
1481037519269642241,2022-01-11 22:57:15,Kartika Berliana cerita kehidupan rumah tangga. Presenter olahraga itu mengatakan hidupnya kini lebih berwarna usai punya anak. https://t.co/cJVsvHpSZN,2,0,1,0,2022-01-11,22,Tuesday,2,3,0
1481036202652413952,2022-01-11 22:52:01,"Seorang guru tewas setelah tertabrak pikap di Bangsal, Mojokerto. Gara-garanya, korban terjatuh dari sepeda motornya saat kondisi jalan licin karena hujan. https://t.co/fLpAwtTCgU",15,2,2,1,2022-01-11,22,Tuesday,2,17,3
1481035064540606464,2022-01-11 22:47:30,Cristiano Ronaldo adalah sosok penting bagi Juventus dalam beberapa tahun terakhir. Adanya Ronaldo bahkan bikin masalah Bianconeri tak terlihat. https://t.co/A6pgYwNt1R,9,0,1,0,2022-01-11,22,Tuesday,2,10,0
1481033926995025920,2022-01-11 22:42:59,Masa depan Egy Maulana Vikri masih jadi tanda tanya. Ada media asing yang menyebut Egy cocok jadi pengganti Chanathip Songkrasin di Consadole Sapporo. https://t.co/YNB5SrWqGR,7,1,2,2,2022-01-11,22,Tuesday,2,9,3
1481032424637313025,2022-01-11 22:37:00,Jumlah kasus rawat inap COVID-19 di Amerika Serikat (AS) mencapai rekor tertinggi. Kenaikan ini terjadi karena adanya lonjakan infeksi oleh varian Omicron. https://t.co/YcQleJJQCY,13,1,2,2,2022-01-11,22,Tuesday,2,15,3
1481030703479463943,2022-01-11 22:30:10,Presiden Jokowi memastikan bahwa vaksin booster akan diberikan secara gratis untuk warga Indonesia. Berikut kombinasi vaksin booster yang akan diberikan. https://t.co/QXoa6BROmD,13,0,7,0,2022-01-11,22,Tuesday,2,20,0
1481029119068590080,2022-01-11 22:23:52,"Polisi mengamankan sepuluh remaja yang diduga hendak tawuran di Jalan Pelda Suryanta, Kota Sukabumi, https://t.co/4AP17Gu2jv",7,1,2,0,2022-01-11,22,Tuesday,2,9,1
1481028087198502914,2022-01-11 22:19:46,Es potong termasuk satu jajanan jadul yang ngangenin. Tapi ada saja yang menyebut jajanan ini tak higienis. Netizen pun tak terima dan melemparkan komentar.  https://t.co/W8V6OJBaWY,22,6,10,1,2022-01-11,22,Tuesday,2,32,7
1481027039784325120,2022-01-11 22:15:37,Masker jadi senjata ampuh tangkal Omicron. CDC kini akan memperbarui pedoman jenis masker yang disarankan untuk menangkal varian Omicron. https://t.co/34SWPUEC0I,8,0,3,0,2022-01-11,22,Tuesday,2,11,0
1481026205520470020,2022-01-11 22:12:18,Nia Ramadhani dan Ardi Bakrie divonis penjara selama 1 tahun atas kasus penyalahgunaan narkoba. Hakim menyatakan Nia dan Ardi terbukti bersalah. https://t.co/IPys1dpyyF,15,1,4,0,2022-01-11,22,Tuesday,2,19,1
1481024889607888900,2022-01-11 22:07:04,"Video dinarasikan aksi begal payudara di Karawaci, viral di medsos. Polisi mengungkap fakta kejadian dan sosok yang disebut sebagai 'korban begal payudara' itu https://t.co/6t5UNU0kMV",7,0,1,1,2022-01-11,22,Tuesday,2,8,1
1481024533125648386,2022-01-11 22:05:39,"Hujan deras terjadi intens di negara bagian Minas Gerais, Brasil. Sebanyak 10 orang tewas dalam dua hari, menurut laporan resmi. https://t.co/NDADG2U29W",6,0,0,0,2022-01-11,22,Tuesday,2,6,0
1481023808802803721,2022-01-11 22:02:46,Nia Ramadhani dan Ardi Bakrie divonis 1 tahun penjara. Sebelumnya ia mengungkapkan alasan menggunakan sabu. #NiaRamadhani #ArdiBakrie  https://t.co/4MLLx3dOoG,6,0,3,0,2022-01-11,22,Tuesday,2,9,0
1481022296605216768,2022-01-11 21:56:46,"Polisi memburu pria yang menendang sesajen di lokasi erupsi Gunung Semeru. Pengejaran pria berinisial HF ini tak hanya di wilayah Jawa Timur, namun hingga NTB. https://t.co/DUXGLfLjrX",105,50,13,10,2022-01-11,21,Tuesday,2,118,60
1481020990851358722,2022-01-11 21:51:34,Azerbaijan dan Armenia bentrok di perbatasan mereka. Bentrokan itu menewaskan satu tentara Azeri dan dua tentara Armenia. https://t.co/fl7RYSu87D,9,1,2,1,2022-01-11,21,Tuesday,2,11,2
1481019698661761037,2022-01-11 21:46:26,2.087 izin tambang akan dicabut. PD mengingatkan Jokowi jangan sampai pencabutan itu menjadi 'bancakan' untuk kepentingan segelintir. https://t.co/PISBr8vTbl,7,1,2,0,2022-01-11,21,Tuesday,2,9,1
1481018274154532868,2022-01-11 21:40:47,Marissya Icha berikan penjelasan mengenai hasil pertemuannya dengan Kementerian Sosial terkait rumah hasil donasi untuk Gala Sky. Ini penjelasannya:   https://t.co/ORvSlnFBS9,2,0,1,0,2022-01-11,21,Tuesday,2,3,0
1481017339701256200,2022-01-11 21:37:04,Kejagung mengungkap nama Emirsyah Satar dalam penyelidikan kasus dugaan korupsi penyewaan pesawat ATR 72-600 di PT Garuda Indonesia. https://t.co/kwhiT9cqyc,4,0,2,0,2022-01-11,21,Tuesday,2,6,0
1481014128726749193,2022-01-11 21:24:18,"Novelis Dear Nathan, Erisca Febriani mengatakan senang dengan cerita pasangan Nathan dan Salma yang sukses namun menegaskan tak bakal ada kelanjutannya. #DearNathan  https://t.co/nYSTZcONFo",2,0,2,0,2022-01-11,21,Tuesday,2,4,0
1481012978455621634,2022-01-11 21:19:44,"Pemkab dan Polresta Banyuwangi melakukan akselerasi percepatan vaksinasi anak usia 6 -11 tahun. Selama 2 hari, 900-an lebih anak telah divaksinasi. https://t.co/PAutNbxaHK",3,0,0,0,2022-01-11,21,Tuesday,2,3,0
1481012024830218245,2022-01-11 21:15:57,"Pria inisial RK (18) di Kota Manado, Sulawesi Utara (Sulut), ditangkap polisi karena menikam JT (24), warga Ternate Tanjung, Singkil, Manado, sebanyak 3 kali. https://t.co/D5aCaOAXBy",2,0,0,0,2022-01-11,21,Tuesday,2,2,0
1481010498573582336,2022-01-11 21:09:53,Unggah video makan daging ayam mentah yang dipenuhi dengan darah segar. Wanita ini tampak nyantai meski netizen panik sendiri menonton videonya. https://t.co/FuWAehoGcp,7,0,4,0,2022-01-11,21,Tuesday,2,11,0
1481008757207351298,2022-01-11 21:02:58,"Tottenham Hotspur punya banyak pekerjaan untuk meningkatkan level, bursa transfer salah satu solusinya. Tapi Antonio Conte tak berharap banyak di Januari ini. https://t.co/S7iX448ise",6,1,1,0,2022-01-11,21,Tuesday,2,7,1
1481006562206523393,2022-01-11 20:54:14,Kejagung menyelidiki dugaan korupsi penyewaan pesawat di PT Garuda Indonesia. Kejagung menyebut dalam kasus ini ada dugaan mark up penyewaan pesawat. https://t.co/Bowt1YGB8H,6,0,2,0,2022-01-11,20,Tuesday,2,8,0
1481005458462752768,2022-01-11 20:49:51,"Pengelola kafe yang bikin kerumunan saat pembukaan perdana diperiksa. Pembukaan kafe bernama Flambo Café &amp; Resto di kawasan Flamboyan, Kota Padang, itu dihadiri sejumlah pejabat, salah satunya Kepala Bappeda Sumbar. https://t.co/YZdXFwjGtm",1,0,0,0,2022-01-11,20,Tuesday,2,1,0
1481003422396604418,2022-01-11 20:41:46,Sosok Julia Fox kerap disebut sebagai kekasih Kanye West. Terungkap jika ia sempat berpose dengan Pete Davidson dan nge-fans Kim Kardashian. Ini potretnya:  https://t.co/fZuIrscTBX,0,0,0,0,2022-01-11,20,Tuesday,2,0,0
1481002096631685121,2022-01-11 20:36:30,"David Bennett, 57, dalam keadaan baik tiga hari setelah menjalani prosedur eksperimental, transplantasi jantung babi selama tujuh jam. https://t.co/2Ghocke0bz",31,10,15,1,2022-01-11,20,Tuesday,2,46,11
1481000736657973249,2022-01-11 20:31:05,Gubernur Jabar Ridwan Kamil dan Walikota Bogor Bima Arya meminta agar warga waspada tanpa panik berlebihan menghadapi varian Omicron. https://t.co/SDmT68jRmp,8,11,2,0,2022-01-11,20,Tuesday,2,10,11
1480999799201611779,2022-01-11 20:27:22,"Truk dengan nomor polisi H 1508 MF menabrak 2 mobil dan 2 sepeda motor di lampu merah Pandanwangi, Kecamatan Diwek, Jombang. Satu orang tewas di tempat. Insiden ini terekam kamera pengawas CCTV. https://t.co/UQdukWNoOQ",7,0,0,0,2022-01-11,20,Tuesday,2,7,0
1480998514708652032,2022-01-11 20:22:16,Nikita Mirzani kembali membuat heboh. Ia menyindir pengusaha Gilang Widya Pratama alias Juragan99. https://t.co/D3VLlKxg91,175,74,57,9,2022-01-11,20,Tuesday,2,232,83
1480997703958118401,2022-01-11 20:19:02,"Waterspout terpantau di Selat Bali. Menurut BMKG Banyuwangi, angin kencang ini sama dengan puting beliung jika berada di daratan. https://t.co/TL7gWEUpFp",7,0,2,0,2022-01-11,20,Tuesday,2,9,0
1480993826755993600,2022-01-11 20:03:38,"Pelatih Real Madrid, Carlo Ancelotti, enggan meremehkan Barcelona yang diterpa banyak masalah musim ini. Ia menilai laga El Clasico bakal selalu sulit. https://t.co/ugTlWPTPLd",3,0,0,0,2022-01-11,20,Tuesday,2,3,0
1480993085337350147,2022-01-11 20:00:41,Anggota Komisi III DPR Arsul Sani menyebut tidak bisa lagi artis hanya direhabilitasi setelah Nia Ramadhani divonis 1 tahun penjara. https://t.co/Z4Tls6rlcM,11,3,4,1,2022-01-11,20,Tuesday,2,15,4
1480991915885670400,2022-01-11 19:56:02,"Kacamata Virtual Reality biasanya digunakan untuk bermain game, tapi di peternakan justru dikenakan oleh sapi. Sapi terbukti menghasilkan susu lebih banyak. https://t.co/VsrfPtdtg4",4,0,2,0,2022-01-11,19,Tuesday,2,6,0
1480990597104160771,2022-01-11 19:50:48,Pengemudi itu tidak mengetahui jalan dan kondisi ketinggian jalan tidak rata. Mobil terperosok kemudian terguling ke kali. https://t.co/V5aKfTS2ac,2,0,0,0,2022-01-11,19,Tuesday,2,2,0
1480989390092607496,2022-01-11 19:46:00,Gibran Rakabuming dan Kaesang Pangarep dilaporkan ke KPK atas dugaan KKN terhadap relasi bisnis yang diduga terlibat pembakaran hutan. Begini respons Istana. https://t.co/m4XMShZRK9,11,6,1,2,2022-01-11,19,Tuesday,2,12,8
1480987717676814337,2022-01-11 19:39:21,"David Bennett, 57, dalam keadaan baik tiga hari setelah menjalani prosedur eksperimental, transplantasi jantung babi selama tujuh jam. https://t.co/7r30aYVGpt",19,1,9,0,2022-01-11,19,Tuesday,2,28,1
1480986440922279936,2022-01-11 19:34:17,"Cairan pelumas (oli) sempat berceceran di Jalan Pasar Senen, Senen, Jakarta Pusat. Ceceran oli ini pun membuat sejumlah pemotor yang melintas terjatuh. https://t.co/r6SeQ0QtUx",4,0,3,0,2022-01-11,19,Tuesday,2,7,0
1480982105760927746,2022-01-11 19:17:03,Truk trailer mengalami rem blong sehingga menabrak 2 mobil dan 2 sepeda motor di Jombang. Begini detik-detik kecelakaan itu terjadi. https://t.co/WfoJ6ODNPc,1,5,0,0,2022-01-11,19,Tuesday,2,1,5
1480981145634451456,2022-01-11 19:13:15,Terduga pelaku pencabulan anak di bawah umur di Kulon Progo telah ditangkap. Polisi membeberkan modus bejat pelaku. https://t.co/CZyKDfMKC8,18,2,9,0,2022-01-11,19,Tuesday,2,27,2
1480979671059771392,2022-01-11 19:07:23,Sebuah truk yang hendak masuk ke kapal feri jatuh ke Sungai Nil Mesir. Akibatnya 2 orang tewas dan 8 orang hilang. https://t.co/n4uvTCgg09,4,0,1,0,2022-01-11,19,Tuesday,2,5,0
1480978758056173577,2022-01-11 19:03:45,Padahal di mulut flyover Pesing sudah ada rambu dilarang motor melintas. Lalu sampai kapan flyover Pesing harus dijaga polisi? https://t.co/vJjRsoA1iY,6,7,1,2,2022-01-11,19,Tuesday,2,7,9
1480977116472696833,2022-01-11 18:57:14,Ruang rapat Fraksi Hanura di DPRD Batam hangus terbakar. Tidak ada korban dalam kebakaran di kantor legislatif tersebut. https://t.co/amApgfISeg,2,0,1,0,2022-01-11,18,Tuesday,2,3,0
1480976129871785989,2022-01-11 18:53:19,"Proyek galian drainase yang berada di Jl Jendral Gatot Subroto belum selesai juga. Padahal, tahun sudah berganti dari 2021 ke 2022. #detikcomdoyourmagic https://t.co/RmtK81miRN",6,3,4,1,2022-01-11,18,Tuesday,2,10,4
1480974759064178692,2022-01-11 18:47:52,Karo Penmas Divisi Humas Polri Brigjen Ahmad Ramadhan menegaskan cuitan Ferdinand Hutahaean soal 'Allahmu ternyata lemah' merupakan berita bohong. https://t.co/KiXamxkPfX,92,89,24,40,2022-01-11,18,Tuesday,2,116,129
1480973677344796675,2022-01-11 18:43:34,Anies Baswedan menganggarkan Rp 197 miliar untuk program penyaring sampah. Program ini ditargetkan selesai Juni 2022. Seperti apa? https://t.co/25hD1LARqD,53,17,12,4,2022-01-11,18,Tuesday,2,65,21
1480972771987542018,2022-01-11 18:39:58,"Pencurian kambing di Depok membuat geger warga. Pelaku mengambil 8 ekor kambing, menjagalnya di tempat dan hanya meninggalkan jeroan saja. https://t.co/m7ZJqMDKx2",11,2,2,2,2022-01-11,18,Tuesday,2,13,4
1480971549385674764,2022-01-11 18:35:07,"Tim gabungan dari TNI, Polri dan Satpol PP gagal menutup tempat hiburan malam Sky Garden di Deli Serdang. Apa alasannya? https://t.co/7IoludkRey",7,1,2,0,2022-01-11,18,Tuesday,2,9,1
1480970348925497359,2022-01-11 18:30:20,Kuasa hukum Nia Ramadhani dan Ardi Bakrie menyebut bahwa seharusnya mereka direhabilitasi. Sebab kuasa hukum menilai Nia dan Ardi merupakan korban penyalahguna narkotika. https://t.co/P8U0QKLWJV,6,1,1,0,2022-01-11,18,Tuesday,2,7,1
1480969459330437121,2022-01-11 18:26:48,"Puluhan siswa SD Negeri 29 Gunung Sarik, Kecamatan Kuranji Padang, Sumatera Barat, mengalami keracunan massal usai menyantap bakso bakar yang berada di depan sekolahnya. Para korban mengalami muntah-muntah dan sakit perut. https://t.co/6ofnvULctk",6,1,1,0,2022-01-11,18,Tuesday,2,7,1
1480968275836157965,2022-01-11 18:22:06,Nia Ramadhani dan Ardi Bakrie divonis hukuman 1 tahun penjara atas kasus penyalahgunaan narkoba. Vonis ini lebih berat dari tuntutan jaksa. https://t.co/ZDDeZ5tX0a,11,1,3,0,2022-01-11,18,Tuesday,2,14,1
1480967076512780289,2022-01-11 18:17:20,Di dalam gambar berikut ada beberapa hal yang tidak masuk akal. Bila kamu bisa menemukannya berarti logika kamu jalan. https://t.co/pAfryBv9Ou,11,5,2,0,2022-01-11,18,Tuesday,2,13,5
1480965989936340996,2022-01-11 18:13:01,"Direktur Eksekutif Indikator Politik Indonesia, Burhanudin Muhtadi, menyebut Anies Baswedan akan mudah mendapat konsolidasi dukungan di pilpres jika maju melalui Gerindra.  https://t.co/zeSIhbc5Oa",4,6,2,1,2022-01-11,18,Tuesday,2,6,7
1480964233030471682,2022-01-11 18:06:02,"Inter Milan dan Juventus akan beradu untuk titel pertama musim ini di Piala Super Italia. Demi membungkam Juve, Nerazzurri berencana main agresif dan gigih. https://t.co/O3DbcxvXXO",1,0,0,0,2022-01-11,18,Tuesday,2,1,0
1480963831992094725,2022-01-11 18:04:27,"Wakil Ketua KPK, Nurul Ghufron, merespons soal dua putra Presiden, Gibran Rakabuming Raka dan Kaesang Pangarep, yang dilaporkan Ubedilah Badrun terkait dugaan tindak pidana korupsi.  https://t.co/6gnLiycm7Z",18,6,5,4,2022-01-11,18,Tuesday,2,23,10
1480962032455323657,2022-01-11 17:57:18,Luhut mengatakan RI masuk kondisi siaga utama saat tingkat keterisian rumah sakit mencapai 20-30 persen. Pemerintah akan memantau ketat perkembangan Omicron. https://t.co/pxFiZUmhST,23,15,9,7,2022-01-11,17,Tuesday,2,32,22
1480961761675202562,2022-01-11 17:56:13,"Beberapa tips bisa dilakukan untuk mendongkrak gairah seksual, baik pria maupun wanita. Salah satunya dengan mengonsumsi coklat. https://t.co/WKvCqBcZeo",8,0,3,1,2022-01-11,17,Tuesday,2,11,1
1480960683290279942,2022-01-11 17:51:56,Tidak hanya penyakit jantung kronis yang menjadi penyebab narapidana Andi Lolo (35) tewas usai dijemput polisi. https://t.co/GFYiFmGZcZ,4,0,0,0,2022-01-11,17,Tuesday,2,4,0
1480959405806043142,2022-01-11 17:46:51,Di sana terdapat sederet rumah jadul yang beberapa diantaranya memiliki nilai sejarah. Seperti apa? https://t.co/SeBQW1MGKN,5,0,7,0,2022-01-11,17,Tuesday,2,12,0
1480958416084426752,2022-01-11 17:42:55,"Puluhan PKL di depan RS UKI, Cawang bakal direlokasi ke lokasi binaan. Relokasi dilakukan karena keberadaan PKL kerap membuat lalulintas macet. https://t.co/iB60lykMvh",5,1,2,0,2022-01-11,17,Tuesday,2,7,1
1480957179427438595,2022-01-11 17:38:01,Menteri Investasi/Kepala BKPM Bahlil Lahadalia mengklaim bahwa para pengusaha menginginkan agar Pilpres 2024 ditunda ke 2027. Ini respons Puan. https://t.co/qVVzsxNhZo,7,0,3,0,2022-01-11,17,Tuesday,2,10,0
1480956247906177030,2022-01-11 17:34:18,Apa saja isi rukun nikah dalam agama Islam? Berikut lima rukun nikah yang wajib ada agar pernikahan sah sesuai ajaran Islam. https://t.co/UCjufSU8rN,17,0,7,0,2022-01-11,17,Tuesday,2,24,0
1480955491815669760,2022-01-11 17:31:18,Ferdinand terancam 10 tahun dipenjara karena cuitan 'Allahmu ternyata lemah'. Dirinya meminta penangguhan penahanan karena gangguan saraf. https://t.co/5mlxn9W2yY,51,63,5,10,2022-01-11,17,Tuesday,2,56,73
1480954515872526338,2022-01-11 17:27:26,Nia Ramadhani pernah merasa dilema menjadi dirinya sendiri adalah sebuah kutukan. Nia pun tak menyangka ketika dituntut 12 bulan rehabilitasi karena sabu. https://t.co/LblvkyvXAj,8,2,2,3,2022-01-11,17,Tuesday,2,10,5
1480953591120728070,2022-01-11 17:23:45,Mutasi virus Corona selalu diwaspadai. Contoh terbaru dapat dilihat pada kasus Corona India. Negara ini mengalami lonjakan kasus Corona akibat varian Omicron. https://t.co/M4hznWuWLB,7,0,5,2,2022-01-11,17,Tuesday,2,12,2
1480952835445510155,2022-01-11 17:20:45,"Seorang pria jadi korban pemalakan disertai penganiayaan di Kampung Bahari, Jakarta Utara. Kapolsek Jakut, Kompol Ricky Prenata menyebut pihaknya kesulitan mencari pelaku karena korban tidak membuat laporan. https://t.co/uDVH9FKljf",10,0,1,0,2022-01-11,17,Tuesday,2,11,0
1480951700601339904,2022-01-11 17:16:14,Jaksa mendesak hakim untuk membubarkan dan menyita aset yayasan milik Herry Wirawan untuk dilelangkan. https://t.co/Fy06IrzdAX,19,1,2,0,2022-01-11,17,Tuesday,2,21,1
1480950584190644226,2022-01-11 17:11:48,"Para ilmuwan tidak ada hentinya mencari cara untuk dapat ke luar angkasa dengan berbagai cara. Kini ada ide gila yang rupanya sudah lama dibicarakan, yakni membuat lift ke luar angkasa. Apa mungkin? https://t.co/Q3SZWirfJ6",17,3,3,2,2022-01-11,17,Tuesday,2,20,5
1480949635611086856,2022-01-11 17:08:02,Vaksin booster untuk COVID-19 rencananya akan mulai diberikan Rabu (12/1/2022). Beberapa saran dari dokter ada ada baiknya diikuti saat menerima booster. https://t.co/uLR0p0dEru,4,0,3,0,2022-01-11,17,Tuesday,2,7,0
1480948612158967811,2022-01-11 17:03:58,Vaksinasi booster mulai dilakukan hari Rabu (12/1). Mekanisme pelaksanaan ada yang gratis dan berbayar. Siapa saja yang mendapatkan booster gratis? https://t.co/Jvm1S4eX4F,6,0,2,2,2022-01-11,17,Tuesday,2,8,2
1480947895155240965,2022-01-11 17:01:07,"Selama hampir 1,5 abad LBM Eijkman berkontribusi penting bagi dunia kesehatan. Peleburan ke BRIN telah membuatnya kehilangan para ilmuwan andalan. https://t.co/W9uvAlIkM7",10,2,3,0,2022-01-11,17,Tuesday,2,13,2
1480944395180519432,2022-01-11 16:47:13,Deputi V Kantor Staf Kepresidenan Jaleswari Pramodhawardani menegaskan Presiden Jokowi menolak perpanjangan masa jabatan. https://t.co/NWV7RMXqeH,64,24,16,9,2022-01-11,16,Tuesday,2,80,33
1480943232372588547,2022-01-11 16:42:35,Kondisi kesehatan Pak Ogah menurun. Dalam media sosial miliknya terlihat Pak Ogah mulai ngaco bicara. Ia pun mengatakan ingin terus pulang. https://t.co/UWMkegZZzt,15,3,2,0,2022-01-11,16,Tuesday,2,17,3
1480942534935388161,2022-01-11 16:39:49,Pedangdut inisial V adalah Velline Chu yang menjadi tersangka terkait kasus penyalahgunaan narkoba. Ini fakta-fakta kasusnya. https://t.co/noIpznj7z3,8,3,1,0,2022-01-11,16,Tuesday,2,9,3
1480941497122009089,2022-01-11 16:35:42,Seorang pria di Tapanuli Utara membakar temannya sendiri menggunakan bensin. Ia karena kesal motornya dirusak korban. https://t.co/hBQlIJMhY3,16,1,3,3,2022-01-11,16,Tuesday,2,19,4
1480940411539623942,2022-01-11 16:31:23,"Saat itu ada sejumlah penumpang yang berada di toilet wanita lokasi emas ditemukan. Saat ditanyai soal emas itu, kata Dewi, tidak ada penumpang yang mengaku memiliki. https://t.co/L5aYfMSuTn",8,0,1,1,2022-01-11,16,Tuesday,2,9,1
1480939407138078723,2022-01-11 16:27:23,Nia Ramadhani dan Ardi Bakrie divonis 1 tahun penjara terkait penyalahgunaan narkoba. Penampilan Nia kala sidang turut disorot. Ini potretnya:  https://t.co/YCTXQFXcsz,14,2,2,0,2022-01-11,16,Tuesday,2,16,2
1480938348797734924,2022-01-11 16:23:11,"Sempat membuat resah warga karena sering muncul di pemukiman penduduk, seekor Harimau Sumatera akhirnya diamankan petugas BKSDA Sumatera Barat. https://t.co/Za945Oz0g7",13,7,3,4,2022-01-11,16,Tuesday,2,16,11
1480937611409690627,2022-01-11 16:20:15,Marcus Rashford yang melempem di Manchester United tengah jadi sorotan. Rashford butuh gol untuk meningkatkan kembali rasa percaya dirinya. https://t.co/xARf3bta9a,6,1,0,0,2022-01-11,16,Tuesday,2,6,1
1480937345528610819,2022-01-11 16:19:12,Kerinduan Abdul Hamid atau Pak Ogah kepada Pak Raden pecah saat memeluk boneka Pak Ogah di kediamannya. https://t.co/fxOX5ooseg,85,0,15,2,2022-01-11,16,Tuesday,2,100,2
1480936033898409984,2022-01-11 16:13:59,"Penasaran bagaimana cara daftar vaksin booster gratis? Bisa cek tiket vaksin booster di PeduliLindungi atau langsung datang ke fasilitas kesehatan, ini caranya. https://t.co/BvVzPWgLNj",11,0,5,0,2022-01-11,16,Tuesday,2,16,0
1480935059406393349,2022-01-11 16:10:07,Seorang pria berinisial I (19) dibekuk polisi karena memerkosa pacarnya hingga hamil. Korban disebut diiming-imingi akan dinikahi oleh pelaku. https://t.co/INlpmWGUdI,9,4,2,1,2022-01-11,16,Tuesday,2,11,5
1480933809436733449,2022-01-11 16:05:09,"Meskipun telah tiada, kakak selebgram Laura Anna, Greta Irene diketahui tetap rutin menghiasi kamar sang adik dengan bunga setiap harinya. Greta pun ungkap alasan kebiasaannya tersebut. https://t.co/qSH0zuOkWz",10,1,3,0,2022-01-11,16,Tuesday,2,13,1
1480932864527159297,2022-01-11 16:01:23,Indonesia rencananya akan memberikan booster atau dosis ketiga vaksin COVID-19 mulai Rabu (12/1/2022). Menkes Budi menjelaskan lokasi pemberian booster. https://t.co/5eIrKXXf6b,9,4,6,0,2022-01-11,16,Tuesday,2,15,4
1480932847267553287,2022-01-11 16:01:19,Lata Mangeshkar dilaporkan tengah berada di ICU karena positif COVID-19. Penyanyi legendaris Bollywood itu kini berusia 92 tahun. https://t.co/3nebv1L4zF,4,0,2,0,2022-01-11,16,Tuesday,2,6,0
1480931817066741771,2022-01-11 15:57:14,Rumor Rans Cilegon FC ingin mendatangkan Mesut Ozil membuat bayangan tim tersebut dimanja oleh sosok yang menghadirkan banyak assist di lapangan. #CNNIndonesia #detiknetwork  https://t.co/yfw5QaPTwX,20,3,3,4,2022-01-11,15,Tuesday,2,23,7
1480931432893714437,2022-01-11 15:55:42,"Tiga pemuda di Yogyakarta yakni Venzha Christ, Erix Soekamti dan Grayce Soba membangun simulasi analog hidup di Mars. https://t.co/IhjbCuhHRV",187,7,37,6,2022-01-11,15,Tuesday,2,224,13
1480931092513361932,2022-01-11 15:54:21,Saringan sampah Rp 197 miliar ini masuk program prioritas Anies yang ditargetkan rampung Juni 2022. Apa keunggulannya? https://t.co/JYxbgaHU9E,24,15,3,2,2022-01-11,15,Tuesday,2,27,17
1480930434804551682,2022-01-11 15:51:44,"Nia Ramadhani, Ardi serta sopirnya divonis satu tahun penjara. Majelis hakim menilai mereka bukan pecandu maupun korban penyalahgunaan narkotika. Berikut penjelasan dari majelis hakim: https://t.co/4L5mlXqLEw",10,4,0,1,2022-01-11,15,Tuesday,2,10,5
1480929426082865165,2022-01-11 15:47:44,"""Mohon maaf karena berat badan saya berlebih, hampir tersungkur. Untung ditolong Pak Menteri,"" kata Bupati Klaten Sri Mulyani. https://t.co/2FZJh2NbJD",11,2,1,0,2022-01-11,15,Tuesday,2,12,2
1480928359253262350,2022-01-11 15:43:29,Epidemiolog UI mengklaim 70 persen anak di RI sudah kebal COVID-19. Lantas PTM 100 persen di tengah merebaknya varian Omicron bakal aman-aman saja? https://t.co/DNfy5WsQen,12,3,1,0,2022-01-11,15,Tuesday,2,13,3
1480927284928389120,2022-01-11 15:39:13,Wagub DKI Riza Patria menyebut Pemprov sudah menyiapkan skenario kemungkinan gelombang ketiga COVID. https://t.co/58HQtqRCye,16,12,1,0,2022-01-11,15,Tuesday,2,17,12
1480926319911354374,2022-01-11 15:35:23,Herry akan mendengarkan langsung tuntutan yang akan dibacakan oleh jaksa. https://t.co/pA6D3oiv2X,10,0,0,0,2022-01-11,15,Tuesday,2,10,0
1480925727847501824,2022-01-11 15:33:02,Ferdinand Hutahaean menjadi tersangka terkait cuitan 'Allahmu ternyata lemah' yang dipublish melalui Twitter-nya. Berikut ini deretan kontroversinya. https://t.co/BKzHY8OJ3F,7,4,1,1,2022-01-11,15,Tuesday,2,8,5
1480923187273781248,2022-01-11 15:22:56,Golkar menilai persoalan pengunduran pilpres ini bisa menimbulkan komplikasi baru. https://t.co/xsYuAgh1Ul,21,3,6,0,2022-01-11,15,Tuesday,2,27,3
1480922175771189250,2022-01-11 15:18:55,Korban tewas dalam kecelakaan maut minibus menabrak truk di Tol Boyolali tadi malam bertambah menjadi tiga orang. Berikut ini identitasnya. https://t.co/A7AsYmTMcz,52,6,14,2,2022-01-11,15,Tuesday,2,66,8
1480920781135781890,2022-01-11 15:13:23,"Indonesia mencatat 802 kasus baru COVID-19, Selasa (11/1/2022). DKI menyumbang kasus terbanyak dengan jumlah 537. https://t.co/asHaKc88ul",11,3,11,2,2022-01-11,15,Tuesday,2,22,5
1480919154802757635,2022-01-11 15:06:55,"Sempat membuat resah warga karena sering muncul di pemukiman penduduk, seekor harimau Sumatera akhirnya diamankan petugas BKSDA. https://t.co/4zPjcELB38",12,6,4,2,2022-01-11,15,Tuesday,2,16,8
1480918075717390341,2022-01-11 15:02:38,Nama Gubernur Jawa Barat Ridwan Kamil berada di posisi kedua usai Sandiaga Uno dalam hasil survei cawapres terkuat di 2024. Ini respons Kang Emil. https://t.co/zcCYyA9GPQ,18,36,1,1,2022-01-11,15,Tuesday,2,19,37
1480918050379640832,2022-01-11 15:02:31,"Kades, polisi, dan pengusaha di Banyuwangi yang tertangkap saat pesta sabu divonis 6 bulan rehabilitasi. Atas putusan itu, jaksa masih pikir-pikir. https://t.co/n2D9nAxNoO",14,3,7,2,2022-01-11,15,Tuesday,2,21,5
1480916954366058507,2022-01-11 14:58:10,Vaksin khusus varian Omicron akan segera hadir. Perusahaan farmasi Pfizer menyebut tersebut bakal siap di Maret 2022 mendatang. https://t.co/BJPReYh7IW,16,13,12,11,2022-01-11,14,Tuesday,2,28,24
1480916277803819019,2022-01-11 14:55:29,Seorang juru bicara terkemuka kelompok Taliban Pakistan telah tewas dibunuh di Afghanistan. Dia tewas setelah dalam pelarian sejak 2014. https://t.co/zKfIOvkOpl,9,0,1,0,2022-01-11,14,Tuesday,2,10,0
1480914708840562688,2022-01-11 14:49:15,Spesies predator laut berdarah panas itu diperkirakan hidup sekitar 250 juta hingga 90 juta tahun lalu. Seperti apa? https://t.co/UI0FCWWzyH,25,0,6,1,2022-01-11,14,Tuesday,2,31,1
1480914679966969862,2022-01-11 14:49:08,"Penerus kuliner Jadah Tempe Mbah Carik, Sudimah Wiro Sartono, meninggal pada Selasa petang (11/1/2022). Sudimah dimakamkan di Kaliurang besok Rabu pukul 11.00. https://t.co/qTgd1uVHEN",16,1,10,0,2022-01-11,14,Tuesday,2,26,1
1480914678394105856,2022-01-11 14:49:08,Presiden Joko Widodo (Jokowi) memastikan vaksinasi dosis ketiga atau vaksin booster COVID-19 untuk warga tidak dipungut biaya. Ini alasannya. https://t.co/rLi7Hpkpwd,19,4,6,1,2022-01-11,14,Tuesday,2,25,5
1480913619714035719,2022-01-11 14:44:55,"""Meski sering kontroversial, Ahok tetap dibanggakan karena dinilai punya kinerja bagus terutama saat memimpin di Jakarta."" https://t.co/4y4h7KaCGA",73,32,10,5,2022-01-11,14,Tuesday,2,83,37
1480912535247368196,2022-01-11 14:40:37,Kemnaker juga membentuk Satuan Tugas (Satgas) Pencegahan Pekerja Migran Indonesia non prosedural di 25 lokasi embarkasi/debarkasi/daerah asal PMI. https://t.co/Ot5jLOeJbE,9,1,1,0,2022-01-11,14,Tuesday,2,10,1
1480911938016223238,2022-01-11 14:38:14,"Pelukis Nugroho asal Magelang mempunyai gaya melukis yang berbeda. Jika biasanya para pelukis menggunakan kanvas sebagai media melukis, ia memilih menggunakan kaca. Seperti apa kisahnya? https://t.co/n9ghaLuGeT",15,0,0,0,2022-01-11,14,Tuesday,2,15,0
1480911008919080974,2022-01-11 14:34:33,"Pertengkaran rumah tangga bisa bermula dari kehadiran pelakor atau pebinor. Namun, bagaimana bila bukinya hanya chatting, apakah sudah bisa dipidanakan? #detiksAdvocate https://t.co/O59B2GOzUc",15,4,1,2,2022-01-11,14,Tuesday,2,16,6
1480910312136228880,2022-01-11 14:31:47,Ada syarat dan ketentuan untuk penerima booster. Apa syaratnya? https://t.co/Hh4VuLbwqd,15,0,8,1,2022-01-11,14,Tuesday,2,23,1
1480908997553278979,2022-01-11 14:26:33,"Banjir yang melanda Desa Kwadungan Lor, Padas mulai merendam Jalan Arteri Ngawi Caruban. Banjir yang ketinggiannya 10-15 cm membuat kendaraan harus merayap. https://t.co/YEEUTtf24a",14,1,4,0,2022-01-11,14,Tuesday,2,18,1
1480908586452672522,2022-01-11 14:24:55,Pemprov DKI akan menutup pelican crossing di dekat JPO Karet 'kapal pinisi' di Jalan Sudirman. Apa kata warga? https://t.co/7SgKk7r1n6,14,0,0,0,2022-01-11,14,Tuesday,2,14,0
1480907839090700306,2022-01-11 14:21:57,"TB Hasanuddin menyebut biasanya oknum TNI memiliki alasan masing-masing, dari ada masalah hingga kepribadian yang buruk. https://t.co/tcB3j7flf4",17,0,2,1,2022-01-11,14,Tuesday,2,19,1
1480906942197424135,2022-01-11 14:18:23,Ustaz Yusuf Mansur melaporkan sejumlah orang ke polisi terkait pencemaran nama baik. Salah satu oknum tersebut adalah penggugat Ustaz Yusuf di Pengadilan Negeri Tangerang. https://t.co/geCZyhduOZ,9,2,0,0,2022-01-11,14,Tuesday,2,9,2
1480906298464083970,2022-01-11 14:15:50,"Usai persidangan, kuasa hukum Gaga Muhammad, Fahmi Bachmid, mengutarakan pesan-pesan Gaga yang disampaikan untuk publik. Salah satu poin yang disinggung adalah meminta untuk tidak memanfaatkan penderitaan Laura Anna sebagai panggung pansos. https://t.co/ZB65OpHnBH",9,2,1,0,2022-01-11,14,Tuesday,2,10,2
1480905209173921800,2022-01-11 14:11:30,"Jenazah SAR (14), bocah asal Pemalang, disimpan oleh keluarganya di rumah selama lebih dari 2 bulan. Petugas medis telah mengungkap penyebab meninggalnya. https://t.co/6l0j9QcHFe",19,1,4,0,2022-01-11,14,Tuesday,2,23,1
1480903908570587139,2022-01-11 14:06:20,"Herry Wirawan terdakwa pemerkosa 13 santriwati di Bandung dituntut hukuman mati. Selain kabar soal Herry, ada juga kasus pembunuhan anggota geng motor. https://t.co/mh6UDWX3q0",19,5,3,1,2022-01-11,14,Tuesday,2,22,6
1480903490704748551,2022-01-11 14:04:40,"Banjir kembali menerjang Kecamatan Pengaron, Kabupaten Banjar, Kalimantan Selatan, Selasa (11/1). Ratusan rumah warga mulai terendam. https://t.co/u9Sfv6yfaX",11,0,3,0,2022-01-11,14,Tuesday,2,14,0
1480902808601874434,2022-01-11 14:01:58,"Agar aktivitas seks bisa dilakukan dengan lebih bergairah, penting untuk menjaga kebugaran tubuh. Salah satunya dengan mengonsumsi asupan bernutrisi dan herbal. #detikNetwork https://t.co/NVVzIgpbqF",7,0,0,0,2022-01-11,14,Tuesday,2,7,0
1480901623304142854,2022-01-11 13:57:15,Tak ada Cristiano Ronaldo saat Manchester United mengalahkan Aston Villa di Piala FA. Ronaldo rupanya mengalami cedera ringan sehingga harus absen.  https://t.co/GvmZ9BSyKp,8,1,0,0,2022-01-11,13,Tuesday,2,8,1
1480900692420222977,2022-01-11 13:53:33,"Melamar pekerjaan maupun mendaftar beasiswa di luar negeri menggunakan CV ATS. Simak tips membuat CV ATS Friendly yuk!

via: detikedu https://t.co/VthtBtlubu",30,0,10,0,2022-01-11,13,Tuesday,2,40,0
1480899718704156674,2022-01-11 13:49:41,"#Terpopuler Ketika Uni Soviet ambruk, 400 km dari Bumi melayang seorang kosmonaut yang tidak tahu apa yang tengah terjadi di negaranya. Simak kisahnya: https://t.co/blIoHCt6Qd",34,1,7,0,2022-01-11,13,Tuesday,2,41,1
1480898627262369793,2022-01-11 13:45:21,"""Beliau memang salah satu figur yang cocok menjadi Presiden pengganti Jokowi. Sayang saja rasanya kalau beliau tidak maju."" https://t.co/7ipRIjUBnr",17,19,1,2,2022-01-11,13,Tuesday,2,18,21
1480897920169922560,2022-01-11 13:42:32,Megawati Soekarnoputri mengungkap adanya benalu yang mencari untung di tengah kondisi pandemi COVID-19. PKS justru ungkit penyimpangan bansos. https://t.co/TEqZjxgeM3,47,11,4,3,2022-01-11,13,Tuesday,2,51,14
1480896890522804229,2022-01-11 13:38:27,Nia Ramadhani dan Ardi Bakrie menyatakan banding atas hukuman 1 tahun penjara karena terbukti bersalah di kasus narkoba. Apa respons jaksa? https://t.co/rNptV6jiHW,6,2,0,0,2022-01-11,13,Tuesday,2,6,2
1480895333190230016,2022-01-11 13:32:15,Pimpinan KPK menyebut adanya harta irasional pada kasus Walkot Bekasi Rahmat Effendi. Lantas bagaimana harta kekayaan Rahmat Effendi dari tahun ke tahun? https://t.co/jSYCWc51DL,13,3,2,3,2022-01-11,13,Tuesday,2,15,6
1480894589796077578,2022-01-11 13:29:18,Persita Tangerang akhirnya meraih kemenangan lagi pada pekan ke-19 BRI Liga 1. https://t.co/uZgwQhlXtP,6,0,0,0,2022-01-11,13,Tuesday,2,6,0
1480894551632060417,2022-01-11 13:29:09,Kota Pasuruan dibelah tiga aliran sungai besar. Kondisi ini menyebabkan kota di pesisir utara pulau Jawa ini rawan banjir yang disebabkan luapan sungai. https://t.co/4qcK9YlBQ3,8,0,0,0,2022-01-11,13,Tuesday,2,8,0
1480894550340247554,2022-01-11 13:29:09,Polisi mengungkap kasus penemuan mayat pria dengan kondisi telah membusuk di perkebunan milik warga di Jambi. Mayat tersebut merupakan korban pembunuhan. https://t.co/c66jDCXl5l,8,0,0,0,2022-01-11,13,Tuesday,2,8,0
1480894149658304515,2022-01-11 13:27:33,"Oknum TNI AL diduga memukul driver ojek online (ojol). Akibatnya, kantor Polsek Pamulang, Tangerang Selatan digeruduk puluhan driver ojol. https://t.co/ps7LRiPZM1",30,6,7,2,2022-01-11,13,Tuesday,2,37,8
1480892897578921987,2022-01-11 13:22:35,Apakah kalian masih bingung menentukan permainan yang ingin dimainkan pada Januari 2022? Ini daftar game pc gratis yang patut dicoba gamer:  https://t.co/NQOkqVKivq,10,0,1,1,2022-01-11,13,Tuesday,2,11,1
1480892159100432386,2022-01-11 13:19:39,Samsung kabarnya akan menggelar event Galaxy Unpacked pada 8 Februari 2022. Di event ini mereka sepertinya akan meluncurkan trio Galaxy S22. https://t.co/oGsmA8egZm,10,0,0,2,2022-01-11,13,Tuesday,2,10,2
1480891145836285958,2022-01-11 13:15:37,"Selama di Negeri Paman Sam, Suyanto bekerja di sebuah industri pembuatan pesawat terbang. Simak ceritanya: https://t.co/08ajJoOYPm",35,2,6,3,2022-01-11,13,Tuesday,2,41,5
1480890589759557632,2022-01-11 13:13:24,"#Foto Warga muslim di Bulgaria, punya tradisi pernikahan yang unik. Keunikan tersebut masih dipertahankan hingga kini. Yuk lihat potretnya. https://t.co/BaN9dHCtka",9,0,1,0,2022-01-11,13,Tuesday,2,10,0
1480890326923554819,2022-01-11 13:12:22,"Ponsel layar lipat Oppo Find N baru dirilis pada pertengahan Desember 2021 lalu, dan batch pertamanya langsung terjual habis.  https://t.co/8Qdjk97jRn",5,0,1,0,2022-01-11,13,Tuesday,2,6,0
1480889194041987076,2022-01-11 13:07:52,Video yang menampilkan 2 polantas Polres Muna tengah mengangkut motor dari sebuah sekolah disoraki oleh ratusan siswa viral di media sosial https://t.co/iiDKyEnDak,6,2,1,0,2022-01-11,13,Tuesday,2,7,2
1480888269747413004,2022-01-11 13:04:11,"Seekor sanca kembang sepanjang lebih dari 3 meter terciduk saat ekskavator mengangkut tumpukan sampah di sungai di Desa Kedawung Kulon, Pasuruan, Jawa Timur. https://t.co/cLJ0hjHtqa",4,2,0,0,2022-01-11,13,Tuesday,2,4,2
1480887547618373642,2022-01-11 13:01:19,"Menyambut tahun baru, Sony kembali memberikan akses secara cuma-cuma, untuk beberapa game PS Plus kepada member. Semuanya dapat dinikmati sejak 4 Januari lalu. https://t.co/QftlHQ0dkl",2,0,0,0,2022-01-11,13,Tuesday,2,2,0
1480887307842555904,2022-01-11 13:00:22,"Truk dengan nomor polisi H 1508 MF menabrak 2 mobil dan 2 sepeda motor di lampu merah Pandanwangi, Kecamatan Diwek, Jombang. Satu orang tewas di tempat. Insiden ini terekam kamera pengawas CCTV. https://t.co/VN0lSPxfM1 https://t.co/Nj0rdwTCLz",6,0,2,0,2022-01-11,13,Tuesday,2,8,0
1480886731729682433,2022-01-11 12:58:05,"Kamu yang mencari sepatu untuk menikah bisa mencari yang model serta detailnya romantis, ini 7 rekomendasinya: https://t.co/rw2gq7vMAX",4,0,1,0,2022-01-11,12,Tuesday,2,5,0
1480886419925225472,2022-01-11 12:56:50,Vaksinasi COVID-19 untuk anak usia 6-11 tahun dimulai Selasa 14 Desember 2021. Ini semua tentang vaksin buat anak di bawah 12 tahun yang harus diketahui:  https://t.co/GuZxYuloAR,1,0,0,0,2022-01-11,12,Tuesday,2,1,0
1480886036578373634,2022-01-11 12:55:19,"Ini waktunya para siswa untuk memilih jurusan kuliah yang sesuai untuk masa depan. Apa saja tanda jika kamu sudah memilih jurusan kuliah yang tepat ya?

via: detikedu https://t.co/mMvPyWwsHU",6,0,2,1,2022-01-11,12,Tuesday,2,8,1
1480886018278625283,2022-01-11 12:55:14,"Ubedillah Badrun jadi sorotan pasca melaporkan dua anak Presiden RI, Gibran Rakabuming Raka dan Kaesang Pangarep ke KPK. Ini sosoknya. https://t.co/3v2TB6ureF",55,31,6,1,2022-01-11,12,Tuesday,2,61,32
1480885308455460866,2022-01-11 12:52:25,Bingung ingin memainkan game PC gratis di tahun 2022? Ini rekomendasi yang bisa kamu mainkan secara cuma-cuma nih:  https://t.co/StgIKM4MMa,12,1,4,0,2022-01-11,12,Tuesday,2,16,1
1480884712445038593,2022-01-11 12:50:03,"Kepala kurikulum Kemendikbudristek jelaskan hanya ada satu kriteria bagi sekolah yang ingin terapkan kurikum prototipe. Apa ya itu? 

via: detikedu https://t.co/YlB1aMLnNl",7,1,0,1,2022-01-11,12,Tuesday,2,7,2
1480884377970171906,2022-01-11 12:48:43,Kunci pertama dalam menarik investor adalah pastikan startup yang kamu miliki dikelilingi oleh orang-orang yang tepat. https://t.co/mkvYO2ksnk,8,0,1,0,2022-01-11,12,Tuesday,2,9,0
1480884357833400322,2022-01-11 12:48:39,"Siap-siap! Aplikasi Allo Bank diluncurkan Maret, targetnya 10 juta pengguna Allo Bank terjaring di 2022. https://t.co/7UQotjlbCP",7,0,1,2,2022-01-11,12,Tuesday,2,8,2
1480883390287077379,2022-01-11 12:44:48,Julia Fox ternyata adalah fans fanatik serial Keeping Up with The Kardashian dan ingin menjadi bagian dari keluarga Kim. Kini Julia Fox berkencan dengan Kanye West. https://t.co/TU66op8r5H,8,3,1,0,2022-01-11,12,Tuesday,2,9,3
1480883022950027268,2022-01-11 12:43:20,"Kebakaran rumah di Kelurahan Ujung Menteng, Cakung, Jaktim sudah dipadamkan. Kebakaran diduga akibat korsleting listrik. https://t.co/DlHTYTa5Ek",1,0,0,0,2022-01-11,12,Tuesday,2,1,0
1480882712579919876,2022-01-11 12:42:06,"Masa jabatan presiden sendiri telah ditetapkan dalam UUD 1945. Lantas, bisakah diperpanjang?

via: detikedu https://t.co/uCkSkqyOXP",25,18,0,0,2022-01-11,12,Tuesday,2,25,18
1480882692128485376,2022-01-11 12:42:01,Penggemar anime pasti sudah tidak asing lagi dengan serial Attack on Titan. Bagian kedua dari musim terakhir Attack on Titan kini sudah tayang di iQiyi. https://t.co/se2NvqiDSS,12,2,2,0,2022-01-11,12,Tuesday,2,14,2
1480882244705263622,2022-01-11 12:40:15,"Erisca Febriani punya sejumlah cerita di balik kesuksesan trilogi novel dan film Dear Nathan. Dari ditolak penerbit, ditipu sampai dikatai naskah jelek. Ini kisahnya:  https://t.co/AoDFAXGUDz",3,0,0,0,2022-01-11,12,Tuesday,2,3,0
1480881703832928257,2022-01-11 12:38:06,Lelang aset Tommy Soeharto dilakukan pada 12 Januari 2022 dengan batas akhir penawaran 12.00 WIB (sesuai server). Ini syarat dan ketentuannya.  https://t.co/O8ohYDn0P0,11,6,2,2,2022-01-11,12,Tuesday,2,13,8
1480881053606809602,2022-01-11 12:35:31,Kaesang terlihat memposting video dalam media sosial miliknya. Kali ini terlihat jika Kaesang sedang dipijit oleh Jan Ethes.  https://t.co/9z7yTk3jJg,13,1,2,1,2022-01-11,12,Tuesday,2,15,2
1480881023751798787,2022-01-11 12:35:24,Kerusuhan terjadi di se-antero Kazakhstan dikarenakan harga BBM dan LPG yang naik. Gedung dan pusat pemerintahan diamuk massa. Begini foto-foto kerusakannya. https://t.co/VvHlb3fSr2,19,2,2,0,2022-01-11,12,Tuesday,2,21,2
1480880466278428673,2022-01-11 12:33:11,"Dari 1999 sampai 2022 sekarang ini, Ibrahimovic selalu bikin gol tiap tahun! https://t.co/GOCjlTm4So",15,2,1,0,2022-01-11,12,Tuesday,2,16,2
1480879524774617093,2022-01-11 12:29:26,Klub itu bisa menjadi tempat yang tak asing buat Saddil karena banyak komunitas muslim di sana. https://t.co/lB3wsE29uc,9,0,0,0,2022-01-11,12,Tuesday,2,9,0
1480879502557335559,2022-01-11 12:29:21,"Kasus kebakaran bengkel di Cibodas, Kota Tangerang sempat memicu perhatian publik karena ternyata dilakukan pelaku yang diduga sakit hati terhadap kekasihnya. https://t.co/ZWNFoacAlx",5,1,0,0,2022-01-11,12,Tuesday,2,5,1
1480878289262714880,2022-01-11 12:24:32,Barcelona akan menghadapi Real Madrid di semifinal Piala Super Spanyol. Berikut  empat hal yang perlu diperbaiki Blaugrana jika ingin mengalahkan Los Blancos. https://t.co/3tkdRfFKky,3,1,0,0,2022-01-11,12,Tuesday,2,3,1
1480877923129307142,2022-01-11 12:23:04,"Kondisi ini pun tak dipungkiri membuat investor kebingungan mengambil sikap, menahan atau menjualnya. https://t.co/aSbSS7sJPZ",6,4,0,1,2022-01-11,12,Tuesday,2,6,5
1480876940085141506,2022-01-11 12:19:10,Rute penerbangan Banyuwangi-Sumenep (PP) resmi dibuka. Penerbangan perdana rute Banyuwangi-Sumenep ini ditandai inaugurasi flight maskapai Susi Air. https://t.co/aHYG8yoHJv,9,0,1,0,2022-01-11,12,Tuesday,2,10,0
1480876938738733058,2022-01-11 12:19:10,Sindikat penyelundup penyu hijau di perairan Kabupaten Pangkep ditangkap aparat gabungan. 93 kilogram penyu tersebut telah dijual ke rumah makan di Makassar https://t.co/EWhh6J1Kya,9,1,1,1,2022-01-11,12,Tuesday,2,10,2
1480876402635427840,2022-01-11 12:17:02,"Nasywa, anak Desy Ratnasari sangat ingin dikenal tanpa ada embel-embel nama orang tuanya. Nasywa juga kerap melaran Desy datang ke sekolah. https://t.co/L5dGm0nOPK",16,2,1,1,2022-01-11,12,Tuesday,2,17,3
1480876087366361094,2022-01-11 12:15:47,Salah satu pemain drama Korea Snowdrop yang aktingnya menarik perhatian adalah Yoo In Na. Mau tahu fakta peran Yoo In Na yang jadi plot twist? https://t.co/pnIkebVlwQ,27,1,3,1,2022-01-11,12,Tuesday,2,30,2
1480875444241149961,2022-01-11 12:13:13,"Kreasi menu restoran terus berkembang, namun kadang bikin pengunjung geleng kepala. Contohnya menu leher bebek utuh di restoran ini:  https://t.co/fDxP1XDHys",4,3,0,0,2022-01-11,12,Tuesday,2,4,3
1480875123641143297,2022-01-11 12:11:57,"Masakan Korea semakin disukai banyak orang, termasuk juga bumbu masakannya. Jangan khawatir, kini 5 bumbu masak Korea ini sudah berlabel halal MUI. https://t.co/JiPoTTDxPk",3,2,0,0,2022-01-11,12,Tuesday,2,3,2
1480874468851568640,2022-01-11 12:09:21,Seorang gadis 7 tahun ini berhasil membuat netizen terpukau dengan keterampilannya membuat roti canai. Dalam sehari ia bisa membuat sampai 60 roti. https://t.co/jxW3O3skYp,16,0,0,0,2022-01-11,12,Tuesday,2,16,0
1480874435322257412,2022-01-11 12:09:13,"Polisi kembali menangkap seorang sindikit pengiriman PMI ilegal dari Batam, Kepulauan Riau. Wanita berinisial E itu terlibat dalam pengiriman PMI ilegal. https://t.co/47bZBVEiLO",6,0,2,1,2022-01-11,12,Tuesday,2,8,1
1480874091989151747,2022-01-11 12:07:51,"Mendapat pemasukan lewat jembatan perahu sampai Rp 25 juta per hari terkesan mudah. Tapi, pembangunan jembatan ini butuh waktu dan biaya yang tinggi lho! https://t.co/cI27xfsZvG",21,2,4,1,2022-01-11,12,Tuesday,2,25,3
1480873562101751808,2022-01-11 12:05:45,"Saat makan bayam, sering kali bayam nyangkut di gigi. Bukan kebetulan, ternyata ada alasan ilmiah di balik bayam besar risikonya nyangkut di gigi. https://t.co/UOsEx7kQBJ",6,3,3,0,2022-01-11,12,Tuesday,2,9,3
1480873542464032768,2022-01-11 12:05:40,Doni mengungkapkan dirinya meminum air kelapa untuk menjaga daya tahan tubuh setelah dipatuk ular. Dia berharap racun ular tidak terlalu cepat menjalar ke tubuhnya. https://t.co/gElNkJsEug,9,2,2,3,2022-01-11,12,Tuesday,2,11,5
1480873246912393219,2022-01-11 12:04:30,Mulai awal tahun 2022 ini Samsung mengumumkan bahwa toko aplikasi Tizen sudah tidak dapat diakses lagi oleh pengguna lama ataupun baru. https://t.co/wff9KCpjYi,4,2,2,2,2022-01-11,12,Tuesday,2,6,4
1480872888374857728,2022-01-11 12:03:04,"Salt Bae tak pernah luput dari perhatian. Selain aksi tabur garam, ia kerap menunjukkan aksi-aksi baru. Salah satunya memotong buah segar bak Fruit Ninja!  https://t.co/Q1mMps8qJu",3,1,1,0,2022-01-11,12,Tuesday,2,4,1
1480872557737828354,2022-01-11 12:01:45,Pebulutangkis Indonesia absen di sejumlah turnamen Internasional bukan karena PBSI mengalami persoalan dana. https://t.co/pzDY4jvEgW,4,0,2,1,2022-01-11,12,Tuesday,2,6,1
1480872547885502464,2022-01-11 12:01:43,Bukan kali ini saja Ferdinand harus berurusan dengan aparat hukum imbas pernyataannya yang kontroversial di media sosial. Berikut beberapa kasus yang sempat menyeret Ferdinand ke Kepolisian. #CNNIndonesia #detikNetwork  https://t.co/CxlHHy2Dtt,8,5,1,0,2022-01-11,12,Tuesday,2,9,5
1480871880475254785,2022-01-11 11:59:04,"Pemkot Bogor meninjau 'kuburan' pesawat di Kecamatan Kemang, Bogor untuk memastikan ada kegiatan apa di lokasi tersebut https://t.co/vYuoCESzSu",20,1,2,2,2022-01-11,11,Tuesday,2,22,3
1480871372100358152,2022-01-11 11:57:03,"Jasad R, bocah 9 tahun warga Banjarnegara ditemukan di tebing hutan. Berikut fakta selengkapnya. https://t.co/cWvD1LxDY5",11,0,2,1,2022-01-11,11,Tuesday,2,13,1
1480869594369830914,2022-01-11 11:49:59,"""Sebagai informasi ada atau tidak ada TWK, kami di kedeputian penindakan memang meminta tambahan personel,"" kata Karyoto. https://t.co/k6WeDkFEr5",34,13,5,9,2022-01-11,11,Tuesday,2,39,22
1480869591932932098,2022-01-11 11:49:58,"Dinas keamanan Ukraina, SBU, menahan seorang agen intelijen militer Rusia atas dugaan merencanakan serangan terhadap pelabuhan Odessa di wilayah Ukraina. https://t.co/YYFhcrScXv",8,0,0,0,2022-01-11,11,Tuesday,2,8,0
1480869287787220995,2022-01-11 11:48:46,Mie instan dengan rasa pedas sudah banyak di pasaran dan disukai orang. Kini ada mie ramen super pedas yang diklaim sebagai ramen terpedas di dunia. Mau coba? https://t.co/SXu7YkJULJ,6,6,0,1,2022-01-11,11,Tuesday,2,6,7
1480867825678004226,2022-01-11 11:42:57,"Fernando Syahputra membeberkan mengenai hubungan Mery Anastasia dan Lionardus Syahputra di balik kasus kebakaran bengkel di Cibodas, Kota Tangerang. https://t.co/JLTe6IPdWV",6,0,1,0,2022-01-11,11,Tuesday,2,7,0
1480867310374162439,2022-01-11 11:40:54,Wakil Ketua KPK Nurul Ghufron menyebut adanya harta irasional di kasus Wali Kota Rahmat Effendi. https://t.co/dIsUi60fWs,9,1,2,1,2022-01-11,11,Tuesday,2,11,2
1480867082887737347,2022-01-11 11:40:00,Orang yang minum soda dingin ternyata merasa lebih senang dibandingkan minum minuman biasa. Salah satu penyebabnya karena suara mendesis dari minuman bersoda. https://t.co/sSC3gZPvo3,7,2,2,0,2022-01-11,11,Tuesday,2,9,2
1480866549099552771,2022-01-11 11:37:53,Seorang kakek bernama Rusmin (63) ditemukan dalam kondisi meninggal dunia di dalam rumah kosong milik gereja di Kabupaten Semarang. https://t.co/SiuqO3tXB8,18,0,3,0,2022-01-11,11,Tuesday,2,21,0
1480865768132780037,2022-01-11 11:34:46,Sudah 10 hari anjing ras Pomerania di Bali milik wanita di Bali hilang. Polisi turut tangan membantu mencari anjing tersebut. #detiktif https://t.co/inNY7Qa6QB,3,0,1,0,2022-01-11,11,Tuesday,2,4,0
1480865746473398275,2022-01-11 11:34:41,Di media sosial viral keluhan WNA terkait fasilitas hotel yang tidak layak untuk isolasi COVID-19. Satgas mengaku akan melakukan standarisasi. https://t.co/8ujte426nB,5,1,3,0,2022-01-11,11,Tuesday,2,8,1
1480864557094649856,2022-01-11 11:29:58,PSG memberi peringatan ke Sergio Ramos! https://t.co/FCQmP1Zrto,5,0,1,0,2022-01-11,11,Tuesday,2,6,0
1480864535670054915,2022-01-11 11:29:53,Persipura berhasil mengalahkan Persija 2-0 di pekan ke-19 BRI Liga 1 musim ini. Kemenangan ini mengantarkan Mutiara Hitam keluar dari zona degradasi. https://t.co/pwAr245NhI,10,9,0,1,2022-01-11,11,Tuesday,2,10,10
1480864534176964608,2022-01-11 11:29:52,Pengelola menyebut pakaian para LC Purworejo yang viral itu bukan seragam SMA. Lantas siapa yang punya ide 'seragam' tersebut? https://t.co/volLMZklVM,4,0,2,0,2022-01-11,11,Tuesday,2,6,0
1480864290605355011,2022-01-11 11:28:54,Tongseng yang satu ini memakai daging sapi. Tanpa aroma tajam daging kambing tetapi memakai bumbu rempah dan cabe berlimpah. Ini resepnya: https://t.co/J5it5KT5AY,7,0,2,0,2022-01-11,11,Tuesday,2,9,0
1480863996567822339,2022-01-11 11:27:44,"Ketua DPC PDIP Solo, FX Hadi Rudyatmo meminta Wali Kota Solo Gibran Rakabuming Raka tetap bersikap tenang menanggapi pelaporan di KPK. Begini pesan FX Rudy. https://t.co/wSYfFWaAry",9,2,2,0,2022-01-11,11,Tuesday,2,11,2
1480863763788095489,2022-01-11 11:26:49,"Terkenal enak dengan harga yang terjangkau. Banyak tempat makan di depan rumah sakit yang laris manis, dan selalu diserbu para pembeli. Ini daftarnya:  https://t.co/BNmQfuPHcV",5,0,1,0,2022-01-11,11,Tuesday,2,6,0
1480863446086438913,2022-01-11 11:25:33,Gerard Pique menegaskan Blaugrana bakal main habis-habisan di El Classico! https://t.co/E0gdkBDs5C,1,2,3,0,2022-01-11,11,Tuesday,2,4,2
1480862047244103681,2022-01-11 11:19:59,"Performa Mesut Ozil selama bertanding tidak terlepas dari pola makannya yang sehat. Ada beberapa makanan yang harus dihindari, termasuk makanan favoritnya.  https://t.co/CAr2Gz0ViP",12,1,3,0,2022-01-11,11,Tuesday,2,15,1
1480862030764642309,2022-01-11 11:19:55,Luhut meminta PT PLN Batubara dibubarkan. Ini lho profil anak usaha PT PLN (Persero) tersebut. https://t.co/5GgYVp0VGZ,8,2,3,0,2022-01-11,11,Tuesday,2,11,2
1480862010480992259,2022-01-11 11:19:51,Pengelola karaoke mengaku tidak ada maksud sama sekali untuk menjatuhkan institusi manapun dengan penggunaan pakaian mirip seragam SMA itu. https://t.co/gykQIJnz0q,4,1,2,1,2022-01-11,11,Tuesday,2,6,2
1480861170735198208,2022-01-11 11:16:30,"Video detik-detik truk pasir terseret arus Sungai Gung, Kabupaten Tegal viral di media sosial. Dua orang di dalam truk itu tewas tenggelam usai terseret arus. https://t.co/R9JgVoCNfb",3,1,1,1,2022-01-11,11,Tuesday,2,4,2
1480860607083687940,2022-01-11 11:14:16,Seorang anak tewas akibat ledakan bom di dalam sebuah bus umum di wilayah Filipina bagian selatan yang rawan konflik. Enam orang lainnya mengalami luka-luka. https://t.co/nzucHfhaLC,2,0,0,0,2022-01-11,11,Tuesday,2,2,0
1480860604952977413,2022-01-11 11:14:15,"Dewan Perwakilan Rakyat (DPR) Aceh mengesahkan Rancangan Qanun (Raqan) tentang Anggaran Pendapatan dan Belanja Aceh (APBA) 2022 sebesar Rp 16,17 triliun. https://t.co/5P0c8y3i9X",4,0,0,0,2022-01-11,11,Tuesday,2,4,0
1480859768252153856,2022-01-11 11:10:56,Video LC atau pemandu lagu di sebuah tempat karaoke di Purworejo viral lantaran berpakaian mirip seragam SMA. Pengelola menutup sementara tempat karaoke itu. https://t.co/xoOVpW7aaT,5,0,2,2,2022-01-11,11,Tuesday,2,7,2
1480859247273558022,2022-01-11 11:08:52,"Puluhan emak-emak demo di Kantor Desa Sidoharjo, Kecamatan Gedeg, Mojokerto. Mereka menuntut Kepala Dusun (Kadus) Lengkong dicopot dari jabatannya. https://t.co/VvyAWUTMyr",7,1,0,2,2022-01-11,11,Tuesday,2,7,3
1480858959791759360,2022-01-11 11:07:43,Nova mengatakan pengunduran mungkin dilakukan karena ada Pilpres. https://t.co/ohtYsHvHGU,1,0,1,1,2022-01-11,11,Tuesday,2,2,1
1480858352351596547,2022-01-11 11:05:18,"Di REN Coffee &amp; Eatery, Tebet. Kafe ini mengusung konsep taman zen gaya Jepang, dibuat dengan interior stylish serta ruangan penuh jendela yang Instagrammable. https://t.co/o7Bf2XU7M1",4,1,0,1,2022-01-11,11,Tuesday,2,4,2
1480857066025758723,2022-01-11 11:00:12,Video lumba-lumba tergeletak di atas kapal sempat viral. Si pengunggah yang tak lain nakhoda kapal mengau iseng saat mengunggah penampakan lumba-lumba tersebut. https://t.co/Zw1N5NzbzJ,5,0,1,0,2022-01-11,11,Tuesday,2,6,0
1480856790879383554,2022-01-11 10:59:06,Simak lagi awal perjalanan karier Özil di Jerman! https://t.co/eALZ29L2IJ,2,0,0,0,2022-01-11,10,Tuesday,2,2,0
1480856767890440193,2022-01-11 10:59:01,"#Terpopuler Dayana, selebgram asal Kazakhstan jadi perhatian karena situasi negara tersebut yang mencekam. Banyak netizen khawatir dengannya. https://t.co/ldmM3Qz7bC",24,15,4,3,2022-01-11,10,Tuesday,2,28,18
1480856471395082241,2022-01-11 10:57:50,Pesan khusus Baim Wong untuk Satria Muda Jakarta yang mematok target mempertahankan gelar juara di Indonesia Basketball League (IBL) 2022. https://t.co/HZ3fS1ixnT,12,1,0,0,2022-01-11,10,Tuesday,2,12,1
1480856454328369156,2022-01-11 10:57:46,"Tata cara wudhu yang benar menjadi pemahaman wajib bagi umat muslim. Perhatikan ya, berikut caranya yang benar. 

via: detikedu https://t.co/fjCsesDaj6",14,1,7,0,2022-01-11,10,Tuesday,2,21,1
1480856133355118595,2022-01-11 10:56:29,Velline Chu dan suaminya ditetapkan sebagai tersangka di kasus nakoba. Keduanya kemudian mengajukan rehabilitasi narkoba. https://t.co/TTRlr0NLUv,7,1,0,0,2022-01-11,10,Tuesday,2,7,1
1480856114162028544,2022-01-11 10:56:25,Luhut bakal mencari perusahaan-perusahaan yang tidak memenuhi kewajibannya untuk memasok batu bara ke PLN. https://t.co/NNwJr1Dh7h,8,0,1,0,2022-01-11,10,Tuesday,2,9,0
1480855710850297862,2022-01-11 10:54:49,"Semakin bertambah usia, penting memperbaiki pola makan serta beralih ke gaya hidup yang lebih sehat. Terutama bagi orang yang sudah berusia di atas 50 tahun. https://t.co/1cdcBauKLw",6,0,0,0,2022-01-11,10,Tuesday,2,6,0
1480855693070684164,2022-01-11 10:54:44,"Penulis muda Erisca Febriani yang namanya melambung berkat novel Dear Nathan, mengangkat berbagai tema krusial dalam karyanya.  https://t.co/nyK8u6lCFD",8,0,1,1,2022-01-11,10,Tuesday,2,9,1
1480854815592824833,2022-01-11 10:51:15,"Resep sup nasi telur khas Jepang ini disebut Ojiya. Bahannya sederhana, gampang dibuat. Ini resepnya:  https://t.co/ljJxHFJrvh",18,1,2,0,2022-01-11,10,Tuesday,2,20,1
1480854579663278087,2022-01-11 10:50:19,Kepolisian akhirnya memutuskan Ferdinand Hutahaean jadi tersangka. Begini komentar para netizen:  https://t.co/fiy28KV8Vq,9,4,2,1,2022-01-11,10,Tuesday,2,11,5
1480854562126938112,2022-01-11 10:50:15,"Buah nangka memang sulit ditemukan di luar negeri. Namun, wanita asal Dubai ini menemukannya di salah satu supermarket. Ini reaksinya mencicipi nangka:  https://t.co/7uWIgnC2fg",36,21,3,1,2022-01-11,10,Tuesday,2,39,22
1480854297097252865,2022-01-11 10:49:12,Nia Ramadhani dan Ardi Bakrie divonis jalani pidana penjara selama 1 tahun. Hakim menyatakan Nia dan Ardi terbukti bersalah terkait narkotika. Ini kata netizen:  https://t.co/QNLp4h69rA,9,1,1,0,2022-01-11,10,Tuesday,2,10,1
1480854105954344960,2022-01-11 10:48:26,"Meski Manchester United menang 1-0 atas Aston Villa dalam pertandingan Piala FA semalam, Marcus Rashford tampil buruk sehinga diserang para netizen. https://t.co/eOP2TpC9ML",3,0,0,0,2022-01-11,10,Tuesday,2,3,0
1480854070265057280,2022-01-11 10:48:17,Kata 'sopan' sempat ramai diperbincangkan. Kali ini di sidang vonis Nia Ramadhani dan Ardi Bakrie tak disinggung soal kesopanan Nia Ramadhani cs. https://t.co/XjGFNFC8Ix,6,4,1,1,2022-01-11,10,Tuesday,2,7,5
1480853794787409922,2022-01-11 10:47:12,Ketua Umum PBSI Agung Firman Sampurna mengklaim polemik bonus Piala Thomas sudah beres. https://t.co/6W8sz0tgxC,8,2,1,0,2022-01-11,10,Tuesday,2,9,2
1480853773845245957,2022-01-11 10:47:07,"Bucin dan terlalu mencintai pasangannya. Pria ini rela menuliskan setiap makanan, minuman hingga kue kesukaan sang kekasih di ponselnya agar tidak lupa. https://t.co/Iy0DuGK3V2",1,2,0,3,2022-01-11,10,Tuesday,2,1,5
1480853535952625666,2022-01-11 10:46:10,"Mie instan disarankan tidak dikonsumsi sehari-hari. Jika terbiasa makan mie instan tiap hari, begini efeknya buat tubuh:  https://t.co/cIQxJn71pm",9,0,6,3,2022-01-11,10,Tuesday,2,15,3
1480852796761067523,2022-01-11 10:43:14,Kota termacet di Indonesia ternyata bukan Jakarta. Inilah kota termacet di Indonesia menurut penelitian Inrix.  https://t.co/7j5MRMKXve,102,40,31,60,2022-01-11,10,Tuesday,2,133,100
1480852782873817093,2022-01-11 10:43:11,Armand Maulana kembali menjalankan project solo kariernya melalui single Sampai Akhir Zaman yang rilis tepat hari ini. https://t.co/qzgBNHrDdO,6,1,1,0,2022-01-11,10,Tuesday,2,7,1
1480852131162767365,2022-01-11 10:40:35,Menkes RI Budi Gunadi Sadikin mengungkap 3 regime vaksin booster yang akan mulai diberikan Rabu (12/1/2022). Ketiganya menyesuaikan ketersediaan stok vaksin. https://t.co/5vm4AqC3vo,24,0,7,19,2022-01-11,10,Tuesday,2,31,19
1480851551992389632,2022-01-11 10:38:17,Sebuah video ladies companion (LC) atau pemandu lagu di sebuah tempat karaoke di Purworejo viral di media sosial lantaran berpakaian mirip seragam SMA. https://t.co/wg0M5Wbozg,5,1,2,2,2022-01-11,10,Tuesday,2,7,3
1480851062152118274,2022-01-11 10:36:20,"Dalam aturan yang dikeluarkan Kementerian Perindustrian itu, mobil-mobil LCGC kini dikenakan PPnBM 3%.  https://t.co/26kH8zLhTa",5,1,1,0,2022-01-11,10,Tuesday,2,6,1
1480851044741664768,2022-01-11 10:36:16,Honda akan meluncurkan motor balap untuk menghadapi MotoGP 2022 pada akhir pekan ini. Marc Marquez dipastikan absen dalam seremoni tersebut.  https://t.co/71eNqkw895,4,0,1,0,2022-01-11,10,Tuesday,2,5,0
1480851018158125056,2022-01-11 10:36:10,"Polisi menetapkan JW, nakhoda kapal penangkap lumba-lumba sebagai tersangka. JW bercerita kronologi tertangkapnya satwa dilindungi tersebut. https://t.co/iEKwms9dgN",2,1,0,1,2022-01-11,10,Tuesday,2,2,2
1480850511322652673,2022-01-11 10:34:09,Wakil Ketua KPK Nurul Ghufron angkat bicara soal pelaporan yang dilakukan Ubedillah Badrun terhadap Gibran Rakabuming Raka dan Kaesang Pangarep. https://t.co/zvqJCXK7pv,17,16,2,0,2022-01-11,10,Tuesday,2,19,16
1480849723468648449,2022-01-11 10:31:01,"Ternyata, perkelahian itu sengaja dibuat demi konten kekerasan di media sosial. Duh! https://t.co/y30WA6FR7f",5,0,1,0,2022-01-11,10,Tuesday,2,6,0
1480849457902145541,2022-01-11 10:29:58,Dayana sempat curhat soal kerusuhan yang terjadi di Kazakhstan lewat media sosial. Kini akun instagramnya menghilang. https://t.co/4t7iBYxCCL,14,2,0,0,2022-01-11,10,Tuesday,2,14,2
1480849182307012609,2022-01-11 10:28:52,"Indonesia melaporkan 802 kasus COVID-19 pada Selasa (11/1/2022). Total kasus positif menjadi 4.267.451, sembuh 4.116.648, dan meninggal 144.144. https://t.co/BguRfV963y",3,0,1,1,2022-01-11,10,Tuesday,2,4,1
1480848945463140362,2022-01-11 10:27:56,"Pria inisial FST ditangkap membawa airsoft gun dan taser gun di Jl Otista, Jaktim. Debt collector itu juga rupanya membawa motor hasil rampasan dari debitur. https://t.co/3HUa2CHvBZ",4,1,2,0,2022-01-11,10,Tuesday,2,6,1
1480848710544334850,2022-01-11 10:27:00,Sidang Kenang Mirdad dan Tyna Kanna belum sampai ke tahap pembacaan putusan. Hakim masih bermusyawarah. https://t.co/6pxem7g3ay,6,0,0,0,2022-01-11,10,Tuesday,2,6,0
1480848211183079426,2022-01-11 10:25:01,"Mau masuk jurusan kedokteran? Sebelum pilih-pilih kampus, cek dulu yuk universitas dengan jurusan kedokteran terbaik di Indonesia versi QS WUR by Subject 2021! 

via: detikedu https://t.co/lFbSjz3JXK",6,0,2,0,2022-01-11,10,Tuesday,2,8,0
1480847940063305729,2022-01-11 10:23:56,Nia Ramadhani dan Ardi Bakrie pada Selasa (11/1) siang ini mendapat putusan hakim soal kasus penyalahgunaan narkoba. Masing-masing dituntut penjara 1 tahun. https://t.co/BV2o1PHRqO,8,0,2,0,2022-01-11,10,Tuesday,2,10,0
1480847689445257219,2022-01-11 10:22:56,Presiden Jokowi mengatakan pemerintah bakal memberikan booster vaksin COVID-19 secara gratis. Jokowi minta agar masyarakat tetap menjaga protokol kesehatan. https://t.co/dP8Qkfqw0M,16,2,5,4,2022-01-11,10,Tuesday,2,21,6
1480847350805454852,2022-01-11 10:21:35,KPK menahan mantan Kepala Divisi PT Waskita Karya Adi Wibowo. Adi merupakan salah satu tersangka kasus dugaan korupsi proyek pembangunan kampus IPDN di Gowa. https://t.co/opJWgKavPK,15,1,2,0,2022-01-11,10,Tuesday,2,17,1
1480847143678132224,2022-01-11 10:20:46,Shin Tae-yong dikontrak PSSI untuk melatih Timnas Indonesia dan berbagai timnas kelompok usia selama empat tahun. https://t.co/GH2Kz0BbGT,15,0,2,0,2022-01-11,10,Tuesday,2,17,0
1480847127009972226,2022-01-11 10:20:42,"Cristiano Ronaldo dikabarkan tidak betah di Manchester United, PSG mulai ancang-ancang membelinya di musim panas nanti! https://t.co/buUGhtohWT",6,0,2,3,2022-01-11,10,Tuesday,2,8,3
1480846086998835206,2022-01-11 10:16:34,"Gubernur Jabar Ridwan Kamil (RK) mengunjungi Pemkot Bekasi. Di depan ASN Pemkot Bekasi, RK bicara soal kontemplasi hingga integritas. https://t.co/p9MdWQ4GiP",8,3,2,0,2022-01-11,10,Tuesday,2,10,3
1480845584517025797,2022-01-11 10:14:34,#Foto Drakor Now We Are Breaking Up yang dibintangi Song Hye Kyo memicu protes penggemar. Intip potret cantiknya dalam drama yang belum lama tamat. https://t.co/KVtKdvet7F,17,1,3,1,2022-01-11,10,Tuesday,2,20,2
1480844800962224130,2022-01-11 10:11:27,Demo mahasiswa di Dispendik Sumenep diwarnai aksi perusakan kawat berduri. Massa kesal karena Kepala Dispendik yang menemui mereka dibatasi kawat berduri. https://t.co/LqpEwdGe44,4,0,1,0,2022-01-11,10,Tuesday,2,5,0
1480843774658027521,2022-01-11 10:07:23,"Wali Kota Eri Cahyadi berencana menambah 8 pompa air tahun 2022. Pompa ini akan dipasang di pintu air kawasan Kalidami, RSI Jalan Ahmad Yani dan Margorejo. https://t.co/3jLcfCmJgX",6,1,2,0,2022-01-11,10,Tuesday,2,8,1
1480843548299862020,2022-01-11 10:06:29,Indonesia mulai memberangkatkan lagi jamaah umrah ke Arab Saudi menggunakan maskapai Lion Air. Kapan Garuda Indonesia menyusul? https://t.co/7ILkHiA2EH,6,0,2,2,2022-01-11,10,Tuesday,2,8,2
1480843283345686530,2022-01-11 10:05:26,Indonesia dalam waktu dekat akan segera mulai memberikan booster alias dosis tambahan vaksin COVID-19. BPOM memberi panduan vaksin apa saja yang bisa dicampur. https://t.co/kUZZtSlAuz,5,0,4,0,2022-01-11,10,Tuesday,2,9,0
1480842960329658371,2022-01-11 10:04:09,Oknum polisi Polsek Cileungsi diduga nyuekin laporan ojol yang kehilangan motor. Oknum polisi tersebut langsung ditindak tegas. https://t.co/9aXODwSEmM,215,52,60,19,2022-01-11,10,Tuesday,2,275,71
1480842613888593922,2022-01-11 10:02:46,Kereta LRT Jabodebek diketahui melintas di jalur Pancoran ke Dukuh Atas Senin (10/1) kemarin. Sudah mulai uji coba? https://t.co/uAtsvHVqPl,9,0,1,0,2022-01-11,10,Tuesday,2,10,0
1480841227150970883,2022-01-11 09:57:15,"Ketua LSM Pandika Siliwangi Nusantara ditangkap polisi karena memeras Kades Petunjungan, Brebes. Tersangka meminta uang untuk mencabut laporannya ke polisi. https://t.co/oXeVILzYIG",19,1,1,2,2022-01-11,9,Tuesday,2,20,3
1480840607060926466,2022-01-11 09:54:48,Salam perpisahan dari Chanathip Songkrasin ke Hokkaido Consadole Sapporo yang ia tinggalkan. https://t.co/OwI5bttqXJ,3,0,0,0,2022-01-11,9,Tuesday,2,3,0
1480839630182305793,2022-01-11 09:50:55,"Pedri dan Ferran Torres akan menyusul skuad Blaugrana untuk laga El Clasico, Barcelona Vs Real Madrid, di Piala Super Spanyol.  https://t.co/gAwAeTZZXT",4,0,0,0,2022-01-11,9,Tuesday,2,4,0
1480839603418550276,2022-01-11 09:50:48,Jaksa meyakini Angin dan Dadan terbukti menerima suap senilai Rp 15 miliar dan SGD 4 juta. Berikut selengkapnya. https://t.co/kbgowhOGVU,5,0,0,0,2022-01-11,9,Tuesday,2,5,0
1480838842072682498,2022-01-11 09:47:47,"Sebagai manajer Nagita Slavina, Lutfi berbagi cerita kepada bosnya. Belum dikaruniai buah hati dari 12 tahun pernikahannya. Manajer Gigi diberikan program bayi tabung. https://t.co/kI58QMnOj3",31,0,3,0,2022-01-11,9,Tuesday,2,34,0
1480838316379590656,2022-01-11 09:45:41,"#Terpopuler Raffi Ahmad selalu bikin kejutan. Setelah Menteri Luar Negeri dan Siwon, kini legenda sepakbola akan ke rumah Raffi Ahmad.  https://t.co/khLdbewSIc",10,0,0,0,2022-01-11,9,Tuesday,2,10,0
1480837562856087552,2022-01-11 09:42:42,Herry Wirawan terdakwa pemerkosa 13 santriwati dituntut hukuman mati. Herry akan menanggapi tuntutan itu lewat pleidoi. https://t.co/Rx9DaW8qIH,9,1,3,1,2022-01-11,9,Tuesday,2,12,2
1480836776566665220,2022-01-11 09:39:34,Venna Melinda memutuskan menikah dengan Ferry Irawan pada Maret 2022 dan bakal digelar di Bali. Ternyata Venna pernah menolak ajakan nikah Ferry Irawan. https://t.co/ZoXfTdjbkZ,7,2,1,0,2022-01-11,9,Tuesday,2,8,2
1480836022720241664,2022-01-11 09:36:35,Gibran dan Kaesang dilaporkan ke KPK atas dugaan KKN dalam hubungan bisnis. Ini kata Pelapor dan KPK. https://t.co/BJJ6eXVQZl,20,8,3,1,2022-01-11,9,Tuesday,2,23,9
1480835519105978372,2022-01-11 09:34:35,Spotlight culture detikcom kali ini membahas tentang novelis di balik seri Dear Nathan yang terpopuler saat ini. Dia adalah Erisca Febriani:  https://t.co/cF9pNW0xcQ,5,0,0,1,2022-01-11,9,Tuesday,2,5,1
1480834773622919170,2022-01-11 09:31:37,"Hari besar keagamaan Islam untuk tahun ini, setidaknya ada 5 perayaan yang akan berlangsung. Hari besar apa ya yang bakal berlangsung dalam waktu dekat?

via: detikedu https://t.co/gjAWu08R0P",3,0,1,0,2022-01-11,9,Tuesday,2,4,0
1480834520723214341,2022-01-11 09:30:36,Foto band legendaris The Rolling Stones diabadikan dalam set prangko baru Inggris yang dibuat oleh Royal Mail. Royal Mail Inggris akan merilis satu set khusus berisi 12 prangko. https://t.co/8SqUd09IY2,3,0,1,1,2022-01-11,9,Tuesday,2,4,1
1480834011052351491,2022-01-11 09:28:35,"Kuasa hukum Ferdinand Hutahaean, Rony Hutahaean, ungkap kliennya mengidap penyakit saraf selama 2 tahun. Ia menyebut kliennya seringkali hilang kesadaran dan baru siuman setelah 30 menit hingga 1 jam. https://t.co/hdlBIkwNDp",5,33,1,3,2022-01-11,9,Tuesday,2,6,36
1480833190487023620,2022-01-11 09:25:19,Banjir kembali melanda sejumlah desa di Pasuruan akibat luapan sungai-sungai dan hujan deras. Sebanyak 15 desa di 6 kecamatan terdampak banjir. #Pasuruan https://t.co/cfjrC4uDPo,8,3,3,0,2022-01-11,9,Tuesday,2,11,3
1480832689573806081,2022-01-11 09:23:20,"Selama berpacaran, pelaku melancarkan bujuk rayu agar korban mau berhubungan badan. Korban pun dijanjikan jika hamil akan dinikahi. https://t.co/NalD8wqsAM",11,7,1,5,2022-01-11,9,Tuesday,2,12,12
1480832688194039810,2022-01-11 09:23:20,"Polri mengungkapkan kondisi terkini di Halmahera Utara, Maluku Utara (Malut), yang sempat diguncang gempa magnitudo 5,5 kemarin pagi. https://t.co/OmaDGUetR0",10,0,0,0,2022-01-11,9,Tuesday,2,10,0
1480832154309435394,2022-01-11 09:21:12,Nia Ramadhani dan Ardi Bakrie pada Selasa (11/1) siang ini mendapat putusan hakim terkait kasus penyalahgunaan narkoba. Masing-masing dituntut penjara 1 tahun. https://t.co/eKaMWuH5Wu https://t.co/jTulD597Lc,24,1,6,1,2022-01-11,9,Tuesday,2,30,2
1480831595758198787,2022-01-11 09:18:59,Wali Kota Solo Gibran Rakabuming Raka menyatakan siap diperiksa terkait laporan di KPK oleh dosen UNJ Ubedillah Badrun. Akankan Gibran membuat laporan balik? https://t.co/gWHIAOzJdK,28,12,3,1,2022-01-11,9,Tuesday,2,31,13
1480830610109304833,2022-01-11 09:15:04,"Sesosok mayat perempuan ditemukan warga di kebun tebu Dusun Tebon, Desa Kayangan, Diwek, Jombang. Korban dalam kondisi bugil dan jasadnya sudah membusuk. https://t.co/9BS06NQIeG",4,0,1,0,2022-01-11,9,Tuesday,2,5,0
1480830092041457664,2022-01-11 09:13:01,"Liburan bersama teman di tempat wisata Situ Cileunca, Pangalengan, Jawa Barat, sekelompok orang ini mengalami getok harga saat makan di warung. https://t.co/DO9VTSaVNc",128,119,40,23,2022-01-11,9,Tuesday,2,168,142
1480829819256557568,2022-01-11 09:11:56,Pembatalan itu diperintahkan setelah sejumlah penumpang dalam penerbangan AS dinyatakan positif virus Corona (COVID-19) setibanya di China. https://t.co/xGrVlc7HG9,9,0,2,0,2022-01-11,9,Tuesday,2,11,0
1480829286319853571,2022-01-11 09:09:48,Erick Thohir menikmati weekendnya dengan healing tipis-tipis di Danau Toba. Netizen pun mengundang Menteri BUMN tersebut untuk datang ke daerahnya. https://t.co/zpcoquHwk0,24,3,1,0,2022-01-11,9,Tuesday,2,25,3
1480828750413668352,2022-01-11 09:07:41,Fujianti Utami Putri dalam waktu dekat akan debut akting dalam layar lebar berjudul Bukan Cinderella. https://t.co/qXUI40ZHmb,9,6,1,0,2022-01-11,9,Tuesday,2,10,6
1480828267129192449,2022-01-11 09:05:45,Kendall Jenner sempat jadi sasaran kritik dan hujatan karena penampilan seksinya di pernikahan sahabatnya. Kini faktanya terungkap dan membuat mereka bungkam.  https://t.co/iy0ZvraGGB,3,0,1,0,2022-01-11,9,Tuesday,2,4,0
1480827490356670466,2022-01-11 09:02:40,"Masa emas! Usia 2 tahun merupakan usia yang tidak boleh dilewatkan, untuk itu perlu stimulasi yang tepat agar anak semakin cerdas. Ini tipsnya.

via: detikedu https://t.co/Nfiras2B2m",13,0,4,0,2022-01-11,9,Tuesday,2,17,0
1480827144406196225,2022-01-11 09:01:18,#FOTO Ivan Gunawan dan Ayu Ting Ting tetap jadi sorotan banyak orang. Ini momen kedekatan mereka berdua:  https://t.co/PhiL1cJDiM,7,0,1,0,2022-01-11,9,Tuesday,2,8,0
1480827115645935619,2022-01-11 09:01:11,"Rumah pasangan sultan Gunung Sindur ini sangat mewah dan megah. Di dalamnya didominasi dengan warna putih dan marmer. Intip isi rumahnya di sini, yuk! #detikNetwork  https://t.co/8nZl2phlJN",6,1,1,0,2022-01-11,9,Tuesday,2,7,1
1480826573364379654,2022-01-11 08:59:02,"""...Karena bodoh kita sendiri kenapa mau tanda tangan kemahalan. Hal-hal ini yang harus kita petakan,"" tegas Erick Thohir.  https://t.co/1mcJm0tTzJ",20,4,3,1,2022-01-11,8,Tuesday,2,23,5
1480826314814853121,2022-01-11 08:58:00,Gibran Rakabuming mengaku sudah berkomunikasi dengan Kaesang Pangarep terkait adanya laporan itu. https://t.co/TovGTgr1PM,38,14,1,2,2022-01-11,8,Tuesday,2,39,16
1480826088045617156,2022-01-11 08:57:06,Polisi menyebut ledakan maut di Pandeglang bersumber dari bom ikan yang biasa digunakan nelayan. Saat ini polisi masih terus melakukan penyelidikan. https://t.co/vAU6fb7vaW,9,1,1,1,2022-01-11,8,Tuesday,2,10,2
1480825833573031936,2022-01-11 08:56:05,Tim jaksa menuntut Herry hukuman mati. Herry tertunduk pasrah. Begini penampakannya: https://t.co/nCsVJtsVDJ,55,11,3,4,2022-01-11,8,Tuesday,2,58,15
1480825305208086529,2022-01-11 08:53:59,Nia Ramadhani divonis 1 tahun penjara atas kasus narkoba yang menjeratnya. Ia tak bisa lagi melakukan hobi yang baru dilakukannya sejak pandemi COVID-19. https://t.co/yH8BGSjvd4,48,11,8,6,2022-01-11,8,Tuesday,2,56,17
1480823358958809092,2022-01-11 08:46:15,"The Daddies menang atas wakil tuan rumah, Prem Singh Chouhan/Rajesh Verma dan melaju ke babak kedua. https://t.co/81O0zzeTAS",9,0,1,0,2022-01-11,8,Tuesday,2,10,0
1480823239832182785,2022-01-11 08:45:47,"Direktur Jenderal Perdagangan Dalam Negeri mengatakan harga minyak goreng kemasan premium masih mengikuti mekanisme harga pasar, berbeda dengan yang subsidi. https://t.co/7OPXAUlV0O",8,2,1,2,2022-01-11,8,Tuesday,2,9,4
1480822952773959682,2022-01-11 08:44:38,Vaksinasi booster mulai dilakukan hari Rabu (12/1). Mekanisme pelaksanaan ada yang gratis dan berbayar. Siapa saja yang mendapatkan booster gratis? https://t.co/ylqelyBuE1,8,3,2,4,2022-01-11,8,Tuesday,2,10,7
1480822461939826691,2022-01-11 08:42:41,BMI Sulsel yang melaporkan Ferdinand Hutahaean ke Mapolda Sulsel meminta Polri tidak memberikan penangguhan penahanan ke Ferdinand. https://t.co/jss6kOCUKh,13,1,3,1,2022-01-11,8,Tuesday,2,16,2
1480821828230778884,2022-01-11 08:40:10,Pihak UNJ tak ingin dikaitkan dengan pelaporan tersebut. https://t.co/QGwMLnP7sm,37,17,7,1,2022-01-11,8,Tuesday,2,44,18
1480821109939486721,2022-01-11 08:37:19,#Foto Ini Faradiba Putri Fahira. Hijabers yang disebut pacar selebgram Keanu. Seperti apa ya pesona Diba? https://t.co/4aE5mBpbYs,9,2,1,2,2022-01-11,8,Tuesday,2,10,4
1480821095095848961,2022-01-11 08:37:16,"Tata cara mandi wajib haid perlu dipahami. Seperti apa tata caranya yang benar? Simak ya, ladies! https://t.co/tZUKMYIFDn",16,0,7,0,2022-01-11,8,Tuesday,2,23,0
1480820621026205701,2022-01-11 08:35:23,"Menkes menyebut mayoritas pasien Omicron RI tidak memerlukan perawatan serius di RS. Perawatan di rumah tak bisa sembarangan, begini catatan eks petinggi WHO. https://t.co/H3okaJ9HXU",7,0,1,0,2022-01-11,8,Tuesday,2,8,0
1480820587467583488,2022-01-11 08:35:15,"Dugaan korupsi itu terkait dengan pengadaan pesawat ATR 72-600. Pertanyaannya, itu terjadi di era kepemimpinan siapa di Garuda Indonesia? https://t.co/U7DjudASEV",17,4,1,3,2022-01-11,8,Tuesday,2,18,7
1480820088517320704,2022-01-11 08:33:16,Kejadian ini viral di media sosial. Korban sempat melawan dan mengejar pelaku begal payudara. https://t.co/7esbazP6mL,9,3,1,1,2022-01-11,8,Tuesday,2,10,4
1480819122023845888,2022-01-11 08:29:25,Produsen Pocari Sweat lagi buka lowongan kerja besar-besaran nih! Simak yuk informasi lengkapnya: #infoloker https://t.co/npol2Q0ACJ,8,0,2,0,2022-01-11,8,Tuesday,2,10,0
1480819101127909386,2022-01-11 08:29:20,"Nia Ramadhani dan Ardi Bakrie divonis menjalani pidana penjara selama 1 tahun. Padahal, dalam tuntutannya, Nia dan Ardi dituntut rehabilitasi 1 tahun. https://t.co/sE1eUYe1WC",12,4,1,2,2022-01-11,8,Tuesday,2,13,6
1480818526713753602,2022-01-11 08:27:03,Seorang pilot sebuah pesawat ringan Cessna 172 diselamatkan oleh petugas Kepolisian Los Angeles dari reruntuhan pesawatnya. Penyelamatan ini berlangsung dramatis karena berlangsung hanya beberapa saat sebelum sebuah kereta menabraknya. https://t.co/pJ3hnhq4h7,7,0,2,0,2022-01-11,8,Tuesday,2,9,0
1480817962848342017,2022-01-11 08:24:49,Nia Ramadhani dan Ardi Bakrie divonis 1 tahun penjara. Padahal Nia merasa dirinya kini sudah jadi sosok yang lebih baik usai rehab. #NiaRamadhani  https://t.co/sqCKq8eJzP,9,1,2,0,2022-01-11,8,Tuesday,2,11,1
1480817475721781250,2022-01-11 08:22:53,"Mischka Devon raih Rekor Muri sebagai 'Kakak Beradik Pemenang Medali Olimpiade Matematika dan Sains Internasional Terbanyak 2021. Keren!

via: detikedu https://t.co/dRpQPjn5iN",23,1,5,1,2022-01-11,8,Tuesday,2,28,2
1480817212382396418,2022-01-11 08:21:50,"Jventus segera mencari penyerang baru, usai Federico Chiesa terancam absen panjang karena menderita cedera ACL. https://t.co/zU5QNDhvhv",1,2,4,0,2022-01-11,8,Tuesday,2,5,2
1480816652824494080,2022-01-11 08:19:36,"Merasakan rindu kepada anak-anaknya, Nia Ramadhani hanya bisa berjumpa lewat ponsel. Bahkan perjumpaan itu bukan dalam bentuk komunikasi secara langsung. https://t.co/Ux1PNRgWy8",9,1,1,0,2022-01-11,8,Tuesday,2,10,1
1480816351069589506,2022-01-11 08:18:24,Mantan pemain Manchester United mengatakan bahwa lini tengah Setan Merah sekelas dengan tim degradasi!. https://t.co/uYI9BiOyVY,4,0,1,0,2022-01-11,8,Tuesday,2,5,0
1480816096022351875,2022-01-11 08:17:24,"Seorang petinju meninggal dunia setelah di-KO oleh lawannya. Sebelum meninggal, ibunda sang petinju sudah minta putranya untuk pensiun saja. https://t.co/VTrKQssuav",5,1,1,0,2022-01-11,8,Tuesday,2,6,1
1480815597541810176,2022-01-11 08:15:25,Kali ini sebuah investasi bodong di Lamongan dibongkar oleh korban yang mengaku rugi Rp 115 juta. #Lamongan https://t.co/EaHq6i3PUf,7,0,0,0,2022-01-11,8,Tuesday,2,7,0
1480814018298138631,2022-01-11 08:09:08,Vidi Aldiano dipastikan akan menggelar akad nikah dengan Sheila Dara Aisha minggu depan. #VidiAldiano #SheilaDara https://t.co/3znteIAebk,19,3,2,1,2022-01-11,8,Tuesday,2,21,4
1480813966234243074,2022-01-11 08:08:56,"Meski motor modifikasinya sering rusak, Peri Santoso, penjual lumpia asal Klaten tetap bersemangat berjualan keliling kampung. Peri mengharapkan bantuan #sahabatbaik untuk membeli motor baru agar bisa terus berjuang mencari rezeki. Ayo bantu Peri melalui @berbuatbaik_id. https://t.co/h529GcM1mk",67,2,17,0,2022-01-11,8,Tuesday,2,84,2
1480813492475203585,2022-01-11 08:07:03,Vicky Prasetyo dipolisikan mantan istri atas dugaan penipuan dan penggelapan duit bisnis klub. Laporan itu kini diselidiki polisi. https://t.co/moTvK8ZLmp,11,1,3,0,2022-01-11,8,Tuesday,2,14,1
1480812988798054400,2022-01-11 08:05:03,"Vicky Prasetyo dipolisikan mantan istri siri, Vivi Paris atas dugaan penipuan dan penggelapan. Vivi mengaku alami kerugian ratusan juta rupiah atas iming-iming usaha klub kudeta oleh Vicky. https://t.co/QoqdFSY8kj",7,5,0,2,2022-01-11,8,Tuesday,2,7,7
1480812500643946496,2022-01-11 08:03:06,Nia Ramadhani dan Ardi Bakrie mengalami naik dan turun kehidupan meski bergelimang kekayaan. Kini mereka divonis 1 tahun penjara akibat narkoba. https://t.co/58pPjz57ND,23,2,0,0,2022-01-11,8,Tuesday,2,23,2
1480812263376400384,2022-01-11 08:02:10,"Bila kamu bisa menyelesaikan teka-teki ini kurang dari 5 menit dan benar, tandanya kemampuan berpikir kamu luar biasa. Ayo buktikan! https://t.co/9PFRwsh4ty",1,0,1,0,2022-01-11,8,Tuesday,2,2,0
1480811466693484544,2022-01-11 07:59:00,"Setelah kejeblos dan bertemu kambing saat meninjau venue Formula E di Anco, Giring kembali melontarkan kritik. Kali ini soal komitmen fee Rp 560 M. https://t.co/gJMCVPRzhq",16,18,0,0,2022-01-11,7,Tuesday,2,16,18
1480811447601049603,2022-01-11 07:58:55,Mohammad Ahsan/Hendra Setiawan main siang ini di India Open 2022 https://t.co/7IiEoXU86N,10,0,1,0,2022-01-11,7,Tuesday,2,11,0
1480810730781908993,2022-01-11 07:56:05,Valentino Rossi sebenarnya bisa saja melanjutkan karier di MotoGP 2022 bersama Ducati di timnya sendiri. Tapi The Doctor keukeuh pensiun!  https://t.co/FgGNAT1bvT,6,0,2,0,2022-01-11,7,Tuesday,2,8,0
1480810711093764098,2022-01-11 07:56:00,"Tak hanya memastikan pesanan sesuai aplikasi, driver ini juga menulis puisi hingga membonuskan masker. Wah, baik hati ya...... https://t.co/bngwLbbaoV",10,0,0,0,2022-01-11,7,Tuesday,2,10,0
1480809984564899840,2022-01-11 07:53:07,"Masa-masa kuliah memberikan kesempatan yang luas untuk mengembangkan keterampilan. Ini 10 skill yang perlu dipelajari untuk kesuksesan karier kamu! 

Via: detikedu https://t.co/27NAHqW9o4",4,0,2,0,2022-01-11,7,Tuesday,2,6,0
1480809966198001665,2022-01-11 07:53:02,Keanu Reeves sekali lagi membuktikan dirinya sebagai pria paling baik hati di Hollywood!  https://t.co/wGTjl8aByJ,15,0,2,0,2022-01-11,7,Tuesday,2,17,0
1480809304513040389,2022-01-11 07:50:24,"Pesta pernikahan di Temanggung, Jawa Tengah, viral di media sosial. Betapa tidak, kedua mempelai diarak menggunakan forklift sebelum memasuki pelaminan. https://t.co/YwyFTib7WL",12,3,0,0,2022-01-11,7,Tuesday,2,12,3
1480808792451424257,2022-01-11 07:48:22,"Kemenangan O Yeong Su di Golden Globe 2022 mengundang perhatian presiden Korea Selatan, Moon Jae In. https://t.co/AXHJJH75KU",9,0,1,0,2022-01-11,7,Tuesday,2,10,0
1480807902629838850,2022-01-11 07:44:50,#FOTO Nia Ramadhani dan Ardi Bakrie divonis 1 tahun penjara di kasus narkoba. Ini penampilan Nia Ramadhani sepanjang sidang vonis di PN Jakarta Pusat:  https://t.co/9su69OF0FZ,19,6,1,2,2022-01-11,7,Tuesday,2,20,8
1480807285303787521,2022-01-11 07:42:23,"Percaya tidak percaya hal itu dialami oleh miliarder Bill Miller, di mana 50% aset pribadinya berasal dari Bitcoin. Gokil! https://t.co/2WLRGhPH83",4,0,4,0,2022-01-11,7,Tuesday,2,8,0
1480807055090925577,2022-01-11 07:41:28,"Setelah dilaporkan menghilang, jenazah Muhammad Ferdiansah ditemukan kemarin. Kepolisian Australia Barat mengatakan ia berjalan menyimpang dari trek pendakian. https://t.co/CcCLFHnizr",10,0,4,0,2022-01-11,7,Tuesday,2,14,0
1480806466164609028,2022-01-11 07:39:08,Marcus Rashford jadi sorotan di laga Manchester United vs Aston Villa pada lanjutan Piala FA.  https://t.co/NbSpePXQMG,1,0,0,0,2022-01-11,7,Tuesday,2,1,0
1480805842744188933,2022-01-11 07:36:39,Fenomena waterspout terpantau di Selat Bali. Waterspout terpantau sekitar pukul 12.30 WIB. Pelabuhan Ketapang Banyuwangi ditutup sementara. https://t.co/FP2JS6VyBH,4,0,3,2,2022-01-11,7,Tuesday,2,7,2
1480805293323862018,2022-01-11 07:34:28,Manchester United menang 1-0 atas Aston Villa di Piala FA. Tapi Manajer Ralf Rangnick tak puas dan mengindikasikan para pemain MU belum kerja keras. https://t.co/FHFdpUuG4w,6,0,0,0,2022-01-11,7,Tuesday,2,6,0
1480804442236719106,2022-01-11 07:31:05,"Satu lagi pesaing Samsung Galaxy Z Fold 3 hadir. Dia adalah Honor Magic V, HP layar lipat ini tawarkan spesifikasi lebih gahar dengan harga sedikit lebih murah. https://t.co/FvuofEh0C3",4,0,1,0,2022-01-11,7,Tuesday,2,5,0
1480804412054556672,2022-01-11 07:30:58,Toyota Land Cruiser dipastikan meluncur di Indonesia. Land Cruiser akan diluncurkan secara virtual bersama model New Fortuner 2.8 VRZ.  https://t.co/GyIUtoB1BY,12,0,3,0,2022-01-11,7,Tuesday,2,15,0
1480804146081148930,2022-01-11 07:29:55,Sarung tangan motor merupakan salah satu barang yang kini mulai banyak dipakai oleh pengendara roda dua.  https://t.co/wyO8um2xvm,4,1,2,0,2022-01-11,7,Tuesday,2,6,1
1480803864404234240,2022-01-11 07:28:47,Harga tiket MotoGP Indonesia 2022 disebut murah meriah. Apalagi untuk orang barat yang akan menganggap tiket nonton MotoGP di Indonesia sangat murah!  https://t.co/cpxwsXSHoL,1,0,3,0,2022-01-11,7,Tuesday,2,4,0
1480803620107042819,2022-01-11 07:27:49,"Di Ciamis ada angkot dengan interior mewah yang memiliki lantai keramik, joknya menggunakan sofa, Lengkap dengan tisu dan full musik serta lampu mirip di kafe.  https://t.co/kqOKwB3HpQ",7,1,1,0,2022-01-11,7,Tuesday,2,8,1
1480803602100895744,2022-01-11 07:27:45,"Seekor penyu jenis lekang ditemukan mati membusuk di sekitar Pantai Bugel, Kapanewon Panjatan, Kulon Progo. Begini kondisinya. https://t.co/UMdooflWH4",6,0,1,0,2022-01-11,7,Tuesday,2,7,0
1480803358869004289,2022-01-11 07:26:47,"Nia Ramadhani terus menangis sejak pembacaan tuntutan. Mendengar divonis 1 tahun penjara pun, Nia Ramadhani kembali menangis. #NiaRamadhani  https://t.co/uZXBt69YFB",8,7,2,2,2022-01-11,7,Tuesday,2,10,9
1480803357631602690,2022-01-11 07:26:47,Erick Thohir bagikan momen healingnya saat di Danau Toba. Dia pun memuji keindahan alam danau yang memberi energi untuk bekerja. Setuju ngggak? https://t.co/NNfGJx62g0,10,1,4,1,2022-01-11,7,Tuesday,2,14,2
1480802823621255170,2022-01-11 07:24:39,"Rumor Mesut Ozil memanas, medsos Raffi Ahmad diserbu netizen, 'Ozil mana Ozil?' https://t.co/H8N9TewsvU",9,1,2,1,2022-01-11,7,Tuesday,2,11,2
1480802561380827136,2022-01-11 07:23:37,"""Ubedillah ini mengklaim dirinya aktivis 98 dan menjadikan 98 sebagai pembenaran untuk memfitnah keluarga presiden. Dia mencari popularitas dengan cara zalim,"" kata Ketum JoMan Immanuel Ebenezer. https://t.co/33zN4dnOCl",44,33,8,2,2022-01-11,7,Tuesday,2,52,35
1480802337115545601,2022-01-11 07:22:43,Saddil Ramdani diminati oleh klub Liga Serbia. Sabah FC menyatakan tidak mau melepasnya!  https://t.co/YI5WMmxF4T,4,0,0,0,2022-01-11,7,Tuesday,2,4,0
1480802322485809152,2022-01-11 07:22:40,Nia Ramadhani dan Ardi Bakrie pada Selasa (11/1) siang ini mendapat putusan hakim terkait kasus penyalahgunaan narkoba. Masing-masing dituntut penjara 1 tahun. https://t.co/QlbzZXgOzd,5,1,1,1,2022-01-11,7,Tuesday,2,6,2
1480801757554958342,2022-01-11 07:20:25,Menkes menyampaikan bahwa mayoritas pasien terkonfirmasi Omicron memiliki gejala ringan. Pasien hanya perlu menjalani isolasi mandiri di rumah https://t.co/Y6lHGcoyVD,8,1,1,0,2022-01-11,7,Tuesday,2,9,1
1480801737229447169,2022-01-11 07:20:20,"Memesan makanan online, netizen ini justru dapatkan kekecewaan. Semua pesanan online ini tak ada yang sesuai ekspektasi. https://t.co/EV0USytbY8",3,0,0,1,2022-01-11,7,Tuesday,2,3,1
1480800866697457664,2022-01-11 07:16:53,Dia diketahui sebagai dosen di Universitas Negeri Jakarta (UNJ) dan juga dikenal sebagai analis politik. Begini sosoknya: https://t.co/nNIBnmHKac,49,37,9,4,2022-01-11,7,Tuesday,2,58,41
1480800847827189761,2022-01-11 07:16:48,"Bubur ayam tak hanya dari Cirebon atau Cianjur saja, ada juga bubur ayam khas Tasikmalaya yang layak dicoba. Seperti ini racikannya:  https://t.co/aHBFd8uFhv",2,0,0,1,2022-01-11,7,Tuesday,2,2,1
1480800599973191683,2022-01-11 07:15:49,"Ilmuwan menciptakan Human Longevity Laboratory atau laboratorium umur panjang manusia, untuk mengetahui berapa usia kalian dan memperpanjangnya. https://t.co/pmHgN9DDz3",4,0,0,0,2022-01-11,7,Tuesday,2,4,0
1480800582948560898,2022-01-11 07:15:45,"Sejumlah operator seluler di Eropa Seperti Vodafone, Telefonica, dan T-Mobile tengah mencari cara untuk memblokir fitur Private Relay yang ada di iOS 15. https://t.co/V1p9l6HwqE",2,0,0,0,2022-01-11,7,Tuesday,2,2,0
1480800260163264516,2022-01-11 07:14:28,"Seiring maraknya perjalanan ke luar angkasa, para ahli terus mencari cara paling mutakhir untuk menuju ke sana. Salah satunya, ide naik lift ke luar angkasa. https://t.co/RHrebzDbDY",5,0,0,1,2022-01-11,7,Tuesday,2,5,1
1480799788752945154,2022-01-11 07:12:36,"Jika kalian tertarik melanjutkan pendidikan ke salah satu perguruan tinggi terbaik di dunia ini, simak syarat pendaftaran beasiswa S1 di Singapura ini ya!

via: detikedu https://t.co/HhHdiZUSbY",6,0,3,0,2022-01-11,7,Tuesday,2,9,0
1480799766695006209,2022-01-11 07:12:30,"Fotografer Edas Wong kembali berkeliaran di jalanan untuk menemukan sesuatu yang menarik perhatiannya. Dengan angle tepat, ini hasil fotonya:  https://t.co/MpyvSWMn1g",2,0,2,0,2022-01-11,7,Tuesday,2,4,0
1480798775253905410,2022-01-11 07:08:34,"Es teh jumbo viral kini ramai di berbagai platform media sosial. Sebelum mencobanya di rumah, cek dulu saran ahli gizi, yuk! 

via: detikedu https://t.co/eAzriA7DOs",8,1,2,2,2022-01-11,7,Tuesday,2,10,3
1480798367273783296,2022-01-11 07:06:57,Detik-detik truk nyangkut di bibir jurang selama tiga hari bikin merinding nih...  https://t.co/G9AA2Q8E4x,0,0,3,0,2022-01-11,7,Tuesday,2,3,0
1480797900955426818,2022-01-11 07:05:06,"Philippe Coutinho dipinjamkan Barcelona ke Aston Villa. Menurut Rivaldo, keputusan Coutinho itu dinilai sangat tepat!  https://t.co/bSfzWC8KpB",4,0,1,0,2022-01-11,7,Tuesday,2,5,0
1480797896995917825,2022-01-11 07:05:05,Fenomena waterspout terpantau di Selat Bali. Waterspout terpantau sekitar pukul 12.30 WIB https://t.co/jvtXgOfMsy,2,1,2,0,2022-01-11,7,Tuesday,2,4,1
1480797658713399297,2022-01-11 07:04:08,Jadwal BRI Liga 1 hari ini ada dua pertandingan yang berlangsung. Persita vs Persela dan Persija Jakarta vs Persipura Jayapura. https://t.co/smMBF2nC8T,3,0,0,0,2022-01-11,7,Tuesday,2,3,0
1480797640115818496,2022-01-11 07:04:03,Erick Thohir memberikan bukti-bukti terkait dugaan korupsi pesawat ATR Garuda Indonesia ke Kejaksaan Agung. https://t.co/NytfDcumnp,8,1,3,0,2022-01-11,7,Tuesday,2,11,1
1480797147314466821,2022-01-11 07:02:06,"Salah satu pendiri WhatsApp, Jan Koum, kekayaannya USD 10 miliar. Wajar jika barang kepunyaannya mewah, termasuk kapal pesiar ini:  https://t.co/TjdKHlzgR4",7,2,2,1,2022-01-11,7,Tuesday,2,9,3
1480797122421211137,2022-01-11 07:02:00,Nia Ramadhani dan Ardi Bakrie divonis oleh hakim menjalani hukuman satu tahun penjara. #NiaRamadhani #ArdiBakrie  https://t.co/mi0nA9DGO3,5,1,1,1,2022-01-11,7,Tuesday,2,6,2
1480796538758737924,2022-01-11 06:59:41,"Memicu ledakan kasus di banyak negara, Menkes mengingatkan Indonesia akan menghadapi gelombang Omicron. Ini saran dokter soal makanan jika terpapar Omicron. https://t.co/XYz6UXxQcU",2,0,2,0,2022-01-11,6,Tuesday,2,4,0
1480796041335218183,2022-01-11 06:57:42,Nia Ramadhani dan Ardi Bakrie menghadapi sidang putusan kasus narkoba. Vonis yang dibacakan majelis hakim ternyata jauh dari harapan Nia dan Ardi.  https://t.co/9k2rTY77xX,11,3,5,1,2022-01-11,6,Tuesday,2,16,4
1480795535086956545,2022-01-11 06:55:42,"Rumor Mesut Ozil panas, medsos Raffi Ahmad diserbu netizen, 'Ozil mana Ozil?'  https://t.co/MASkUC4FtW",14,4,4,0,2022-01-11,6,Tuesday,2,18,4
1480795050263343104,2022-01-11 06:53:46,Saddil Ramdani diminati oleh klub Liga Serbia. Sabah FC menyatakan tidak mau melepasnya. https://t.co/e1sld9lWRN,3,1,1,0,2022-01-11,6,Tuesday,2,4,1
1480794922693365762,2022-01-11 06:53:16,Presiden Joko Widodo (Jokowi) memutuskan vaksin booster akan diberikan gratis untuk masyarakat. Ini syaratnya: https://t.co/N7wWV1fpL0,10,0,5,1,2022-01-11,6,Tuesday,2,15,1
1480794790723821568,2022-01-11 06:52:44,Marissya Icha ngaku kecewa dengan pemanggilan Kemensos soal penggalangan dana rumah untuk Gala Sky. Pasalnya agenda klarifikasi di Kemensos diubah jadi dilakukan virtual. https://t.co/8NLiNbYcBO,5,0,1,0,2022-01-11,6,Tuesday,2,6,0
1480794782423261185,2022-01-11 06:52:42,Marcus Rashford jadi sorotan di laga Manchester United vs Aston Villa pada lanjutan Piala FA.  https://t.co/0nGKlY9AkJ,4,1,1,0,2022-01-11,6,Tuesday,2,5,1
1480794474733137923,2022-01-11 06:51:29,"""Pemberian vaksin ini gratis bagi seluruh masyarakat Indonesia, karena saya tegaskan keselamatan rakyat adalah yang utama,"" ucap Jokowi. https://t.co/tCh8TZKS7J",107,11,36,12,2022-01-11,6,Tuesday,2,143,23
1480794208629936128,2022-01-11 06:50:25,Manchester United unggul lewat sundulan Scott McTominay pada menit ke-8 yang memastikan kemenangan 1-0. Danny Ings sempat mencetak gol untuk Aston Villa.  https://t.co/WTd0ImfPco,2,0,0,0,2022-01-11,6,Tuesday,2,2,0
1480794207455485955,2022-01-11 06:50:25,"Selain hukuman badan, Herry juga dijatuhi tuntutan denda hampir Rp 1 M. https://t.co/LsWQLoMnAP",29,6,7,2,2022-01-11,6,Tuesday,2,36,8
1480794023816482816,2022-01-11 06:49:41,"Philippe Coutinho menghabiskan musim 2021/2022 sebagai pemain pinjaman di Aston Villa. Namun saat bertemu MU di Piala FA, kenapa tidak dimainkan?  https://t.co/47ULtLUzh4",1,0,0,0,2022-01-11,6,Tuesday,2,1,0
1480794022604062722,2022-01-11 06:49:41,Cuitan di dunia maya juga bisa menimbulkan kegaduhan di ruang publik. https://t.co/ikhVRKfaMQ,5,1,1,0,2022-01-11,6,Tuesday,2,6,1
1480792789822709762,2022-01-11 06:44:47,Sah! Jokowi mengumumkan vaksinasi booster dimulai 12 Januari 2022. Siapa saja masyarakat umum yang sudah bisa dapat vaksinasi booster? https://t.co/OrdmlmbkvF,56,5,32,5,2022-01-11,6,Tuesday,2,88,10
1480792538537734148,2022-01-11 06:43:47,"Pemprov DKI Jakarta mau membangun saringan sampah di perbatasan. Pagu anggaran untuk proyek tersebut berjumlah Rp 197,21 miliar. https://t.co/wHeGADo2Sa",4,1,2,1,2022-01-11,6,Tuesday,2,6,2
1480792537392631811,2022-01-11 06:43:47,Pelaku yang diketahui berinisial HF ini terancam hukuman empat tahun penjara. https://t.co/54vDZMSq9Y,13,3,5,3,2022-01-11,6,Tuesday,2,18,6
1480792296530628610,2022-01-11 06:42:49,"Pedri dan Ferran Torres akan menyusul skuad Blaugrana untuk laga El Clasico, Barcelona Vs Real Madrid, di Piala Super Spanyol. https://t.co/ttDFd1ERno",2,0,0,0,2022-01-11,6,Tuesday,2,2,0
1480792063109128192,2022-01-11 06:41:54,Terdakwa Yahya Waloni divonis 5 bulan penjara. Yahya Waloni diyakini melakukan tindak pidana melakukan ujaran kebencian terkait SARA. https://t.co/lbu9Uoayic,7,5,3,0,2022-01-11,6,Tuesday,2,10,5
1480792043945402369,2022-01-11 06:41:49,5 bulan rehabilitasi yang dijalani Nia Ramadhani dan Ardi Bakrie tak lagi dianggap. Itu dikarenakan mereka dinyatakan bukan sebagai pecandu atau korban. https://t.co/yE55LR8KZX,14,6,3,5,2022-01-11,6,Tuesday,2,17,11
1480791512535478273,2022-01-11 06:39:43,"Nia Ramadhani, Ardi Bakrie dan Zen Vivanto divonis 1 tahun penjara karena terbukti menyalahgunakan narkoba. Begini perjalanan kasusnya. https://t.co/CWN0LbQV17",168,27,23,15,2022-01-11,6,Tuesday,2,191,42
1480791025773858818,2022-01-11 06:37:46,"Mengutip arahan Megawati, PKS mengingatkan agar setiap pembuatan UU selalu merujuk UUD 1945 dan Pancasila. https://t.co/6nzLtgLdAn",5,0,0,0,2022-01-11,6,Tuesday,2,5,0
1480790998301163522,2022-01-11 06:37:40,"Menyambut awal 2022, akun resmi Shueisha menerbitkan satu halaman khusus di majalah meski tidak diterjemahkan dalam bahasa Inggris. https://t.co/MQZnLnMHyL",3,0,1,0,2022-01-11,6,Tuesday,2,4,0
1480790676006739968,2022-01-11 06:36:23,"Ferdinand Hutahaean resmi menjadi tersangka karena kasus cuitan ""Allahmu ternyata lemah"" di akun Twitter miliknya. Ini pasal dan ancaman hukumannya. https://t.co/ek6KxAzU7k",8,0,3,1,2022-01-11,6,Tuesday,2,11,1
1480790181254995970,2022-01-11 06:34:25,"Adik dari almarhum Bibi Ardiansyah, Fujianti Utami Putri segera melakukan debut dalam layar lebar melalui film Bukan Cinderella. https://t.co/7F3oo4X7AZ",47,19,6,4,2022-01-11,6,Tuesday,2,53,23
1480789799279673344,2022-01-11 06:32:54,"Philippe Coutinho dipinjamkan Barcelona ke Aston Villa. Menurut Rivaldo, keputusan Coutinho itu dinilai sangat tepat! https://t.co/anlz1uuXCC",6,0,0,0,2022-01-11,6,Tuesday,2,6,0
1480789196029710336,2022-01-11 06:30:30,"Philippe Coutinho lagi mengurus visa sebelum bisa melakoni debut di Aston Villa. Manajer The Villans, Steven Gerrad, tak sabar bertemu eks rekannya itu. https://t.co/zNkXPB8USX",2,0,0,0,2022-01-11,6,Tuesday,2,2,0
1480788956954431492,2022-01-11 06:29:33,Komedi romantis yang diciptakan oleh Darren Star dan dibintangi Lily Collins membawa kabar bahagia karena bakal berlanjut ke musim 3 dan 4. #EmilyinParis    https://t.co/egytxxD9Vy,3,2,1,0,2022-01-11,6,Tuesday,2,4,2
1480788441541529601,2022-01-11 06:27:30,"Setelah pledoi usai, satu per satu sahabat Laura Anna meneriakkan hastag #JusticeforLaura. Greta Irene pun menyindir soal karma. https://t.co/EajyklEj40",11,0,2,0,2022-01-11,6,Tuesday,2,13,0
1480787942331322375,2022-01-11 06:25:31,UGM dan UI jadi PTN incaran calon mahasiswa jalur SNMPTN setiap tahunnya. Yuk intip jurusan yang paling sepi peminat di SNMPTN tahun sebelumnya. Via: detikedu https://t.co/FLU2Jpbyl8,7,1,5,0,2022-01-11,6,Tuesday,2,12,1
1480787195506089990,2022-01-11 06:22:33,Arkeolog menemukan pemakaman berusia 3.000 tahun yang berisi makam klan kaya China zaman dahulu kala. Ini bukti kekayaannya:  https://t.co/jlhEiEL4qW,8,0,5,0,2022-01-11,6,Tuesday,2,13,0
1480786701454872581,2022-01-11 06:20:35,"Cairan pelumas (oli) berceceran di Jalan Salemba, Jakpus. Tumpahan oli ini membuat sejumlah pemotor terjatuh. https://t.co/1FX9fEwbLb",3,0,1,0,2022-01-11,6,Tuesday,2,4,0
1480786199061188609,2022-01-11 06:18:36,"Manajer Toprak, Kenan Sofuoglu memaparkan syarat dia mau gabung ke MotoGP, yang salah satunya ialah bergabung dengan tim pabrikan.  https://t.co/r2ebySZObt",4,1,1,0,2022-01-11,6,Tuesday,2,5,1
1480785953958547460,2022-01-11 06:17:37,"Simak ya, detikers! Berikut cara membuat akun LTMPT 2022 untuk lulusan 2020, 2021, dan siswa kelas 12. 

via: detikedu https://t.co/3pq9joRZHq",6,0,3,0,2022-01-11,6,Tuesday,2,9,0
1480785200569323520,2022-01-11 06:14:38,Jalanan rusak dan berlumpur di Banyuasin yang viral dikeluhkan pelajar sejak 2 bulan lalu belum juga diperbaiki. Kondisi jalan itu disebut makin parah. Duh! https://t.co/eqo6E7JPaJ,17,6,4,0,2022-01-11,6,Tuesday,2,21,6
1480784908993843201,2022-01-11 06:13:28,"Penyanyi Malaysia Ifa Raziah sedang jadi perbincangan di negaranya. Bukan karena prestasi, tapi ia berpose pamer saat beribadah di Tanah Suci. Haduh.... https://t.co/Sy3x9BmYP2",14,8,5,2,2022-01-11,6,Tuesday,2,19,10
1480784675278884867,2022-01-11 06:12:32,Seorang peneliti di Siprus mengklaim menemukan varian baru yang menggabungkan Delta dan Omicron. Namun banyak ahli menganggap Deltacron hanya kesalahan di lab. https://t.co/BdLx1GoYnv,11,3,1,3,2022-01-11,6,Tuesday,2,12,6
1480784171375243265,2022-01-11 06:10:32,"""Misalnya, pemerintah akhirnya menunda pelaksanaan jalur perjalanan tervaksinasi atau Vaccinated Travel Lane (VTL) menyusul merebaknya mutasi Covid-19,"" ujar Sandiaga. https://t.co/F60W98DuJM",5,0,2,0,2022-01-11,6,Tuesday,2,7,0
1480783657421971460,2022-01-11 06:08:30,"Saat pencernaan tak lancar, makanan tinggi serat jadi jawabannya. Ini rekomendasi buah yang dikonsumsi saat BAB tak lancar:  https://t.co/yiIZWrLJjB",10,1,3,0,2022-01-11,6,Tuesday,2,13,1
1480783431093137410,2022-01-11 06:07:36,"Pertama di dunia, seorang pria asal Amerika Serikat menjadi yang pertama menerima transplantasi jantung babi hasil modifikasi genetik. https://t.co/zWThgvySGE",12,4,7,2,2022-01-11,6,Tuesday,2,19,6
1480782937926819840,2022-01-11 06:05:38,"Sapi adalah jenis hewan yang berkembang biak tanpa mengalami metamorfosis. Lalu, gimana ya cara sapi berkembang biak? Simak penjelasannya yuk! 

via: detikedu https://t.co/8jgTzMAF3m",6,1,3,0,2022-01-11,6,Tuesday,2,9,1
1480782445524004864,2022-01-11 06:03:41,Almira Andani cerita soal keluarga. Penyanyi jebolan The Voice Indonesia ini mengatakan berasal dari kalangan yang religius. https://t.co/rPAbn71Yx1,9,0,2,0,2022-01-11,6,Tuesday,2,11,0
1480781802516193282,2022-01-11 06:01:07,"Sudah mengetahui cara memilih hero untuk digunakan di mode rank Mobile Legends? Jika belum, simak penjelasan ini:  https://t.co/OUNBR9zoEr",4,3,1,1,2022-01-11,6,Tuesday,2,5,4
1480780928763023365,2022-01-11 05:57:39,"Polisi melakukan olah TKP terkait ledakan dahsyat di sebuah rumah di Pandeglang, Banten. Polisi mengamankan 12 item dan diduga kuat ledakan dipicu bom. https://t.co/EFzUQvrdGC",5,0,1,0,2022-01-11,5,Tuesday,2,6,0
1480780683576549379,2022-01-11 05:56:41,Artis kondang Raffi Ahmad berencana membawa RANS Entertainment miliknya bisa melantai di BEI. Nih bocorannya dari Raffi..... https://t.co/OVNrYvXnXQ,20,6,11,7,2022-01-11,5,Tuesday,2,31,13
1480780198115225601,2022-01-11 05:54:45,"Roof box atau kompartemen penyimpanan tambahan yang diletakkan pada atap mobil ternyata bisa melanggar aturan. Potensi pelanggaran ini diungkap oleh eks Kasubdit Gakkum Ditlantas Polda Metro Jaya, Budiyanto. https://t.co/8YJb17ZJaa",3,0,1,0,2022-01-11,5,Tuesday,2,4,0
1480780184601124864,2022-01-11 05:54:42,"Jalan Raya Tambakrejo, Kecamatan Kraton, Kabupaten Pasuruan terendam banjir akibat luapan Sungai Welang. Akibat jalan terendam banjir, lalu lintas tersendat. https://t.co/0xOl4GuvUU",4,0,0,0,2022-01-11,5,Tuesday,2,4,0
1480779961288044545,2022-01-11 05:53:48,Ardi Bakrie langsung mengajukan banding atas vonis 1 tahu penjara. Pernyataan Ardi ini juga mewakili sikap Nia Ramadhani dan sopirnya Zen Vivanto. https://t.co/xoRTn9VU6W,51,20,9,4,2022-01-11,5,Tuesday,2,60,24
1480779941344157701,2022-01-11 05:53:44,"Majelis hakim membeberkan penyebab Nia Ramadhani, Ardi Bakrie, dan sopirnya divonis penjara bukan rehabilitasi. Ini penjelasan hakim:  https://t.co/gmTC7XPZWF",342,72,58,34,2022-01-11,5,Tuesday,2,400,106
1480779658207580171,2022-01-11 05:52:36,"Nia Ramadhani divonis 1 tahun penjara terkait narkoba. Ini potret Nia Ramadhani di sidang vonis yang digelar di PN Jakarta Pusat, Selasa (11/1):  https://t.co/kXra2G6TBk",11,5,2,3,2022-01-11,5,Tuesday,2,13,8
1480779649726791680,2022-01-11 05:52:34,Robby Shine siap penuhi ngidam Nastasya yang satu ini. Hal itu dilakukannya demi kebahagiaan istri dan jabang bayi.  https://t.co/zjpZFcOFCs,5,0,0,0,2022-01-11,5,Tuesday,2,5,0
1480779306703982594,2022-01-11 05:51:12,Jaksa juga meminta hakim menjatuhkan pidana tambahan berupa kebiri kimia https://t.co/c0OkylXmid,39,15,3,2,2022-01-11,5,Tuesday,2,42,17
1480779296885125122,2022-01-11 05:51:10,"Mochamad Chandra Kurniawan tidak asing terdengar oleh kalangan pecinta otomotif, khususnya mobil. Punya lebih dari 10 mobil, ia kerap dibicarakan media asing. https://t.co/czE4K3t0Yl",3,0,1,0,2022-01-11,5,Tuesday,2,4,0
1480778502857281536,2022-01-11 05:48:01,Pihak kepolisian dipastikan mengusut tuntas dugaan kasus pemerkosaan tersebut. https://t.co/jThh1XImIy,11,1,5,5,2022-01-11,5,Tuesday,2,16,6
1480778257905635330,2022-01-11 05:47:02,"Nia Ramadhani dan Ardi Bakrie divonis menjalani pidana penjara selama 1 tahun. Usai divonis, Nia Ramadhani tampak menangis. https://t.co/aRiRDaGyTx",18,1,3,0,2022-01-11,5,Tuesday,2,21,1
1480778238498684928,2022-01-11 05:46:58,Apakah karier kamu akan meningkat di 2022? Atau mungkinkah kamu naik gaji? Ini ramalan zodiak karier dan keuangan 2022 menurut pakar tarot. #RamalanZodiak https://t.co/tBFGUeLCVa,4,1,1,0,2022-01-11,5,Tuesday,2,5,1
1480777784129728522,2022-01-11 05:45:09,Terdakwa kasus pemerkosaan 13 santriwati Herry Wirawan dituntut hukuman mati. Jaksa menilai hukuman itu sesuai dengan perbuatan Herry Wirawan. https://t.co/QhEM8rT2LD,4662,561,807,246,2022-01-11,5,Tuesday,2,5469,807
1480777766656221185,2022-01-11 05:45:05,Admin akun Twitter resmi milik Pemkot Depok di nonaktifkan sementara. Hal itu dilakukan setelah heboh akun me-retweet 'Cari Keluarga Polisi Penembak FPI'. https://t.co/LKj32ejGxY,8,3,2,0,2022-01-11,5,Tuesday,2,10,3
1480777226807390211,2022-01-11 05:42:57,"Kreditur maskapai Garuda Indonesia mengajukan klaim penagihan utang hingga Rp 196,9 triliun. #GarudaIndonesia https://t.co/J40xGrmuln",27,4,17,3,2022-01-11,5,Tuesday,2,44,7
1480776696580222977,2022-01-11 05:40:50,"Akan dimulai besok, ada dua mekanis pelaksanaan vaksin booster COVID-19, yakni gratis dan berbayar. Siapa saja yang bisa mendapatkan gratis? https://t.co/LOv3T5Cv0l",6,1,3,0,2022-01-11,5,Tuesday,2,9,1
1480776471396368386,2022-01-11 05:39:56,Hadirnya orang ketiga dalam rumah tangga jadi cobaan yang tak diinginkan oleh pasangan manapun. Ini kata ustaz:  https://t.co/AdPXvp3Tyd,7,1,1,0,2022-01-11,5,Tuesday,2,8,1
1480776213304168448,2022-01-11 05:38:55,Rumah tangga Yoyo Chen dan Vincent Wong kembali jadi perhatian publik setelah menang di sebuah acara penghargaan. Ini kisahnya:  https://t.co/HOkKR5NMAU,4,0,1,0,2022-01-11,5,Tuesday,2,5,0
1480775681680236546,2022-01-11 05:36:48,Kelompok preman itu mengeroyok korban. Mereka juga merampas ponsel milik korban. https://t.co/p9g08NGcMF,7,0,2,0,2022-01-11,5,Tuesday,2,9,0
1480775177281679361,2022-01-11 05:34:48,"""Kami menjamin Allo bank akan besar secara transaksi, nasabah, tapi juga besar secara profitability, karena ini penting untuk jaga sustainabilty Allo Bank,"" https://t.co/ZLQO0iYGKW",3,0,4,1,2022-01-11,5,Tuesday,2,7,1
1480774687965732865,2022-01-11 05:32:51,Gibran dan Kaesang dilaporkan ke KPK oleh Dosen UNJ terkait dugaan KKN. Gibran dan pihak KPK pun buka suara terkait hal itu. https://t.co/JLXapC4QC0,7,2,5,0,2022-01-11,5,Tuesday,2,12,2
1480774464493309956,2022-01-11 05:31:58,Sssttt....CT Corp dan Bukalapak dalam proses membuat perusahaan patungan dalam bentuk e-commerce. https://t.co/agYov6Wlc6,8,0,2,0,2022-01-11,5,Tuesday,2,10,0
1480774153632423943,2022-01-11 05:30:44,"Selamat Datang Kembali di Old Trafford, Steven Gerrard! https://t.co/aotn75i9D5",5,0,1,0,2022-01-11,5,Tuesday,2,6,0
1480773585782419460,2022-01-11 05:28:28,"Dengan tanggung jawab yang besar, menarik untuk mengulik gaji Paspampres. Berapa ya kira-kira? https://t.co/5X1dqckGdh",4,0,1,0,2022-01-11,5,Tuesday,2,5,0
1480773311915335680,2022-01-11 05:27:23,"Polisi mengamankan debt collector di Jl Otista, Jaktim. Pria itu kedapatan membawa airsoft gun dan taser gun di jok motornya. https://t.co/dIZQO8mGEc",1,0,4,1,2022-01-11,5,Tuesday,2,5,1
1480773025742082049,2022-01-11 05:26:15,Majelis hakim memiliki alasan mengapa memvonis Nia Ramdhani dan suaminya dengan hukuman penjara. https://t.co/JF5w2H1ilx,8,3,1,1,2022-01-11,5,Tuesday,2,9,4
1480772506428616705,2022-01-11 05:24:11,Pedangdut Velline Chu terancam pidana maksimal 12 tahun penjara usai ditangkap terkait kasus narkoba oleh Polda Metro Jaya. Ini alasannya. https://t.co/RyW1A88WrT,5,2,1,0,2022-01-11,5,Tuesday,2,6,2
1480772248411725829,2022-01-11 05:23:10,"Apakah ini impian kamu? Beasiswa ke Turki jenjang S1, S2, dan S3 dibuka untuk tahun akademik 2022/2023. Cek syarat dan cara daftarnya yuk! Via: detikedu https://t.co/S9QhgKrQIH",25,4,4,1,2022-01-11,5,Tuesday,2,29,5
1480772008032055298,2022-01-11 05:22:12,"Saham Allo Bank pada pembukaan perdagangan langsung melesat ke level 7.000. Hingga pukul 09.20, saham BBHI terpantau sudah menguat 1.150 poin (17,28%). https://t.co/liUB2f7hc4",0,0,0,0,2022-01-11,5,Tuesday,2,0,0
1480771767497023488,2022-01-11 05:21:15,"Polisi telah menemukan HF, yang diduga identik dengan pria penendang sesajen di lokasi Erupsi Gunung Semeru. HF diketahui berada di luar daerah Lumajang. https://t.co/Wx6I6uHBpV",35,26,10,4,2022-01-11,5,Tuesday,2,45,30
1480770755667415041,2022-01-11 05:17:14,"Samsung Galaxy S21 FE dapat respon positif di Indonesia. Buktinya seluruh varian yang ditawarkan Samsung saat early bird ludes dipesan, ini spek dan harganya: https://t.co/tQVrTitOsy",7,3,4,2,2022-01-11,5,Tuesday,2,11,5
1480770525718794242,2022-01-11 05:16:19,"Indonesia dipastikan akan menghadapi gelombang varian Omicron. Masyarakat tak perlu panik, begini pesan Menkes terkait kemungkinan ada lonjakan kasus. https://t.co/MmnYdtJ0fj",10,6,5,1,2022-01-11,5,Tuesday,2,15,7
1480769774263185412,2022-01-11 05:13:20,Kisah pilu dialami seorang penyanyi asal Taiwan bernama Yuan Weiren. Ia menjadi lumpuh dan sempat koma usai terjatuh di rumahnya. Begini kisahnya:  https://t.co/mrxX327Bho,6,1,1,0,2022-01-11,5,Tuesday,2,7,1
1480769094878171143,2022-01-11 05:10:38,Video pria melempar dan menendang sesajen di lokasi erupsi Semeru bikin geger. Begini respons DPR hingga MUI: https://t.co/UemKvbJRXW,2,1,0,0,2022-01-11,5,Tuesday,2,2,1
1480769058731667457,2022-01-11 05:10:29,"Kebakaran di apartemen di New York, AS menewaskan 19 orang. Para korban ditemukan di setiap lantainya. https://t.co/9SadyXjkpV",2,0,0,0,2022-01-11,5,Tuesday,2,2,0
1480768535089528835,2022-01-11 05:08:24,Media sosial Twitter hari ini Selasa (11/1) terpantau ramai membahas dua putra Predisen RI Joko Widodo.  https://t.co/EttBqDMckc,7,1,1,0,2022-01-11,5,Tuesday,2,8,1
1480767811488292872,2022-01-11 05:05:32,"Terhitung tiga bulan lagi, migrasi TV analog ke digital atau Analog Switch Off akan dilakukan. Siap-siap siaran TV analog mulai dimatikan sejak 30 April 2022. https://t.co/15aGvDOzvS",30,3,11,1,2022-01-11,5,Tuesday,2,41,4
1480767789526827015,2022-01-11 05:05:27,Pimpinan DPR RI segera mengesahkan RUU TPKS menjadi RUU inisiatif DPR RI. Pengesahan itu digelar 18 Januari 2022. https://t.co/BSgFlg4HHF,6,1,2,1,2022-01-11,5,Tuesday,2,8,2
1480767226101837832,2022-01-11 05:03:12,Balap MotoGP perdana di Indonesia ini diprediksi akan dihadiri oleh sekitar 64 ribu pengunjung dari seluruh dunia. Bagaimana persiapannya? https://t.co/gCZkcG9K77,13,5,2,1,2022-01-11,5,Tuesday,2,15,6
1480766662358052872,2022-01-11 05:00:58,"Manchester United memang lolos ke babak keempat Piala FA. Tapi, di balik itu, ada masalah yang belum tuntas, yakni Marcus Rashford masih saja mandul. Duh! https://t.co/JH73293Jiu",1,0,0,0,2022-01-11,5,Tuesday,2,1,0
1480766160316641286,2022-01-11 04:58:58,Honda Italia resmi merilis model Super Cub dengan desain yang lebih sangar bernama Super Cub 125X.  https://t.co/YVCLX9xP3S,16,1,4,0,2022-01-11,4,Tuesday,2,20,1
1480765783559090180,2022-01-11 04:57:28,Nia Ramadhani dan Ardi Bakrie divonis oleh hakim menjalani hukuman satu tahun penjara. #NiaRamadhani #ArdiBakrie  https://t.co/WlEhwv74kf,14,4,1,3,2022-01-11,4,Tuesday,2,15,7
1480765602084044802,2022-01-11 04:56:45,Chelsea Olivia mengabarkan kondisinya yang drop karena keracunan makanan saat liburan. Beruntung pihak hotel memberikan penanganan yang baik. https://t.co/SbHqqzxnPV,8,0,2,0,2022-01-11,4,Tuesday,2,10,0
1480765361716879361,2022-01-11 04:55:48,Hakim menyatakan Nia dan Ardi terbukti bersalah terkait kasus penyalahgunaan narkotika. https://t.co/TuPGnW3pqI,142,12,19,5,2022-01-11,4,Tuesday,2,161,17
1480764875408244739,2022-01-11 04:53:52,"Penyalin Cahaya akan tayang di Netflix. Sejumlah netizen mengurungkan niat untuk menontonnya, namun banyak pula yang ingin menyaksikan film penyabet 12 Piala Citra itu. https://t.co/XuXj7HBy5q",7,3,3,1,2022-01-11,4,Tuesday,2,10,4
1480764340131225601,2022-01-11 04:51:44,"Kuasa hukum terduga pelaku tindakan asusila terhadap tiga mahasiswi UMY, MKA memastikan perbuatan pencabulan terjadi atas dasar suka sama suka bukan perkosaan.  https://t.co/23u2RcSKTr",7,3,6,1,2022-01-11,4,Tuesday,2,13,4
1480763857526312967,2022-01-11 04:49:49,Pendaki gunung Rinjani mungkin sudah tak asing lagi dengan kehadiran jasa ojek yang dapat ditemui di pos Kandang Sapi sampai Pos 2. Begini kehidupannya.... https://t.co/3lZyJM1sUO,7,1,0,0,2022-01-11,4,Tuesday,2,7,1
1480763605603733506,2022-01-11 04:48:49,Pengacara bicara soal penyakit saraf yang diderita Ferdinand Hutahaean selama 2 tahun. Ferdinand Hutahaean disebut sering pingsan jika mengalami tekanan. https://t.co/uMFyLxnhh6,202,372,36,65,2022-01-11,4,Tuesday,2,238,437
1480763593889038336,2022-01-11 04:48:46,"Menparekraf RI, Sandiaga Uno, berencana menggelar perlombaan maraton kelas dunia di Tanah Air. Kegiatan itu dapat menciptakan peluang usaha dan lapangan kerja.  https://t.co/VWoTiKnCKm",9,2,2,0,2022-01-11,4,Tuesday,2,11,2
1480763089343688705,2022-01-11 04:46:46,Pemerintah telah menetapkan besaran gaji tiap PNS sesuai dengan golongannya. Hal ini bisa dilihat pada tabel gaji PNS 2022. Tergiur nggak? https://t.co/RCl3xpToYB,9,8,3,0,2022-01-11,4,Tuesday,2,12,8
1480762816265084928,2022-01-11 04:45:41,Tottenham Hotspur mempertimbangkan untuk melepas setidaknya 4 pemain di bursa transfer Januari. Salah satunya adalah Delle Alli.  https://t.co/rSh9V7whAa,4,0,0,0,2022-01-11,4,Tuesday,2,4,0
1480762316798976000,2022-01-11 04:43:42,Huang Xiaming jadi sorotan dan tuai respon positif atas tindakannya pada supirnya. Ia merayakan ultah sang supir yang sudah kerja selama 17 tahun. https://t.co/gueQRTvxfX,6,0,1,0,2022-01-11,4,Tuesday,2,7,0
1480761015650467842,2022-01-11 04:38:31,"Chanathip Songkrasin, kapten Thailand saat juara Piala AFF 2020, resmi bergabung dengan Kawasaki Frontale, juara bertahan Liga Jepang J1 League.  https://t.co/13sEC5ZF0C",8,0,1,1,2022-01-11,4,Tuesday,2,9,1
1480760813170446342,2022-01-11 04:37:43,"Melalui layanan DJP Online, masyarakat semakin dimudahkan untuk melaporkan SPT atau membayar pajak. Simak ya, begini cara daftarnya: https://t.co/ViFV7LQR2S",2,0,2,0,2022-01-11,4,Tuesday,2,4,0
1480760320184524802,2022-01-11 04:35:46,Satu gol Aston Villa ke gawang Manchester United dianulir lewat keputusan Video Assistant Referee (VAR). Apa yang mendasari keputusan tersebut?  https://t.co/1xvellMuX1,5,0,0,0,2022-01-11,4,Tuesday,2,5,0
1480760318993309696,2022-01-11 04:35:45,Roof box atau kompartemen penyimpanan tambahan yang diletakkan pada atap mobil ternyata bisa melanggar aturan.  https://t.co/pHDM4ZtuxM,4,2,1,1,2022-01-11,4,Tuesday,2,5,3
1480759578237280256,2022-01-11 04:32:49,Geger kabar pria berusia 57 tahun menjadi orang pertama di dunia yang menerima transplantasi jantung babi. Berikut fakta-fakta seputarnya: https://t.co/glijpk1xAW,6,0,3,0,2022-01-11,4,Tuesday,2,9,0
1480759336095866889,2022-01-11 04:31:51,"Manchester United memang lolos ke babak keempat Piala FA. Tapi, di balik itu, ada masalah yang belum tuntas, yakni Marcus Rashford masih saja mandul. Duh!  https://t.co/M2h0anLtQt",22,3,3,0,2022-01-11,4,Tuesday,2,25,3
1480759334896377858,2022-01-11 04:31:51,"Udinese dibantai Atalanta akhir pekan lalu. Tapi, Il Zebrete meminta pertandingan itu diulang karena merasa diperlakukan tidak adil. Kenapa? https://t.co/6jCv5Xb5xM",3,0,0,0,2022-01-11,4,Tuesday,2,3,0
1480758421225971715,2022-01-11 04:28:13,Gaga Muhammad membacakan pembelaan untuk dirinya di depan majelis hakim. Gaga curhat merasa tak ada artinya untuk Laura Anna karena tetap diproses hukum. https://t.co/Lke8MVjtba,2,4,2,1,2022-01-11,4,Tuesday,2,4,5
1480758195073294337,2022-01-11 04:27:19,Kisah pedangdut Velline Chu yang ditangkap gegara kasus narkoba jadi perhatian publik. Ini kronologi dan profil Velline:  https://t.co/uXYIh2qd3A,3,0,2,0,2022-01-11,4,Tuesday,2,5,0
1480758176307888136,2022-01-11 04:27:15,"Pelat nomor putih akan diberlakukan pada pertengahan tahun 2022, berikut sederet faktanya.  https://t.co/wXfsBzFBrk",4,2,3,0,2022-01-11,4,Tuesday,2,7,2
1480757934179164162,2022-01-11 04:26:17,"Selamat datang Kembali di Old Trafford, Steven Gerrard!  https://t.co/vUIjF2G92V",4,0,1,0,2022-01-11,4,Tuesday,2,5,0
1480757920417693708,2022-01-11 04:26:14,"Duta Besar RI untuk AS memuji semangat Prilly Latuconsina menempuh pendidikan. Seperti apa ya kisah kuliah Prilly hingga dapat beasiswa S2?

via: detikedu https://t.co/y9Pplu4S9w",83,6,24,3,2022-01-11,4,Tuesday,2,107,9
1480757136988721153,2022-01-11 04:23:07,Museum Multatuli dibangun bukan untuk mendewakan Eduard Douwes Dekker. Museum itu menjadi penanda gugatan Meneer Belanda terhadap kolonialisme. https://t.co/U9DmQEMtq3,9,2,6,1,2022-01-11,4,Tuesday,2,15,3
1480756642581037056,2022-01-11 04:21:09,Nia Ramadhani masuk ke babak akhir dari kasus narkoba yang dijalaninya bersama sang suami. Nia dan Ardhi ikhlas terima vonis hakim.  https://t.co/m3hpDJAiQf,18,2,2,0,2022-01-11,4,Tuesday,2,20,2
1480756624948187138,2022-01-11 04:21:05,Merek ini menjual lebih dari 5.000 unit kendaraan sepanjang 2021. Model apakah yang terlaris?  https://t.co/PJCfGFhk2r,13,0,2,1,2022-01-11,4,Tuesday,2,15,1
1480756107522064385,2022-01-11 04:19:01,"Kabar gembira menghampiri Barcelona. Bintang muda mereka, Ansu Fati, pulih dari cedera dan ikut diberangkatkan dalam laga El Clasico kontra Real Madrid.  https://t.co/RdVsLyqZU7",6,1,0,0,2022-01-11,4,Tuesday,2,6,1
1480755216681209862,2022-01-11 04:15:29,Di Ciamis ada angkot dengan interior mewah yang memiliki lantai keramik. Joknya menggunakan sofa. Lengkap dengan tisu dan full musik dilengkapi lampu yang mirip di kafe.  https://t.co/rDJOXTWT1j,8,0,1,0,2022-01-11,4,Tuesday,2,9,0
1480754867278913538,2022-01-11 04:14:06,Para ilmuwan ungkap cara kerja otak yang dapat gagal fokus dan mengalihkan perhatian mendadak. Penasaran? Simak penjelasannya yuk. Via: detikedu https://t.co/UUkT393v7E,8,0,6,0,2022-01-11,4,Tuesday,2,14,0
1480754620456738826,2022-01-11 04:13:07,Nia Ramadhani dan Ardi Bakrie hari ini jalani sidang putusan. Nia Ramadhani dan Ardi Bakrie pun sudah tiba di Pengadilan Negeri Jakarta Pusat. Ini potretnya:  https://t.co/LAac9Iw448,4,2,2,0,2022-01-11,4,Tuesday,2,6,2
1480753848557965312,2022-01-11 04:10:03,Ferdinand Hutahaean ditahan terkait cuitan Allahmu Lemah usai ditetapkan sebagai tersangka. Ia pun terancam hukuman maksimal 10 tahun penjara. https://t.co/Xt00VdHF89,8,2,1,0,2022-01-11,4,Tuesday,2,9,2
1480753082871001093,2022-01-11 04:07:00,Tim dokter di Amerika Serikat (AS) melakukan transplantasi jantung babi ke pasien dalam upaya terakhir untuk menyelamatkan hidupnya. Operasi ini merupakan pertama kalinya dalam ilmu kedokteran. https://t.co/ZbVTKGt1Mf,41,16,22,4,2022-01-11,4,Tuesday,2,63,20
1480752095951269889,2022-01-11 04:03:05,Hasil Sanggah CPNS Kemendikbudristek diundur. Simak perubahan jadwalnya di sini yuk! Via: detikedu https://t.co/N8G9Us9jx4,7,0,1,0,2022-01-11,4,Tuesday,2,8,0
1480751511055613958,2022-01-11 04:00:45,Nia Ramadhani dan Ardi Bakrie kembali jalani sidang kasus narkoba. Sidang ini beragendakan putusan dari majelis hakim. https://t.co/iXVrJ3zqyZ,3,1,1,0,2022-01-11,4,Tuesday,2,4,1
1480751504713789440,2022-01-11 04:00:44,"Tak sedikit bule yang diboyong ke Indonesia setelah menikah di sini. Ceu Nena, bule wanita asal Serbia betah menetap di Kuningan bersama seorang pria Sunda. #detiknetwork  https://t.co/WYWK4LCZXv",9,0,3,0,2022-01-11,4,Tuesday,2,12,0
1480750510563078144,2022-01-11 03:56:47,Tak ada Cristiano Ronaldo saat Manchester United mengalahkan Aston Villa di Piala FA. Ronaldo rupanya mengalami cedera ringan sehingga harus absen.  https://t.co/BdIGEIGcoJ,5,0,0,0,2022-01-11,3,Tuesday,2,5,0
1480749766371954688,2022-01-11 03:53:49,Seorang pria asal AS menjadi yang pertama di dunia yang menjalani transplantasi jantung babi hasil modifikasi genetik. Begini kondisinya pasca operasi: https://t.co/LCynepRnb4,21,10,9,6,2022-01-11,3,Tuesday,2,30,16
1480749491594706950,2022-01-11 03:52:44,"Sekelompok warga di Cisarua, Bogor, terlibat bentrokan dengan debt collector. Kejadian itu mengakibatkan satu orang luka-luka. https://t.co/TjkXdgWJxV",6,1,1,0,2022-01-11,3,Tuesday,2,7,1
1480748503517347843,2022-01-11 03:48:48,Penjualan karcis penonton balapan MotoGP Mandalika sudah bisa dibeli masyarakat. Sejauh ini ada lebih dari empat ribu lima ratus tiket yang terjual.  https://t.co/6280cFQZV1,4,0,2,0,2022-01-11,3,Tuesday,2,6,0
1480747773481955334,2022-01-11 03:45:54,50 HP bakal diblokir oleh WhatsApp di 2022 ini lantaran perangkat tersebut tidak menjalankan sistem operasi yang disyaratkan. Ini daftarnya:  https://t.co/YEqjKuXdpu,4,0,0,0,2022-01-11,3,Tuesday,2,4,0
1480747282819596289,2022-01-11 03:43:57,Peneliti menemukan teknik yang bisa memalsukan shutdown di iPhone. Teknik ini bisa mencegah malware dihapus dan pengguna bisa dimata-matai. https://t.co/Xtqf0W0KIk,4,0,2,0,2022-01-11,3,Tuesday,2,6,0
1480746756447117314,2022-01-11 03:41:52,Pengusaha buka suara soal pernyataan Bahlil Lahadalia mengenai adanya usulan pilpres mundur dari tahun 2024. Ini alasannya. https://t.co/nOOUdliXWi,30,53,5,9,2022-01-11,3,Tuesday,2,35,62
1480746456214642690,2022-01-11 03:40:40,Nia Ramadhani dan Ardi Bakrie hari ini menjalani sidang pembacaan putusan terkait kasus narkoba. Ardi Bakrie mengaku deg-degan mendengar putusan hakim. https://t.co/VRWhO5vEcR,11,2,0,0,2022-01-11,3,Tuesday,2,11,2
1480746205835579397,2022-01-11 03:39:41,"Aliya Nazarbayev, putri dari mantan presiden Kazakhstan kini sedang jadi sorotan. Sebagian hartanya terungkap ke publik dan nilainya begitu fantastis. Wow! https://t.co/r0Bb1WRvrp",6,1,0,0,2022-01-11,3,Tuesday,2,6,1
1480744720502505480,2022-01-11 03:33:46,Para arkeolog menemukan makam menakjubkan yang ditinggalkan orang kaya pada zaman dulunya. Makam ini berisi kereta hingga kepala kuda berlapis emas. https://t.co/vd7Fd0tHz0,3,0,1,0,2022-01-11,3,Tuesday,2,4,0
1480743876021436420,2022-01-11 03:30:25,"Axel Tuanzebe tersingkir dari skuad Manchester United, dengan kini dipinjamkan ke Napoli. Agen bek 24 tahun itu kemudian mengecam Setan Merah!  https://t.co/nx7rCnbsjF",3,0,0,0,2022-01-11,3,Tuesday,2,3,0
1480743386764169219,2022-01-11 03:28:28,Harga emas Antam hari ini Selasa 11 Januari 2022 naik Rp 1.000. Mau beli emas? Jadi segini harganya: #HargaEmas https://t.co/8jl2iUf5LO,6,0,0,0,2022-01-11,3,Tuesday,2,6,0
1480743147265212417,2022-01-11 03:27:31,Ferdinand Hutahaean ditetapkan sebagai tersangka dan langsung ditahan. Kuasa hukum segera mengajukan penangguhan penahanan. https://t.co/GQbYmlRSNL,12,3,6,0,2022-01-11,3,Tuesday,2,18,3
1480741668081053696,2022-01-11 03:21:39,"Di Depok, ada dealer motor fokus menjual Vespa matic bekas. Memiliki 50-60 unit Vespa matic dari berbagai tipe dan terjual sekitar 150 unit Vespa per bulan!  https://t.co/8qdKCVAUgM",18,0,4,0,2022-01-11,3,Tuesday,2,22,0
1480740887311310848,2022-01-11 03:18:33,"Film Penyalin Cahaya kembali membuat heboh, bukan karena prestasi melainkan skandal pelecehan seksual yang dilakukan oleh krunya. https://t.co/7c4rMgjPxs",6,4,2,0,2022-01-11,3,Tuesday,2,8,4
1480739894775455750,2022-01-11 03:14:36,"Gaga Muhammad membacakan pembelaannya. Mengaku salah, tapi Gaga Muhammad juga nilai ada kelalaian dari Laura Anna dan rumah sakit. https://t.co/Ik8uLqOclt",16,14,0,8,2022-01-11,3,Tuesday,2,16,22
1480738911076950018,2022-01-11 03:10:41,"Sekelompok peneliti dari Inggris ingin mencari jawaban mengapa ada banyak anak-anak yang dijadikan mumi dan dikubur dalam biara Capuchin di Palermo, Italia. https://t.co/tqeAkZf2Al",7,0,0,0,2022-01-11,3,Tuesday,2,7,0
1480738385316794368,2022-01-11 03:08:36,Megawati Soekarnoputri dan Hasto Kristiyanto menyinggung sosok benalu ambil untung saat pandemi. Siapa yang dimaksud? https://t.co/fM46UIW0Ul,5,5,0,0,2022-01-11,3,Tuesday,2,5,5
1480737976162390018,2022-01-11 03:06:58,Bareskrim Polri menetapkan Ferdinand Hutahaean sebagai tersangka. Pelapor mengapresiasi Polri https://t.co/Fdiqczsxet,18,5,5,0,2022-01-11,3,Tuesday,2,23,5
1480737359633293316,2022-01-11 03:04:31,Elon Musk membagikan lima nasihat untuk anak muda yang ingin sukses di kehidupan. Ini nasehat dari orang terkaya di dunia:  https://t.co/oE3cLVrOPG,24,1,7,1,2022-01-11,3,Tuesday,2,31,2
1480736779129049090,2022-01-11 03:02:13,Korut kembali meluncurkan rudal balistik dari wilayahnya. Peluncuran ini merupakan yang kedua dilakukan Korut kurang dalam sepekan terakhir. https://t.co/kiM2WXlxH2,9,0,1,0,2022-01-11,3,Tuesday,2,10,0
1480736436638863360,2022-01-11 03:00:51,"Perusahaan penyedia pendidikan swasta terbesar di China, New Oriental Education memberhentikan 60.000 karyawan. Kacau! Ada apa? https://t.co/9VybyBohZY",4,0,1,0,2022-01-11,3,Tuesday,2,5,0
1480735676387799040,2022-01-11 02:57:50,"#Foto Sempat 'disembunyikan' dari publik, Lesti Kejora dan Rizky Billar akhirnya memperlihatkan wajah bayi mereka. Ini momen pemotretan gemas baby L. https://t.co/8KZeQdrSmU",18,3,2,0,2022-01-11,2,Tuesday,2,20,3
1480735376318910466,2022-01-11 02:56:39,"Di Sukabumi nih! Jika ditilik lebih teliti, inilah satu-satunya kabupaten di Jawa Barat yang memiliki Museum Prabu Siliwangi berkoleksi rambut Nabi Muhammad SAW. https://t.co/an6VHjrSWN",8,1,1,0,2022-01-11,2,Tuesday,2,9,1
1480734482395283456,2022-01-11 02:53:05,Banjir menggenangi permukiman warga di 3 kelurahan di Cilegon. Ketinggian air mencapai 1 meter. #bANJIR #Cilegon https://t.co/u3dBWZzeOM,1,0,1,0,2022-01-11,2,Tuesday,2,2,0
1480733246623207424,2022-01-11 02:48:11,Budi meminta warga tak panik meskipun Indonesia bersiap menghadapi gelombang Omicron. https://t.co/I42PyzKyx1,7,1,2,1,2022-01-11,2,Tuesday,2,9,2
1480732507142295556,2022-01-11 02:45:15,"Polresta Bandung mengungkap modus pencabulan yang dilakukan seorang pimpinan salah satu pondok pesantren di Ciparay, Kabupaten Bandung, terhadap santriwatinya. Pelaku berdalih bisa mengisi tenaga dalam terhadap para korbannya. https://t.co/FCte8vxyfs",30,17,19,11,2022-01-11,2,Tuesday,2,49,28
1480731629903560704,2022-01-11 02:41:45,Menggunakan kondom kerap menjadi pilihan sebagai alat kontrasepsi maupun pencegahan infeksi. Ini cara yang efektif menggunakan kondom supaya aman. https://t.co/kChdVmXnpb,7,0,3,0,2022-01-11,2,Tuesday,2,10,0
1480730880427667460,2022-01-11 02:38:47,Presiden Jokowi melarang ekspor batu bara lantaran PLN mengalami krisis batu bara. Negara mana saja yang protes dengan kebijakan tersebut? https://t.co/OG8tMdzIUt,54,13,15,7,2022-01-11,2,Tuesday,2,69,20
1480730147883991046,2022-01-11 02:35:52,"Surat Al Mulk ayat 2 mengingatkan manusia tentang ujian. Saat hidup tengah diuji, ingatkan selalu kuasa Allah SWT yang menyayangi makhlukNya. Via: detikedu https://t.co/MyVzpey6Vn",25,0,7,0,2022-01-11,2,Tuesday,2,32,0
1480728822743973893,2022-01-11 02:30:36,Ferdinand Hutahaean yang jadi tersangka di kasus cuitan 'Allahmu ternyata lemah' langsung ditahan tadi malam. Polisi turut menyita hp milik Ferdinand Hutahaean. https://t.co/OF1FAbvV0J,16,11,6,3,2022-01-11,2,Tuesday,2,22,14
1480727742417145862,2022-01-11 02:26:19,Hari ini Nia Ramadhani dan Ardi Bakrie akan mendengarkan pembacaan putusan dari majelis hakim terkait kasus narkoba yang menjerat mereka. https://t.co/ViZLTVgIlJ,8,3,1,0,2022-01-11,2,Tuesday,2,9,3
1480727724297760780,2022-01-11 02:26:14,"Baru-baru ini Provinsi Qinghai, China diguncang gempa hebat. Separah apa? #China https://t.co/coByolMbVN",10,4,4,1,2022-01-11,2,Tuesday,2,14,5
1480727226412847104,2022-01-11 02:24:16,"Buah kaya akan serat dan vitamin yang baik bagi kesehatan. Tapi apa saja buah yang bagus untuk diet, terutama diet untuk menurunkan berat badan ya? https://t.co/WFMFXLa04x",6,0,3,0,2022-01-11,2,Tuesday,2,9,0
1480726687499403267,2022-01-11 02:22:07,Presiden Meksiko Andres Manuel Lopez Obrador mengaku kembali tertular COVID-19 untuk kedua kalinya. Lopez Obrador mengaku mengalami gejala ringan. https://t.co/OYHYX0ESl4,2,0,0,0,2022-01-11,2,Tuesday,2,2,0
1480726440458997762,2022-01-11 02:21:08,Viral kisah pria yang berhasil kembali setelah diculik selama 30 tahun. Ia kembali berkat peta kampung halamannya yang ia buat. https://t.co/UvjwmLS7Ve,9,0,0,0,2022-01-11,2,Tuesday,2,9,0
1480725604265771011,2022-01-11 02:17:49,Artis dangdut Velline Chu si 'ratu begal' ditangkap polisi gegara sabu. Dia ditangkap bareng suaminya. Simak fakta-faktanya: https://t.co/pcZzeJtDG3,2,0,0,0,2022-01-11,2,Tuesday,2,2,0
1480725361449222148,2022-01-11 02:16:51,Sebuah perampokan bank terjadi di Vietnam akhir pekan lalu. Pelaku yang membawa kabur miliaran rupiah membeli moge impiannya. https://t.co/76C5aaHy4V,10,2,1,1,2022-01-11,2,Tuesday,2,11,3
1480724350387032069,2022-01-11 02:12:50,"Sungguh apes nasib sopir truk di China ini. Gara-gara ikuti arahan dari GPS, truk yang dia kemudikan nyaris masuk ke jurang. Waduh, untung selamat! https://t.co/C8kfCzkO62",3,0,0,0,2022-01-11,2,Tuesday,2,3,0
1480722232599003137,2022-01-11 02:04:25,"Hai Gemini, banyak sekali peluang untuk mendapatkan keuntungan, tinggal bagaimana kamu berikhtiar. Kalau kata zodiak lainnya, gimana ya? https://t.co/ojtS3WZTso",1,0,0,0,2022-01-11,2,Tuesday,2,1,0
1480721245930987521,2022-01-11 02:00:30,Biaya umrah 2022 diperkirakan akan naik drastis. Harga naik imbas dari kewajiban tes kesehatan dan karantina sebelum dan sesudah menjalani ibadah umrah. #CNNIndonesia #detiknetwork  https://t.co/pWJBCTFssP,14,0,5,2,2022-01-11,2,Tuesday,2,19,2
1480720484832587776,2022-01-11 01:57:28,"Simone Inzaghi bersyukur bisa melatih Inter Milan. Sebabnya, Nerazzurri disebutnya mempunyai skuad yang bagus.  https://t.co/DLW92dWjVs",8,0,0,0,2022-01-11,1,Tuesday,2,8,0
1480719727408336896,2022-01-11 01:54:28,Senegal membuka kiprahnya di Piala Afrika 2021 lewat kemenangan dramatis 1-0 atas Zimbabwe. Gol berasal dari penalti Sadio Mane di pengujung laga.  https://t.co/SL3ddczmJM,2,0,0,0,2022-01-11,1,Tuesday,2,2,0
1480718936127717378,2022-01-11 01:51:19,Polisi menjamin tidak akan menilang pengendara mobil yang menggunakan roof box di atap kendaraannya. Gimana dengan pemobil yang bawa barang tanpa roof box?  https://t.co/H6cEP0e1TL,6,0,1,1,2022-01-11,1,Tuesday,2,7,1
1480718180519755785,2022-01-11 01:48:19,"Pasangan penyanyi Anang Hermansyah dan Ashanty bakal serius mengembangkan metaverse dan NFT. Dalam waktu dekat, Anang akan meluncurkan token ASIX. https://t.co/9ZZSK9jgrI",15,7,2,9,2022-01-11,1,Tuesday,2,17,16
1480717404804198400,2022-01-11 01:45:14,"Umrah masih terus jadi perbincangan. Namun satu yang pasti, biayanya naik cukup menguras kantong. https://t.co/G2o1JNhGvG",27,5,13,5,2022-01-11,1,Tuesday,2,40,10
1480716910480211975,2022-01-11 01:43:16,"Warna putih masih mendominasi mobil di jalanan, tapi trennya terus menurun. Ini warna mobil yang lagi naik daun:  https://t.co/RjUI1ESz6B",4,0,0,1,2022-01-11,1,Tuesday,2,4,1
1480716144277393409,2022-01-11 01:40:13,Seorang WN Amerika Serikat (AS) mengeluhkan kondisi hotel karantina yang ditempatinya di Indonesia. Per malam tarifnya Rp 2 juta tapi kondisinya bobrok. https://t.co/hvdp10PLNY,19,6,9,2,2022-01-11,1,Tuesday,2,28,8
1480715400941817865,2022-01-11 01:37:16,"Axel Tuanzebe tersingkir dari skuad Manchester United, dengan kini dipinjamkan ke Napoli. Agen bek 24 tahun itu kemudian mengecam Setan Merah!  https://t.co/X88lXEw9lU",2,0,0,0,2022-01-11,1,Tuesday,2,2,0
1480714892357378051,2022-01-11 01:35:15,Luhut Binsar Pandjaitan menegaskan belasan kapal batu bara sudah siap berlayar ke luar negeri mulai hari ini. https://t.co/l5ZN66uThI,92,97,23,20,2022-01-11,1,Tuesday,2,115,117
1480714094319652868,2022-01-11 01:32:05,"Nama striker Timnas Jerman Mesut Ozil tengah jadi buah bibir paska dikaitkan dengan RANS FC. Lihat lagi kampung halamannya di Jerman yang indah. 
#MesutOzil https://t.co/tyX3zaKXN3",19,3,1,2,2022-01-11,1,Tuesday,2,20,5
1480713046066700288,2022-01-11 01:27:55,Lalu kenapa orang Amerika lebih memilih rumah yang terbuat dari kayu? https://t.co/bS2euuLzcL,17,2,6,1,2022-01-11,1,Tuesday,2,23,3
1480712294652911617,2022-01-11 01:24:56,Axel Tuanzebe melanjutkan kariernya bersama Napoli. Kabarnya kedatangan Steven Gerrard ke Aston Villa membuat pemain pinjaman Manchester United itu harus pergi.  https://t.co/SBrlzndNUc,1,0,0,1,2022-01-11,1,Tuesday,2,1,1
1480711291622903808,2022-01-11 01:20:56,"Maroko dan Guinea sama-sama membuka Piala Afrika 2021 dengan tiga poin. Maroko mengalahkan Ghana dengan skor 1-0, demikian juga Guinea atas Malawi.  https://t.co/YIf59zsFCK",2,0,0,0,2022-01-11,1,Tuesday,2,2,0
1480711275558711296,2022-01-11 01:20:53,Kabar baik untuk Barcelona yang akhirnya bisa mendaftarkan Ferran Torres. Hal ini terjadi setelah Samuel Umtiti sepakat untuk dipotong gajinya.  https://t.co/tVZsho603v,1,0,0,0,2022-01-11,1,Tuesday,2,1,0
1480709910698594311,2022-01-11 01:15:27,Virus Corona menjangkiti pimpinan tertinggi Juventus. Andrea Agnelli selaku presiden Bianconeri dilaporkan positif mengidap COVID-19.  https://t.co/dEUyeg3tuc,6,1,1,0,2022-01-11,1,Tuesday,2,7,1
1480709736131706881,2022-01-11 01:14:46,PSSI angkat bicara setelah kegagalan Samuel Balinsa bergabung ke klub Thai League 2 Lampang FC. Federasi disebut-sebut bersalah soal penerbitan ITC.  https://t.co/mcwbwYd7m9,0,0,2,0,2022-01-11,1,Tuesday,2,2,0
1480709179220406274,2022-01-11 01:12:33,Toyota menjadi merek mobil yang paling banyak dicari di dunia pada tahun 2021. Itu berdasarkan data Google Trends. https://t.co/VZL5dY92eo,2,0,1,0,2022-01-11,1,Tuesday,2,3,0
1480708938781843456,2022-01-11 01:11:35,"Presiden Komite Olimpade Serbia, Bozidar Maljkovic, mengecam perlakuan Australia ke Novak Djokovic. Negaranya tak akan pernah bersikap serupa negeri Kangguru!  https://t.co/1AXSiKkSm6",8,1,0,0,2022-01-11,1,Tuesday,2,8,1
1480708677879451650,2022-01-11 01:10:33,Seleksi Nasional (Seleknas) PBSI 2022 resmi dibuka. Tunggal putra Hendry Leander asal Jawa Tengah harus bekerja keras untuk menang di hari pertama.  https://t.co/Mi9Ce9nvES,3,0,0,0,2022-01-11,1,Tuesday,2,3,0
1480708213225967616,2022-01-11 01:08:42,"#FOTO Elon Musk dan Jeff Bezos, mereka adalah dua orang terkaya di dunia yang tahtanya saling berebut naik turun. Tapi mereka punya kesamaan: suka meme. https://t.co/C2Q1qEAAJc",6,0,0,0,2022-01-11,1,Tuesday,2,6,0
1480708191583363074,2022-01-11 01:08:37,Menteri Pemuda dan Olahraga Zainudin Amali menengok pelaksanan Proliga 2022 akhir pekan kemarin bersama SBY.  https://t.co/w9kKGy5IMu,8,1,1,0,2022-01-11,1,Tuesday,2,9,1
1480707308736888835,2022-01-11 01:05:07,Penjualan karcis penonton balapan MotoGP Mandalika sudah bisa dibeli masyarakat. Sejauh ini ada lebih dari empat ribu lima ratus tiket yang terjual.  https://t.co/OLzmsr2MEj,16,2,5,3,2022-01-11,1,Tuesday,2,21,5
1480706173389131778,2022-01-11 01:00:36,Mahasiswa UMY terduga pelaku pemerkosaan berinisial MKA alias OCD telah di-DO secara tetap dengan tidak hormat. MKA disebut menerima sanksi DO tersebut. https://t.co/Wqdyj5smkH,5,0,2,3,2022-01-11,1,Tuesday,2,7,3
1480705918085918720,2022-01-11 00:59:35,Sekjen PDIP Hasto Kristiyanto mengatakan Djarot Saiful Hidayat mengibaratkan Tanah Abang macetnya bak poco-poco. Pernyataan ini pun menuai beragam tanggapan. https://t.co/PFz0PLGKEm,2,3,0,1,2022-01-11,0,Tuesday,2,2,4
1480705891678797824,2022-01-11 00:59:29,Menteri Investasi/Kepala BKPM Bahlil Lahadalia mengklaim para pengusaha setuju jika Pilpres 2024 ditunda. PKB sebut Bahlil tak paham konstitusi. https://t.co/yRxhzYu1m7,4,2,1,2,2022-01-11,0,Tuesday,2,5,4
1480705687072251909,2022-01-11 00:58:40,"Axel Tuanzebe tersingkir dari skuad Manchester United, dengan kini dipinjamkan ke Napoli. Agen bek 24 tahun itu kemudian mengecam Setan Merah. https://t.co/bb829FdDor",4,0,1,0,2022-01-11,0,Tuesday,2,5,0
1480705668030025728,2022-01-11 00:58:36,"Rumah milik Ulung (38) hancur terkena ledakan dahsyat di Pandeglang, Banten. Pria tersebut tewas. Tim Gegana Polda Banten diterjunkan ke lokasi kejadian. https://t.co/BTw55dVE3p",2,0,1,0,2022-01-11,0,Tuesday,2,3,0
1480705387624124419,2022-01-11 00:57:29,"Mercedes-Benz E 300 AMG Line rakitan Wanaherang hadir sebagai versi facelift dari pendahulunya. Lantas, seberapa irit Mercy E Class terbaru ini?  https://t.co/c9ZAhGksvH",3,0,1,0,2022-01-11,0,Tuesday,2,4,0
1480705369420750852,2022-01-11 00:57:24,Polsek Pamulang digeruduk puluhan ojol pada Minggu (9/1) malam. Penggerudukan dipicu dugaan pemukulan oknum TNI AL berpangkat mayor kepada driver ojol. https://t.co/cab6n5oBHG,4,0,1,0,2022-01-11,0,Tuesday,2,5,0
1480705347761459207,2022-01-11 00:57:19,Seorang pria berusia 72 tahun di AS ditangkap. Dia ditangkap setelah diduga menelepon Secret Service dan mengancam akan membunuh mantan presiden Donald Trump. https://t.co/MZ5wBCTnhm,3,0,0,0,2022-01-11,0,Tuesday,2,3,0
1480705050301325316,2022-01-11 00:56:08,"Pada tahun 2021, industri otomotif roda dua turut bangkit dari keterpurukan. Pabrikan ini menjadi merek motor paling laris di dunia sepanjang 2021.  https://t.co/0s6u0Dn59T",3,0,0,0,2022-01-11,0,Tuesday,2,3,0
1480705029568880643,2022-01-11 00:56:03,Jadwal dan lokasi ganjil genap di DKI Jakarta pada Januari 2022. Catat!  https://t.co/X7G7b8KdFV,6,0,2,0,2022-01-11,0,Tuesday,2,8,0
1480705028167983106,2022-01-11 00:56:03,"BMKG memprakirakan cuaca di wilayah Daerah Istimewa Yogyakarta (DIY) berpotensi hujan, Selasa (11/1/2022). Berikut prakiraan cuaca selengkapnya. https://t.co/vEA6xGXf7z",3,0,1,0,2022-01-11,0,Tuesday,2,4,0
1480704797317771271,2022-01-11 00:55:08,BPOM RI menyetujui 5 jenis vaksin COVID-19 yang akan digunakan sebagai booster. Kesesuaian antara vaksin primer dengan jenis booster mengikuti panduan berikut. https://t.co/7ROyypif6W,5,1,0,1,2022-01-11,0,Tuesday,2,5,2
1480704780108505088,2022-01-11 00:55:04,Menteri Investasi/Kepala BKPM Bahlil Lahadalia tengah menjadi kontroversi. Isu pebisnis berharap Pilpres 2024 mundur bikin dirinya menuai komentar sinis. https://t.co/6oE6TBTdXX,3,2,1,2,2022-01-11,0,Tuesday,2,4,4
1480704298312949761,2022-01-11 00:53:09,Sadio Mane dapat ancaman santet sampai mati jika main di Piala Afrika 2021. Mane merespons dengan bilang Allah-lah yang menentukan kapan dirinya mati. https://t.co/u1PDPcmpBq,385,13,70,8,2022-01-11,0,Tuesday,2,455,21
1480704276913696769,2022-01-11 00:53:04,"Rencana pemberian vaksin booster COVID-19 rupanya banyak disambut positif. Banyak yang menantikannya, dan tetap berminat sekalipun akhirnya harus bayar. https://t.co/3Fy8QiTRyY",4,1,0,0,2022-01-11,0,Tuesday,2,4,1
1480704002178404354,2022-01-11 00:51:58,Penjualan karcis penonton balapan MotoGP Mandalika sudah bisa dibeli masyarakat. Sejauh ini ada lebih dari empat ribu lima ratus tiket yang terjual. https://t.co/evQjous1Y9,9,1,1,1,2022-01-11,0,Tuesday,2,10,2
1480703982880370692,2022-01-11 00:51:54,Inilah momen saat Tesla Model Y dipermalukan teknologi yang dicela Elon Musk!  https://t.co/7tvmMjqF8Y,4,0,0,1,2022-01-11,0,Tuesday,2,4,1
1480703965822136325,2022-01-11 00:51:50,"Megawati Soekarno Putri menjalin kedekatan dengan Ahok. Megawati memanggil Ahok dengan sahabat, pernah juga singgung soal ganti panggilan jadi BTP. https://t.co/HImxwV5d3y",5,0,0,1,2022-01-11,0,Tuesday,2,5,1
1480703964576419848,2022-01-11 00:51:49,"Gempa Magnitudo 5,2 menguncang Nias Barat, Sumatera Utara (Sumut). Gempa ini tidak menimbulkan potensi tsunami. https://t.co/mK3ZCcLcJl",3,0,0,1,2022-01-11,0,Tuesday,2,3,1
1480703414090838021,2022-01-11 00:49:38,"Perusahaan infrastruktur telekomunikasi, Mitratel, siap untuk menopang bagi operator seluler yang ingin ekspansi ke luar Pulau Jawa. https://t.co/9m37zQga9J",4,0,0,0,2022-01-11,0,Tuesday,2,4,0
1480703398353809411,2022-01-11 00:49:34,Inilah koleksi mobil mewah Mesut Ozil yang diisukan ke RANS Cilegon FC!  https://t.co/uInafUb1x2,4,4,0,1,2022-01-11,0,Tuesday,2,4,5
1480702909969051659,2022-01-11 00:47:38,Sebuah perampokan bank terjadi di Vietnam akhir pekan lalu. Pelaku yang membawa kabur miliaran rupiah membeli moge impiannya!  https://t.co/YQFCXweRwA,7,0,2,0,2022-01-11,0,Tuesday,2,9,0
1480702650282872841,2022-01-11 00:46:36,Polisi menjamin tidak akan menilang pengendara mobil yang menggunakan roof box di atap kendaraannya. Gimana dengan pemobil yang bawa barang tanpa roof box?   https://t.co/xChzqeecQ1,7,0,1,1,2022-01-11,0,Tuesday,2,8,1
1480701776122859520,2022-01-11 00:43:08,"Menurut pihak kepolisian, tidak masalah jika mobil pribadi menggunakan roof box. Asal...  https://t.co/QwDCPAT44o",7,3,2,0,2022-01-11,0,Tuesday,2,9,3
1480700845285064704,2022-01-11 00:39:26,"Kader NasDem, Sahrul Gunawan membuat heboh lantaran hadir ke acara mengenakan atribut partai Golkar. Tindakan Sahrul ini dinilai tidak etis untuk Partai NasDem. https://t.co/IAUALlPSF3",16,2,1,2,2022-01-11,0,Tuesday,2,17,4
1480700368229220355,2022-01-11 00:37:32,Polisi telah menetapkan Ferdinand Hutahaean sebagai tersangka dan ditahan dalam kasus cuitan 'Allahmu lemah'. Ada beberapa fakta yang dirangkup oleh detikcom. https://t.co/60SAwxDoJA,7,4,2,0,2022-01-11,0,Tuesday,2,9,4
1480700107859365892,2022-01-11 00:36:30,"Philippe Coutinho lagi mengurus visa sebelum bisa melakoni debut di Aston Villa. Manajer The Villans, Steven Gerrad, tak sabar bertemu eks rekannya itu. https://t.co/34spKGU0WZ",7,0,1,0,2022-01-11,0,Tuesday,2,8,0
1480699880154845191,2022-01-11 00:35:36,"Polisi merilis kasus pemerkosaan yang dialami oleh anak berusia 9 tahun di Setiabudi, Jaksel. Berikut ini penampakan pelaku pemerkosaan. https://t.co/n0HIuTlKV8",3,1,0,1,2022-01-11,0,Tuesday,2,3,2
1480699375210971139,2022-01-11 00:33:35,"Mengenal ciri-ciri paru-paru bermasalah wajib dilakukan sejak dini. Sebab, paru-paru bermasalah dapat memberikan dampak buruk bagi kesehatan kita loh. https://t.co/CJ2ax45m7z",4,1,0,0,2022-01-11,0,Tuesday,2,4,1
1480698634308042754,2022-01-11 00:30:39,"Puluhan penendara motor masih nekat melintasi flyover Pesing, meski sudah ada rambu larangan. Puluhan pengendara motor ini akhirnya ditilang. https://t.co/Pt1n4dAnNK",3,4,0,0,2022-01-11,0,Tuesday,2,3,4
1480698360004845568,2022-01-11 00:29:33,"Heboh di media sosial aksi ulama di Garut, Jawa Barat marah saat protes terkait eksistensi Negara Islam Indonesia (NII) di DPRD Garut. https://t.co/lwORJWC8Dd",7,1,1,1,2022-01-11,0,Tuesday,2,8,2
1480697626093924355,2022-01-11 00:26:38,"Menko Polhukam, Mahfud Md merespons Menteri Investasi Bahlil Lahadalia soal klaim para pengusaha Pilpres 2024 diundur. Mahfud memastikan Pemilu tetap 2024. https://t.co/Pt3NguvWzT",23,9,4,2,2022-01-11,0,Tuesday,2,27,11
1480696075816214529,2022-01-11 00:20:29,Sisa-sisa fosil 'naga laut' berusia 180 juta tahun telah ditemukan di Inggris. Fosil ini disebut terlengkap dan terbesar yang pernah ditemukan di Inggris. https://t.co/nLooW0V857,76,3,13,0,2022-01-11,0,Tuesday,2,89,3
1480695056554242051,2022-01-11 00:16:26,"Wakil Ketua Umum NasDem, Ahmad Ali menyoroti kadernya yang juga Wakil Bupati Bandung Sahrul Gunawan lantaran mengenakan jaket Golkar di acara Golkar. https://t.co/xBjKk5JOqA",5,3,0,0,2022-01-11,0,Tuesday,2,5,3
1480694326992805890,2022-01-11 00:13:32,"Teman kencan wanita S yang ditemukan tewas di Hotel Teluknaga, Kabupaten Tangerang, yang berinisial R ditetapkan sebagai tersangka. https://t.co/04y61Wnncc",7,0,0,0,2022-01-11,0,Tuesday,2,7,0
1480693835361619969,2022-01-11 00:11:34,"Tentara WhatsApp dilarang menggunakan WhatsApp, Telegram, dan Signal. Sebagai gantinya mereka disarankan menggunakan aplikasi lokal bernama Threema. https://t.co/VEvugj6pvX",22,34,12,5,2022-01-11,0,Tuesday,2,34,39
1480692486565773320,2022-01-11 00:06:13,"Organisasi umat Hindu, DPD Prajaniti Hindu Indonesia Jatim melaporkan pria penendang sesajen ke polisi. Organisasi ini melapor ke Polda Jatim. https://t.co/HvLK5V8Kqp",254,25,44,10,2022-01-11,0,Tuesday,2,298,35
1480691712938938369,2022-01-11 00:03:08,Ferdinand Hutahaean mencuit di Twitter tentang 'Allahmu lemah.' Polemik cuitan itu berlanjut hingga akhirnya Ferdinand ditetapkan sebagai tersangka dan ditahan. https://t.co/fa8QIqF5Ew,13,6,9,1,2022-01-11,0,Tuesday,2,22,7
1480691088646094853,2022-01-11 00:00:40,BPOM izinkan penggunaan darurat 5 vaksin sebagai booster vaksin COVID-19. Vaksin booster itu akan diberikan kepada masyarakat umum pada 12 Januari mendatang. https://t.co/ihXXK8g4uS,1,2,3,0,2022-01-11,0,Tuesday,2,4,2
1480690280114364417,2022-01-10 23:57:27,Posisi Megawati sebagai Ketua Dewan Pengarah BRIN pernah jadi sorotan. Megawati mengaku heran kenapa banyak orang yang menyorot dirinya. https://t.co/ueNr9NoaDj,15,18,5,3,2022-01-10,23,Monday,1,20,21
1480689287163260931,2022-01-10 23:53:30,"Seorang mahasiswi di Lamongan diamankan terkait investasi bodong yang dilakukannya. Dari dua korban yang melapor, mahasiswi ini berhasil meraup Rp 3,9 miliar. https://t.co/xZHIinXOF2",25,2,5,4,2022-01-10,23,Monday,1,30,6
1480688531324420102,2022-01-10 23:50:30,"Tak hanya rasanya yang manis dan menyegarkan, buah apel juga memiliki manfaat bagi kesehatan tubuh yang tak perlu diragukan. Penasaran? Simak informasinya yuk. https://t.co/WAbcuBB1Pv",8,0,2,0,2022-01-10,23,Monday,1,10,0
1480687792892039174,2022-01-10 23:47:34,India mengalami lonjakan kasus Corona akibat varian Omicron. Lonjakkan kasus disebut hampir delapan kali lipat untuk tambahan kasus harian sejak awal tahun. https://t.co/bkvb94wYjS,7,0,3,2,2022-01-10,23,Monday,1,10,2
1480686617731940357,2022-01-10 23:42:54,"Sebanyak 981 KK di Kampung Tembok Bolong Muara Baru, Jakut, terdampak krisis air bersih. Diketahui, krisis air bersih sudah terjadi sekitar 10 bulan. https://t.co/J1UuZt6UGk",5,9,5,6,2022-01-10,23,Monday,1,10,15
1480686057444229124,2022-01-10 23:40:40,Pemerintah Arab Saudi hanya mengizinkan kaum pria untuk mengunjungi makam Nabi Muhammad di Masjid Nabawi di Kota Madinah. Sedangkan kaum perempuan tak diizinkan https://t.co/IV1wwpUZqz,11,0,3,2,2022-01-10,23,Monday,1,14,2
1480684826374160389,2022-01-10 23:35:47,"Vespa matic hadir dalam berbagai tipe di Indonesia. Namun di pasar Vespa matic bekas, tipe yang paling banyak diincar justru bukan di tipe termurahnya. https://t.co/rh0yASA05O",7,0,3,0,2022-01-10,23,Monday,1,10,0
1480684004751851521,2022-01-10 23:32:31,Aksi pria tendang sesajen di lokasi erupsi Gunung Semeru tengah dan menjadi buah bibir masyarakat. Pakar sosial dan budaya turut buka suara soal aksi ini. https://t.co/F8Wlqz0knH,13,6,2,2,2022-01-10,23,Monday,1,15,8
1480682255882362882,2022-01-10 23:25:34,Ketua Komisi Fatwa MUI Jatim KH Makruf Khozin bicara terkait viral pria menendang sesajen. Makruf menyebut tidak selayaknya pria itu mengkafirkan sesama muslim. https://t.co/Mm5Wpi4tBC,26,21,5,5,2022-01-10,23,Monday,1,31,26
1480681498416144384,2022-01-10 23:22:33,BlackBerry tumbang antara lain karena kesalahan pucuk pimpinannya. Ini 4 ramalan yang salah besar soal BlackBerry:  https://t.co/OqYXCotd1w,17,4,3,0,2022-01-10,23,Monday,1,20,4
1480679507715674113,2022-01-10 23:14:38,Pemprov DKI akan menghilangkan pelican crossing di dekat JPO bertema kapal pinisi di Sudirman. Penyeberangan orang itu dihapus setelah JPO baru difungsikan. https://t.co/ZaDkpNRlpX,10,0,1,1,2022-01-10,23,Monday,1,11,1
1480678716426620930,2022-01-10 23:11:30,Sebuah bayangan yang diduga berasal dari suatu obyek cukup besar wujudnya telah terekam di layanan peta Google Maps. Ini penampakannya:  https://t.co/x1dZ8UJq1T,12,1,1,0,2022-01-10,23,Monday,1,13,1
1480678052397039622,2022-01-10 23:08:52,"JPO bertema kapal pinisi di Karet, Sudirman, tuai kritik karena dianggap tidak ramah pejalan kaki. Pemprov DKI menyebut revitalisasi JPO justru disenangi warga. https://t.co/nsKsZKTEdK",8,4,1,3,2022-01-10,23,Monday,1,9,7
1480676712555896834,2022-01-10 23:03:32,"Kasus pembuangan bayi di makam desa di Pasuruan berujung diversi. T, ibu yang membuang bayi perempuan tersebut dikembalikan ke orang tuanya. https://t.co/nW1WoLXUPN",5,0,0,0,2022-01-10,23,Monday,1,5,0
1480675695261069312,2022-01-10 22:59:30,"Tak pernah pelit atau perhitungan, orang-orang ini hobi berbagi. Mereka bahkan sampai rebutan mentraktir makanan orang lain! https://t.co/QqrqBDW7bg",10,2,2,1,2022-01-10,22,Monday,1,12,3
1480674945948602370,2022-01-10 22:56:31,"Dalam dua hari tersebut, Telkom menampilkan produk digital dan startup karya terbaik anak bangsa ke delegasi asing, pemerintahan, investor hingga mitra bisnis. https://t.co/cJDetK6vNj",3,0,1,0,2022-01-10,22,Monday,1,4,0
1480673993803849732,2022-01-10 22:52:44,"Apple merilis iPhone pertama tepat 15 tahun yang lalu. Meski revolusioner di zamannya, perangkat ini tak punya sejumlah fitur standar ponsel saat ini.  https://t.co/qefO0f2xw2",11,1,2,0,2022-01-10,22,Monday,1,13,1
1480672899740540931,2022-01-10 22:48:23,"Terdapat struktur misterius dan super padat yang terletak di luar inti Bumi. Dalam penelitian terbaru, ilmuwan mungkin telah menemukan dari mana asalnya. https://t.co/B85aNjjvgG",13,2,2,0,2022-01-10,22,Monday,1,15,2
1480671908693639168,2022-01-10 22:44:27,"Kasus dugaan penipuan pembelian siomai Rp 4,2 juta di Penjaringan, memasuki babak baru. Polisi menganalisis keterangan pelapor dan terlapor dalam kasus ini. https://t.co/STx4lw1WzV",9,1,2,0,2022-01-10,22,Monday,1,11,1
1480671154591662085,2022-01-10 22:41:27,"iPhone kini jadi salah satu perangkat paling berpengaruh di dunia. Tapi di awal peluncurannya, tiga hal ini nyaris membuat iPhone jadi produk gagal: #iPhone  https://t.co/9Naju2wAgw",7,0,1,1,2022-01-10,22,Monday,1,8,1
1480670379702112256,2022-01-10 22:38:22,Pemerintah Irak memulangkan 111 keluarga yang pernah terlibat kelompok ISIS. Mereka dipulangkan dari kamp yang dikelola Kurdi di Suriah bagian utara. https://t.co/a3s9k6pAnk,8,0,1,0,2022-01-10,22,Monday,1,9,0
1480669042222727172,2022-01-10 22:33:03,Seorang warga AS mengeluh soal fasilitas hotel Indonesia yang dipakai untuk mengarantina pelaku perjalanan luar negeri. Kondisi hotel disebut tidak layak. https://t.co/V4rHIj6FmJ,24,11,14,2,2022-01-10,22,Monday,1,38,13
1480668574452969476,2022-01-10 22:31:12,Manchester United bersusah payah menyingkirkan Aston Villa di ajang Piala FA. Setan Merah menang tipis 1-0 dan lolos ke babak keempat. https://t.co/VWwYEqAkZl,5,0,1,0,2022-01-10,22,Monday,1,6,0
1480668330965241858,2022-01-10 22:30:14,Pemerintah melaporkan temuan 454 kasus Corona di Indonesia pada hari ini. Provinsi yang paling banyak melaporkan kasus dalam 24 jam terakhir yakni DKI Jakarta. https://t.co/F3nqiacIu2,11,5,2,1,2022-01-10,22,Monday,1,13,6
1480667278983450625,2022-01-10 22:26:03,"Penyebab tewasnya S di hotel daerah Teluknaga, Tangerang, belum diketahui. Polisi mengatakan kronologi berawal saat S dan temannya datang ke hotel bersama. https://t.co/cx79mskg6k",9,0,2,0,2022-01-10,22,Monday,1,11,0
1480666287093293058,2022-01-10 22:22:06,"Kuasa hukum Gaga Muhammad, Fahmi Bachmid, menilai tuntutan hukuman Gaga terlalu berat. Fahmi pun berharap bahwa hakim dapat mempertimbangkan poin-poin di dalam nota pembelaannya sebagai pertimbangan. https://t.co/xkrsaA3UWj",2,1,2,0,2022-01-10,22,Monday,1,4,1
1480665300492341254,2022-01-10 22:18:11,"Menko Marves, Luhut Binsar Pandjaitan, mengatakan tren peningkatan kasus Covid-19 disebabkan oleh para pelaku perjalanan dari luar negeri (PPLN). Luhut sekali lagi meminta semua pihak menahan diri untuk tidak bepergian ke luar negeri. https://t.co/vp1LG8T6WI",18,12,4,2,2022-01-10,22,Monday,1,22,14
1480664524751446018,2022-01-10 22:15:06,Berkat tren di TikTok iPod Shuffle alat khusus pemutar musik buatan Apple ini kembali populer setelah lama dipensiunkan. https://t.co/1GQ1DIGrCr,8,0,2,2,2022-01-10,22,Monday,1,10,2
1480663436430229505,2022-01-10 22:10:47,"Seorang berinisial ST dibacok rekannya di depan Pospol Jalan Daan Mogot, Jakbar. Kasus tersebut kini dalam penyelidikan polisi. https://t.co/1g02PV2fG7",4,0,1,1,2022-01-10,22,Monday,1,5,1
1480661900212211712,2022-01-10 22:04:41,"BMKG menyampaikan, peringatan dini untuk wilayah DKI Jakarta. BMKG menyebut, ada potensi hujan disertai kilat dan angin di beberapa wilayah Jakarta. https://t.co/ImFr8zauYg",9,0,3,2,2022-01-10,22,Monday,1,12,2
1480661137179901952,2022-01-10 22:01:39,"Pihak kepolisian mengungkap alasan pedangdut Velline Chu memakai narkoba. Velline mengaku memakai narkoba karena trauma yang disebabkan oleh KDRT yang pernah ia alami saat masih bersama mantan suaminya, HS. https://t.co/riG3HIICPa",4,2,1,1,2022-01-10,22,Monday,1,5,3
1480660323518795776,2022-01-10 21:58:25,Poco Indonesia menyiapkan sejumlah strategi agresif untuk menggebrak pasar ponsel di Indonesia pada 2022. Ini strateginya:  https://t.co/A4j8nZck22,9,0,1,1,2022-01-10,21,Monday,1,10,1
1480659286350974977,2022-01-10 21:54:17,"Tahukah detikers, jumlah simpanan nasabah kaya ini menguasai 51,2% dari total simpanan yang ada di perbankan Indonesia lho. https://t.co/Cibs2n5xdK",9,1,2,3,2022-01-10,21,Monday,1,11,4
1480658236823031811,2022-01-10 21:50:07,Banyaknya korban tewas di Jawa Tengah akibat kesetrum jebakan tikus listrik yang dipasang di sawah menyita perhatian banyak pihak. https://t.co/rwuTZzmefl,11,1,4,0,2022-01-10,21,Monday,1,15,1
1480656989407559680,2022-01-10 21:45:10,"Menparekraf RI, Sandiaga Uno, berencana menggelar perlombaan maraton kelas dunia di Tanah Air. Kegiatan itu dapat menciptakan peluang usaha dan lapangan kerja. https://t.co/KaPU9hS2Jd",11,3,1,3,2022-01-10,21,Monday,1,12,6
1480656254343254023,2022-01-10 21:42:14,Tes COVID-19 dengan melakukan usapan di hidung atau swab antigen diklaim tidak dapat mendeteksi varian Omicron dalam beberapa hari pertama infeksi.  https://t.co/EgWiIhnS9e,4,1,7,3,2022-01-10,21,Monday,1,11,4
1480655474013970434,2022-01-10 21:39:08,"Riot Games mengumumkan agent Valorant terbaru bernama Neon. Memiliki kemampuan sprint dan slide, ia akan bergabung pada tanggal 11 Januari 2022. https://t.co/oogHwFIYjP",3,0,0,0,2022-01-10,21,Monday,1,3,0
1480654737750040590,2022-01-10 21:36:13,Babak 16 besar Liga Champions akan menyajikan duel Inter Milan kontra Liverpool. Eks striker top Ian Rush mengemukakan alasan Liverpool lebih unggul dari Inter. https://t.co/R66RD6HBWs,5,0,0,0,2022-01-10,21,Monday,1,5,0
1480653989330960393,2022-01-10 21:33:14,"Kali ini, barang milik negara yang akan dilelang salah satunya adalah mobil Toyota Supra. Lelang Toyota Supra ini dibuka dengan harga Rp 100 jutaan. https://t.co/64oYRnwI2q",138,35,28,16,2022-01-10,21,Monday,1,166,51
1480653430758723593,2022-01-10 21:31:01,"Adik Ainun Habibie, Melok Besari menanti tindaklanjut Pemerintah Kota Bandung berkaitan rumahnya yang dikepung bising kafe-bar. https://t.co/o8PJNgG5k0",10,1,5,1,2022-01-10,21,Monday,1,15,2
1480652356253626375,2022-01-10 21:26:45,"Arsenal tersingkir dari Piala FA setelah dikandaskan Nottingham Forest. Sudah begitu, pemain mudanya Nuno Tavares bikin ulah karena ngambek ketika diganti! https://t.co/JPqY6yTDS2",3,0,1,0,2022-01-10,21,Monday,1,4,0
1480649890409689097,2022-01-10 21:16:57,"Sebagai cara membuat Bitcoin tetap bernilai, Satoshi Nakamoto selaku penciptanya yang misterius membatasi suplainya. Tepatnya, hanya ada 21 juta koin Bitcoin. https://t.co/8H9V4yfyMX",4,1,2,0,2022-01-10,21,Monday,1,6,1
1480648637768257538,2022-01-10 21:11:59,Vaksin Nusantara diwacanakan bakal menjadi booster. Menko Airlangga ungkap perkembangan vaksin besutan eks Menkes Terawan. https://t.co/efnfrZCP1j,6,0,2,1,2022-01-10,21,Monday,1,8,1
1480647643613302784,2022-01-10 21:08:01,Pelanggar bisa langsung terciduk dan minim sentuhan langsung dengan petuga. E-TLE Mobile bisa menjadi solusi jangka pendek.  https://t.co/hkYiE9lhfw,4,0,1,0,2022-01-10,21,Monday,1,5,0
1480646346432552961,2022-01-10 21:02:52,Bagi kamu pemilik All New Toyota Avanza jangan lupa untuk menyervis kendaraan di bengkel resmi. https://t.co/F2nj0P8ie7,6,0,1,0,2022-01-10,21,Monday,1,7,0
1480645058982522888,2022-01-10 20:57:45,Hampir 8.000 orang telah ditahan di Kazakhstan setelah berhari-hari kerusuhan terburuk di negara Asia Tengah yang menewaskan puluhan orang. https://t.co/3hqcpdueF7,7,1,3,3,2022-01-10,20,Monday,1,10,4
1480644052123017216,2022-01-10 20:53:45,"Nintendo Switch memiliki penjualan lima kali lebih baik dibandingkan PlayStation dan Xbox. Jika keduanya digabungkan, totalnya belum dapat menyaingi Switch. https://t.co/MKZuFyt1CK",9,0,3,1,2022-01-10,20,Monday,1,12,1
1480642962652639235,2022-01-10 20:49:25,"Usai dipercantik, Plaza Stasiun Manggarai, Jakarta, jadi tempat warga bermain. Sayang ada membuang sampah sembarangan. https://t.co/GhzItrcxDN",7,3,2,0,2022-01-10,20,Monday,1,9,3
1480641925245976582,2022-01-10 20:45:18,"Di saat warga lainnya menjadi miliarder, Sarwi Entin (50), hanya menerima Rp 4,1 juta dari ganti rugi tanahnya untuk proyek tol Yogya-Solo. Begini ceritanya. https://t.co/q2Euk04EHd",10,0,1,1,2022-01-10,20,Monday,1,11,1
1480640948086484992,2022-01-10 20:41:25,"Penggelaran jaringan 5G di Indonesia masih tahap awal. Mitratel, salah satu pemain tower, siap membangun infrastruktur telekomunikasi tersebut. https://t.co/cQ2wRvt3wA",2,0,2,0,2022-01-10,20,Monday,1,4,0
1480640189219360773,2022-01-10 20:38:24,"Setelah dikalahkan Wolverhampton, Manchester United akan menjamu Aston Villa di babak ketiga Piala FA. MU akan bertekad bangkit dari keterpurukan. https://t.co/s3D25QsB33",4,0,2,0,2022-01-10,20,Monday,1,6,0
1480639690978045959,2022-01-10 20:36:25,"Mitratel, perusahaan infrastruktur telekomunikasi, membidik untuk melakukan aksi korporasi merger dan akuisisi aset menara dari Telkomsel di tahun 2022. https://t.co/mvAadMgxR9",2,0,1,0,2022-01-10,20,Monday,1,3,0
1480638708995051521,2022-01-10 20:32:31,"Paris St. Germain dikritik tajam setelah cuma berimbang 1-1 di markas Lyon. Eks pelatih timnas Prancis Raymond Domenech membela, sembari menyeret Real Madrid. https://t.co/OdTrdG4OFv",4,0,0,0,2022-01-10,20,Monday,1,4,0
1480637935951220742,2022-01-10 20:29:27,Bareskrim Polri menahan dan menjadikan Ferdinand Hutahaean tersangka di kasus cuitan. Polri mempersilakan Ferdinand apabila ingin mengajukan praperadilan. https://t.co/F1pzSv7o9c,13,5,5,3,2022-01-10,20,Monday,1,18,8
1480637150928543756,2022-01-10 20:26:20,"#FOTO Kerusuhan di Kazakhstan semakin parah. Sejumlah mobil hangus terbakar, ratusan orang dilaporkan tewas. Gara-gara harga BBM dan LPG naik. https://t.co/QNr6rzYrr6",7,1,0,1,2022-01-10,20,Monday,1,7,2
1480635356458459139,2022-01-10 20:19:12,Nenek berusia 76 tahun di Sulsel ditemukan tewas akibat kebakaran dua unit rumah. Bagaimana kejadiannya? https://t.co/sJeREMJzHp,3,1,0,0,2022-01-10,20,Monday,1,3,1
1480634285765844997,2022-01-10 20:14:57,"Klay Thompson akhirnya main lagi di NBA. Comeback-nya terbilang indah, bawa Golden State Warriors kalahkan Cleveland Cavaliers. https://t.co/mSWiptt4su",2,0,1,0,2022-01-10,20,Monday,1,3,0
1480632769856380933,2022-01-10 20:08:55,"Bukan mobil listrik full baterai yang diincar, rupanya banyak masyarakat Amerika Serikat yang berburu mobil hybrid. Ternyata ini alasannya:  https://t.co/7wyYEoElWj",5,1,0,0,2022-01-10,20,Monday,1,5,1
1480631927765929987,2022-01-10 20:05:35,OPPO Find X3 Pro 5G dilengkapi fitur fotografi terkini yang dapat menghadirkan perspektif berbeda melalui teknologi Microlens. https://t.co/zP60PzaoUs,4,0,1,0,2022-01-10,20,Monday,1,5,0
1480630606824448005,2022-01-10 20:00:20,"Dying Light 2 Stay Human dikonfirmasi bahwa dibutuhkan waktu hingga 500 jam atau sekitar 20 hari, jika ingin menyelesaikan game ini hingga 100%. https://t.co/it2xNEoCdN",4,0,0,0,2022-01-10,20,Monday,1,4,0
1480629837161189379,2022-01-10 19:57:16,Apakah lubang hitam bisa membuat kita berpindah tempat? Studi terbaru mencoba mengungkapnya. https://t.co/D8301TMP9l,5,0,1,0,2022-01-10,19,Monday,1,6,0
1480628271947595782,2022-01-10 19:51:03,BPOM telah meresmikan 5 jenis vaksin COVID-19 sebagai booster atau dosis tambahan. Ahli menyebut booster bisa bermanfaat kurangi risiko gejala Omicron. https://t.co/GW8BJGrw1H,2,1,2,0,2022-01-10,19,Monday,1,4,1
1480626869515038732,2022-01-10 19:45:29,"Warga masih mengeluhkan persoalan air PAM di lingkungannya. Selain masalah bau seperti bangkai di air itu, aliran air PAM juga tidak deras alias letoi. #detikcomdoyourmagic https://t.co/DyRsiXtUeW",2,0,0,1,2022-01-10,19,Monday,1,2,1
1480625727636705281,2022-01-10 19:40:56,Bahlil Lahadalia menyuarakan wacana dari kaum pengusaha: Pilpres 2024 mundur ke 2027. Kepentingan ekonomi-politik ditengarai ada di balik wacana ini. https://t.co/7dpNqKn42j,8,12,1,5,2022-01-10,19,Monday,1,9,17
1480624660513492995,2022-01-10 19:36:42,"Menkes menyebut Indonesia akan menghadapi gelombang Omicron. Meski harus tetap waspada, Menkes mengingatkan masyarakat untuk tidak perlu panik. https://t.co/IYrBR9EtXo",5,2,4,0,2022-01-10,19,Monday,1,9,2
1480623430898696199,2022-01-10 19:31:49,"Dari jajaran prosesor Intel generasi ke-12 Alder Lake, terselip satu seri prosesor yang bisa clock speed-nya bisa digeber sampai 5,5 GHz. https://t.co/US2RofHyvi",5,1,1,0,2022-01-10,19,Monday,1,6,1
1480622599596294144,2022-01-10 19:28:31,"Jae eks DAY6 tengah menjadi sorotan usai mengucapkan hal tidak pantas kepada Jamie. Rupanya sebelum kejadian tersebut, Jae sudah kerap melontarkan kata-kata yang menjadi kontroversi. Berikut rangkumannya... https://t.co/R8AvygWxOz",4,1,0,0,2022-01-10,19,Monday,1,4,1
1480621867073482760,2022-01-10 19:25:36,"Maroko dan Guinea sama-sama membuka Piala Afrika 2021 dengan tiga poin. Maroko mengalahkan Ghana dengan skor 1-0, demikian juga Guinea atas Malawi. https://t.co/EHuFHoNPD2",4,0,1,0,2022-01-10,19,Monday,1,5,0
1480621356496703489,2022-01-10 19:23:34,Kepala BPOM Penny K Lukito menyetujui 5 jenis vaksin yang dipergunakan untuk booster COVID-19. Bagaimana dengan efek sampingnya? Simak penjelasannya: https://t.co/tklWZdHrhm,9,3,2,0,2022-01-10,19,Monday,1,11,3
1480620082044801029,2022-01-10 19:18:30,"BPOM keluarkan izin darurat 5 vaksin COVID-19 sebagai booster, bakal seefektif apa melawan varian Omicron? Begini jawaban BPOM: https://t.co/mFVihNTBNI",5,0,0,0,2022-01-10,19,Monday,1,5,0
1480619572088692742,2022-01-10 19:16:29,Polri menjerat Ferdinand Hutahaean dengan pasal membuat keonaran di masyarakat. Ferdinand Hutahaean terancam hukuman penjara 10 tahun. https://t.co/MQBN6cQSMQ,32,8,8,5,2022-01-10,19,Monday,1,40,13
1480619226574512128,2022-01-10 19:15:06,RW di Krukut micro lockdown usai ditemukan 1 warga suspek Corona varian Omicron. Ini sederet faktanya. https://t.co/e2nWPGa6Pe,6,0,0,2,2022-01-10,19,Monday,1,6,2
1480617962474250241,2022-01-10 19:10:05,Petugas cleaning service di Bandara Kualanamu menemukan 97 gram emas di kamar mandi. Belum diketahui pemilik emas tersebut. https://t.co/U7JJa5xZTF,7,0,1,1,2022-01-10,19,Monday,1,8,1
1480616726958166018,2022-01-10 19:05:10,Valve baru saja mengungkapkan rekor baru. Sebanyak 28.230.853 gamer online secara bersamaan. Angka tersebut meningkat bila dibandingkan tahun sebelumnya. https://t.co/mXIx0fV9NJ,6,0,1,1,2022-01-10,19,Monday,1,7,1
1480615780626616321,2022-01-10 19:01:25,Polisi mengungkap tampang kedua pelaku yang telah mengenakan baju tahanan. Seperti apa? https://t.co/rqc1ELR8au,14,2,1,2,2022-01-10,19,Monday,1,15,4
1480614792712830979,2022-01-10 18:57:29,Hasil survei Indikator Politik Indonesia (IPI) menunjukkan masyarakat setuju pemberian hukuman mati kepada koruptor kelas kakap. https://t.co/ix9EPl46sv,171,20,30,6,2022-01-10,18,Monday,1,201,26
1480613683004940295,2022-01-10 18:53:05,Panglima TNI Jenderal TNI Andika Perkasa mengatakan ada perubahan pada Satgas daerah rawan serta pengamanan pulau terluar untuk wilayah Maluku dan Maluku Utara. https://t.co/U3621Aj5Le,1,0,1,0,2022-01-10,18,Monday,1,2,0
1480612800460464128,2022-01-10 18:49:34,Masih ingat free kick unik dari sebuah laga sepakbola level SMA di Jepang? Di ajang itu ada pula eksekusi penalti yang butuh 30 penalti sampai bola disepak! https://t.co/ohmal4Yn6k,7,1,1,0,2022-01-10,18,Monday,1,8,1
1480611727511375876,2022-01-10 18:45:18,"Sebuah bom meledak di sebuah perguruan tinggi di Quetta, Balochistan, Pakistan pada Kamis (30/12). Ledakan tersebut menewaskan 4 orang dan sedikitnya 15 orang luka-luka. https://t.co/dfJnA6OL4M",0,0,2,0,2022-01-10,18,Monday,1,2,0
1480610503433109510,2022-01-10 18:40:27,Gubernur Sumut Edy Rahmayadi meminta warga ikut membantu pembangunan Sumut. Edy mengatakan tidak mungkin harus meminta bantuan Gubernur DKI Anies Baswedan https://t.co/aYytVMzba4,23,36,5,3,2022-01-10,18,Monday,1,28,39
1480609096982269959,2022-01-10 18:34:51,Mobil modifikasi BMW M2 berjuluk The Beast dan modifikasi Porsche Cayman 'CRK' yang membintangi film Crazy Fast Indonesian menjadi jawara kontes modifikasi. https://t.co/Y8rUdWVyX0,3,0,0,0,2022-01-10,18,Monday,1,3,0
1480608002042482692,2022-01-10 18:30:30,"Dosen Unesa diduga melakukan pelecehan seksual pada mahasiswinya. Hingga saat ini, ada 3 mahasiswi yang melapor ke kampus. https://t.co/yZ8vb4N3pY",20,1,8,4,2022-01-10,18,Monday,1,28,5
1480606712180707336,2022-01-10 18:25:23,"Dua pelaku pengedar sabu asal China berhasil ditangkap saat hendak mengedarkan sabu di Pamulang, Tangerang Selatan. Polisi lakukan penggrebekan pada Selasa (4/1). Satu pelaku tewas usai ditembak polisi saat hendak melawan. https://t.co/peBTVZppqu",4,1,0,1,2022-01-10,18,Monday,1,4,2
1480605905771282433,2022-01-10 18:22:10,Wilman Vil menjadi satu-satunya korban selamat dalam serangan geng bersenjata yang menewaskan dua jurnalis di Haiti. Bagaimana kisahnya? https://t.co/pNO1luRTpv,13,0,2,0,2022-01-10,18,Monday,1,15,0
1480605674992287753,2022-01-10 18:21:15,Ferdinand Hutahaean ditetapkan sebagai tersangka atas cuitan 'Allahmu ternyata lemah'. Ferdinand dijerat pasal tentang membuat keonaran di masyarakat. https://t.co/a3mLDIAYHT,15,5,8,8,2022-01-10,18,Monday,1,23,13
1480604938518646790,2022-01-10 18:18:20,Kecelakaan beruntun melibatkan tiga truk di KM 27 Tol Tangerang-Merak arah Merak menewaskan dua orang. Belum diketahui penyebab kecelakaan maut ini. https://t.co/94XZxKhxfW,2,0,2,0,2022-01-10,18,Monday,1,4,0
1480604923305811968,2022-01-10 18:18:16,"Polisi mengungkap jejak kriminal E, tersangka pemerkosaan anak berusia 9 tahun di Setiabudi. Tersangka E diduga pernah melakukan aksi yang sama 3 tahun silam. https://t.co/Od6ff72kz4",1,1,1,0,2022-01-10,18,Monday,1,2,1
1480603884406157320,2022-01-10 18:14:08,Pemilik rumah sempat menjerat ular sepanjang empat meter itu. Begini penampakannya! https://t.co/p7rdwDor5N,2,0,1,0,2022-01-10,18,Monday,1,3,0
1480603024653529089,2022-01-10 18:10:44,"Baru-baru ini, ilmuwan mengidentifikasi adanya varian baru yang dijuluki 'Deltacron'. Para ilmuwan pun mengungkap sumber kemunculan pertama dari varian ini. https://t.co/uJjZ1LT7Me",7,6,10,6,2022-01-10,18,Monday,1,17,12
1480602035074605061,2022-01-10 18:06:48,"Ketua Komisi Pemberantasan Korupsi (KPK) Firli Bahuri menyampaikan serapan anggaran KPK pada tahun 2021 mencapai 95,7%. Ia pun kemudian menyebut anggaran KPK tahun 2022 naik Rp 300 miliar dari tahun 2021 menjadi Rp 1,3 triliun. https://t.co/FqwAM8TUxX",2,0,0,0,2022-01-10,18,Monday,1,2,0
1480600996472659971,2022-01-10 18:02:40,"Polda Metro Jaya mengungkap kronologi penggerebekan terhadap dua pengedar sabu di Pamulang, Tangerang Selatan (4/1). Terjadi baku tembak saat penggerebekan yang menewaskan satu pelaku. https://t.co/HnzbNJjfb7",6,0,0,0,2022-01-10,18,Monday,1,6,0
1480600029026992139,2022-01-10 17:58:49,Polisi bekuk pria inisial TT usai membuat komentar tidak pangkat terkait meninggalnya Ketua MUI Kabupaten Sukabumi Kh A. Komarudin. Komentar TT kemudian viral dan mendapat hujatan dari warganet. Ia pun dibekuk polisi. https://t.co/K5iPvt2xLH,1,1,1,1,2022-01-10,17,Monday,1,2,2
1480599035547369479,2022-01-10 17:54:52,Korea Selatan memang sudah buka pintu perjalanan ke beberapa negara. Namun warganya belum boleh traveling ke negara-negara ini. https://t.co/kJEujomnzT,5,0,0,0,2022-01-10,17,Monday,1,5,0
1480598245105668105,2022-01-10 17:51:44,"Mercedes-Benz E 300 AMG Line rakitan Wanaherang hadir sebagai versi facelift dari pendahulunya, sehingga praktis masih menggendong mesin dan platform yang sama. Lantas, seberapa irit Mercy E Class terbaru ini? https://t.co/PQiQTc7Rr2",5,0,1,1,2022-01-10,17,Monday,1,6,1
1480597186874429442,2022-01-10 17:47:32,Petenis nomor satu dunia Novak Djokovic bisa bernapas lega. Djokovic bebas bermain di Australia Terbuka 2022 usai memenangi banding atas kasus pembatalan visa. https://t.co/RxpFjDvyBG,5,0,0,0,2022-01-10,17,Monday,1,5,0
1480596417093775363,2022-01-10 17:44:28,"BPOM resmi menerbitkan izin penggunaan 5 jenis vaksin Covid-19 untuk booster. Dengan syarat pemakaiannya, calon penerima berusia 18 tahun keatas dan telah mendapatkan vaksin primer sejak 6 bulan lalu https://t.co/2AavNb5ULP",6,0,1,0,2022-01-10,17,Monday,1,7,0
1480596092681129991,2022-01-10 17:43:11,"Iran mempamerkan tiga rudal balistik di lapangan pusat kota Teheran, Iran setelah pembahasan perjanjian nuklir Teheran di Wina temui jalan buntu. Pameran ini juga menandai dua tahun serangan rudal balistik Iran menarget pangkalan Amerika di Irak. https://t.co/ScTtsntwVl",5,1,0,1,2022-01-10,17,Monday,1,5,2
1480595241774292999,2022-01-10 17:39:48,"Menurut pihak kepolisian, tidak masalah jika mobil pribadi menggunakan roof box. Asal... https://t.co/H7S0ZrNBlC",6,0,0,0,2022-01-10,17,Monday,1,6,0
1480594497373446144,2022-01-10 17:36:50,Pak Ogah yang terbaring sakit sempat tidak mau berobat ke Rumah Sakit karena belum membayar BPJS selama 4 tahun. #PakOgah  https://t.co/f29dD7TZj2,70,1,27,5,2022-01-10,17,Monday,1,97,6
1480593744076365827,2022-01-10 17:33:51,Salah satu benteng untuk mencegah masuknya varian Omicron ke Indonesia adalah karantina. Satgas COVID-19 sudah menyiapkan beberapa hotel yang bisa jadi pilihan. https://t.co/EqxsQ3osDN,3,0,1,1,2022-01-10,17,Monday,1,4,1
1480592500767264771,2022-01-10 17:28:54,Momen sapaan dan keakraban Megawati kepada Ahok ini juga sudah pernah terjadi beberapa kali sebelumnya. Berikut momen-momennya: https://t.co/IpOBXscGp5,10,0,2,0,2022-01-10,17,Monday,1,12,0
1480591833365458948,2022-01-10 17:26:15,"Pada masanya dulu, iPhone ini sejatinya punya semua modal untuk jadi smartphone sempurna nan fenomenal. Sial, perangkat ini malah tersandung persoalan besar:  https://t.co/o4xn6fldJM",2,0,1,0,2022-01-10,17,Monday,1,3,0
1480590818079608837,2022-01-10 17:22:13,Artis Ashanty dikabarkan terinfeksi Omicron usai liburan dari Turki. Menparekraf Sandiaga Uno minta masyarakat tak liburan ke luar negeri. https://t.co/9Hest1ggOf,8,2,2,2,2022-01-10,17,Monday,1,10,4
1480588520364417024,2022-01-10 17:13:05,BPOM telah mengeluarkan izin darurat pemberian vaksin booster COVID-19. Vaksin Merah Putih rencananya akan digunakan begitu uji klinis selesai. https://t.co/1Xueczrrdr,6,0,1,0,2022-01-10,17,Monday,1,7,0
1480587634565128196,2022-01-10 17:09:34,"Sekitar 600 pejuang Taliban mengikuti parade militer di Kabul, Afghanistan pada Minggu (9/1) merayakan kelulusan mereka. Terdapat juga kendaraan tempur dan helikopter meramaikan pawai pasukan Taliban yang terlihat modern. https://t.co/KmgJgfSzTS",8,0,1,0,2022-01-10,17,Monday,1,9,0
1480586274897551361,2022-01-10 17:04:10,Polisi menahan Ferdinand Hutahaean sebagai tersangka kasus cuitan 'Allahmu ternyata lemah'. Berdasarkan hasil pemeriksaan dokter menyebut Ferdinand bisa ditahan https://t.co/9KDe2GtNCI,51,10,16,3,2022-01-10,17,Monday,1,67,13
1480585718288334862,2022-01-10 17:01:57,"Dosen Universitas Negeri Jakarta (UNJ), Ubedillah Badrun melaporkan Wali Kota Solo, Gibran Rakabuming Raka dan adiknya Kaesang Pangarep ke KPK. Gibran pun mengaku siap diperiksa jika salah. https://t.co/ypftGVZ1oH",18,3,2,2,2022-01-10,17,Monday,1,20,5
1480584284054372361,2022-01-10 16:56:15,BPOM menyetujui 5 vaksin COVID-19 untuk booster di Indonesia. Salah satu alasan pemberian booster adalah menurunnya antibodi setelah pemberian vaksinasi primer. https://t.co/f0HIhTACdo,3,2,1,1,2022-01-10,16,Monday,1,4,3
1480582954636115969,2022-01-10 16:50:58,"Terserah mau bilang aku pelit, yang pasti buat aku gadget itu lebih banyak enggak bagusnya untuk anak di bawah umur. Eh tapi enggak nyangka hasilnya malah gini. #detikNetwork  https://t.co/M4bjmNIfa1",5,1,0,0,2022-01-10,16,Monday,1,5,1
1480582468579246085,2022-01-10 16:49:03,Polisi menetapkan Ferdinand Hutahaean sebagai tersangka terkait kasus cuitan 'Allahmu ternyata lemah'. Ferdinand lalu ditahan polisi. https://t.co/NOygbCuonR,376,109,65,31,2022-01-10,16,Monday,1,441,140
1480582451860750339,2022-01-10 16:48:59,"Investasi forex menjadi salah satu jenis investasi yang memiliki ROI atau return of investment yang tinggi, tapi hati-hati penipuan ya! https://t.co/TarKIanu4w",6,1,3,0,2022-01-10,16,Monday,1,9,1
1480581939455275009,2022-01-10 16:46:56,"Teka-teki berikut akan menguji apakah mata dan pikiran kamu masih fokus atau malah sudah buyar. Yuk coba! Kalau gagal, tandanya butuh tidur cepat. https://t.co/7cSNQYK4Zc",1,3,0,0,2022-01-10,16,Monday,1,1,3
1480581176398163968,2022-01-10 16:43:54,"Setelah Delmicron, dunia kembali digegerkan dengan penemuan varian COVID-19 terbaru bernama Deltacron oleh seorang ilmuwan di siprus. Beneran ada nggak sih? https://t.co/BwhZyENN9s",4,3,2,1,2022-01-10,16,Monday,1,6,4
1480580670728687616,2022-01-10 16:41:54,Seorang suami mendukung penuh istrinya yang sedang diet. Ia memberikan hadiah cincin berlian usai sang istri berhasil menurunkan berat badan hingga 75 kilogram. https://t.co/RwjYn2ez2z,12,0,2,1,2022-01-10,16,Monday,1,14,1
1480580148084846595,2022-01-10 16:39:49,"WNA asal AS, Matthew J Martin mengeluh soal kondisi hotel karantina yang tidak layak. Sekjen PHRI, Maulana Yusran menyebut bahwa itu adalah hotel isolasi. https://t.co/uJxmwrt0V9",6,0,2,1,2022-01-10,16,Monday,1,8,1
1480579033582743552,2022-01-10 16:35:24,"Jadi fitur utama membeli makanan. Aplikasi makanan online kini memiliki rating ampuh, yang buat banyak penjual makanan kaki lima memiliki banyak pelanggan baru. https://t.co/0Rczq9fwFF",3,0,0,0,2022-01-10,16,Monday,1,3,0
1480578550747082755,2022-01-10 16:33:28,"Ayu Aulia mengaku sudah bertemu keluarga besar Zikri Daulay untuk meminta maaf atas viral video ciuman keduanya. Atas kejadian tersebut, Ayu menyebut keluarga Zikri menyarankan lebih baik menikahkan keduanya demi menghindari fitnah dan zina. https://t.co/vFG6iNR84r",6,1,0,0,2022-01-10,16,Monday,1,6,1
1480577556281798658,2022-01-10 16:29:31,Genap sudah satu tahun insiden jatuhnya pesawat SJ-182. Tabur bunga dilakukan untuk mengenang para korban. https://t.co/48QHRaBWLI,13,0,6,0,2022-01-10,16,Monday,1,19,0
1480576732700815360,2022-01-10 16:26:15,Rumah milik Ulung (38) hancur akibat ledakan. Lelaki tersebut tewas di tempat saat peristiwa maut itu terjadi. https://t.co/x22sh5G8J9,16,0,3,0,2022-01-10,16,Monday,1,19,0
1480575962085572616,2022-01-10 16:23:11,"LRT Jabodebek tengah diujicoba. Kereta LRT terlihat melintas di Jalan Gatoto Subroto dan melewati flyover lengkung Kuningan, Jakarta Selatan, Senin (10/1). https://t.co/saCJCnBQnA",23,3,0,1,2022-01-10,16,Monday,1,23,4
1480575438779039749,2022-01-10 16:21:07,Wakil Bupati Nonaktif OKU Johan Anuar terdakwa kasus dugaan korupsi tanah kuburan meninggal dunia. Johan berjuang melawan sakit kanker beberapa bulan terakhir. https://t.co/SRz7fI8QNc,11,6,1,0,2022-01-10,16,Monday,1,12,6
1480573708930633735,2022-01-10 16:14:14,"BMKG mengeluarkan peringatan dini cuaca di wilayah Jabodetabek. Hingga pukul 01.30 WIB, Jabodetabek berpotensi dilanda hujan disertai petir. https://t.co/low3H24l2u",17,0,6,2,2022-01-10,16,Monday,1,23,2
1480573188547428360,2022-01-10 16:12:10,Masyarakat antusias untuk menonton ajang balap motor MotoGP Mandalika. Ini dibuktikan dengan pemesanan kamar hotel yang tinggi. https://t.co/qg5YsmCcaa,6,0,0,0,2022-01-10,16,Monday,1,6,0
1480572297215975425,2022-01-10 16:08:38,"Ditraktir makan teman memang paling asyik. Namun jangan salah menyikapi, begini etika yang baik saat ditraktir makan teman. https://t.co/9qra3vAKNj",17,3,4,1,2022-01-10,16,Monday,1,21,4
1480571393574117386,2022-01-10 16:05:02,Emas merupakan komoditas berharga simbol kekayaan dan kemewahan di hampir setiap budaya manusia. Yuk intip potret pekerja tambang emas antam di Gunung Pongkor. https://t.co/lyOwN3EOKc,10,0,0,0,2022-01-10,16,Monday,1,10,0
1480570472802750465,2022-01-10 16:01:23,"Menko Marves, Luhut Binsar Pandjaitan, mengapresiasi kepala daerah yang telah meningkatkan jumlah testing dan tracing dalam seminggu terakhir. Luhut menyebut selama Januari, hanya ada satu kasus kematian terkait Covid-19 di Jakarta. https://t.co/TIFperw1Dv",4,0,0,0,2022-01-10,16,Monday,1,4,0
1480570204866424837,2022-01-10 16:00:19,"Dalam nota pembelaannya yang dibacakan di sidang laka lantas pada Senin (10/1), Gaga Muhammad mengaku telah merasa dipenjara rasa bersalah sejak tragedi kecalakaan tahun 2019 lalu yang menyebabkan Laura Anna lumpuh. https://t.co/eKolRAgVGf",4,1,0,1,2022-01-10,16,Monday,1,4,2
1480569417364688897,2022-01-10 15:57:11,"Seiring merebaknya Omicron, RI sempat dikhawatirkan bakal diterpa gelombang-3 COVID-19 pasca Nataru. Epidemiolog optimistis hal tersebut bisa ditangkal, kenapa? https://t.co/CWf6MywvrX",5,2,2,1,2022-01-10,15,Monday,1,7,3
1480568545067077638,2022-01-10 15:53:43,BPOM memberikan izin penggunaan darurat pada 5 jenis vaksin COVID-19 untuk booster atau dosis ketiga. Ada yang bersifat homolog dan juga heterolog. Ini bedanya: https://t.co/uGjUPv3vBX,6,0,2,0,2022-01-10,15,Monday,1,8,0
1480566573681324041,2022-01-10 15:45:53,"Usai meminjamkan Jabar Sharza ke Persiraja Banda Aceh, Persela Lamongan mendatangkan Selwan Al-Jaberi. Selwan adalah pemain asing Persela berpaspor Irak. https://t.co/x18e82u6iN",8,0,0,0,2022-01-10,15,Monday,1,8,0
1480564717525610501,2022-01-10 15:38:30,Bentrokan antara dua kelompok warga pecah di Papua. Bentrokan itu memakan korban jiwa. https://t.co/gkbl3vfjMH,7,0,2,0,2022-01-10,15,Monday,1,9,0
1480563909308395521,2022-01-10 15:35:18,Kepala BPOM RI Penny K Lukito angkat bicara soal wacana vaksin Nusantara bakal jadi booster. Ia menegaskan vaksin tersebut merupakan vaksin terapi. https://t.co/j2JnpbCJP7,6,1,3,0,2022-01-10,15,Monday,1,9,1
1480562799902433285,2022-01-10 15:30:53,Ashanty positif Covid-19 pulang dari Turki menuai pro dan kontra netizen. Krisdayanti pun memberikan dukungan untuk Ashanty agar tak menghiraukan hal itu dan lebih fokus untuk sembuh. https://t.co/P8Pwhvbwwz,9,1,2,1,2022-01-10,15,Monday,1,11,2
1480562228948520960,2022-01-10 15:28:37,"Bos MNC Group Hary Tanoesoedibjo belum lama ini makan malam bersama Presiden ke-45 Amerika Serikat (AS), Donald Trump. Begini momennya: https://t.co/pywespWSVs",30,2,4,0,2022-01-10,15,Monday,1,34,2
1480561045559296008,2022-01-10 15:23:55,"Ilmuwan China menerbitkan hasil deteksi in-situ dari sinyal air di Bulan lewat misi Change-5. Studi ini diterbitkan di jurnal peer-review Science Advance, Sabtu (8/1). Berikut hasil temuannya! https://t.co/urlQiregeL",4,0,2,0,2022-01-10,15,Monday,1,6,0
1480560690041606153,2022-01-10 15:22:30,"Keji aksi 2 sekuriti di Sumatera Selatan, Fen Efendi (39) dan Arianto (24). Keduanya memerkosa wanita berinisial TS (42) setelah menuding korban mencuri sawit. https://t.co/tEhW9Vgd14",9,2,1,1,2022-01-10,15,Monday,1,10,3
1480559763863789569,2022-01-10 15:18:49,NJOP ini adalah harga rata-rata yang diperoleh dari transaksi jual beli yang terjadi secara wajar. Lalu berapa harga tanah paling murah di Jakarta berdasarkan NJOP? https://t.co/JOdzuRKvcK,21,1,8,2,2022-01-10,15,Monday,1,29,3
1480559739046342657,2022-01-10 15:18:43,"Satgas transisi erupsi Semeru kembali menemukan satu jenazah korban erupsi. Korban ditemukan di lokasi pertambangan pasir di Desa Sumber Wuluh, Candipuro. https://t.co/lpzKC0qscd",7,0,1,0,2022-01-10,15,Monday,1,8,0
1480559209150357510,2022-01-10 15:16:37,"Pada masanya, BlackBerry digandrungi salah satunya karena keyboard fisik. Di kemudian hari, justru keyboard itu yang dinilai menjadi penyebab keruntuhannya. https://t.co/0uEi7uXwhz",14,4,10,3,2022-01-10,15,Monday,1,24,7
1480558189099814919,2022-01-10 15:12:34,"Dua anak Presiden, Gibran Rakabuming Raka dan Kaesang Pangarep dilaporkan ke KPK oleh Dosen UNJ, Ubedilah Badrun. Laporan itu diklaim berkaitan dengan KKN relasi bisnis Gibran dan Kaesang dengan grup bisnis yang diduga terlibat pembakaran hutan. https://t.co/wIc3lM39b2",68,27,15,5,2022-01-10,15,Monday,1,83,32
1480557280760410113,2022-01-10 15:08:57,Aksi kejahatan cyber kembali menerpa dunia cryptocurrency. Tak tanggung-tanggung peretasan yang dilakukan membuat rugi para investor kripto hingga US$ 200 juta. https://t.co/uA2gTfuPta,39,3,13,3,2022-01-10,15,Monday,1,52,6
1480556490750672896,2022-01-10 15:05:49,"#FOTO Janganlah cepat percaya dan terhasut dengan foto-foto viral yang beredar di dunia maya, seperti kumpulan foto ini yang sempat bikin geger dunia. https://t.co/TMRY6ARRL5",11,0,1,0,2022-01-10,15,Monday,1,12,0
1480554499026694154,2022-01-10 14:57:54,Smoothie buah-buahan bisa menjadi pilihan menu sarapan sehat. Cara membuatnya mudah dengan menyontek resep ala Chef Eddrian Tjhia. https://t.co/79qriLO68D,10,0,6,2,2022-01-10,14,Monday,1,16,2
1480554473797959686,2022-01-10 14:57:48,Mahasiswa asal Sulut meninggal misterius di Kanada. Pihak keluarga menunggu hasil identifikasi sebelum bisa dibawa pulang ke Indonesia. https://t.co/zTeAZQyuap,7,0,4,0,2022-01-10,14,Monday,1,11,0
1480553620278071298,2022-01-10 14:54:25,"Bilqis, anak Ayu Ting Ting, ikut-ikutan ibunya yang suka dengan BTS. Kini, ia resmi menjadi seorang Army.  https://t.co/yjswvksx7G",9,3,1,5,2022-01-10,14,Monday,1,10,8
1480553333681184776,2022-01-10 14:53:16,"Jalan rusak di Desa Bulurejo, Juwiring, Klaten, yang viral di media sosial dicek oleh polisi pada Senin (10/1/2022). Ternyata, gambarnya sudah diganti. https://t.co/tk21Pjp5ai",7,1,0,0,2022-01-10,14,Monday,1,7,1
1480552557684703238,2022-01-10 14:50:11,"Samuel Balinsa gagal memperkuat klub Liga 2 Thailand, Lampang FC. Pihak klub dan PSSI menjelaskan masalahnya. https://t.co/vfCesy4S3D",9,0,0,0,2022-01-10,14,Monday,1,9,0
1480551666650959883,2022-01-10 14:46:39,Ledakan dahsyat memorakporandakan rumah warga di Pandeglang. Polisi masih menyelidiki sumber penyebab ledakan mematikan tersebut. https://t.co/2x5dRmMFFo,9,0,1,0,2022-01-10,14,Monday,1,10,0
1480550657715322881,2022-01-10 14:42:38,"Hanya segelintir orang lalu-lalang di jalanan, banyak yang terlalu takut meninggalkan rumah. #Kazakhstan https://t.co/36d6SuVtdj",11,0,3,0,2022-01-10,14,Monday,1,14,0
1480549577489068037,2022-01-10 14:38:21,"Kaget lihat tagihan makannya di salah satu restoran mewah mencapai harga Rp 19,5 juta. Fuji berhasil membuat netizen heboh. https://t.co/p8PoIlqZyR",7,2,0,1,2022-01-10,14,Monday,1,7,3
1480549234680254465,2022-01-10 14:36:59,Pria membuang dan menendang sesajen di lokasi erupsi Semeru viral. Siapa sebenarnya yang meletakkan sesajen tersebut di lokasi? https://t.co/apQhteFzn3,15,12,2,0,2022-01-10,14,Monday,1,17,12
1480548591919939591,2022-01-10 14:34:26,Krisdayanti menyebut Aurel Hermansyah sempat mengeluh capek saat akan pulang dari Turki. KD pun hanya menyarankan anaknya untuk istirahat total. https://t.co/3avRcLJhUM,8,4,1,1,2022-01-10,14,Monday,1,9,5
1480545729303269386,2022-01-10 14:23:03,"Sebuah apartemen di Bronx, New York City (NYC), AS, kebakaran dan menewaskan 19 orang, termasuk 9 anak-anak. Penyebab kebakaran diduga berasal dari pemanas listrik yang tidak berfungsi. https://t.co/EuCH0sUGJf",6,0,1,0,2022-01-10,14,Monday,1,7,0
1480545710420672513,2022-01-10 14:22:59,Beragam peristiwa terjadi di Jawa Barat dan Banten hari ini. Heboh Wabup Bandung Sahrul Gunawan berjaket Golkar hingga ledakan bom maut di Pandeglang. https://t.co/pSix28JrSy,8,0,0,0,2022-01-10,14,Monday,1,8,0
1480544659780866049,2022-01-10 14:18:48,"Ada begitu banyak hotel di dunia, tapi mana yang paling sering bikin heboh Instagram karena keindahannya? Berikut 5 hotel terbaik di Asia yang ada di Bali: https://t.co/MTT1G6mcLZ",9,0,0,0,2022-01-10,14,Monday,1,9,0
1480544634870902788,2022-01-10 14:18:42,"Pemerintah terus melakukan evaluasi PPKM wilayah Jawa-Bali dan luar Jawa-Bali. Terlebih di minggu ini, kasus aktif mengalami peningkatan di beberapa wilayah. https://t.co/hKXAfWtyMI",5,0,1,0,2022-01-10,14,Monday,1,6,0
1480543183616491522,2022-01-10 14:12:56,Wakil Bupati Nonaktif Kabupaten OKU Johan Anuar meninggal dunia. Johan wafat dengan status sebagai terdakwa kasus dugaan korupsi tanah kuburan. https://t.co/5BJDAiYXPe,30,19,7,3,2022-01-10,14,Monday,1,37,22
1480542551555907588,2022-01-10 14:10:26,"Bumi Perkemahan Bedengan Selorejo, Malang, Jawa Timur menjadi salah satu tempat kemping sip buat akhir pekan. Wisata alam itu selalu ramai. https://t.co/5l5Tv7klGs",10,0,2,0,2022-01-10,14,Monday,1,12,0
1480542294801621010,2022-01-10 14:09:24,"Satu lagi destinasi wisata baru di Kabupaten Magelang yang patut dikunjungi. Bernama Borobudur Edupark, wisatawan bisa belajar memahat di sini. https://t.co/TEVumZXyF8",9,0,1,0,2022-01-10,14,Monday,1,10,0
1480541209999429639,2022-01-10 14:05:06,"Kim Yohan tak hanya dikenal sebagai idol, tetapi juga aktor. Ia mengaku awalnya tidak terlalu tertarik dengan dunia akting. Simak wawancara eksklusifnya di sini: #KimYohan  https://t.co/MJPm5g6ReF",162,0,75,1,2022-01-10,14,Monday,1,237,1
1480540356332695556,2022-01-10 14:01:42,"Di Sembalun ada banyak sapi. Bukan sapi biasa, inilah sapi gunung yang sangat unik. https://t.co/TDfSnNKiJ7",13,0,5,1,2022-01-10,14,Monday,1,18,1
1480539737974882315,2022-01-10 13:59:15,Gaga Muhammad membacakan pledoi di persidangan kasus kecelakaan yang membuat Laura Anna lumpuh. Ia menyinggung Laura yang lalai dan minta dihukum ringan. https://t.co/haRKa6yMYy,145,92,24,42,2022-01-10,13,Monday,1,169,134
1480539175531298823,2022-01-10 13:57:01,"Pandemi COVID-19 berdampak pada banyak sektor. Salah satunya jasa penyewaan private jet, yang malah meningkat di tahun 2021 lalu. https://t.co/u3MMC57yJt",14,1,1,1,2022-01-10,13,Monday,1,15,2
1480538899743133700,2022-01-10 13:55:55,"Dahlan mengatakan, ada anggota DPR meminta tunjangan hari raya (THR) ketika dirinya menjabat Direktur Utama PLN. https://t.co/1WBz744lNP",9,1,3,2,2022-01-10,13,Monday,1,12,3
1480537384110510095,2022-01-10 13:49:54,Gubernur Khofifah datang ke Jember mengunjungi warga terdampak banjir. Khofifah mengingatkan pentingnya tidak membuang sampah sembarangan. https://t.co/nnna2msOMK,14,2,1,0,2022-01-10,13,Monday,1,15,2
1480537111707140105,2022-01-10 13:48:49,"Gempa bumi magnitudo (M) 6,9 yang terjadi di Provinsi Qinghai, China, mengakibatkan runtuhnya sebagian Tembok Besar (Great Wall). https://t.co/VEaRMMYFHF",57,4,26,2,2022-01-10,13,Monday,1,83,6
1480536008173268992,2022-01-10 13:44:26,"Jembatan Cinta di Desa Mekarbuana, Tegalwaru, Karawang, Jawa Barat menjadi primadona warga lokal di akhir pekan. Penasaran? https://t.co/0NJfHx6NZx",14,0,1,0,2022-01-10,13,Monday,1,15,0
1480535255257866241,2022-01-10 13:41:26,Mantan ilmuwan NASA mengungkap rencananya untuk mengubah Mars jadi planet yang bisa dihuni oleh manusia. Ini caranya:  https://t.co/XCRcZ7MIRh,20,4,5,2,2022-01-10,13,Monday,1,25,6
1480533988284456968,2022-01-10 13:36:24,Seorang warga AS mengeluhkan hotel di Indonesia yang dipakai untuk karantina COVID-19 pelaku perjalanan luar negeri. Tarifnya tidak sesuai dengan fasilitas. https://t.co/OJX92Opqj8,31,3,13,6,2022-01-10,13,Monday,1,44,9
1480533167954083841,2022-01-10 13:33:08,"Disatukan dalam situasi berpotensi berujung kematian, para perempuan ini menguatkan satu sama lain. Puluhan tahun setelah perang, keberanian mereka diungkap. https://t.co/rIzVcgKFMA",14,0,1,0,2022-01-10,13,Monday,1,15,0
1480532194078642179,2022-01-10 13:29:16,Epidemiolog UI Pandu Riono yakin tak ada gelombang ketiga Covid-19 di Indonesia. Ia juga optimistis tak ada pembatasan di masa mudik Lebaran 2022. https://t.co/6qmAXmpgee,22,2,8,3,2022-01-10,13,Monday,1,30,5
1480530403370876931,2022-01-10 13:22:09,"Arsenal tersingkir dari Piala FA setelah dikandaskan Nottingham Forest. Sudah begitu, pemain mudanya Nuno Tavares bikin ulah karena ngambek ketika diganti! https://t.co/SK8dNtod8E",8,1,0,1,2022-01-10,13,Monday,1,8,2
1480530374782558212,2022-01-10 13:22:02,Menaker Ida Fauziyah mengungkapkan Konfederasi Serikat Pekerja Seluruh Indonesia (KSPSI) memiliki tujuan untuk mewujudkan kesejahteraan. https://t.co/BhEVIAKdNc,5,1,0,0,2022-01-10,13,Monday,1,5,1
1480528986790891520,2022-01-10 13:16:32,"Longsor susulan kembali terjadi di Cadas Hideung, Kecamatan Sukanagara, Cianjur. Longsor menutup jalan yang menghubungkan Kecamatan Sukanagara-Pagelaran. https://t.co/VMF6Q8Xm0J",7,0,2,1,2022-01-10,13,Monday,1,9,1
1480528682917801995,2022-01-10 13:15:19,Melesaknya sejumlah lembaga riset ke dalam BRIN dianggap menggiring langkah penelitian Indonesia menuju kesuraman. Simak pembahasannya: https://t.co/qr8m4jvDoT,23,1,5,1,2022-01-10,13,Monday,1,28,2
1480527646400335880,2022-01-10 13:11:12,Kementerian Perdagangan mengatakan harga eceran tertinggi itu rencananya untuk enam bulan ke depan. https://t.co/eRDHkEP6Iw,10,4,4,3,2022-01-10,13,Monday,1,14,7
1480526823653998592,2022-01-10 13:07:56,"Kebakaran hebat terjadi di sebuah apartemen di New York, AS. Ngerinya, imbas kebakaran itu, belasan orang tewas dan ditemukan di tiap lantai apartemen. https://t.co/0G1qnzrzEc",9,1,3,1,2022-01-10,13,Monday,1,12,2
1480526822404243459,2022-01-10 13:07:55,"Tragis! 19 orang tewas dalam kebakaran yang menghanguskan sebuah apartemen di Kota New York, Amerika Serikat. Korban ditemukan di setiap lantai. https://t.co/o1flcDwtSi",2,0,1,0,2022-01-10,13,Monday,1,3,0
1480526593999220738,2022-01-10 13:07:01,"Merasakan sensi memasuki lorong tambang emas di Gunung Pongkor, Jawa Barat sungguh menakjubkan. Di perut bumi inilah logam mulia itu dihasilkan. https://t.co/5xYEKeADki",8,0,1,1,2022-01-10,13,Monday,1,9,1
1480526340570943490,2022-01-10 13:06:01,Petugas cleaning service di Bandara Kualanamu menemukan 97 kg emas di kamar mandi. Belum diketahui pemilik emas tersebut. https://t.co/l3uiKzfqYq,105,32,19,18,2022-01-10,13,Monday,1,124,50
1480525785203101698,2022-01-10 13:03:48,"Ade Puspitasari menyebut jika 'partai kuning' dan 'orange' berkoalisi, partai lain akan kandas di Pemilu 2024. Partai Hanura merespons. https://t.co/aQ1yEbFQlu",2,0,0,1,2022-01-10,13,Monday,1,2,1
1480524239887347714,2022-01-10 12:57:40,"Angkot jurusan Cisarua-Lembang ringsek akibat kecelakaan tunggal, diduga sopir meninggal karena komplikasi medis. https://t.co/kH6IsfvT3X",10,0,3,1,2022-01-10,12,Monday,1,13,1
1480523486347108353,2022-01-10 12:54:40,Hakim MK menilai syarat ini tidak transparan sehingga memunculkan dugaan-dugaan negatif. https://t.co/8z7E30N8YX,17,1,5,2,2022-01-10,12,Monday,1,22,3
1480522599218176008,2022-01-10 12:51:09,Wakil Ketua DPD RI Sultan B Najamudin mendorong Kementerian ESDM dan Badan Tenaga Nuklir Nasional (Batan) mengeksplorasi potensi energi nuklir. https://t.co/5ojqSXfKm0,13,0,0,2,2022-01-10,12,Monday,1,13,2
1480521787423211521,2022-01-10 12:47:55,Peraturan presidential threhold 20 persen kembali digugat ke MK dengan harapan dihapus sehingga setiap parpol bisa mengajukan capresnya. Bukan hal baru. https://t.co/t9ZohqueFL,20,10,2,1,2022-01-10,12,Monday,1,22,11
1480520992053207047,2022-01-10 12:44:45,"Indonesia dipastikan bakal menghadapi gelombang varian Omicron. Tak perlu panik, begini pesan Menkes terkait kemungkinan ada lonjakan kasus. https://t.co/mehoDJfRdN",57,37,33,21,2022-01-10,12,Monday,1,90,58
1480520216576765961,2022-01-10 12:41:41,Ibu Gaga Muhammad sebelumnya menyebut Greta Irene suka dengan anaknya. Begini tanggapan Greta Irene:  https://t.co/9iXNWRUi0v,5,0,0,1,2022-01-10,12,Monday,1,5,1
1480519317347262464,2022-01-10 12:38:06,Berbagai negara melayangkan protes kepada Indonesia karena melarang ekspor batu bara. https://t.co/2zZbQH19Mf,33,2,5,4,2022-01-10,12,Monday,1,38,6
1480517530905202694,2022-01-10 12:31:00,"Doddy Sudrajat diperiksa sebagai terlapor kasus pencemaran nama baik yang dilaporkan oleh Rofi'i. Usai diperiksa, Doddy lebih banyak diam. https://t.co/rDLQ394mhl",5,0,0,0,2022-01-10,12,Monday,1,5,0
1480517506578198529,2022-01-10 12:30:54,"Gempa bumi dengan magnitudo (M) 2,3 terjadi di Palu, Sulawesi Tengah (Sulteng). Gempa ini berpusat di darat dan dilaporkan dirasakan di Palu. https://t.co/I9xQxDTqmw",2,0,0,0,2022-01-10,12,Monday,1,2,0
1480517007544045570,2022-01-10 12:28:55,"Mesut Ozil dikabarkan akan dibeli klubnya Raffi Ahmad, RANS Cilegon FC. Namun sepertinya, Fenerbahce masih membutuhkan tenaga Ozil. https://t.co/8CQYVtKXmH",35,1,4,3,2022-01-10,12,Monday,1,39,4
1480516715972894721,2022-01-10 12:27:46,Bandara Cologne Bonn di Jerman menawarkan pengalaman vaksinasi unik. Tempat vaksinasi berada di dalam pesawat Airbus A300 Zero Guntuk anak-anak berusia 5 hingga 11 tahun https://t.co/WUnov4NPpj,3,0,0,0,2022-01-10,12,Monday,1,3,0
1480516697442369537,2022-01-10 12:27:41,#FOTO Verrell Bramasta dan Natasha Wilona dikabarkan menjalin lagi kisah asmara mereka. Ini momen kebersamaan mereka saat liburan:  https://t.co/gto7ZyWMtR,3,1,0,0,2022-01-10,12,Monday,1,3,1
1480516088899194880,2022-01-10 12:25:16,Venna Melinda bicara soal persiapan pernikahannya dengan Ferry Irawan. Mereka bakal melangsungkan akad nikah di Bali. https://t.co/5y6IdkPqeF,16,0,1,0,2022-01-10,12,Monday,1,17,0
1480515149840760834,2022-01-10 12:21:33,Polisi mengungkapkan kronologi penangkapan pedangdut Velline Chu di kawasan Bekasi. Adapun barang bukti yang disita polisi dari narkotika jenis sabu hingga bong kaca. https://t.co/HAQ8Dr7tZD,12,2,1,1,2022-01-10,12,Monday,1,13,3
1480514575707615232,2022-01-10 12:19:16,Polisi mengungkapkan kondisi istri pemilik rumah yang hancur akibat ledakan bom di Kabupaten Pandeglang. Korban saat ini harus menjalani perawatan di RS. https://t.co/vXxFtQWshC,9,0,5,0,2022-01-10,12,Monday,1,14,0
1480514090745401350,2022-01-10 12:17:20,"Menyambut awal 2022, ini fakta lukisan langka Raden Saleh mulai dari harga miliaran rupiah sampai lukisan yang ada di Singapura:  https://t.co/cVD4c1ALSe",12,0,2,0,2022-01-10,12,Monday,1,14,0
1480514067391467527,2022-01-10 12:17:14,"Gempa magnitudo 4,9 mengguncang Malang, Jawa Timur. Gempa ini tidak berpotensi tsunami, namun getaran gempa dirasakan masyarakat Lumajang hingga Jember. https://t.co/uXc5J5X253",16,0,7,0,2022-01-10,12,Monday,1,23,0
1480513565110980608,2022-01-10 12:15:15,Gorya benci banget Thyme sejak awal episode F4 Thailand: Boys Over Flowers. Tapi kejadian di pesta penyambutan Mira mengubah banyak hal dalam hidupnya.  https://t.co/UMMbCK0xT0,2,1,1,1,2022-01-10,12,Monday,1,3,2
1480512405906067457,2022-01-10 12:10:38,"Ada alasan kenapa PTM SD hingga SMP di Yogya belum dilakukan 100 persen. Yuk, simak info lengkapnya! Via: detikedu https://t.co/7HRgQ5Fe8v",2,0,1,0,2022-01-10,12,Monday,1,3,0
1480511880309452802,2022-01-10 12:08:33,Pedangdut Velline Chu dan suami ditangkap polisi terkait penyalahgunaan narkotika. Efek mengonsumsi sabu dapat berbahaya bagi tubuh. Ini penjelasannya. https://t.co/LwGJcDizBt,2,2,3,0,2022-01-10,12,Monday,1,5,2
1480511406348906496,2022-01-10 12:06:40,"Klub Liga 1 milik Raffi Ahmad, Rans Cilegon FC dikabarkan akan merekrut Mesut Ozil sebagai pemainnya musim depan. Berapa gaji yang harus dibayarkan Raffi jika merekrut Ozil? Selengkapnya di #CNNIndonesia #detiknetwork  https://t.co/4boqGcflno",32,0,7,5,2022-01-10,12,Monday,1,39,5
1480510807746166785,2022-01-10 12:04:17,Sampah antariksa berpotensi membuyarkan mimpi Elon Musk untuk menmbangun kehidupan di planet lain dan membuat manusia terperangkap di Bumi. https://t.co/KHODjcUfHr,5,0,3,0,2022-01-10,12,Monday,1,8,0
1480509961004269579,2022-01-10 12:00:55,"Satu RW di Krukut, Tamansari, Jakarta Barat menerapkan micro lockdown imbas satu warga menjadi pasien suspek varian omicron. Simak kronologinya di #CNNIndonesia. #detikNetwork https://t.co/5VS8BzDo2Q",4,0,3,0,2022-01-10,12,Monday,1,7,0
1480509698801602562,2022-01-10 11:59:53,"BPOM RI sudah menyetujui Molnupiravir untuk pasien COVID-19, bagaimana nasib Ivermectin yang sebelumnya diklaim sangat ampuh lawan COVID-19? https://t.co/hOOyqS5iwE",8,1,4,1,2022-01-10,11,Monday,1,12,2
1480509678920552448,2022-01-10 11:59:48,Apa kamu masih memikirkan nama bayi perempuan Arab terbaik untuk buah hati tercinta? Ini daftar nama bayi perempuan Arab yang bisa jadi pilihan:  https://t.co/e78NYt38tN,16,9,5,1,2022-01-10,11,Monday,1,21,10
1480509657286332416,2022-01-10 11:59:43,Pihak Kepolisian di Australia Barat khawatir dengan keselamatan Muhammad Ferdiansah. Mobilnya ditemukan ditinggalkan begitu saja di tempat parkir. https://t.co/iuLM3cqX7Q,8,0,3,0,2022-01-10,11,Monday,1,11,0
1480508748045111303,2022-01-10 11:56:06,Kekayaan yang dihasilkan Elon Musk pada 2021 sangat mengejutkan karena adanya peningkatan yang signifikan. Segini jumlah kekayaan Elon Musk:  https://t.co/qwYIobr59x,16,4,5,2,2022-01-10,11,Monday,1,21,6
1480508492490453001,2022-01-10 11:55:05,"detikcom mendapat kesempatan untuk berbincang dengan Kim Yohan soal perilisan album solo terbarunya. Berjudul Illusion, kini sang idola tampil beda! https://t.co/cLKF2qnb7Z",143,1,77,1,2022-01-10,11,Monday,1,220,2
1480507410188062724,2022-01-10 11:50:47,Gading Martin bertemu Wali Kota Solo Gibran Rakabuming Raka dan Komandan Korem 074/Warastratama Kolonel Inf Rudy Saladin. https://t.co/BPLOdZiu0a,5,0,2,1,2022-01-10,11,Monday,1,7,1
1480507099985719299,2022-01-10 11:49:33,"Nawal Citra Ardina (14), anak yang dilaporkan hilang sudah ditemukan. Siswi SMP 1 Pasuruan ini ditemukan di Bogor, Jawa Barat, dalam kondisi sehat. https://t.co/R7jH1legwq",8,1,2,0,2022-01-10,11,Monday,1,10,1
1480506573965434883,2022-01-10 11:47:28,"Jembatan duplikasi Leuwigajah, Cimahi yang baru, sudah mulai diuji coba sejak akhir tahun 2021. Namun sayang jembatan itu sudah jadi sasaran vandalisme. https://t.co/ss6HQBA58t",11,1,1,1,2022-01-10,11,Monday,1,12,2
1480505931993694209,2022-01-10 11:44:55,"Aksi perusakan sesajen oleh seorang pria di lokasi terdampak erupsi Semeru menuai banyak kecaman dari berbagai pihak. Ketua Komisi VIII DPR-RI, Yandri Susanto juga turut menyesalkan tindakan itu. https://t.co/7x65un9wcT",6,4,2,0,2022-01-10,11,Monday,1,8,4
1480505930781442049,2022-01-10 11:44:55,Elon Musk membagikan video jadul yang diambil pada tahun 1995 di mana Bill Gates diledek soal internet. https://t.co/muU5jUnGUR,7,0,6,0,2022-01-10,11,Monday,1,13,0
1480505134836764679,2022-01-10 11:41:45,Iwan Ratman dihukum 14 tahun penjara karena membangun kilang fiktif senilai Rp 50 miliar. Putusan yang dijatuhkan PN Samarinda itu dikuatkan PT Samarinda. https://t.co/wp28HrxxeV,20,1,7,1,2022-01-10,11,Monday,1,27,2
1480504600457367559,2022-01-10 11:39:37,#Foto Rumor Raffi Ahmad selaku pemilik RANS Cilegon FC yang mau membeli Mesut Ozil bikin heboh. Ini potret Ozil....  https://t.co/qlKfldON16,10,0,3,0,2022-01-10,11,Monday,1,13,0
1480504577745117191,2022-01-10 11:39:32,"Gempa M 4.9 mengguncang Malang. Gempa tersebut dirasakan warga di lereng Gunung Semeru, Lumajang. https://t.co/5OmC6STkWW",13,0,3,0,2022-01-10,11,Monday,1,16,0
1480504575442530304,2022-01-10 11:39:31,Bupati Jember Hendy Siswanto bersama Forkopimda mengecek lokasi banjir. Hendy menemukan adanya tumpukan sampah setinggi 40 cm menyumbat saluran pintu air. https://t.co/RWdDJLjrjT,4,1,1,0,2022-01-10,11,Monday,1,5,1
1480503982153945092,2022-01-10 11:37:10,Kerusuhan di Kazakhstan semakin parah. Lebih dari 160 orang dilaporkan tewas dan hampir 6.000 orang ditangkap. https://t.co/Z1Z6oJxM2w,19,0,2,1,2022-01-10,11,Monday,1,21,1
1480503735449227279,2022-01-10 11:36:11,Dua warga menjadi korban jiwa banjir Jember. Mereka adalah pasangan suami istri (pasutri). #Jember #Banjir https://t.co/U3TtfCCANh,5,0,0,0,2022-01-10,11,Monday,1,5,0
1480503707901087745,2022-01-10 11:36:05,"Ketua Umum PDIP Megawati Soekarnoputri mengaku kerap ditanya soal posisinya sebagai Dewan Pengarah Badan Riset dan Inovasi Nasional (BRIN). Kata Mega, ia mungkin dianggap kurang pintar. https://t.co/jLDaRPn13e",2,4,1,1,2022-01-10,11,Monday,1,3,5
1480502884190015490,2022-01-10 11:32:48,Presiden Joko Widodo (Jokowi) menyampaikan ucapan selamat hari ulang tahun ke-49 PDI Perjuangan. Jokowi menyampaikan ucapan terima kasih atas dukungan dan bantuan PDIP dalam menghadapi masa-masa yang sulit akibat pandemi Covid-19. https://t.co/XYTPVzaRx5,9,2,1,0,2022-01-10,11,Monday,1,10,2
1480502224728043520,2022-01-10 11:30:11,"Spirit doll tengah jadi perbincangan. Di Twitter sedang ramai soal istana spirit doll, di mana itu ya? https://t.co/2Yp0Xihny6",4,1,3,0,2022-01-10,11,Monday,1,7,1
1480501880585437186,2022-01-10 11:28:49,"Gempa magnitudo 4,9 mengguncang Malang, Jawa Timur. Getaran gempa dirasakan masyarakat Lumajang hingga Jember. https://t.co/VGzAatyVws",11,1,6,1,2022-01-10,11,Monday,1,17,2
1480501380175564801,2022-01-10 11:26:50,"Merasa dimanfaatkan setelah memberikan mobil hingga perhiasan mewah, seorang pangeran asal Italia menginginkan uangnya dikembalikan. Waduu..... https://t.co/SEmpikLTFJ",15,2,2,1,2022-01-10,11,Monday,1,17,3
1480501356335140866,2022-01-10 11:26:44,Dua mahasiswa asal Sulut meninggal dunia saat mengenyam pendidikan di luar negeri. Timothy Dien meninggal di AS dan Grace Karundeng meninggal di Kanada. https://t.co/V13juTfr3u,7,0,2,1,2022-01-10,11,Monday,1,9,1
1480500748068827140,2022-01-10 11:24:19,"Pemilik dari platform pertukaran uang kripto terbesar Binance, Changpeng Zhao masuk menjadi orang terkaya di dunia. https://t.co/SMJoWxExvM",8,0,0,0,2022-01-10,11,Monday,1,8,0
1480500494871240704,2022-01-10 11:23:19,"""Konsep ke depannya akan diberi label Rp 14.000/liter. Jadi masyarakat bisa protes kalau ada yang menjual di atas Rp 14.000/liter karena diberi label,"" https://t.co/CPwfFwdoiG",10,0,4,0,2022-01-10,11,Monday,1,14,0
1480499913200918533,2022-01-10 11:21:00,Aspebindo menyampaikan wacana agar pemerintah menaikkan harga batu bara untuk pemenuhan pasokan dalam negeri atau DMO dari US$ 70 menjadi US$ 90 per ton. https://t.co/pO9ny3mN75,4,2,0,0,2022-01-10,11,Monday,1,4,2
1480499130350940168,2022-01-10 11:17:53,"Gempa bermagnitudo 4,9 mengguncang Malang. Gempa bumi terjadi pukul 17:28:15 WIB. https://t.co/vXZWhB8Gwa",22,1,5,4,2022-01-10,11,Monday,1,27,5
1480498618918342657,2022-01-10 11:15:51,"Edi Supriadi (61), warga Sirnagalih, Desa Gunungcupu, Kecamatan Sindangkasih, Kabupaten Ciamis ditemukan meninggal dunia di kebun, Senin (10/1/2022). https://t.co/2NrzrXFver",3,0,0,0,2022-01-10,11,Monday,1,3,0
1480497810369830913,2022-01-10 11:12:38,Dua mahasiswa asal Sulut meninggal dunia saat mengenyam pendidikan di luar negeri. Timothy Dien meninggal di AS dan Grace Karundeng meninggal di Kanada. https://t.co/4yY29ZlYAv,17,2,1,0,2022-01-10,11,Monday,1,18,2
1480497577581846538,2022-01-10 11:11:43,"Aplikasi satu ini memang menyajikan beragam fitur menarik. Namun di sisi lain, bahaya WhatsApp Aero juga tak boleh dikesampingkan. Ini bahayanya:  https://t.co/4I2MXvWk5P",5,1,1,0,2022-01-10,11,Monday,1,6,1
1480497573744058380,2022-01-10 11:11:42,"Banyak perusahaan teknologi asal China jadi besar bisnisnya dan ekspansi ke berbagai wilayah, termasuk Asia Tenggara. Ternyata begini rasanya bekerja di sana:  https://t.co/t0bIkzVbK9",4,1,0,0,2022-01-10,11,Monday,1,4,1
1480496312420380679,2022-01-10 11:06:41,"Indonesia mencatat sebanyak 454 kasus baru COVID-19, Senin (10/1/2022). DKI menyumbang kasus terbanyak dengan jumlah 360. https://t.co/owLZz3CB7i",10,1,4,2,2022-01-10,11,Monday,1,14,3
1480496303603912708,2022-01-10 11:06:39,"Polisi Inggris berencana mendaftarkan Kastil Windsor ke dalam zona larangan terbang. Lho, ada apa ya? https://t.co/Mn539k8aog",5,0,0,0,2022-01-10,11,Monday,1,5,0
1480496056005767174,2022-01-10 11:05:40,BPOM memberikan EUA untuk lima vaksin COVID-19 yang akan dipakai sebagai booster pada 12 Januari mendatang. Efeknya bakal bertahan berapa lama? https://t.co/nj3dJIxeaB,5,1,0,0,2022-01-10,11,Monday,1,5,1
1480495784642686976,2022-01-10 11:04:35,"Taman nasional di Sidney, Australia, memiliki api yang menyala kurang lebih selama 6.000 tahun. Apa yang menyebabkannya menyala? https://t.co/RiyniHSmjm",13,0,2,0,2022-01-10,11,Monday,1,15,0
1480495482094956545,2022-01-10 11:03:23,"Penerbangan umumnya memakan waktu cukup lama. Tapi yang ini pendek banget, bahkan hitungan detik. https://t.co/PZUIx6QWsU",4,0,0,0,2022-01-10,11,Monday,1,4,0
1480494654692995078,2022-01-10 11:00:06,Pemerintah Korsel dan Jepang kompak meminta Indonesia membuka kembali ekspor Batu Bara ke negara mereka. Eddy Soeparno mengatakan negara memiliki hak menolak dan prioritaskan pasokan dalam negeri. https://t.co/7lRVd2wmxO,11,1,3,1,2022-01-10,11,Monday,1,14,2
1480494409099755520,2022-01-10 10:59:08,"Avaro merilis serangkaian produk IoT terbarunya, mulai dari bohlam hingga colokan pintar. Menariknya harga perangkat tersebut dijanjikan tak bikin meringis. https://t.co/lMrAozF2mX",8,0,2,0,2022-01-10,10,Monday,1,10,0
1480494387285008384,2022-01-10 10:59:02,"Presiden Kazakhstan, Kassym-Jomart Tokayev, menyatakan negaranya telah mengatasi upaya kudeta saat kerusuhan yang diwarnai kekerasan melanda. https://t.co/xzjmGJxzxa",6,0,2,0,2022-01-10,10,Monday,1,8,0
1480493864528011266,2022-01-10 10:56:58,Gubernur Jabar Ridwan Kamil angkat bicara soal banjir yang menerjang Sumedang akibat pembangunan Tol Cisumdawu. Dia menyebut saat ini tengah dilakukan kajian. https://t.co/P92Sx9iGLr,13,15,1,7,2022-01-10,10,Monday,1,14,22
1480492972353495042,2022-01-10 10:53:25,PLT Wali Kota Bekasi Tri Adhianto mengaku jadi orang pertama yang sedih mengetahui info Walkot Bekasi nonaktif Rahmat Effendi terkena OTT KPK. https://t.co/dfULf4NTS7,5,6,1,2,2022-01-10,10,Monday,1,6,8
1480492707302846465,2022-01-10 10:52:22,Aksi massa terus bergejolak di Kazakhstan akibat kemarahan warganya atas melonjaknya harga bahan bakar. Ini nasib bandar antariksa Rusia di Kazakhstan:  https://t.co/oUOUdbA7eN,5,1,4,0,2022-01-10,10,Monday,1,9,1
1480491601923387396,2022-01-10 10:47:58,"Masuk ke dalam salah satu tempat terbaik di dunia, Penang disorot karena kulinernya. Budaya makanan kaki lima Penang begitu mendunia. https://t.co/v2vrNJBBtg",11,0,2,0,2022-01-10,10,Monday,1,13,0
1480491578561019905,2022-01-10 10:47:53,Sebanyak 239 warga Krukut menjalani tes swab massal buntut satu warga terkonfirmasi Omicron. Hasilnya sebanyak 10 warga positf Corona berdasarkan tes antigen. https://t.co/DiXbJTxdik,10,1,5,1,2022-01-10,10,Monday,1,15,2
1480491253750013952,2022-01-10 10:46:35,Berapa hari karantina di Indonesia penting untuk diketahui. Ini aturan terbaru sesuai SE Satgas Covid-19 Nomor 1 Tahun 2022. https://t.co/s8seD7PGR3,5,1,1,1,2022-01-10,10,Monday,1,6,2
1480491252118433793,2022-01-10 10:46:35,Serah terima jabatan ditandai dengan pelepasan dan penyematan tanda jabatan. Kemudian dilakukan penyerahan tongkat komando dari Mulyo Aji kepada Untung. https://t.co/2M6kFCEkPz,6,1,0,0,2022-01-10,10,Monday,1,6,1
1480490739247333378,2022-01-10 10:44:33,Es cendol merupakan minuman yang terbuat dari tepung beras atau hunkue. Segar manis es cendol semakin enak dipadukan dengan durian yang creamy. https://t.co/U7xha1QdmQ,6,0,1,0,2022-01-10,10,Monday,1,7,0
1480490718145789953,2022-01-10 10:44:28,"Pelapor Gibran Rakabuming Raka dan Kaesang Pangarep ke KPK, dituduh politis oleh PDIP. Dosen UNJ bernama Ubedillah itu berharap KPK tak pandang bulu. https://t.co/lD6E4Otsp8",112,16,18,5,2022-01-10,10,Monday,1,130,21
1480490417137369090,2022-01-10 10:43:16,Ayu Aulia dicap negatif imbas viddeo ciuman dengan Zikri Daulay. Keluarga pun angkat bicara soal pergaulan Ayu Aulia:  https://t.co/TnYjIqjtnH,2,2,0,0,2022-01-10,10,Monday,1,2,2
1480489887853858819,2022-01-10 10:41:10,Ryan Diastana Firman adalah direksi termuda di BUMN. Usianya baru 31 tahun! Begini jejak kariernya: https://t.co/R5tgVl4HlE,109,27,17,16,2022-01-10,10,Monday,1,126,43
1480489397262897158,2022-01-10 10:39:13,Pengadilan junta Myanmar menjatuhkan hukuman empat tahun penjara terhadap Aung San Suu Kyi. https://t.co/29aPrBiKos,6,0,0,0,2022-01-10,10,Monday,1,6,0
1480489065518665732,2022-01-10 10:37:54,"Ketua Umum PDI Perjuangan, Megawati Soekarnoputri bercerita, dulu partainya dianggap sebagai partai sandal jepit. Alasannya karena saat kampanye, PDI hanya diberi lokasi-lokasi yang kecil. https://t.co/1cc9p87krS",4,0,0,1,2022-01-10,10,Monday,1,4,1
1480489046065438723,2022-01-10 10:37:49,Ulama di Kabupaten Garut memarahi sejumlah pejabat di Kabupaten Garut karena dinilai tak serius menangani NII. Momen ekspresif itu terekam kamera dan viral https://t.co/qxPTVLe8P8,10,0,1,0,2022-01-10,10,Monday,1,11,0
1480489044358443013,2022-01-10 10:37:48,"Wakil Ketua Pansus RUU IKN, Saan Mustopa memastikan produk legislasi itu bisa disahkan di rapat paripurna pada bulan ini. https://t.co/D8z31Evbsg",1,0,0,0,2022-01-10,10,Monday,1,1,0
1480489042907217927,2022-01-10 10:37:48,"Hari ini dilaporkan ada tambahan 454 kasus positif COVID-19 di Indonesia. Selain itu, ada 244 orang di Indonesia yang sembuh dari COVID-19. https://t.co/OhW9gMuEGO",0,0,0,0,2022-01-10,10,Monday,1,0,0
1480488685091147784,2022-01-10 10:36:23,Di Ciamis ada angkot dengan interior mewah yang memiliki lantai keramik. Joknya menggunakan sofa. Lengkap dengan tisu dan full musik dilengkapi lampu yang mirip di kafe. https://t.co/0iXzLbbZdP,4,1,1,1,2022-01-10,10,Monday,1,5,2
1480488664140550145,2022-01-10 10:36:18,"Indonesia melaporkan 454 kasus COVID-19 pada Senin (10/1/2022). Total kasus positif menjadi 4.266.649, sembuh 4.116.202, dan meninggal 144.136. https://t.co/9WhpYEITCD",3,0,0,0,2022-01-10,10,Monday,1,3,0
1480488662710243329,2022-01-10 10:36:17,"Viral di media sosial 2 remaja di Kabupaten Jeneponto, Sulawesi Selatan (Sulsel) diduga tewas dilindas truk tangki gas LPG akibat terjatuh saat freestyle. https://t.co/fZDQTBKZyB",3,0,0,0,2022-01-10,10,Monday,1,3,0
1480488661451956224,2022-01-10 10:36:17,"KPK berjanji menindaklanjuti laporan dugaan tindak pidana korupsi yang menyeret dua putra Presiden Jokowi, Gibran Rakabuming Raka dan Kaesang Pangarep. https://t.co/TdSi4Vqt8U",22,12,6,5,2022-01-10,10,Monday,1,28,17
1480488143551975427,2022-01-10 10:34:14,Berikut daftar lengkap pemenang Golden Globes 2022. Ada Will Smith hingga O Yeong Su dari Squid Game. #GoldenGlobes2022  https://t.co/vG1lt49W7A,7,0,1,0,2022-01-10,10,Monday,1,8,0
1480487847559847937,2022-01-10 10:33:03,"Witan Sulaeman, pesepakbola muda Indonesia, terkenal dengan gaya membumi. Baru-baru ini, viral di sosmed gaya Witan yang sedang nyantai. Sederhana banget! https://t.co/UB6bqFjiRs",12,0,2,1,2022-01-10,10,Monday,1,14,1
1480487845701767172,2022-01-10 10:33:03,"Polisi selesai menggelar olah TKP ledakan maut yang menewaskan seorang penghuni rumah di Pandeglang, Banten. Polisi menduga kuat ledakan itu dipicu bom. https://t.co/NbvaeCA6L5",10,1,6,1,2022-01-10,10,Monday,1,16,2
1480487492730171392,2022-01-10 10:31:39,Operator jalan tol bisa digugat ganti rugi hingga Rp 120 juta bila kecelakaan terjadi karena jalan rusak dan merenggut korban jiwa. https://t.co/rZlmUO9hPi,66,8,15,2,2022-01-10,10,Monday,1,81,10
1480487470445871105,2022-01-10 10:31:33,Sebuah video menunjukkan seorang wanita diduga dijambret lalu terseret di jalanan Medan viral di media sosial. Polisi telah menangkap pelakunya. https://t.co/0eTHBF72MM,2,0,2,1,2022-01-10,10,Monday,1,4,1
1480486572155981830,2022-01-10 10:27:59,Keluarga Ayu Aulia buka suara soal heboh video ciuman dengan Zikri Daulay. Mereka meminta maaf atas apa yang terjadi. https://t.co/JTwKGZ9Qz0,1,1,1,0,2022-01-10,10,Monday,1,2,1
1480486285747830787,2022-01-10 10:26:51,KTP digital mulai diujicoba di sejumlah wilayah. Bagaimana sederet informasi terbarunya? https://t.co/U3jzM4hvOd,8,0,2,0,2022-01-10,10,Monday,1,10,0
1480486284636344322,2022-01-10 10:26:51,"Penyebab terjadinya banjir di Jember masih diasesmen. Dugaan sementara, banjir disebabkan oleh tersumbatnya aliran sungai akibat tumpukan kayu dan bambu. https://t.co/fkwY6Nwq0g",3,0,0,0,2022-01-10,10,Monday,1,3,0
1480486074224885760,2022-01-10 10:26:00,Beredar undang acara tasyakuran dalam rangka dua tahun kepemimpinan Kepala Dinas Pendidikan DKI Jakarta. Disdik DKI beri penjelasan. https://t.co/0qmSQiNbEs,1,0,0,0,2022-01-10,10,Monday,1,1,0
1480484854856929284,2022-01-10 10:21:10,Artis VU yang sedang ramai diperbincangkan adalah Velline Chu. Penyanyi dangdut itu ditangkap oleh Polisi karena kasus penyalahgunaan narkoba. https://t.co/Q9NiLqiNVI,12,4,0,1,2022-01-10,10,Monday,1,12,5
1480483843517865985,2022-01-10 10:17:09,"Jika dosis 1-2 pakai Sinovac, vaksin COVID-19 jenis mana yang boleh dipakai sebagai booster? Ini aturan BPOM soal masing-masing jenis vaksin booster. https://t.co/eeuJiH83Nv",152,2,41,7,2022-01-10,10,Monday,1,193,9
1480483822412173314,2022-01-10 10:17:03,Penyerang Atletico Madrid Angel Correa menciptakan gol spektakuler dari garis tengah lapangan. Meskipun Atletico pada akhirnya cuma seri 2-2 melawan Villarreal. https://t.co/zAffBY5LqP,4,0,0,0,2022-01-10,10,Monday,1,4,0
1480483251248631809,2022-01-10 10:14:47,Identitas pria yang menendang sesajen di lokasi erupsi Gunung Semeru perlahan mulai terkuak. Dugaan identitasnya beredar di sejumlah aplikasi perpesanan. https://t.co/HaDqgUoQvt,24,16,0,1,2022-01-10,10,Monday,1,24,17
1480483014241136640,2022-01-10 10:13:51,Upacara menyambut Hari Kedewasaan jadi momen yang dinanti anak muda di Jepang. Pasalnya di hari itu mereka telah dianggap dewasa menurut hukum negara tersebut. https://t.co/PIG6XKDXgc,10,1,0,1,2022-01-10,10,Monday,1,10,2
1480481529671335937,2022-01-10 10:07:57,"Ketua Animal Defenders Indonesia (ADI) Doni Herdaru Tona memaparkan temuan penyebab kematian anjing secara misterius di Mandalika, NTB. https://t.co/voCeCAS8mq",45,16,16,11,2022-01-10,10,Monday,1,61,27
1480481279644774402,2022-01-10 10:06:57,Enam beasiswa luar negeri ini dapat dilamar tanpa TOEFL. Cek di sini ya waktu dibukanya pendaftaran! Via: detikedu https://t.co/8QtWiDV1I8,13,0,5,1,2022-01-10,10,Monday,1,18,1
1480481258044014592,2022-01-10 10:06:52,Ketua KPC-PEN Airlangga Hartanto menjelaskan banyak kasus COVID-19 datang dari luar negeri. Ke depannya kasus tersebut akan dipisah dari laporan wilayah. https://t.co/toBeV2z5le,2,1,0,0,2022-01-10,10,Monday,1,2,1
1480480692710608896,2022-01-10 10:04:37,"Ajang Golden Globe Awards 2022 diboikot. Meski begitu, Golden Globe 2022 tetap digelar pada Minggu (9/1) waktu setempat tanpa siaran di televisi, tanpa karpet merah dan pembawa acara. https://t.co/RTusmIddWG",1,0,0,1,2022-01-10,10,Monday,1,1,1
1480479966412300289,2022-01-10 10:01:44,"Ketua Animal Defenders Indonesia (ADI) Doni Herdaru Tona memaparkan temuan penyebab kematian anjing secara misterius di Mandalika, NTB. https://t.co/whyUMx7ZMU",3,0,1,1,2022-01-10,10,Monday,1,4,1
1480479965263060996,2022-01-10 10:01:44,"Ketua DPD RI, AA LaNyalla Mahmud Mattalitti mengimbau pemerintah Kabupaten Jember untuk melakukan penanganan pasca bencana banjir secara konsisten. https://t.co/6D1EXKRpm8",15,0,7,0,2022-01-10,10,Monday,1,22,0
1480479636127629314,2022-01-10 10:00:25,Marissya Icha bakal menghadap Kemensos soal donasi rumah Gala Sky yang diadukan oleh Doddy Sudrajat. https://t.co/r9LDxh6b8d,4,1,0,0,2022-01-10,10,Monday,1,4,1
1480479529604947969,2022-01-10 10:00:00,Mari kita ulas kilas balik peristiwa penting sepanjang 2021 selengkapnya di: https://t.co/UZFsXLxJFY,2,0,0,0,2022-01-10,10,Monday,1,2,0
1480479144811151361,2022-01-10 09:58:28,"Fransiska, si pendonor ginjal, membagikan pengalamannya usai mendonorkan ginjalnya untuk Eko Budi Utomo, kakak temannya. Transplantasi pun dinilai sukses. Ia menyebut tak ada yang berbeda meski kini beraktivitas dengan 1 ginjal. https://t.co/Dnru1A74Jq",11,1,3,2,2022-01-10,9,Monday,1,14,3
1480479124904943622,2022-01-10 09:58:24,"Medina Zein hari ini harusnya diperiksa sebagai tersangka kasus pencemaran nama baik yang dilaporkan Marissya Icha. Tetapi, Medina Zein absen karena sakit. https://t.co/DKnsXa6suq",4,0,0,1,2022-01-10,9,Monday,1,4,1
1480478644460044291,2022-01-10 09:56:29,"Mau kuliah di jurusan yang tidak ada matematika? Coba cek nih daftar jurusan yang tidak belajar matematika buat referensi SBMPTN 2022! 
Via: detikedu https://t.co/jFOm0I62an",4,0,3,2,2022-01-10,9,Monday,1,7,2
1480478387252645889,2022-01-10 09:55:28,Tercatat 414 kasus Omicron di RI. Dari 414 kasus Omicron tersebut hanya 2 orang yang memiliki gejala sedang dan membutuhkan oksigen. https://t.co/TKt8oxFMvt,4,1,1,1,2022-01-10,9,Monday,1,5,2
1480478373516353536,2022-01-10 09:55:24,Apakah anak perempuanmu akan berulang tahun? Sesekali berikan ucapan ulang tahun untuk anak perempuan yang menyentuh hati. Ini pilihannya. https://t.co/wfSa4Sm6x1,6,0,0,1,2022-01-10,9,Monday,1,6,1
1480478087460577283,2022-01-10 09:54:16,Sebuah video yang menunjukan sekelompok pemuda melakukan perusakan Taman Semeru di Probolinggo viral. Sejumlah fasilitas umum di taman tersebut rusak. https://t.co/d9EgccSJig,5,0,0,0,2022-01-10,9,Monday,1,5,0
1480477568092549120,2022-01-10 09:52:12,"Tahun baru, semangat baru! Suami ingin alih profesi jadi pengusaha, tapi dananya belum ada? Jangan khawatir, detikcom bantu modalin! https://t.co/n2DoMVxllg",5,2,1,0,2022-01-10,9,Monday,1,6,2
1480477066449596418,2022-01-10 09:50:13,Marissya Icha selesai menjalani pemeriksaan pertamanya terkait kasus dugaan penganiayaan Medina Zein di Polres Metro Jakarta Selatan.  https://t.co/U1fE879W1K,3,1,0,0,2022-01-10,9,Monday,1,3,1
1480477049236205568,2022-01-10 09:50:09,"Universitas Kyoto di Jepang tengah apes, karena mereka kehilangan data hasil penelitian penting sebesar 77TB. Kok bisa? https://t.co/mCWHJSngBR",6,2,0,0,2022-01-10,9,Monday,1,6,2
1480476819652591623,2022-01-10 09:49:14,"Seorang kakek di Klaten, Mukhtar Harjo Taruno (72), menerima uang ganti rugi proyek tol Yogya-Solo total Rp 7,5 miliar. Woah! Bagaimana ceritanya? https://t.co/qf0RQwsLLC",110,13,16,8,2022-01-10,9,Monday,1,126,21
1480476798425120772,2022-01-10 09:49:09,Megawati Soekarnoputri menyapa Ahok sebagai sahabat di HUT ke-49 PDIP. Apa kata Ahok soal momen tersebut? https://t.co/mqkcisnDGH,5,3,0,0,2022-01-10,9,Monday,1,5,3
1480476560541036545,2022-01-10 09:48:12,"Menyambut tahun 2022, Junji Ito yang dikenal sebagai mangaka dengan genre horor mempublikasikan ilustrasi makhluk aneh terbaru lagi. https://t.co/BB3B15jRhe",5,0,1,0,2022-01-10,9,Monday,1,6,0
1480476543654760450,2022-01-10 09:48:08,"Putri pertama keluarga Onsu, Thalia Putri Onsu, memiliki cita-cita sebagai artis, yaitu mengikuti karier sang ibunda sebagai seorang penyanyi. https://t.co/FRcHRSjTHK",3,0,0,0,2022-01-10,9,Monday,1,3,0
1480476291950329856,2022-01-10 09:47:08,Hotel dan penginapan lain menjadi hal paling diburu menjelang MotoGP Mandalika. Kemenparekraf memberikan alternatif. https://t.co/ZnbdEiqN6j,3,0,0,0,2022-01-10,9,Monday,1,3,0
1480475507426746368,2022-01-10 09:44:01,Elite PDIP belakangan sibuk membagikan beras bergambar Puan Maharani. Ternyata FX Hadi Rudy sebelumnya juga melakukan hal sama. https://t.co/88OlkV92tD,4,4,0,0,2022-01-10,9,Monday,1,4,4
1480475272348672004,2022-01-10 09:43:05,Kondisi kesehatan Pak Ogah menurun. Dalam media sosial miliknya terlihat Pak Ogah mulai ngaco bicara. Ia pun mengatakan ingin terus pulang. https://t.co/zbFlDDBAd9,15,2,3,0,2022-01-10,9,Monday,1,18,2
1480475250043330561,2022-01-10 09:43:00,BPOM RI memberikan izin penggunaan darurat atau EUA pada lima jenis vaksin COVID-19 sebagai booster. Berikut perbandingan kelima vaksin tersebut: https://t.co/bD9dDyIJ2I,4,1,4,0,2022-01-10,9,Monday,1,8,1
1480475226907590659,2022-01-10 09:42:54,"Kebakaran maut di Jasinga, Bogor pada (7/1) kemarin menewaskan seorang nenek dan cucu. Dugaan sementara penyebab kebakaran tersebut lantaran korsleting listrik. https://t.co/TCdTsLLAvu",1,0,0,0,2022-01-10,9,Monday,1,1,0
1480475225695346691,2022-01-10 09:42:54,Ada kabar RUU Ibu Kota Negara yang bakal jadi dasar pemindahan ibukota Indonesia segera disahkan pekan depan. Benarkah? https://t.co/h4NyXRlQHx,1,2,0,1,2022-01-10,9,Monday,1,1,3
1480474495290789888,2022-01-10 09:40:00,"Hai para suami, yuk kasih tau istrinya suruh ikutan program ""Modal Usaha untuk Suami"" dari detikcom! Para istri berkesempatan mendapatkan hadiah ""Modal Usaha untuk Suami"" senilai jutaan rupiah lho.⁣⁣⁣
⁣⁣⁣
Caranya bisa klik dan kunjungi https://t.co/dG0yoZAZCY yaa! https://t.co/E9kwZn0YBd",4,0,1,0,2022-01-10,9,Monday,1,5,0
1480474335039176709,2022-01-10 09:39:22,Vaksin booster gratis atau bayar jadi tanda tanya yang banyak dicari tahu masyarakat. Ini penjelasan Kemenkes soal tarif vaksin booster. https://t.co/uaKQGvE44s,3,2,0,1,2022-01-10,9,Monday,1,3,3
1480474315929931778,2022-01-10 09:39:17,"Kabar Mesut Ozil yang mau dibeli bos RANC Cilegon, Raffi Ahmad jadi rumor panas. Ozil sendiri, sebenarnya sudah cukup 'akrab' dengan Indonesia. https://t.co/dlb0fh61dA",23,3,0,3,2022-01-10,9,Monday,1,23,6
1480473494261575681,2022-01-10 09:36:01,KPK pamer telah melakukan 141 OTT sejak pertama kali berdiri. KPK menyebut semua OTT itu 100 persen terbukti di persidangan. https://t.co/Z5nyVxcsT7,3,2,0,0,2022-01-10,9,Monday,1,3,2
1480472921126678530,2022-01-10 09:33:44,"Pada edisi tertentu, harga Vespa matic dalam status bekas justru melonjak tinggi harganya atau istilahnya 'kegoreng'. #VespaMatic  https://t.co/KIsqI11TkM",5,1,0,1,2022-01-10,9,Monday,1,5,2
1480472899920318464,2022-01-10 09:33:39,"Kasus Omicron DKI Jakarta kembali bertambah. Terbaru, ada dua kasus yang terjadi, baik dari transmisi lokal maupun dari luar negeri. Ini informasinya. https://t.co/eJN44r0XgF",6,0,0,0,2022-01-10,9,Monday,1,6,0
1480472898485772289,2022-01-10 09:33:39,Menteri Investasi/Kepala BKPM Bahlil Lahadalia mengklaim kalangan pengusaha berharap Pilpres 2024 diundur. Begini tanggapan PDIP. https://t.co/HoLL2pO4vx,3,2,0,1,2022-01-10,9,Monday,1,3,3
1480472372629196800,2022-01-10 09:31:34,Pak Ogah yang terbaring sakit sempat tidak mau berobat ke Rumah Sakit karena belum membayar BPJS selama 4 tahun. #PakOgah  https://t.co/kKaBJVB0iQ,469,38,124,10,2022-01-10,9,Monday,1,593,48
1480471782104698880,2022-01-10 09:29:13,"Jauh sebelum terjun ke dunia politik, Sahrul Gunawan lebih dulu moncer di dunia hiburan. https://t.co/KB5a2pIU2Q",8,0,2,2,2022-01-10,9,Monday,1,10,2
1480471542014304256,2022-01-10 09:28:16,"Koordinator PPKM Jawa-Bali, Luhut Pandjaitan, menjelaskan sejumlah daerah bakal kembali masuk ke PPKM Level 1. https://t.co/5HHo2Geo8s",18,10,4,1,2022-01-10,9,Monday,1,22,11
1480471243216375811,2022-01-10 09:27:04,"Gibran Rakabuming Raka dan adiknya, Kaesang Pangarep, dilaporkan ke KPK. Begini tanggapan Gibran. https://t.co/N5BbXmT6rY",38,13,8,0,2022-01-10,9,Monday,1,46,13
1480470606659399680,2022-01-10 09:24:33,"""Karena saya sangat mencintainya, iri lihat banyak yang melamar dia,"" kata pelaku, Andi Yasih (57). https://t.co/hPh2DZH0LS",7,4,1,4,2022-01-10,9,Monday,1,8,8
1480470329235550214,2022-01-10 09:23:26,Timnas Indonesia akan beruji coba dua kali melawan Bangladesh pada jeda internasional atau FIFA Matchday. PSSI menjamin BRI Liga 1 2021 pun akan diliburkan. https://t.co/EQWTNIo4s5,3,2,0,0,2022-01-10,9,Monday,1,3,2
1480470131725815814,2022-01-10 09:22:39,Ustaz Yusuf Mansur bakal mengambil langkah hukum terkait tuduhan bisnis bodong. Ada sejumlah pihak yang dilaporkan. https://t.co/KInmDTHrP5,13,8,4,4,2022-01-10,9,Monday,1,17,12
1480469514475167745,2022-01-10 09:20:12,Acuan perubahan kapasitas PTM adalah level PPKM. Disdik DKI menyesuaikan kapasitas PTM dengan level PPKM. https://t.co/tDrIvugLyl,1,0,0,0,2022-01-10,9,Monday,1,1,0
1480469475547922434,2022-01-10 09:20:03,"Polisi merilis kasus narkoba pedangdut berinisial V yang diketahui adalah Velline Chu. Velline ditangkap di rumahnya bersama suaminya, Budi Harianto. https://t.co/SBKnD5wX0D",2,0,0,0,2022-01-10,9,Monday,1,2,0
1480469462394540037,2022-01-10 09:20:00,"Buat detikers yang menjadi anak pertama, atau bahkan punya kakak anak pertama ada kejutan spesial nih dari detikcom untuk kamu. Bagi anak pertama berkesempatan mendapatkan handphone senilai belasan juta rupiah lho!
⁣⁣
Caranya bisa langsung klik https://t.co/7nSz16MS54 https://t.co/VQb7xgWx5b",5,1,0,0,2022-01-10,9,Monday,1,5,1
1480468674523897860,2022-01-10 09:16:52,"Toyota Land Cruiser dipastikan meluncur di Indonesia, Kamis (13/1/2022). Ini bocoran tipe dan harga NJKB-nya:  https://t.co/52QjJrShk4",4,0,0,0,2022-01-10,9,Monday,1,4,0
1480468370533326849,2022-01-10 09:15:39,Ancilla Irish Gabriella (25) peserta meditation camp di Tangerang Selatan yang hilang telah ditemukan. Ancilla sebelumnya hilang sejak 21 Desember 2021. https://t.co/yhcelHmczI,1,1,0,0,2022-01-10,9,Monday,1,1,1
1480468369069703172,2022-01-10 09:15:39,Apakah kamu pernah bermimpi untuk menjadi seorang raja? Ternyata mimpi untuk menjadi raja bukanlah hal yang mustahil loh. https://t.co/TPXWlewqIX,4,0,0,0,2022-01-10,9,Monday,1,4,0
1480468326883209217,2022-01-10 09:15:29,"Dosen UNJ, Ubedillah Badrun melaporkan bisnis yang terkait dengan Gibran-Kaesang. PDIP menduga laporan itu politis. https://t.co/NJ01Gd0bK9",4,3,0,3,2022-01-10,9,Monday,1,4,6
1480467861663625218,2022-01-10 09:13:38,Menteri Investasi/Kepala BKPM Bahlil Lahadalia mengatakan dunia usaha setuju apabila pemilihan presiden diundur dari 2024. Apa alasannya? https://t.co/ZlLGuA46Lu,6,7,1,6,2022-01-10,9,Monday,1,7,13
1480467840998248449,2022-01-10 09:13:33,Kepala BPOM Penny K Lukito menyebut pemberian vaksin Corona dosis tambahan untuk Moderna hanya diberikan setengah dosis. Begini aturannya: https://t.co/pBtwcsoRZe,6,1,6,3,2022-01-10,9,Monday,1,12,4
1480467558356639744,2022-01-10 09:12:26,Menkes melaporkan sebagian besar kasus COVID-19 varian Omicron RI dipicu perjalanan luar negeri. Ini 4 negara 'penyumbang' kasus Omicron terbesar di RI. https://t.co/YLdBNr8iy5,2,0,0,0,2022-01-10,9,Monday,1,2,0
1480467036476260354,2022-01-10 09:10:21,"""Hanya satu kematian, saya ulangi hanya 1 kematian yang selama bulan Januari ini yang ditemukan di Jakarta,"" kata Luhut. https://t.co/2hEIfUtwOk",12,5,1,0,2022-01-10,9,Monday,1,13,5
1480467014061858818,2022-01-10 09:10:16,"Pada momen ulang tahunnya ke -40, Kate Middleton membagikan foto terbarunya. Ini pesan yang ingin disampaikannya. https://t.co/rGlqLZ22Dp",5,0,0,0,2022-01-10,9,Monday,1,5,0
1480466526994145282,2022-01-10 09:08:20,"HP BlackBerry dulu merupakan simbol eksklusivitas, tapi kini tinggal kenangan. Lihat lagi perjalanan BlackBerry dari masa kebangkitan sampai kejatuhannya:  https://t.co/iAMbp0vFwF",14,1,4,0,2022-01-10,9,Monday,1,18,1
1480466503099113474,2022-01-10 09:08:14,Apple dikabarkan akan mengadakan event pada bulan Maret atau April 2022. Event ini kemungkinan akan jadi tempat peluncuran iPhone SE 3 dengan 5G.  https://t.co/iE3v6bRwQB,14,2,2,2,2022-01-10,9,Monday,1,16,4
1480465105439580162,2022-01-10 09:02:41,"Pasti sudah mengenal sosok Lyodra Ginting, ya? Penyanyi 18 tahun ini terpilih sebagai wanita tercantik nomor 8 di dunia, lho. Intip potretnya, yuk. #detikNetwork  https://t.co/ceJgy47ic4",18,0,2,2,2022-01-10,9,Monday,1,20,2
1480465088658264073,2022-01-10 09:02:37,Pemerintah akan melakukan pemisahan level assessment antara pelaku perjalanan dari luar negeri dengan kasus COVID di daerah. https://t.co/3xWTqqZQxq,6,0,1,0,2022-01-10,9,Monday,1,7,0
1480464438041919496,2022-01-10 09:00:02,Adam Deni bakal mengklarifikasi soal tuduhan meminta Rp 10 miliar kepada Jerinx sebagai syarat pencabutan laporan. https://t.co/myapbOHCkd,7,0,1,0,2022-01-10,9,Monday,1,8,0
1480464435080740867,2022-01-10 09:00:01,"Hai detikers, udah pada ikutan program Kalung untuk Istri belum? Kali ini para suami se-Indonesia punya kesempatan bikin senang istri dengan bawa pulang hadiah kalung emas lho. Khusus yang memiliki istri sah yaa!

Caranya klik di sini https://t.co/fdrW1u3hxO https://t.co/JuyFjAfqEp",3,0,1,0,2022-01-10,9,Monday,1,4,0
1480464426344062979,2022-01-10 08:59:59,Nindy Ayunda mengisyaratkan sudah punya calon pendamping. Wajah dan namanya bikin penasaran. #NindyAyunda  https://t.co/GkBqOtijSX,5,0,0,0,2022-01-10,8,Monday,1,5,0
1480463555593920512,2022-01-10 08:56:31,"Laporan itu diklaim berkaitan dengan dugaan korupsi, kolusi, dan nepotisme atau KKN terhadap relasi bisnis Gibran dan Kaesang dengan grup bisnis yang diduga terlibat pembakaran hutan. https://t.co/ePCrIjU1CI",225,67,52,10,2022-01-10,8,Monday,1,277,77
1480463533196427267,2022-01-10 08:56:26,"Gaga Muhammad jalani sidang lanjutan di Pengadilan Negeri Jakarta Timur. Di dalam sidang, ia menyampaikan kalimat perpisahan untuk Laura Anna. https://t.co/BlQhlwHZBi",3,0,0,0,2022-01-10,8,Monday,1,3,0
1480462927966584833,2022-01-10 08:54:02,"Hai detikers, udah pada ikutan program Motor untuk Mertua belum? Di program ini para menantu dan calon menantu se-Indonesia bisa bawa pulang motor untuk para mertua / calon mertua. Ini saatnya kamu menjadi menantu idaman. 

Caranya bisa cek di sini ya https://t.co/T0EAWsdQMi https://t.co/yJqX3YTwop",3,2,2,0,2022-01-10,8,Monday,1,5,2
1480462456942206978,2022-01-10 08:52:10,Ferdinand Hutahaean membawa bukti riwayat kesehatan datangi Bareskrim Polri guna penuhi pemeriksaan sebagai saksi terkait cuitan Allahmu lemah. https://t.co/HHgyMBN2rl,3,3,1,4,2022-01-10,8,Monday,1,4,7
1480462140318359553,2022-01-10 08:50:54,Siapa sangka Jung Hae In dan J-Hope BTS ternyata berteman dekat? Persahabatan keduanya terungkap oleh penggemar pada 2019. https://t.co/YKMsad56A5,14,0,1,3,2022-01-10,8,Monday,1,15,3
1480461640135028736,2022-01-10 08:48:55,"Artis Ivanka Suwandi diduga ditipu mafia properti di Bali. Sebab, rumah yang dibeli Ivanka Suwandi dan dibayar hingga lunas dijual lagi oleh pihak pengembang. https://t.co/UeSDn6PHc5",4,1,0,0,2022-01-10,8,Monday,1,4,1
1480461625610039297,2022-01-10 08:48:51,"Sebanyak 22 orang dilaporkan tewas membeku di dalam kendaraan. Mereka terjebak dalam hujan salju lebat di stasiun bukit Murree di distrik Rawalpindi, Pakistan. https://t.co/SycvApQ41h",7,0,0,0,2022-01-10,8,Monday,1,7,0
1480461120821506049,2022-01-10 08:46:51,Velline Chu dan suaminya terancam hukuman paling singkat 4 tahun penjara dan paling lama 12 tahun penjara. #VellineChu  https://t.co/gJ97Yf3E9Q,7,5,2,0,2022-01-10,8,Monday,1,9,5
1480460848904691716,2022-01-10 08:45:46,Jokowi meminta warga tak pergi ke luar negeri selama beberapa pekan ke depan menyusul melonjaknya kasus Omicron. https://t.co/mArRJlaxK0,36,22,3,11,2022-01-10,8,Monday,1,39,33
1480460611368673283,2022-01-10 08:44:50,"Tanpa menunggu waktu kondangan, kamu bisa menikmati hidangan sop manten di warung kaki lima ini. Seporsinya cuma dibanderol Rp 5.000. https://t.co/l2kpJ3tYBw",7,1,0,1,2022-01-10,8,Monday,1,7,2
1480460363732815873,2022-01-10 08:43:50,Beredar video seorang pria menendang dan membuang sesajen di lokasi erupsi Gunung Semeru. Apa kata warga Lumajang? https://t.co/Ote4RfGEsb,8,2,1,1,2022-01-10,8,Monday,1,9,3
1480459873041141763,2022-01-10 08:41:54,"KPK kembali melelang mobil sitaan negara. Kali ini, ada dua mobil dan beberapa barang rampasan dari koruptor yang akan dilelang. https://t.co/IVotL7MqW6",12,1,2,1,2022-01-10,8,Monday,1,14,2
1480459852904284164,2022-01-10 08:41:49,"Kawanan perompak menyandera dan merampas barang milik 8 ABK Kapal SPOB Graha 21 di Perairan Morosi, Konawe, Sulawesi Tenggara. Begini detik-detiknya. https://t.co/oDPNBeew2D",2,0,0,0,2022-01-10,8,Monday,1,2,0
1480458174746476545,2022-01-10 08:35:09,"Raffi Ahmad selalu bikin kejutan. Setelah Menteri Luar Negeri dan Siwon, kini legenda sepakbola akan ke rumah Raffi Ahmad.  https://t.co/ILydf6atuG",27,2,2,1,2022-01-10,8,Monday,1,29,3
1480457292252336135,2022-01-10 08:31:38,"Raffi Ahmad santer dikabarkan akan membawa Mezut Ozil ke RANS Cilegon. Pertanyaannya adalah, sanggupkah si 'Sultan Andara' itu menggaji Ozil? https://t.co/HvkNAnBqdz",238,48,29,19,2022-01-10,8,Monday,1,267,67
1480457281766629377,2022-01-10 08:31:36,"#FOTO 15 tahun lalu, Apple merilis iPhone generasi pertama di Macworld Expo, San Francisco, California. Ini momen Steve Jobs memperkenalkan iPhone:  https://t.co/AOEu0PygDF",8,0,3,0,2022-01-10,8,Monday,1,11,0
1480456487386460165,2022-01-10 08:28:26,Roof box atau kompartemen penyimpanan tambahan yang diletakkan pada atap mobil ternyata bisa melanggar aturan. Ini penjelasannya:  https://t.co/fGLJzgELg2,4,4,5,2,2022-01-10,8,Monday,1,9,6
1480456466796630017,2022-01-10 08:28:21,Seorang pemobil tewas akibat mobilnya mengalami kecelakaan setelah menghindari jalan berlubang di ruas tol Palembang-Lampung. Ada dugaan pengelola tol lalai.  https://t.co/6k64m738AJ,41,13,9,5,2022-01-10,8,Monday,1,50,18
1480455730234896385,2022-01-10 08:25:26,WHO menyebutkan penyebaran Omicron disebabkan oleh kombinasi faktor. Ini lima cara penularan Omicron menurut para ahli:  https://t.co/yISk7A85HE,2,0,0,0,2022-01-10,8,Monday,1,2,0
1480455715273781250,2022-01-10 08:25:22,"Ayu Aulia dikabarkan dekat dengan Zikri Daulay, ia pun tidak menampik hal tersebut. Ini yang bikin Ayu Aulia kepincut Zikri Daulay:  https://t.co/sc6mdPOd2H",3,0,0,0,2022-01-10,8,Monday,1,3,0
1480454875318145024,2022-01-10 08:22:02,Velline Chu dikenal dengan lagunya Ratu Begal. Ia sempat viral beberapa tahun lalu karena ngaku dianiaya kekasihnya yang seorang oknum polisi. https://t.co/ZpIAjN5WNY,22,4,2,1,2022-01-10,8,Monday,1,24,5
1480454601598017538,2022-01-10 08:20:57,Artis SM Entertainment mendulang banyak prestasi selama 2021. Hasil penjualan album pun mencapai angka yang fantastis. Daebak!  https://t.co/QMhlKqfnWy,8,1,1,0,2022-01-10,8,Monday,1,9,1
1480453517710336005,2022-01-10 08:16:38,Megawati menyinggung masih ada kelompok yang antikemajuan saat ini. Megawati mengambil contoh seperti mereka yang menolak uluran dari pemerintah. https://t.co/nc4Nle4S1J,32,25,2,1,2022-01-10,8,Monday,1,34,26
1480453496935698436,2022-01-10 08:16:33,Apa itu Tritura? Ini sejarah serta isi Tritura 10 Januari. https://t.co/1oaTlWKBoT,4,0,0,0,2022-01-10,8,Monday,1,4,0
1480453001655508992,2022-01-10 08:14:35,Tak hanya bagian daging saja yang bisa diolah jadi makanan enak. Bahkan bagian kulit hewan juga bisa jadi hidangan enak yang populer. https://t.co/7g8ziRae0c,5,0,0,1,2022-01-10,8,Monday,1,5,1
1480452523400085504,2022-01-10 08:12:41,"Berbagai instansi membuka formasi SMA dan SMK sederajat di tiap Seleksi CPNS. Lalu, bagaimana ya cara daftar CPNS lulusan SMA? Simak yuk! Via: detikedu https://t.co/qXRLMFnZuV",12,0,2,0,2022-01-10,8,Monday,1,14,0
1480452504101998592,2022-01-10 08:12:37,#Foto Selamat ya! Pemain timnas Indonesia di Piala AFF 2020 Witan Sulaeman melamar kekasihnya Rismahani yang ditaksirnya sejak SD. Intip momennya yuk.  https://t.co/j7KSqc10wq,9,0,1,0,2022-01-10,8,Monday,1,10,0
1480452283422973954,2022-01-10 08:11:44,Salah satu maskapai penerbangan Lufthansa melakukan penerbangan tanpa penumpang. Hal ini dilakukan agar mereka tak kena semprit otoritas penerbangan. https://t.co/gCBG95z0Kd,1,0,1,0,2022-01-10,8,Monday,1,2,0
1480452264569495554,2022-01-10 08:11:40,Bagaimana ya peruntungan cinta Libra hingga Pisces di 2022? Berikut ramalan zodiak cinta 2022 menurut pakar tarot. #RamalanZodiak https://t.co/P7rokyKaQc,0,0,0,0,2022-01-10,8,Monday,1,0,0
1480451985887444992,2022-01-10 08:10:33,"Pedangdut Velline Chu dibekuk lantaran kasus dugaan penyalahgunaan narkotika jenis sabu bersama suaminya, BH. Ini alasan Velline Chu nyabu:  https://t.co/cUEZn0SbNO",4,0,1,0,2022-01-10,8,Monday,1,5,0
1480451984582979584,2022-01-10 08:10:33,"Wisata Hell's Gate atau Pintu Neraka di Turkmenistan akan ditutup. Sementara di Brasil, ada batu tebing roboh timpa kapal wisata. https://t.co/dGmsgPa9JM",1,0,0,0,2022-01-10,8,Monday,1,1,0
1480451731368599553,2022-01-10 08:09:32,Terkadang anak-anak kesulitan dalam memahami pelajaran di sekolah. Perhatikan 5 tanda berikut ya jika anak membutuhkan tutor privat. Via: detikedu https://t.co/oR3DmU2p8w,5,0,0,0,2022-01-10,8,Monday,1,5,0
1480451237661319174,2022-01-10 08:07:35,Valerie Patkar akhirnya menerbitkan novel kelima yang berjudul Lukacita akhir pekan lalu. Dia berjumpa dengan 50 pembacanya setelah dua tahun. https://t.co/xF4NLjg9pD,49,0,9,1,2022-01-10,8,Monday,1,58,1
1480451217851621381,2022-01-10 08:07:30,"Rayakan ulang tahun yang ke-119 tahun, orang tertua di dunia ini mendapatkan kejutan manis berupa minuman bersoda yang disukainya. https://t.co/JxjiIymHDU",24,2,2,1,2022-01-10,8,Monday,1,26,3
1480450953757212677,2022-01-10 08:06:27,"Cristiano Ronaldo bak memberi teka-teki. Suatu posting-an di sosial medianya bertuliskan 'keep working', bisa jadi sebagai tanda perpisahan ke MU. https://t.co/FF5kwY7aDu",16,2,0,1,2022-01-10,8,Monday,1,16,3
1480450379338985475,2022-01-10 08:04:10,Yiren EVERGLOW belum lama ini jadi sorotan. Sapaan tahun barunya jadi perdebatan antara publik China dan Korea. https://t.co/yEaNodBDXf,6,0,0,0,2022-01-10,8,Monday,1,6,0
1480450365682241538,2022-01-10 08:04:07,"Sebuah video tentang batu tebing besar yang roboh viral di medsos. Batu tebing ini memakan banyak korban, dan kini terus bertambah. https://t.co/9GvtNxVDj6",7,0,1,0,2022-01-10,8,Monday,1,8,0
1480449794799722501,2022-01-10 08:01:51,"BPOM mengeluarkan izin penggunaan darurat 5 jenis vaksin untuk booster COVID-19. Vaksin tersebut adalah Sinovac, AstraZeneca, Moderna, Pfizer, dan Zifivax. https://t.co/MOSyNEuc0R",14,4,5,0,2022-01-10,8,Monday,1,19,4
1480449776378392577,2022-01-10 08:01:46,Polisi menetapkan Velline Chu sebagai tersangka kasus narkoba. Polisi menyebut Velline Chu berdalih memakai narkoba demi menghilangkan trauma KDRT. https://t.co/jcBIsbatuO,5,2,0,0,2022-01-10,8,Monday,1,5,2
1480449380100579328,2022-01-10 08:00:12,Pada 4 Januari kemarin dukungan untuk OS Blackberry sudah berakhir sehingga tamat sudah riwayat ponsel lawas BlackBerry. Padahal dulu sang bos pede. #BlackBerry  https://t.co/D3rkDWMyGX,5,1,1,1,2022-01-10,8,Monday,1,6,2
1480448590740922368,2022-01-10 07:57:04,"Wakil Ketua Komisi VII Fraksi PAN, Eddy Soeparno mendukung keputusan Presiden Joko Widodo yang menghentikan sementara ekspor batu bara 31 Januari 2022. Eddy meminta adanya sanksi tegas bagi pihak yang melanggar aturan ini. https://t.co/LVACk9Gvp5",2,0,2,0,2022-01-10,7,Monday,1,4,0
1480448088204525568,2022-01-10 07:55:04,Sri Rahayu mengolah belimbing wuluh dan menjadikannya kreasi cake yang nikmat. Sri prihatin karena banyak limbah belimbing wuluh tidak termanfaatkan. https://t.co/yExHducKRN,16,1,2,1,2022-01-10,7,Monday,1,18,2
1480447338002931713,2022-01-10 07:52:05,"Pedangdut Velline Chu dibekuk karena dugaan penyalahgunaan sabu bersama suaminya, BH. Ini barang buktinya: #VellineChu  https://t.co/w62tGKiCMN",10,1,0,0,2022-01-10,7,Monday,1,10,1
1480447336857882625,2022-01-10 07:52:05,Velline Chu disangkakan dengan pasal berlapis dengan hukuman maksimal 12 tahun penjara. https://t.co/S264yycntl,8,1,2,0,2022-01-10,7,Monday,1,10,1
1480447080426582016,2022-01-10 07:51:04,"Banjir menerjang kawasan perumahan Bumi Mangli Permai (BMP), Kecamatan Kaliwates, Jember. Ketinggian air sempat mencapai leher orang dewasa. Sebuah mobil hanyut terbawa derasnya arus. https://t.co/OvJOtWFkLa https://t.co/Fgspb5uU9s",15,0,3,3,2022-01-10,7,Monday,1,18,3
1480447018292109314,2022-01-10 07:50:49,"""Sampai saat ini, saya belum pernah mengajukan surat pengunduran diri ke Partai NasDem, saya NasDem, diusung Partai NasDem,"" ucap Sahrul. https://t.co/D1EaAHxDek",6,0,0,2,2022-01-10,7,Monday,1,6,2
1480446714897223680,2022-01-10 07:49:36,"Jefri Nichol dan Anya Geraldine dipasangkan dalam video musik Bagai Bintang di Surga, NOAH. Jefri Nichol sampai naik papan demi sejajar dengan Anya. https://t.co/S289Exw441",7,0,1,0,2022-01-10,7,Monday,1,8,0
1480446693640388617,2022-01-10 07:49:31,Megawati Soekarnoputri memberikan pidato politik dalam peringatan HUT ke-49 PDIP dengan menyapa sederet tokoh yang hadir. Nama Basuki Tjahaja Purnama (Ahok) mendapat sapaan secara khusus dari Megawati. https://t.co/r0EVNZZ2oC,17,0,1,0,2022-01-10,7,Monday,1,18,0
1480446117003374598,2022-01-10 07:47:14,"Mayoritas warga RI pakai Sinovac sebagai vaksin COVID-19. Dengan akan dimulainya program vaksin booster, penerima Sinovac bisa pakai jenis apa? https://t.co/VMusZMnSK0",5,1,1,0,2022-01-10,7,Monday,1,6,1
1480445843928985601,2022-01-10 07:46:09,"Tren kuliner selalu berubah setiap tahunnya, demikian juga dengan minuman. Tahun 2022 ini ada minuman yang hits mulai dari boba hingga minuman fermentasi. https://t.co/wvVkBaKgjo",4,0,0,0,2022-01-10,7,Monday,1,4,0
1480445835297103873,2022-01-10 07:46:07,#FOTO Velline Chu ditangkap dengan barang bukti sabu. Ini penampakan sang pedangdut usai ditangkap: #VellineChu  https://t.co/jV5VYtik6c,4,1,0,1,2022-01-10,7,Monday,1,4,2
1480445602982989827,2022-01-10 07:45:11,Velline Chu ditangkap bareng pria bernama Budi Hartono. https://t.co/LJampDRDed,3,1,2,0,2022-01-10,7,Monday,1,5,1
1480445580396617730,2022-01-10 07:45:06,Polres Lumajang turun tangan menyelidiki kasus pria yang viral membuang dan menendang sesajen di lokasi erupsi Semeru. Polisi menyebut sudah mendapatkan titik terang mengenai sosok pria tersebut. https://t.co/l7tKhzS03r,2,1,1,1,2022-01-10,7,Monday,1,3,2
1480445317472395264,2022-01-10 07:44:03,Ibunda Ayu Aulia ngaku syok ketika mendengar kabar anaknya ciuman dengan Zikri Daulay. Ia bahkan sempat jatuh sakit gara-gara memikirkan hal tersebut. https://t.co/D9yqmzvJ1x,4,2,0,0,2022-01-10,7,Monday,1,4,2
1480445074777513989,2022-01-10 07:43:05,"Dayana, selebgram asal Kazakhstan jadi perhatian karena situasi negara tersebut yang mencekam. Banyak netizen khawatir dengannya...  https://t.co/KttK1qNLnq",51,17,4,4,2022-01-10,7,Monday,1,55,21
1480445061624209411,2022-01-10 07:43:02,Polisi menggelar jumpa pers terkait penangkapan penyanyi dangdut Velline Chu terkait kasus sabu. Velline Chu dihadirkan dalam jumpa pers. https://t.co/GDJVsCRepv,2,0,0,2,2022-01-10,7,Monday,1,2,2
1480444758971629573,2022-01-10 07:41:50,"Seorang karyawan menggadaikan mobil kantor sehingga tagihan dari leasing ditagihkan ke perusahaan. Lalu, apa yang harus dilakukan perusahaan? #detiksAdvocate https://t.co/f5MJvDaZU0",7,1,0,1,2022-01-10,7,Monday,1,7,2
1480444744463527940,2022-01-10 07:41:47,"Mau masuk politeknik? Yuk, cek dulu daftar peringkat politeknik terbaik di Indonesia versi Webometrics 2021: 
Via: detikedu https://t.co/nh1LdB3rWq",3,0,1,1,2022-01-10,7,Monday,1,4,1
1480444472215363585,2022-01-10 07:40:42,LPS mencatat jumlah simpanan nasabah kaya tercatat mengalami kenaikan. Begini data dan faktanya: https://t.co/fNLJlhsWa6,4,2,1,0,2022-01-10,7,Monday,1,5,2
1480444448211443717,2022-01-10 07:40:36,Kabar soal pemain Fenerbahce itu sampai-sampai juga ikut dibahas media asal Turki. Apakah Ozil sudah ketemu Raffi dan setuju ke RANS Cilegon? https://t.co/EBumpZf0dd,20,0,3,3,2022-01-10,7,Monday,1,23,3
1480443072144097284,2022-01-10 07:35:08,Pedangdut Velline Chu dibekuk lantaran dugaan penyalahgunaan narkotika jenis sabu. Ia ditangkap oleh Polres Metro Jakarta Selatan bersama suaminya.  https://t.co/AEVLYUKEzJ,4,5,0,1,2022-01-10,7,Monday,1,4,6
1480443058642636801,2022-01-10 07:35:05,"ASIX yang merupakan perusahaan keluarga Anang Hermansyah makin melebarkan sayap di dunia internet. Setelah di YouTube, mereka kini merambah NFT. https://t.co/tuf8UQQ4PD",11,4,1,3,2022-01-10,7,Monday,1,12,7
1480442357757661191,2022-01-10 07:32:18,Ivan Gunawan terlihat hadir di acara ultah Bilqis Khumairah Razak. Ivan Gunawan ungkap kedekatan dengan anak Ayu Ting Ting.  https://t.co/RyqQDfQDB0,4,1,0,0,2022-01-10,7,Monday,1,4,1
1480441980752646144,2022-01-10 07:30:48,"Usut punya usut, penyanyi dangdut inisial VU ini ternyata adalah Velline Chu yang dikenal sebagai 'Ratu Begal'. https://t.co/l8WQtJ58t1",59,63,5,18,2022-01-10,7,Monday,1,64,81
1480441757263437824,2022-01-10 07:29:54,"Di Depok, Jawa Barat, ada dealer motor bekas yang optimis menjual Vespa matic bekas dan sanggup jualan 150 unit per bulannya. Mereka adalah Vescooter. https://t.co/zwgJ7aXpSF",13,0,5,0,2022-01-10,7,Monday,1,18,0
1480441734526025730,2022-01-10 07:29:49,Brooks Nader model cantik asal New York mengungkapkan jika dirinya telah dikuntit seseorang setelah mengetahui adanya produk Apple AirTag di kantong jaketnya. Ini sosok Brooks Nader:  https://t.co/md4ZrqoCT6,4,0,0,0,2022-01-10,7,Monday,1,4,0
1480440658427006979,2022-01-10 07:25:32,"Jadwal Liga 1 hari ini akan memainkan satu laga. Tira Persikabo vs Persebaya Surabaya yang menjadi sajian, Senin (10/1/2022). https://t.co/3B7wChTpPP",3,0,0,0,2022-01-10,7,Monday,1,3,0
1480439893331427331,2022-01-10 07:22:30,Di-bully karena tidak bisa senyum membuat masa kecilnya menderita tapi Tayla kini tumbuh jadi wanita yang sukses dan dikenal sebagai selebgram. Ini kisahnya..... https://t.co/ikFDMwIXfx,15,0,3,1,2022-01-10,7,Monday,1,18,1
1480439873685315584,2022-01-10 07:22:25,Bos MNC Group Hary Tanoesoedibjo mendapat kado khusus berupa replika 'kunci emas' Gedung Putih dari Presiden Ke-45 Amerika Serikat (AS) Donald Trump. https://t.co/9gNnmKTlhW,15,1,1,0,2022-01-10,7,Monday,1,16,1
1480439257319809025,2022-01-10 07:19:58,"Yayasan Lembaga Konsumen Indonesia (YLKI) curiga adanya permainan harga, di mana pengusaha sepakat menentukan harga minyak goreng. https://t.co/zv3cVvOp01",14,4,3,2,2022-01-10,7,Monday,1,17,6
1480439237132566528,2022-01-10 07:19:54,"#FOTO Badai salju yang terjadi di Murree, Pakistan, telah membuat ribuan mobil terjebak. Puluhan orang dilaporkan tewas akibat kejadian itu, Senin (10/1/2022). https://t.co/qphYO6nBz2",5,0,2,0,2022-01-10,7,Monday,1,7,0
1480438959956189190,2022-01-10 07:18:47,"""Sudah ada empat dukungan untuk Ganjar, ini masih banyak yang mengantre. Ini kita sampaikan ke DPD dan DPP PDIP,"" ujar Rudy. https://t.co/4Y85WnIgzC",32,8,3,1,2022-01-10,7,Monday,1,35,9
1480438934287048711,2022-01-10 07:18:41,Juventus menunjukkan mental baja di markas AS Roma untuk pulang dengan tiga angka. Tapi drama yang terjadi di ibu kota terasa memangkas usia. https://t.co/zequhZjpml,9,0,1,0,2022-01-10,7,Monday,1,10,0
1480438114254471169,2022-01-10 07:15:26,"Kemenkes RI melaporkan transmisi lokal varian Omicron RI bertambah, total sudah ada 50 kasus. Lantas seperti apa perbedaan gejala Omicron dan flu biasa? https://t.co/ByZm15HCEA",18,1,6,5,2022-01-10,7,Monday,1,24,6
1480437863896465409,2022-01-10 07:14:26,Wakil Wali Kota Bekasi Tri Adhianto Tjahyono resmi menjabat sebagai Plt Wali Kota Bekasi. Ini koleksi mobil mewahnya:  https://t.co/RLdZbB3ApG,7,1,2,0,2022-01-10,7,Monday,1,9,1
1480437082631909376,2022-01-10 07:11:20,"Varian Omicron di Indonesia jumlahnya terus bertambah. Dari total kasus yang ada, beberapa di antaranya merupakan transmisi lokal. https://t.co/tKO7fGz3zx",3,1,1,0,2022-01-10,7,Monday,1,4,1
1480437060108492801,2022-01-10 07:11:14,Raffi Ahmad harus ngeluarin duit seberapa banyak ya untuk memboyong Mesut Ozil ke RANS Cilegon? #RaffiAhmad #MesutOzil https://t.co/iovgyqgJQO,23,4,3,0,2022-01-10,7,Monday,1,26,4
1480436590128377856,2022-01-10 07:09:22,"Tindakan pencurian tak hanya terjadi di dunia perbankan saja, namun juga industri buku. Seorang staf penerbit diduga curi ratusan naskah novel sebelum terbit. Waduh! https://t.co/zEhglay75X",8,0,2,0,2022-01-10,7,Monday,1,10,0
1480436090398035971,2022-01-10 07:07:23,"Mimpi Aenur Rofiq yang sehari-hari jadi pemulung demi biaya sekolah terkabul. Berkat bantuan sejumlah pihak, Rofiq mulai bersekolah hari ini. https://t.co/YXwPhLE0B1",33,3,9,1,2022-01-10,7,Monday,1,42,4
1480435222458118145,2022-01-10 07:03:56,Anggaran tahun 2022 untuk anggota DPRD DKI naik. Sejumlah pos anggaran wakil rakyat DKI yang naik tuai kritik. https://t.co/f1HOpYk447,5,1,2,0,2022-01-10,7,Monday,1,7,1
1480434980346019842,2022-01-10 07:02:59,Marissya Icha penuhi panggilan Polres Jakarta Selatan untuk mengklarifikasi soal aduan Medina Zein yang merasa kena gebok. https://t.co/Z0P9FR2RKz,1,0,2,0,2022-01-10,7,Monday,1,3,0
1480434738657738757,2022-01-10 07:02:01,Golden Globes digelar hari ini tanpa ada penayangan besar-besaran. Ada skandal yang muncul di Golden Globes tahun ini. #GoldenGlobes  https://t.co/Ed50EFdjxI,0,0,1,1,2022-01-10,7,Monday,1,1,1
1480434539474341888,2022-01-10 07:01:14,Program senjata hipersonik Korea Utara tampaknya meningkat dan terus bertambah. Ini menimbulkan kekhawatiran bagi negara lain yang dianggap jadi musuhnya. https://t.co/nRqVgJPiy8,11,1,3,0,2022-01-10,7,Monday,1,14,1
1480434518397968384,2022-01-10 07:01:08,"Korban jiwa banjir di Jember bertambah satu orang. Dengan demikian, total korban jiwa banjir yang terjadi pada Minggu (9/1) kemarin menjadi 3 orang. https://t.co/ooPjo3RxFv",6,1,2,0,2022-01-10,7,Monday,1,8,1
1480433777272709123,2022-01-10 06:58:12,"Calon suami Melanie Putria, Aldico Sapardan sudah selesai jalani operasi pengangkatan tumor di otaknya. Melanie Putria ngaku tambah yakin untuk menikah. https://t.co/Di9luOEOxy",4,0,1,0,2022-01-10,6,Monday,1,5,0
1480433756838244354,2022-01-10 06:58:07,"Orang terkaya di India, Mukesh Ambani membeli hotel mewah Mandarin Oriental New York senilai US$ 98,15 juta atau setara dengan Rp 1,4 triliun. https://t.co/t5O1b0Y39j",6,1,1,0,2022-01-10,6,Monday,1,7,1
1480433245300920322,2022-01-10 06:56:05,Wabup Bandung Sahrul Gunawan angkat bicara soal fotonya yang mengenakan jaket Golkar yang viral di media sosial. Apa katanya? https://t.co/1dvBZ8S3t4,1,0,1,0,2022-01-10,6,Monday,1,2,0
1480432945223639043,2022-01-10 06:54:53,Persib Bandung mendapatkan tambahan tenaga menatap lanjutan Liga 1. Ezra Walian dan Victor Ibonefo sudah berlatih dengan Maung Bandung di Bali. https://t.co/LRpG3QRIZj,7,0,0,0,2022-01-10,6,Monday,1,7,0
1480432179100491776,2022-01-10 06:51:51,"Bos Apple, Tim Cook, mengantongi penghasilan hampir US$ 100 juta atau setara Rp 1,43 triliun (kurs Rp 14.300) per tahun pada tahun 2021. https://t.co/DkVjASPoGz",13,2,1,2,2022-01-10,6,Monday,1,14,4
1480431894290386948,2022-01-10 06:50:43,"Ayu Ting Ting mengungkapkan jika ia merasa sedih karena tidak memiliki banyak waktu dengan anak semata wayangnya, Bilqis. https://t.co/wla5aYm6Ag",9,0,1,1,2022-01-10,6,Monday,1,10,1
1480431627100696586,2022-01-10 06:49:39,Beredar undangan refleksi dan tasyakuran 2 tahun kepemimpinan Nahdiana sebagai Kepala Dinas Pendidikan DKI. Tamu undangan drescode batik bernuansa merah. https://t.co/RDCgvAO77y,4,1,1,1,2022-01-10,6,Monday,1,5,2
1480431078829608961,2022-01-10 06:47:28,Idris menegaskan Pemkot tidak akan menunda PTM 100 persen. https://t.co/AulEJzAnIr,1,0,1,1,2022-01-10,6,Monday,1,2,1
1480430833718673408,2022-01-10 06:46:30,6 orang kawanan perompak beraksi di atas Kapal SPOB Graha 21. Aksi perompakan tersebut dilakukan dengan menyekap dan merampas sejumlah barang berharga milik ABK. https://t.co/fo03v3HAvH,2,0,1,0,2022-01-10,6,Monday,1,3,0
1480430817826545668,2022-01-10 06:46:26,Massa FUMI menggelar demonstrasi di Jakarta. Mereka meminta MUI segera mencabut persetujuan penggunaan vaksin Corona atau COVID-19 nonhalal. https://t.co/iuAtaVLO3D,9,14,4,10,2022-01-10,6,Monday,1,13,24
1480430519292727299,2022-01-10 06:45:15,"Edinson Cavani menutup pintu keluar Manchester United. Manajer interim MU Ralf Rangnick mengatakan, Cavani menjamin akan bertahan sampai akhir musim ini. https://t.co/MLfq3YtVcR",5,0,1,1,2022-01-10,6,Monday,1,6,1
1480430305790107649,2022-01-10 06:44:24,Ayu Aulia dan Zikri Daulay sempat membuat heboh. Ayu Aulia mengaku banyak ditanya tentang berbagai hal oleh keluarga Zikri Daulay. https://t.co/T1N0MbJPY1,2,0,1,0,2022-01-10,6,Monday,1,3,0
1480430284160053256,2022-01-10 06:44:19,"Apakah kalian sering mengalami kekalahan ketika bertanding di mode Rank Mobile Legends? Simak cara sederhana ini, agar bisa menang dan cepat naik tier:  https://t.co/mzSQB4T3JR",5,9,5,3,2022-01-10,6,Monday,1,10,12
1480429789085421570,2022-01-10 06:42:21,Krisdayanti yang selalu memantau kesehatan Aurel usai liburan dari Turki. https://t.co/KEFXxyda4X,6,1,1,1,2022-01-10,6,Monday,1,7,2
1480429530300956675,2022-01-10 06:41:19,Berikut fakta-fakta peristiwa kecelakaan tol Kayu Agung yang detikcom rangkum. Apa saja? https://t.co/9QKXJxuwej,2,1,2,1,2022-01-10,6,Monday,1,4,2
1480429516212342786,2022-01-10 06:41:16,Arus lalin dari Cengkareng menuju Jakarta Utara viral karena macet parah. Simak penjelasan Dishub: https://t.co/DfgpYc2eev,2,1,2,0,2022-01-10,6,Monday,1,4,1
1480429186221236225,2022-01-10 06:39:57,Fenomena mengadopsi boneka arwah atau spirit doll sedang heboh di Indonesia. Ini kata Sarwendah soal spirit doll miliknya yang dianggap seperti boneka biasa:  https://t.co/uaHlmJBHbS,8,0,2,0,2022-01-10,6,Monday,1,10,0
1480428445234511872,2022-01-10 06:37:01,Ivan Gunawan sudah tidak memiliki boneka arwah lagi. Boneka yang dianggap anaknya itu telah dihibahkan kepada orang lain. #IvanGunawan  https://t.co/YwlcUV1e9i,9,2,2,0,2022-01-10,6,Monday,1,11,2
1480428425571717121,2022-01-10 06:36:56,"Seorang driver ojol diduga menjadi korban pemukulan oleh oknum TNI di wilayah Pamulang, Tangerang Selatan. Oknum TNI AL itu disebutkan berpangkat mayor. https://t.co/hooJFGOU6E",18,5,9,4,2022-01-10,6,Monday,1,27,9
1480428173942788098,2022-01-10 06:35:56,Ditinggal pergi begitu saja selalu memberikan efek yang kurang enak untuk dirasakan. Rasa campur aduk itu diangkat oleh Juicy Luicy yang jadi korban ghosting. https://t.co/9k8ZCHeEGT,2,0,4,0,2022-01-10,6,Monday,1,6,0
1480428154451861507,2022-01-10 06:35:51,Jaksa Agung ST Burhanuddin resmi melantik Sunarta menjadi Wakil Jaksa Agung menggantikan Setia Untung Arimuladi yang telah memasuki masa pensiun. https://t.co/5uUFi632wH,1,0,3,0,2022-01-10,6,Monday,1,4,0
1480427823101878272,2022-01-10 06:34:32,Keluarga menduga ada orang yang mengantar Annisa. #detiktif https://t.co/Y4MdhdsYjv,9,0,3,0,2022-01-10,6,Monday,1,12,0
1480427554964135940,2022-01-10 06:33:28,"Sejumlah jurusan sepi peminat di SNMPTN ITB, ITS, UI, Unair, UGM, dan Unpad bisa jadi pertimbangan untuk SNMPTN 2022. Apa saja ya? Cek yuk! Via: detikedu https://t.co/GzrqWXzusw",6,0,3,0,2022-01-10,6,Monday,1,9,0
1480427063932764162,2022-01-10 06:31:31,"Kantor Wali Kota Bekasi, Jawa Barat, dibanjiri karangan bunga. Ada apa? https://t.co/jRuJoAJgg2",4,4,1,0,2022-01-10,6,Monday,1,5,4
1480427043011575808,2022-01-10 06:31:26,"RI kini mencatat total 414 kasus COVID-19 varian Omicron. Mayoritas pasien nihil gejala, epidemiolog bongkar alasan di baliknya. Bukti vaksin COVID-19 manjur? https://t.co/H14y5hmRLK",3,0,2,1,2022-01-10,6,Monday,1,5,1
1480426676970569729,2022-01-10 06:29:59,"Bagi kamu yang berniat ingin membeli mobil dalam waktu dekat, sebaiknya pastikan dahulu jika memiliki garasi atau lahan yang cukup untuk mobil diparkir. https://t.co/HgRZnoj3W8",9,0,1,0,2022-01-10,6,Monday,1,10,0
1480426411991175168,2022-01-10 06:28:56,"Tak ingin keberadaannya kepergok penonton, Andrew dan Tobey sembunyi-sembunyi masuk bioskop. Wah, gimana cerita kocaknya? https://t.co/Rz8kMlN5Sq",7,1,3,1,2022-01-10,6,Monday,1,10,2
1480425675920232451,2022-01-10 06:26:00,Megawati berbicara mengenai posisinya sebagai Ketua BRIN. Megawati menyinggung bahwa dirinya dianggap kurang pintar. https://t.co/toulrPQ2k5,16,33,4,3,2022-01-10,6,Monday,1,20,36
1480424849784909826,2022-01-10 06:22:43,Rhoma Irama mengaku selalu menangis dalam setiap momen bahkan ketika suasana hati bahagia. #RhomaIrama  https://t.co/EdI8DitAG8,4,2,1,0,2022-01-10,6,Monday,1,5,2
1480424287790059523,2022-01-10 06:20:29,Dari idola K-pop hingga aktor populer akan segera menyelesaikan wamilnya pada tahun ini. Ini daftarnya:   https://t.co/tSrRNDEkt0,4,0,6,0,2022-01-10,6,Monday,1,10,0
1480423726952951811,2022-01-10 06:18:16,"Lagi ramai, rumor Raffi Ahmad selaku pemilik RANS Cilegon FC yang mau membeli Mesut Ozil. Media di Turki turut membahasnya! https://t.co/G7mTfc1n5A",47,5,11,3,2022-01-10,6,Monday,1,58,8
1480423465182240768,2022-01-10 06:17:13,#Foto Sebanyak 330 sekolah mulai dari tingkat SD hingga SMP di Kota Bandung gelar PTM 100 persen hari ini dengan menerapkan prokes ketat. Ini potretnya.  https://t.co/Ed7U7teGza,3,0,1,0,2022-01-10,6,Monday,1,4,0
1480423159732097024,2022-01-10 06:16:00,"Harga minyak goreng mahal masih terus dikeluhkan. Tingginya harga sudah terjadi sejak tahun lalu, dan bertambah mahal jelang natal 2021 dan tahun baru 2022. https://t.co/dmYpMr8227",5,2,1,0,2022-01-10,6,Monday,1,6,2
1480422882429841409,2022-01-10 06:14:54,Berita terpopuler: Beberapa orang sukses diet karena dibully. Ada juga soal bakso-bakso ekstrem yang pernah dicoba Shanty Denny 'Si Ratu Bakso'. https://t.co/IfrWVMSvSV,9,1,2,0,2022-01-10,6,Monday,1,11,1
1480422649545347079,2022-01-10 06:13:59,Lemak di perut dianggap yang paling sulit diatasi. Ahli kesehatan menyarankan untuk mulai menerapkan pola makan ini jika perut ingin lebih ramping. https://t.co/wQiNAYVi7g,8,2,4,1,2022-01-10,6,Monday,1,12,3
1480422120756760579,2022-01-10 06:11:53,Gulai ayam merah ini bisa mengunggah selera makan. Pedas gurih dengan bumbu rempah yang pekat. Enak dimakan dengan ketupat atau nasi. https://t.co/XaY9Aww6lC,16,1,2,0,2022-01-10,6,Monday,1,18,1
1480421797568860161,2022-01-10 06:10:36,Kasus Covid-19 punya varian baru yang dikenal dengan nama Omicron. Ada beberapa makanan yang baik dikonsumsi untuk mengatasi Omicron. Apa saja? https://t.co/Aln1ywpWPB,14,1,7,0,2022-01-10,6,Monday,1,21,1
1480420697675649027,2022-01-10 06:06:13,Roro Fitria masih menikmati menjadi pengantin baru usai menikah dengan Andri Irawan. Roro Fotria ngaku suka cemburu karena hal ini:  https://t.co/2OVgrr8vo6,9,0,1,1,2022-01-10,6,Monday,1,10,1
1480420174335549450,2022-01-10 06:04:09,"Ketua LTMPT Mochamad Ashari mengumumkan waktu dimulainya pembuatan akun. Simak ya detikers, cara pendaftaran yang benar seperti ini: Via: detikedu https://t.co/Cp2CPla6DC",629,3,81,6,2022-01-10,6,Monday,1,710,9
1480419927387484163,2022-01-10 06:03:10,Muncul isu soal pelecehan seksual yang menimpa salah satu kru di balik film Penyalin Cahaya. Tim film Penyalin Cahaya langsung menyatakan sikapnya. https://t.co/7soXkP5vey,11,0,5,1,2022-01-10,6,Monday,1,16,1
1480419624940417029,2022-01-10 06:01:58,"Penderita asam lambung perlu menjaga pola makannya. Saat sarapan, 5 menu sarapan ini menjadi pilihan paling baik dan aman untuk dikonsumsi. Berikut daftarnya. https://t.co/AnvMHf5Wob",12,0,4,0,2022-01-10,6,Monday,1,16,0
1480418951863676930,2022-01-10 05:59:17,"Penyanyi dangdut wanita berinisial VU ditangkap polisi karena kasus narkoba. Polisi mengungkap, VU ditangkap karena kasus sabu. https://t.co/zn40lofbBQ",4,0,0,0,2022-01-10,5,Monday,1,4,0
1480418936235732996,2022-01-10 05:59:13,Penyanyi dangdut disebut telah dibekuk lantaran kasus narkoba. Pedangdut itu berinisial V yang belakangan disebut juga VU. https://t.co/Ox1b1L37s3,70,60,8,3,2022-01-10,5,Monday,1,78,63
1480418638683377665,2022-01-10 05:58:02,Salah satu fitur canggih yang jadi unggulan dari Mercedes-Benz kekinian adalah fitur parkir otomatis yang disebut Active Parking Assist. Begini cara kerjanya:  https://t.co/8zdSi9pEha,3,0,0,0,2022-01-10,5,Monday,1,3,0
1480418616235409410,2022-01-10 05:57:57,Jokowi mengatakan PDIP telah menjadi partai yang konsisten membela rakyat. https://t.co/jVyl9yBdHr,21,28,4,4,2022-01-10,5,Monday,1,25,32
1480418347837710337,2022-01-10 05:56:53,"Sejumlah driver ojol mendatangi Mapolsek Pamulang, Tangerang Selatan malam tadi. Narasi yang beredar, mereka mengantarkan temannya untuk melapor ke polisi karena jadi korban pemukulan oleh oknum TNI Angkatan Laut (AL). https://t.co/LnkryO4c9i",6,0,2,0,2022-01-10,5,Monday,1,8,0
1480418329718407175,2022-01-10 05:56:49,Menteri Energi Filipina Alfonso Cusi meminta pemerintah Indonesia untuk mencabut larangan ekspor batu bara. Apa katanya? https://t.co/rxFreyJbp2,18,7,2,2,2022-01-10,5,Monday,1,20,9
1480418027648733184,2022-01-10 05:55:37,"Squid Game bawa pulang satu piala di Golden Globe 2022. Piala tersebut dianugerahkan kepada O Yeong Su, kakek pemeran pemain 001. Selamat!  https://t.co/pK78TZwWQc",21,0,4,0,2022-01-10,5,Monday,1,25,0
1480418008052940806,2022-01-10 05:55:32,Satu keluarga di Kabupaten Bandung diduga terpapar Omicron. Saat ini sekeluarga teridiri lima orang itu tengah menjalani karantina. https://t.co/iw0iAI4Ug7,10,2,3,2,2022-01-10,5,Monday,1,13,4
1480417711419240449,2022-01-10 05:54:21,Pengumuman! Disney membuka lowongan kerja untuk posisi dua koordinator konten media sosialnya. Gajinya lumayan lho. https://t.co/eoQ8HIsb27,7,0,0,1,2022-01-10,5,Monday,1,7,1
1480417691949309953,2022-01-10 05:54:17,Venna Melinda dan Ferry Irawan disebut bakal menikah pada Maret 2022. https://t.co/AFeRt88WwM,3,0,0,0,2022-01-10,5,Monday,1,3,0
1480417458804645888,2022-01-10 05:53:21,Tri Adhianto memimpin apel perdana sebagai Plt Wali Kota Bekasi. Dia mendoakan Wali Kota Bekasi nonaktif Rahmat Effendi atau Pepen diberi ketegaran. https://t.co/pAi5rrZrsE,4,0,0,0,2022-01-10,5,Monday,1,4,0
1480417439951241219,2022-01-10 05:53:17,"Membeli sebuah mobil mungkin jadi impian banyak orang, bahkan ada beberapa di antaranya harus berjuang menabung selama beberapa tahun. https://t.co/Br946qKOFE",8,1,4,0,2022-01-10,5,Monday,1,12,1
1480417140947787781,2022-01-10 05:52:05,Ketua Umum PDIP Megawati Soekarnoputri bicara tentang Daerah Sumatera Barat (Sumbar). Seperti apa? https://t.co/HhKAMLxS1w,1,4,0,0,2022-01-10,5,Monday,1,1,4
1480417122018807810,2022-01-10 05:52:01,Kawasan pinggiran ibu kota Jakarta jadi sasaran banyak orang untuk mencari hunian. Sawangan menjadi salah satu opsinya. https://t.co/QewjoHoyw1,3,0,1,0,2022-01-10,5,Monday,1,4,0
1480416892305170434,2022-01-10 05:51:06,"Kurikulum K-13 mendapat banyak keluhan dari para orang tua dan guru. Menurut pengamat, ini yang dikatakan guru &amp; ortu. Mana yang terbaik? Via: detikedu https://t.co/rsWbQ8GVfj",7,0,2,1,2022-01-10,5,Monday,1,9,1
1480416869383380996,2022-01-10 05:51:01,Artis Irish Bella jadi sorotan saat tampil di sebuah acara. Penampilan ibu satu anak itu dinilai makin cantik. Ini tips dari Irish Bella:  https://t.co/ti4NgJQtOg,6,0,0,1,2022-01-10,5,Monday,1,6,1
1480416343191080961,2022-01-10 05:48:55,Ayu Aulia diminta menikah dengan Zikri Daulay imbas video ciuman yang sempat bikin heboh. Ini penuturan Ayu Aulia diminta nikah dengan Zikri Daulay:  https://t.co/W4F8bEIXFC,2,1,2,3,2022-01-10,5,Monday,1,4,4
1480416325797351427,2022-01-10 05:48:51,"Trump siap luncurkan Twitter versi dia sendiri Truth Social, 21 Februari mendatang. Postingannya disebut Truth, posting ulang disebut Re-Truth. https://t.co/VYFfupajSs",2,0,3,3,2022-01-10,5,Monday,1,5,3
1480415565143580674,2022-01-10 05:45:50,Polisi menangkap penyanyi dangdut inisial VU terkait kasus narkoba. VU ditangkap bareng seorang pria. https://t.co/apIo0hCkgF,193,188,27,21,2022-01-10,5,Monday,1,220,209
1480414923268116480,2022-01-10 05:43:17,"Peri Santoso kehilangan kedua kakinya akibat kecelakaan terjatuh dari kereta. Namun, Ia tidak patah semangat dan berjualan menggunakan motor modifikasi. Sayangnya motornya kini kerap kali mogok. Ayo bantu Peri dapatkan motor baru dengan berdonasi melalui @berbuatbaik_id. https://t.co/ikWz2Rm2gS",13,0,4,0,2022-01-10,5,Monday,1,17,0
1480414785720176643,2022-01-10 05:42:44,"15 tahun yang lalu, Steve Jobs mengenalkan iPhone generasi pertama, produk terbaru Apple yang berhasil mengubah dunia. #SteveJobs  https://t.co/V3sL5qXKE8",13,0,1,2,2022-01-10,5,Monday,1,14,2
1480413144656883719,2022-01-10 05:36:13,"Ayah Vanessa Angel, Doddy Sudrajat, hari ini diperiksa sebagai terlapor di kasus pencemaran nama baik. Doddy pun memenuhi undangan pemeriksaan tersebut. https://t.co/wQCOHuUOh8",3,3,1,1,2022-01-10,5,Monday,1,4,4
1480413143004332041,2022-01-10 05:36:12,"“Pemerintah kan dapat cuan dari harga ekspor yang tinggi, instrumen fiskalnya bisa saling menopang. Kita juga nggak mau beban rakyat sudah berat, kalau harus naik TDL,” kata Ketua Umum Aspebindo Anggawira. Simak selengkapnya di: https://t.co/X4ckTP8pKj https://t.co/FqjX2XgYIr",7,1,3,0,2022-01-10,5,Monday,1,10,1
1480412644364496903,2022-01-10 05:34:13,Varian Omicron menyebar dengan sangat cepat di Indonesia. Jenis masker apa yang terbaik untuk perlindungan terhadap varian Omicron? https://t.co/DextlrG6ZN,5,7,0,1,2022-01-10,5,Monday,1,5,8
1480412239282597892,2022-01-10 05:32:37,"Sepanjang tahun 2021, Kita sudah melewati banyak #AktivitasTanpaBatas yang seru!
-
Selamat datang 2022, di tahun ini, IndiHome akan terus berkomitmen untuk menemani dan memberikan hiburan terbaik untuk Sobat
-
#InternetnyaIndonesia https://t.co/2SsGVC1gAa",3,1,0,0,2022-01-10,5,Monday,1,3,1
1480411298512920576,2022-01-10 05:28:52,Kasus penyalahgunaan narkoba yang melibatkan public figure kembali terjadi. Kali ini seorang penyanyi dangdut wanita ditangkap polisi karena kasus narkoba. https://t.co/I45hGgMzuR,17,25,3,2,2022-01-10,5,Monday,1,20,27
1480411103708467200,2022-01-10 05:28:06,"Pada awal 2022 ini, harga Bitcoin sempat jatuh ke level terendahnya. Saatnya beli nih? https://t.co/mWQMmKGM9f",10,0,3,0,2022-01-10,5,Monday,1,13,0
1480410839588945922,2022-01-10 05:27:03,Ibadah umrah untuk jamaah asal Indonesia kembali dibuka sejak kemarin. Kemenag dengan asosiasi telah menetapkan biaya umrah 2022 sebesar Rp 28 juta. https://t.co/U9QJkNVzSd,22,2,4,2,2022-01-10,5,Monday,1,26,4
1480410031938023424,2022-01-10 05:23:50,"Soto daging sapi khas Betawi ini berkuah santan dan gurih mantap rasanya. Dipadukan dengan tomat dan suun rasanya makin enak, apalagi saat hangat. https://t.co/C0hzUh1yop",6,0,0,0,2022-01-10,5,Monday,1,6,0
1480409275889500162,2022-01-10 05:20:50,Film 'Don't Look Up' yang dibintangi Leonardo DiCaprio dan Jennifer Lawrence ini dapat banyak pujian. Ilmu sains dilibatkan dalam filmnya. https://t.co/dIpfyzef9W,14,1,2,0,2022-01-10,5,Monday,1,16,1
1480409257677832200,2022-01-10 05:20:46,"Setelah sempat mulai naik lagi pada awal pekan lalu, hari ini harga emas batangan 24 karat tersebut turun ceceng. Jadi segini harganya: https://t.co/vGUoYs6pjp",0,1,0,0,2022-01-10,5,Monday,1,0,1
1480408525381713920,2022-01-10 05:17:51,"""Langkah Nadiem Makarim dalam menerapkan perubahan kurikulum sebenarnya sebuah terobosan besar dalam pendidikan,"" ucap pengamat pendidikan, Bukik Setiawan. Via: detikedu https://t.co/CJGen8V7CX",4,1,0,0,2022-01-10,5,Monday,1,4,1
1480407707618361349,2022-01-10 05:14:36,"Micro-lockdown diterapkan di RW 02, Krukut, Tamansari, Jakarta Barat, usai 36 warganya positif COVID-19, satu di antaranya dilaporkan suspek varian Omicron. https://t.co/CP630GCLk0",7,2,1,0,2022-01-10,5,Monday,1,8,2
1480407196177477636,2022-01-10 05:12:34,Rizky Billar dan Lesti Kejora akhirnya memperlihatkan wajah sang buah hati. Proses itu disiarkan langsung oleh salah satu stasiun televisi swasta. Ini potretnya:  https://t.co/NPh4YlP4xK,9,18,1,9,2022-01-10,5,Monday,1,10,27
1480406665652539392,2022-01-10 05:10:28,Beredar lagi surat berisi pengangkatan tenaga guru honorer berusia lebih dari 35 tahun. Berikut fakta-faktanya: https://t.co/dRSJ0bdPTP,1,0,1,0,2022-01-10,5,Monday,1,2,0
1480405912602955778,2022-01-10 05:07:28,"Sudah ada 31 transmisi lokal Omicron di Indonesia, warga harus teliti memilih masker yang tepat. Berikut tiga jenis masker tidak efektif: https://t.co/CPY0cg9GHM",5,1,1,1,2022-01-10,5,Monday,1,6,2
1480405306085683201,2022-01-10 05:05:04,Legislator PDIP Rahmad Handoyo melempar kritik keras kepada Pandu Riono. Hal itu terkait pernyataan Pandu Riono yang bilang masyarakat ditakuti Omicron. https://t.co/hAZy6N9TcG,4,2,0,1,2022-01-10,5,Monday,1,4,3
1480404439295004677,2022-01-10 05:01:37,Potret Wakil Bupati Bandung Sahrul Gunawan mengenakan jaket beratribut Golkar jadi perbincangan netizen. Sahrul pun memberikan reaksinya terkait hal itu. https://t.co/uj0w6Luip2,6,1,0,0,2022-01-10,5,Monday,1,6,1
1480404128178360324,2022-01-10 05:00:23,Toyota akan menampilkan mobil dengan performa tinggi di ajang Tokyo Auto Salon 2022. Toyota Gazoo Racing (TGR) akan menampilkan mobil modifikasinya.  https://t.co/7TubrVSeC1,7,0,1,0,2022-01-10,5,Monday,1,8,0
1480404097132072963,2022-01-10 05:00:15,Ayu Aulia mengaku sedang dekat dengan Zikri Daulay. Ini awal mula kedekatan Ayu Aulia dengan Zikri Daulay:  https://t.co/AAumcuuKVQ,2,0,0,0,2022-01-10,5,Monday,1,2,0
1480403554393370624,2022-01-10 04:58:06,"Sebuah mobil menabrak motor dan minimarket di Pekanbaru, Riau malam tadi. Akibat kejadian itu tiga orang luka-luka. https://t.co/GkYHdomWfY",6,3,0,0,2022-01-10,4,Monday,1,6,3
1480403537985253383,2022-01-10 04:58:02,Megawati Soekarnoputri bicara soal pentingnya sejarah perjuangan bangsa. Dia meminta sejarah perjuangan diajarkan di dunia pendidikan. https://t.co/MOj3HyjdxE,9,9,2,6,2022-01-10,4,Monday,1,11,15
1480402759669227522,2022-01-10 04:54:57,"Akun Twitter resmi Pemerintah Kota (Pemkot) Depok me-retweet unggahan berisi ajakan mencari informasi keluarga Ipda M Yusmin Ohorella, salah satu polisi yang menembak laskar FPI. https://t.co/tZeUnqIX5c",8,1,0,0,2022-01-10,4,Monday,1,8,1
1480402484048900097,2022-01-10 04:53:51,"Unesa tengah menjadi sorotan. Sebab, salah seorang dosennya diduga melakukan pelecehan seksual pada mahasiswi. https://t.co/LrodMj3buz",20,3,11,2,2022-01-10,4,Monday,1,31,5
1480402033358344193,2022-01-10 04:52:03,Megawati Soekarnoputri menceritakan perjuangan PDIP sebagai partai wong cilik dan partai sandal jepit. Seperti apa cerita Mega? https://t.co/CQdO0aYt2N,13,23,1,2,2022-01-10,4,Monday,1,14,25
1480401452124282881,2022-01-10 04:49:45,Salah satu penyanyi dangdut Tanah Air inisial V disebut telah dibekuk lantaran kasus narkotika. https://t.co/qwUqJ1OL9w,380,321,60,39,2022-01-10,4,Monday,1,440,360
1480401189468581891,2022-01-10 04:48:42,Salah satu trik agar anak mau makan adalah dengan membuat tampilan makanan jadi menarik. Seperti kreasi bento untuk dan lucu berbentuk tokoh kartun ini. https://t.co/TtlxBJsaY5,4,1,0,1,2022-01-10,4,Monday,1,4,2
1480400634914430981,2022-01-10 04:46:30,Ferdinand Hutahaean membawa bukti riwayat kesehatannya. https://t.co/7qTDT8xyXs,12,59,3,14,2022-01-10,4,Monday,1,15,73
1480400022160261120,2022-01-10 04:44:04,Seorang model lewat akun media sosialnya menceritakan jika dirinya dilacak dan dikuntit seseorang menggunakan AirTag selama lima jam. Duh...  https://t.co/fXCZjt5wA3,1,0,2,0,2022-01-10,4,Monday,1,3,0
1480399776147550210,2022-01-10 04:43:05,Kiper Senegal Edouard Mendy dan kapten Kalidou Koulibaly harus melewatkan laga perdana Piala Afrika 2021. Sebab keduanya dinyatakan positif COVID-19. https://t.co/COj2ChCkZw,1,0,0,0,2022-01-10,4,Monday,1,1,0
1480399218657439746,2022-01-10 04:40:52,Spesies pohon yang baru ditemukan diberi nama unik yakni dengan mengambil nama aktor Leonardo DiCaprio. Ternyata ini alsannya:  https://t.co/AknhFxZQsk,6,0,1,2,2022-01-10,4,Monday,1,7,2
1480398972359528449,2022-01-10 04:39:54,"Gempa kembali mengguncang wilayah Halmahera Utara dengan magnitudo 5,5. Tercatat sejumlah rumah warga dilaporkan mengalami kerusakan. https://t.co/08D7IwlHSF",7,0,2,0,2022-01-10,4,Monday,1,9,0
1480398405109272576,2022-01-10 04:37:38,Eks Direktur WHO Asia Tenggara Prof. Tjandra Yoga Aditama memberikan penjelasan terkait Super Immunity atau kekebalan super Covid-19 yang kini tengah ramai diperbincangkan. Simak selengkapnya: https://t.co/j0IDehoouB,2,0,0,0,2022-01-10,4,Monday,1,2,0
1480398177480101890,2022-01-10 04:36:44,"Kabar duka datang dari komedian Bob Saget. Ia ditemukan meninggal dunia di sebuah kamar hotel di Florida, Amerika Serikat. Polisi masih menyelidiki penyebab kematian Bob. #BobSaget  https://t.co/AzHw16izBq",5,1,1,1,2022-01-10,4,Monday,1,6,2
1480398163437666308,2022-01-10 04:36:41,Kemenkes RI mengungkap 8 orang positif COVID-19 dari rombongan Ashanty. Hasil whole genome sequencing benar menunjukkan terpapar Omicron? https://t.co/linjcjWyaO,3,1,0,1,2022-01-10,4,Monday,1,3,2
1480397899305521156,2022-01-10 04:35:38,Ferdinand Hutahaean sambangi Bareskrim Polri untuk penuhi panggilan polisi. Ia datang untuk diperiksa. Begini ekspresinya: https://t.co/yeraAwILU6,1,0,2,0,2022-01-10,4,Monday,1,3,0
1480397876215828484,2022-01-10 04:35:32,#Foto Bob Saget dilaporkan meninggal dunia di usia 65. Pria itu dikenal sebagai aktor dan komedian yang berperan sebagai duda empat orang puri di Full House. https://t.co/KLJ8BVRpYc,15,0,0,0,2022-01-10,4,Monday,1,15,0
1480397385629159424,2022-01-10 04:33:35,Tercatat sudah tiga kali kasus Corona tembus 500 kasus dalam sehari di awal Januari 2022. https://t.co/hwUOTe6qIx,10,1,3,0,2022-01-10,4,Monday,1,13,1
1480397164685709312,2022-01-10 04:32:43,"Jae eks DAY6 ramai dibicarakan lantaran dalam sebuah siaran langsung di sebuah platform live streaming, dia mengatakan bahwa Jamie adalah perempuan tak baik.  https://t.co/7PPzhABi4p",3,0,1,0,2022-01-10,4,Monday,1,4,0
1480397151381434372,2022-01-10 04:32:39,"Warga kesulitan akses ke luar rumah, karena kondisi jalanan utama rusak parah. Bahkan jalan paving ambles sedalam 2 meter. #Jember https://t.co/4TnQsyquZq",3,1,0,0,2022-01-10,4,Monday,1,3,1
1480396594856046595,2022-01-10 04:30:27,PDIP menggelar acara puncak hari jadinya ke-49. Presiden Jokowi dan Wakil Presiden Ma'ruf Amin hingga seluruh jajaran kabinet hadir virtual. https://t.co/A9uEoSzNy5,2,0,0,0,2022-01-10,4,Monday,1,2,0
1480396576019390464,2022-01-10 04:30:22,Meski hukumnya sunnah namun doa qunut Subuh dianjurkan untuk dibaca sebagai salah satu cara menyempurnakan salat. Berikut bacaan doanya. https://t.co/dHcmvcr0kD,14,0,2,0,2022-01-10,4,Monday,1,16,0
1480396084920963080,2022-01-10 04:28:25,Perhitungan pesangon karyawan tetap yang kena PHK bisa menjadi informasi yang penting saat ini. Begini faktanya: https://t.co/JytBGkel2b,9,0,2,1,2022-01-10,4,Monday,1,11,1
1480396073508220932,2022-01-10 04:28:23,"Bagi mahasiswa lulusan S1, ada kabar gembira nih. SM Entertainment Indonesia buka lowongan posisi Administrative Assistant. Yuk, cek persyaratannya! #infoloker https://t.co/ewjQdr8T2X",19,3,4,5,2022-01-10,4,Monday,1,23,8
1480395431196565505,2022-01-10 04:25:49,"Bulan lalu badan antariksa China ngaku menemukan objek 'rumah misterius' di Bulan. Ternyata setelah didekati, objek ini hanya batu biasa.  https://t.co/luPN1P308v",11,1,0,2,2022-01-10,4,Monday,1,11,3
1480394931474780160,2022-01-10 04:23:50,Terdakwa kasus korupsi tanah kuburan itu meninggal akibat sakit kanker paru-paru. https://t.co/5b5ku4jc1L,13,5,4,3,2022-01-10,4,Monday,1,17,8
1480394483539877891,2022-01-10 04:22:03,Bos MNC Group Hary Tanoesoedibjo memamerkan foto bersama Presiden Ke-45 AS Donald Trump di media sosialnya. Keduanya diketahui menghabiskan makan malam bersama. https://t.co/ohFBciWpmp,17,1,3,4,2022-01-10,4,Monday,1,20,5
1480393676790669315,2022-01-10 04:18:51,Aksi pria membuang dan menendang sesajen di lokasi terdampak erupsi Semeru tengah menjadi perbincangan. Polda Jatim membentuk tim dalam memburu pria tersebut. https://t.co/N1AACN2ABx,55,38,8,11,2022-01-10,4,Monday,1,63,49
1480393658734198793,2022-01-10 04:18:47,"Bagi kamu yang sedang merasa pekerjaan ini berat, berikut kata-kata motivasi pagi agar lebih semangat kerja ke kantor. Yuk, coba lihat! https://t.co/aJfv0mhnw1",7,1,1,1,2022-01-10,4,Monday,1,8,2
1480393418639609862,2022-01-10 04:17:50,Jessica Chastain belum lama tampil dalam film The Eyes of Tammy Faye dan kebagian adegan bernyanyi. Tapi ternyata ia lebih pede tampil telanjang bulat. https://t.co/ewkEtXBhsy,4,0,0,1,2022-01-10,4,Monday,1,4,1
1480392880053268486,2022-01-10 04:15:41,"Bakal digelar 12 Januari, ada dua skema vaksin booster COVID-19 yakni gratis dan berbayar. Siapa yang bisa dapat gratis? Cek di sini: https://t.co/yYcZEoDUPT",8,1,3,2,2022-01-10,4,Monday,1,11,3
1480392123358797824,2022-01-10 04:12:41,Piala Afrika 2021 sudah dimulai. Akankah hadir pula kisah-kisah juju dan voodoo di ajang yang juga disebut AFCON atau CAN itu? https://t.co/CuEuYavRXm,2,1,2,0,2022-01-10,4,Monday,1,4,1
1480391399187099655,2022-01-10 04:09:48,Kurikulum prototipe akan menjadi kurikulum skala nasional pada 2024. Apa yang harus dipersiapkan guru dan sekolah? Via: detikedu https://t.co/XRubzItZyU,7,0,1,1,2022-01-10,4,Monday,1,8,1
1480390629217734658,2022-01-10 04:06:44,Sejumlah ponsel BlackBerry lawas harus sayonara karena BlackBerry OS dimatikan. Namun BlackBerry 5G kabarnya tetap akan dirilis. #BlackBerry  https://t.co/LWZt2n9yoG,8,0,1,0,2022-01-10,4,Monday,1,9,0
1480390358961991683,2022-01-10 04:05:40,Komedian Bob Saget meninggal dunia. Ia ditemukan meninggal dunia di sebuah kamar hotel. #BobSaget  https://t.co/9du3bPL831,5,1,1,1,2022-01-10,4,Monday,1,6,2
1480390357816942592,2022-01-10 04:05:40,Megawati membuka HUT ke-49 PDI Perjuangan dengan menyapa sederet tokoh yang hadir. Nama Ahok disapa secara khusus. https://t.co/aOnUP3dpJ7,22,2,3,1,2022-01-10,4,Monday,1,25,3
1480390091902173185,2022-01-10 04:04:36,"Wanita ini lulusan D3 Manajemen Transportasi Laut, pekerjaan saat ini tukang foto keliling. Bagaimana kisahnya? https://t.co/WnRWxZLQhN",8,2,4,1,2022-01-10,4,Monday,1,12,3
1480389229121355786,2022-01-10 04:01:11,Prediksi keuangan menjadi yang paling banyak dicari di awal 2022. Bunda yang penasaran bisa coba membaca ramalan shio untuk memprediksi peluang keberuntungan. #detiknetwork  https://t.co/Std15pBMrf,3,1,1,0,2022-01-10,4,Monday,1,4,1
1480388444899659776,2022-01-10 03:58:04,Apakah kamu punya teman dengan zodiak Capricorn? Atau diri sendiri adalah seorang Capricorn? Ini 7 sifat zodiak yang paling istimewa: #Zodiak https://t.co/8HCkRi7ukc,3,2,0,0,2022-01-10,3,Monday,1,3,2
1480387902169354250,2022-01-10 03:55:54,Asosiasi pengusaha batu bara mengusulkan agar pemerintah menaikkan harga DMO batu bara. Hal ini untuk menyiasati perbedaan harga jual batu bara di pasar global. Tapi kenaikan ini tak mesti diikuti PLN dengan menaikan tarif dasar listrik yang akan membeb... https://t.co/vdbOcVExsh,3,0,0,1,2022-01-10,3,Monday,1,3,1
1480387086717001733,2022-01-10 03:52:40,Ada satu tempat nongkrong di ibukota yang recommended! Lokasinya berada di sekitar Kuningan. https://t.co/uuyDKfYc0q,7,1,2,1,2022-01-10,3,Monday,1,9,2
1480386463850274816,2022-01-10 03:50:11,Ayu Aulia blak-blakan soal Zikri Daulay. Ia ingin jadi pribadi lebih baik usai dekat dengan Zikri. https://t.co/gBuWfsbuL8,6,6,0,0,2022-01-10,3,Monday,1,6,6
1480385466046234624,2022-01-10 03:46:13,Vinicius Junior mencintai Real Madrid. Ada beberapa bukti yang memperlihatkannya di lapangan permainan. https://t.co/7wngmWp3SB,10,0,0,0,2022-01-10,3,Monday,1,10,0
1480384213782257666,2022-01-10 03:41:15,Rumah tangga Kalina Oktarani dengan Vicky Prasetyo jadi sorotan. Vicky ngaku jika Kalina meminta pisah darinya. https://t.co/ghVsphsbv2,7,9,1,0,2022-01-10,3,Monday,1,8,9
1480383698893742080,2022-01-10 03:39:12,"Bentrokan antarwarga di Wamena terjadi lagi. Bentrok antara warga Nduga dan Lanny Jaya itu menyebabkan satu orang tewas, 22 luka-luka dan 34 rumah dibakar. https://t.co/meKfElHaVQ",3,2,1,0,2022-01-10,3,Monday,1,4,2
1480383195283693569,2022-01-10 03:37:12,Pihak Dhena Devanka sempat menyebut sudah berdamai dengan Jonathan Frizzy. Tapi berbeda dengan perkataan tim kuasa hukum Ijonk ini:  https://t.co/ZZfj2awqVQ,0,1,0,0,2022-01-10,3,Monday,1,0,1
1480382384243720197,2022-01-10 03:33:59,"Untuk konsumsi bahan bakarnya, Mercedes-Benz E 300 AMG Line ini tergolong efisien. #MercedesBenz  https://t.co/fCbYGW9DLV",8,1,1,0,2022-01-10,3,Monday,1,9,1
1480381612244320259,2022-01-10 03:30:55,"Hujan deras menyebabkan Sungai Rejoso Pasuruan meluap. Luapan sungai menyebabkan banjir di Desa Kedawung Kulon, Kecamatan Grati. https://t.co/3gsIUENfyK",11,0,1,0,2022-01-10,3,Monday,1,12,0
1480380861115686915,2022-01-10 03:27:56,Video berdurasi tiga puluh detik yang heboh di media sosial ini memperlihatkan seorang pria mengenakan tutup kepala dan rompi melemparkan dan menendang sesajen hingga terjatuh. Aksi tersebut dia lakukan di lokasi erupsi Gunung Semeru. https://t.co/FlVEUIveLw,4,2,0,1,2022-01-10,3,Monday,1,4,3
1480379843099480070,2022-01-10 03:23:53,"Wakil Bupati nonaktif Ogan Komering Ulu (OKU), Sumatera Selatan, Johan Anuar meninggal dunia. Johan meninggal pagi tadi di RS Siti Khodijah. https://t.co/JWgwzey4jf",11,2,2,0,2022-01-10,3,Monday,1,13,2
1480379350864302080,2022-01-10 03:21:56,"Banjir menerjang kawasan perumahan Bumi Mangli Permai (BMP), Kecamatan Kaliwates, Jember. Ketinggian air sempat mencapai leher orang dewasa. Sebuah mobil hanyut terbawa derasnya arus. https://t.co/BdpIOoa07z",9,1,3,0,2022-01-10,3,Monday,1,12,1
1480378832209256452,2022-01-10 03:19:52,Menu nabati (plant-based) kini kian diminati. Eath menyajikan 'chicken wings' plant-based yang ternyata tak kalah lezat dibanding chicken wings sungguhan. https://t.co/GDlNljc2KU,6,0,0,0,2022-01-10,3,Monday,1,6,0
1480378809719439361,2022-01-10 03:19:47,Pemilik kendaraan di wilayah Jadetabek dapat mengunjungi 14 titik layanan Samsat Keliling yang disediakan oleh Polda Metro Jaya. Ini daftarnya:  https://t.co/mSYcpQm07i,5,0,0,0,2022-01-10,3,Monday,1,5,0
1480378526767489028,2022-01-10 03:18:39,"Jose Mourinho tak menyembunyikan kekecewaannya kala AS Roma kalah 3-4 dari Juventus. Dua kali memimpin lalu tumbang, Roma diakuinya bermental lemah. https://t.co/o57Fbg1wfK",16,0,3,0,2022-01-10,3,Monday,1,19,0
1480378040995749889,2022-01-10 03:16:43,Arsenal tersingkir cepat di Piala FA usai disingkirkan Nottingham Forest. The Tricky Trees membuktikan kalau mereka adalah momok The Gunners di ajang ini. https://t.co/aYKBzk7UVM,8,2,1,0,2022-01-10,3,Monday,1,9,2
1480378015787978752,2022-01-10 03:16:37,Apple kabarnya sedang mengembangkan beberapa prototipe iPhone layar lipat. Tapi perangkat ini sepertinya tidak akan diluncurkan dalam waktu dekat. https://t.co/o2Q5iUPfLB,12,3,2,0,2022-01-10,3,Monday,1,14,3
1480377226604470272,2022-01-10 03:13:29,"Raffi Ahmad bikin heboh di media sosialnya. Influencer itu menebar kode ingin membawa Mesut Oezil ke klubnya, RANS CIlegon. https://t.co/5Lm01Ig6ii",52,15,2,6,2022-01-10,3,Monday,1,54,21
1480376970366144512,2022-01-10 03:12:28,Kaca jendela pesawat yang retak bahkan pecah dapat membahayakan seisi pesawat. Ada langkah penyelamatan yang harus diikuti penumpang. https://t.co/AMB9GHtxOh,9,0,1,0,2022-01-10,3,Monday,1,10,0
1480376468081369091,2022-01-10 03:10:28,"Dear Gemini, selagi masih punya waktu mengejar ketertinggalan mengapa mesti ragu. Terus berusaha ya! Mau tahu #RamalanZodiak lainnya? https://t.co/cJrks1sWdP",7,1,0,3,2022-01-10,3,Monday,1,7,4
1480375742194229249,2022-01-10 03:07:35,"Kasusnya bertambah menjadi 414, total transmisi lokal Omicron di Indonesia jadi 50 kasus. Sumber penularan dari mana saja? https://t.co/EcNOcVkuQK",8,4,2,0,2022-01-10,3,Monday,1,10,4
1480374701268639747,2022-01-10 03:03:27,"Raffi Ahmad mengatakan bakal memboyong salah satu legenda pemain sepakbola ke Indonesia, siapa dia? https://t.co/VHA2epKZ6i",71,56,2,74,2022-01-10,3,Monday,1,73,130
1480373832401698818,2022-01-10 03:00:00,"Kemenkes RI melaporkan 414 total kasus COVID-19 varian Omicron di RI, bertambah 75 kasus termasuk 31 kasus transmisi lokal. Bagaimana kondisinya? https://t.co/W1wUWFnqO6",5,1,1,0,2022-01-10,3,Monday,1,6,1
1480373831156092933,2022-01-10 03:00:00,"Pesawat robotik China Chang'e 5 menemukan bukti keberadaan air di permukaan bulan, yang selama ini dianggap tak mempunyai air. https://t.co/dvYVn3I7Im",63,25,17,49,2022-01-10,3,Monday,1,80,74
1480373268410507269,2022-01-10 02:57:45,Berbagai upaya dilakukan Pertamina untuk memangkas impor. Salah satu langkah yang dilakukan ialah dengan mengembangkan Kilang Balikpapan. https://t.co/bMP9Gx7M9F,6,1,0,0,2022-01-10,2,Monday,1,6,1
1480372551230660608,2022-01-10 02:54:54,PT PLN (Persero) pernah dimintai THR oleh anggota DPR. Begini ceritanya: https://t.co/jpJidzvIta,10,9,0,0,2022-01-10,2,Monday,1,10,9
1480371505888436230,2022-01-10 02:50:45,"Puluhan driver ojek online (online) menggeruduk Polsek Pamulang, Minggu (9/1/2022) malam. Ada apa? https://t.co/MUs7GccEep",3,0,2,0,2022-01-10,2,Monday,1,5,0
1480370743250763776,2022-01-10 02:47:43,"Kamu siswa dari jurusan IPS tapi masih bingung memilih jurusan kuliah? Jangan khawatir, ini daftar jurusan kuliah yang bergaji tinggi versi anak IPS. Via: detikedu https://t.co/9DY36Rfz2w",6,0,1,1,2022-01-10,2,Monday,1,7,1
1480370251393114112,2022-01-10 02:45:46,Partai Ummat resmi mengajukan gugatan UU Pemilu. Aturan itu disebut membuat tidak bisa mengusung capres di 2024 nanti. https://t.co/QxHGeexDpG,34,29,6,4,2022-01-10,2,Monday,1,40,33
1480369507818520578,2022-01-10 02:42:49,Ada luka gigitan besar di punggung salah satu hiu putih. Luka itu terekam kamera seorang fotografer. Makhluk apa yang gigit? https://t.co/r3EJ7CWKMy,14,7,1,1,2022-01-10,2,Monday,1,15,8
1480367888947154945,2022-01-10 02:36:23,Lesti Kejora dan Rizky Billar mengumumkan nama anak mereka. Anak laki-laki ialah Muhammad Leslar Al-fatih Billar. Netizen pun mengomentari nama tersebut. https://t.co/82580IgX9O,57,32,1,6,2022-01-10,2,Monday,1,58,38
1480366631121522688,2022-01-10 02:31:23,Mikel Arteta mengakui Arsenal tampil buruk sehingga dikalahkan Nottingham Forest. Manajer The Gunners itu pun meminta maaf kepada fans. https://t.co/FI5qA6syD0,5,0,0,1,2022-01-10,2,Monday,1,5,1
1480365622924038150,2022-01-10 02:27:23,Kerinduan Abdul Hamid atau Pak Ogah kepada Pak Raden pecah saat memeluk boneka Pak Ogah di kediamannya...  https://t.co/TEH8okktBV,154,4,24,3,2022-01-10,2,Monday,1,178,7
1480364586889007108,2022-01-10 02:23:16,"Puluhan jemaah di Tasikmalaya, Jawa Barat, mengalami kecelakaan lalu lintas saat hendak pengajian. Pasalnya, kendaraan bak yang mereka tumpangi terbalik saat menyalip sepeda motor. Belasan orang terluka. https://t.co/1I37VHpwwz",4,1,0,0,2022-01-10,2,Monday,1,4,1
1480363402484764673,2022-01-10 02:18:33,Kerusuhan di Kazakhstan semakin parah. Lebih dari 160 orang dilaporkan tewas dan hampir 6.000 orang ditangkap. https://t.co/bRNKzkshzC,15,0,2,1,2022-01-10,2,Monday,1,17,1
1480362401329520649,2022-01-10 02:14:34,Abdel membuat pernyataan soal kecanduan narkoba. Terlebih saat dirinya sedang mengisi acara bersama Mamah Dedeh. Ini yang bikin Abdel sadar dan jauhkan narkoba:  https://t.co/WtD7ObRqFl,32,2,4,2,2022-01-10,2,Monday,1,36,4
1480361418302099457,2022-01-10 02:10:40,Kalina Oktarani ngaku ingin berpisah dengan Vicky Prasetyo. Hal itu sudah dibenarkan oleh Vicky. Ini yang akan dilakukan Vicky Prasetyo:  https://t.co/myCuCqbhrV,64,85,12,7,2022-01-10,2,Monday,1,76,92
1480360380325052422,2022-01-10 02:06:33,Ricky Cuaca sudah menegaskan tidak memiliki boneka arwah seperti kebanyakan artis. Ia pun kesal dituding memelihara boneka tersebut. Ini penegasan Ricky Cuaca:  https://t.co/0zJ7qPW42p,4,0,0,0,2022-01-10,2,Monday,1,4,0
1480359180066246659,2022-01-10 02:01:46,Seorang nelayan di Aceh mengaku tertekan dengan kebijakan Pemerintah Kota Lhokseumawe yang akan merelokasi keramba budidaya ikan di Waduk Pusong. #CNNIndonesia #detiknetwork  https://t.co/f3LtUMAZYn,1,0,3,0,2022-01-10,2,Monday,1,4,0
1480357931287814145,2022-01-10 01:56:49,Ciro Immobile bikin satu gol ke gawang Inter Milan. Catatan itu membuat striker Lazio tersebut masuk daftar elite. #CiroImmobile https://t.co/AG3GZlP2rq,6,1,0,0,2022-01-10,1,Monday,1,6,1
1480356931755823112,2022-01-10 01:52:50,Kalina Oktarani mengumumkan sudah single dan berpisah dengan Vicky Prasetyo. Ini momen kebersamaan mereka:  https://t.co/FtRVYSogF7,7,3,0,2,2022-01-10,1,Monday,1,7,5
1480355945448452097,2022-01-10 01:48:55,"Lama tak terdengar kabarnya, Kalina Oktarani membawa kabar tak mengenakkan di awal 2022. Dia mengumumkan statusnya single. Lho kok? https://t.co/3d55AtVUCB",10,5,0,1,2022-01-10,1,Monday,1,10,6
1480354925926309888,2022-01-10 01:44:52,- Ashanty sampai hari ini masih berada di rumah sakit untuk menjalani isolasi karena COVID-19. Ashanty kini ogah tanggapi omongan miring netizen. https://t.co/8bmsJGLzl3,8,5,1,3,2022-01-10,1,Monday,1,9,8
1480353386444824577,2022-01-10 01:38:45,"#Terpopuler Ade menilai penangkapan ayahnya oleh KPK bermuatan politis. Menurutnya, Partai Golkar sedang diincar. https://t.co/F6EXIwgDAE",19,28,1,7,2022-01-10,1,Monday,1,20,35
1480352138719023110,2022-01-10 01:33:48,"#Terpopuler Polisi menilang pemotor yang ditabrak mobil hingga terlempar dari flyover Pesing, Jakbar. Dalam aturan yang berlaku, motor dilarang melintasi flyover Pesing. https://t.co/x9HNli9ndL",14,5,2,2,2022-01-10,1,Monday,1,16,7
1480350879299612676,2022-01-10 01:28:47,"#Terpopuler Annisa tidak sadarkan diri tidak lama setelah mengetuk pintu rumahnya. Saat datang, Annisa mengenakan masker dan kerudung hitam. https://t.co/bUwnPtdH9G",9,0,0,1,2022-01-10,1,Monday,1,9,1
1480349899711520768,2022-01-10 01:24:54,"#Terpopuler Kumpulan Bangkai pesawat menyita perhatian warga Desa Pondok Udik, Bogor. Ternyata bangkai pesawat itu sudah ada sejak tahun 2019. https://t.co/vLuQlLBxRX",11,6,1,0,2022-01-10,1,Monday,1,12,6
1480348615046582273,2022-01-10 01:19:48,#Terpopuler Seorang pria menendang sesajen yang disebut berada di wilayah Semeru. Aksi pria menendang sesajen itu viral. https://t.co/dUfGVMvmvY,19,9,0,2,2022-01-10,1,Monday,1,19,11
1480347092551884803,2022-01-10 01:13:45,Sekjen PDIP Hasto Kristiyanto bicara kisi-kisi kader partai yang potensial untuk maju Pilgub DKI 2024. Siapa saja? https://t.co/X9q0BPouNq,5,10,0,1,2022-01-10,1,Monday,1,5,11
1480341646416007169,2022-01-10 00:52:06,"Jagad media sosial di Baubau, Sulawesi Tenggara dihebohkan dengan beredarnya video mesum yang diperankan sejoli pelajar. Polisi sudah turun tangan menyelidiknya https://t.co/WRptYfKRT0",2,3,0,1,2022-01-10,0,Monday,1,2,4
1480340799506235392,2022-01-10 00:48:44,"Tottenham Hotspur boleh mendominasi, tapi tertinggal dari Morecambe bikin laga amat sulit buat mereka. Perubahan di babak kedua menjadi solusi tepat buat Spurs. https://t.co/bh9fIIkYiy",6,0,0,0,2022-01-10,0,Monday,1,6,0
1480340302670008322,2022-01-10 00:46:46,"Kebakaran dahsyat terjadi di New York, Amerika Serikat (AS). Ada 19 orang yang tewas akibat kebakaran tersebut. https://t.co/fp0pbfoFba",10,1,1,1,2022-01-10,0,Monday,1,11,2
1480339801995976713,2022-01-10 00:44:46,Anggaran kunker ke luar negeri DPRD DKI naik jadi Rp 45 M. Formappi kritik keras anggaran tersebut. https://t.co/FWMDOrTCJf,10,2,1,4,2022-01-10,0,Monday,1,11,6
1480338814514212871,2022-01-10 00:40:51,Kasus penularan Omicron paling banyak berasal dari Turki dan Arab Saudi. Mayoritas pasien Omicron sudah divaksinasi COVID-19 lengkap. https://t.co/XUIP8xzhcR,8,1,3,2,2022-01-10,0,Monday,1,11,3
1480338564764348416,2022-01-10 00:39:51,"PDIP mengkritik kondisi Tanah Abang seperti 'poco-poco' karena masih macet. Anggapan itu menuai pro dan kontra, simak selengkapnya. https://t.co/UizCLXIs6U",6,0,0,1,2022-01-10,0,Monday,1,6,1
1480337539970048007,2022-01-10 00:35:47,"Terjadi lagi kasus pesepakbola kolaps di tengah pertandingan. Kasus hadir di liga Qatar, di mana salah satu pesepakbola sampai kejang-kejang di lapangan. https://t.co/4ps96a70aP",6,1,1,1,2022-01-10,0,Monday,1,7,2
1480336769748975618,2022-01-10 00:32:43,"Daerah Ngupit di Klaten, memiliki sejarah panjang profesi tukang sunat atau bong supit. Profesi tersebut bahkan sudah sejak masa kerajaan Mataram Islam. https://t.co/SNPhp52bJh",3,0,2,1,2022-01-10,0,Monday,1,5,1
1480336751948410881,2022-01-10 00:32:39,"Satu unit truk pengangkut galon air mineral mogok di flyover Kalibata, Jakarta Selatan (Jaksel). Akibatnya, arus lalu lintas di flyover Kalibata macet. https://t.co/lkFmnc1QCr",3,0,0,2,2022-01-10,0,Monday,1,3,2
1480336435349798914,2022-01-10 00:31:24,Gubernur DKI Jakarta Anies Baswedan akan purnatugas di akhir tahun ini. Apa yang dilakukan Anies usai jadi Gubernur DKI? https://t.co/X6bTrUV227,34,17,2,5,2022-01-10,0,Monday,1,36,22
1480336149004664837,2022-01-10 00:30:15,"Geger temuan ilmuwan soal klaim varian baru dinamai Deltacron, gabungan varian Delta dan Omicron. Sekitar 25 orang disebut sudah terinfeksi. https://t.co/lSaqQYqI2Q",177,200,52,228,2022-01-10,0,Monday,1,229,428
1480335157966082058,2022-01-10 00:26:19,"Dalam peta dunia saat ini dan diskursus mutakhir, visi Gus Yahya akan dianggap anomali. Sebuah penyimpangan atau keanehan. https://t.co/6Os72ujpO5",1,0,1,1,2022-01-10,0,Monday,1,2,1
1480333836194131970,2022-01-10 00:21:04,Wasekjen MUI Ziyad menyesalkan tindakan pria yang buang-tendang sesajen di lokasi terdampak erupsi Semeru. Dia menilai sikap tersebut tidak perlu dilakukan. https://t.co/kGZL3R0s9H,224,107,30,17,2022-01-10,0,Monday,1,254,124
1480332989548662792,2022-01-10 00:17:42,Pengurus Provinsi IMI Jambi baru saja melantik AM Guntur Muchtar sebagai ketua umum yang baru. Muchtar sudah punya visi-misi untuk tiga tahun ke depan. https://t.co/7nP3ytuKd9,4,0,0,0,2022-01-10,0,Monday,1,4,0
1480332252651343887,2022-01-10 00:14:46,Putri Arab Saudi akhirnya bisa menghirup udara segar usai 3 tahun dibui. Mereka sebelumnya mendekam di balik jeruji besi tanpa dakwaan di Ibu Kota Riyadh. https://t.co/0AKy1zkpVw,14,3,4,0,2022-01-10,0,Monday,1,18,3
1480331220428931074,2022-01-10 00:10:40,"Berbeda dengan Kemenkes RI yang mencatat 31 kasus transmisi lokal, DKI sudah mencatatkan 57 kasus transmisi lokal Omicron. Total ada 407 kasus di Jakarta. https://t.co/phzh9WnWMx",2,1,0,1,2022-01-10,0,Monday,1,2,2
1480330459418664977,2022-01-10 00:07:39,"Lagi-lagi muncul klaim varian baru yang dinamai Deltacron, disebut gabungan varian Delta dan Omicron. Kasusnya diklaim sudah mencapai 25 kasus. https://t.co/gcuc5zPrdw",24,18,6,19,2022-01-10,0,Monday,1,30,37
1480329940444848136,2022-01-10 00:05:35,"Artis Raffi Ahmad bikin heboh di media sosialnya. Influencer itu menebar kode ingin membawa Mesut Oezil ke klubnya, RANS CIlegon. https://t.co/uIk6vKjYWT",1343,178,154,93,2022-01-10,0,Monday,1,1497,271
1480329144634335234,2022-01-10 00:02:25,Kasus Corona varian Omicron di Indonesia melonjak menjadi 414. Mayoritas merupakan kasus impor atau terjadi pada pelaku perjalanan luar negeri yang masuk ke RI. https://t.co/hGyzz9wxXP,15,3,6,1,2022-01-10,0,Monday,1,21,4
1480328304712462336,2022-01-09 23:59:05,Masa jabatan Anies Baswedan sebagai Gubernur DKI Jakarta akan berakhir pada Oktober tahun ini. Arah perjalananan Anies pun masih menjadi tanda tanya besar. https://t.co/PHU0uKVu7Q,11,13,0,1,2022-01-09,23,Sunday,7,11,14
1480328062067789827,2022-01-09 23:58:07,Heboh akun Twitter resmi Pemkot Depok retweet unggahan berisi ajakan cari polisi penembak laskar FPI. PDIP meminta Pemkot beri penjelasan masuk akal ke publik. https://t.co/7wpQuQnfPV,49,21,13,5,2022-01-09,23,Sunday,7,62,26
1480327325128478726,2022-01-09 23:55:12,"""Itu (postingan) cuma untuk mengingatkan pemerintah saja,"" ungkap pengunggah foto dan pembuat gambar burung, M Ali Fahmi, kepada detikcom. https://t.co/elUKwY80S8",19,2,7,1,2022-01-09,23,Sunday,7,26,3
1480325808396845059,2022-01-09 23:49:10,Kasus dugaan penipuan yang dilaporkan seorang tukang siomai bikin heboh. Kabar terbaru pihak terlapor bakal dimintai keterangan oleh polisi pada pekan ini. https://t.co/XxuDXNESYv,8,0,1,1,2022-01-09,23,Sunday,7,9,1
1480325070358777865,2022-01-09 23:46:14,"Makin dilonggarkannya pembatasan tidak berarti COVID-19 berakhir. Buktinya, jumlah pasien di RSDC Wisma Atlet masih bertambah dan kini mencapai 1.798 pasien. https://t.co/3DEcg9QqmC",14,2,4,0,2022-01-09,23,Sunday,7,18,2
1480324078250639360,2022-01-09 23:42:18,"Lagi-lagi muncul klaim varian baru yang dinamai Deltacron, disebut gabungan varian Delta dan Omicron. Kasusnya diklaim sudah mencapai 25 kasus. https://t.co/qDEqVOKDWs",38,47,12,15,2022-01-09,23,Sunday,7,50,62
1480322090033106945,2022-01-09 23:34:23,Golkar DKI menyebut setiap pemimpin memiliki tantangan dan keberhasilan masing-masing. Sehingga tidak bisa disamakan antarpemimpin. https://t.co/PXhFoKyYhT,7,3,2,1,2022-01-09,23,Sunday,7,9,4
1480321606887120902,2022-01-09 23:32:28,Ferdinand akan menjalani pemeriksaan hari ini terkait penyidikan kasus 'Allahmu ternyata lemah'. Ferdinand mengaku siap dan tidak akan kabur. https://t.co/Um1wGJG2sh,14,10,2,0,2022-01-09,23,Sunday,7,16,10
1480320478828974083,2022-01-09 23:27:59,"Indikator Politik Indonesia merilis hasil survei tingkat kepercayaan publik terhadap institusi negara. Hasilnya, tingkat kepercayaan terhadap TNI turun 2,1%. https://t.co/ihwYVJk7ki",22,8,4,1,2022-01-09,23,Sunday,7,26,9
1480319461936750593,2022-01-09 23:23:57,"Ledakan diduga berasal dari tabung gas terjadi di Pandeglang, Banten. Akibatnya, satu unit rumah warga hancur, dan satu penghuni rumah tewas. https://t.co/CIQ4JRMEhI",7,0,0,0,2022-01-09,23,Sunday,7,7,0
1480317969897082884,2022-01-09 23:18:01,Arsenal tersingkir cepat di Piala FA usai disingkirkan Nottingham Forest. The Tricky Trees membuktikan kalau mereka adalah momok The Gunners di ajang ini. https://t.co/sPxh72AjcF,20,2,1,2,2022-01-09,23,Sunday,7,21,4
1480317237349261324,2022-01-09 23:15:07,"Paris Saint-Germain menyelamatkan satu poin dalam kunjungan ke markas Lyon di lanjutan Liga Prancis. Tertinggal dulu, PSG selamat berkat gol Thilo Kehrer. https://t.co/JWXOSSuAmm",8,0,0,0,2022-01-09,23,Sunday,7,8,0
1480316930003292164,2022-01-09 23:13:53,"Gempa kembali mengguncang wilayah Halmahera Utara. Kali ini, gempa tercatat bermagnitudo 5,5. https://t.co/Qfr4qYcqGh",5,0,1,0,2022-01-09,23,Sunday,7,6,0
1480316128333287428,2022-01-09 23:10:42,Gangster lari tunggang langgang saat diuber-uber polisi bikin geger Kabupaten Tangerang. Aksi pengejaran gangster itu sempat diwarnai dengan blokade jalan. https://t.co/cDoiojARbn,18,0,0,0,2022-01-09,23,Sunday,7,18,0
1480315628284219397,2022-01-09 23:08:43,"Ledakan terjadi di sebuah rumah di Desa Tangkilsari, Kecamatan Cimanggu, Pandeglang, Banten. Istri dan anak korban selamat dari ledakan maut itu. https://t.co/VI3BJ5ZsiG",10,0,0,0,2022-01-09,23,Sunday,7,10,0
1480314398052958214,2022-01-09 23:03:50,"Indonesia kembali mencatatkan penambahan 75 kasus varian Omicron, Sabtu (8/1/2022). Total kasus menjadi 414, dengan 31 kasus merupakan transmisi lokal. https://t.co/OiZQkqjL8P",9,1,2,1,2022-01-09,23,Sunday,7,11,2
1480312861234765829,2022-01-09 22:57:43,"Kericuhan yang terjadi di Kazakhstan memicu Presiden Kassym-Jomart Tokayev mendeklarasikan Hari Berkabung Nasional, jatuh pada 10 Januari 2022. https://t.co/1GY4yDyiaf",9,0,0,0,2022-01-09,22,Sunday,7,9,0
1480311872897396746,2022-01-09 22:53:48,Relawan pendukung Erick Thohir untuk Pilpres 2024 bergerilya ke pesantren-pesantren di Bandung. Mereka mengenalkan Menteri BUMN itu agar makin tenar. https://t.co/qKE6lHIBTZ,13,3,0,1,2022-01-09,22,Sunday,7,13,4
1480310839064379402,2022-01-09 22:49:41,LaNyalla meminta pemerintah lebih gencar melakukan terobosan-terobosan untuk membantu pengembangan UMKM. https://t.co/7bdXZvLzGX,19,3,10,1,2022-01-09,22,Sunday,7,29,4
1480309557645746176,2022-01-09 22:44:36,Inter Milan merebut lagi puncak klasemen Serie A dari AC Milan. Hal ini terjadi setelah Nerazzurri mengalahkan Lazio 2-1. https://t.co/BPBc2k08RI,6,0,1,0,2022-01-09,22,Sunday,7,7,0
1480308809792958468,2022-01-09 22:41:37,"Manchester United sudah lama tak memenangi Piala FA. Pemain Setan Merah, Harry Maguire, mengungkap hasrat besar Setan Merah untuk memenangi ajang itu. https://t.co/sCXHQblyFY",3,0,0,0,2022-01-09,22,Sunday,7,3,0
1480307815730356225,2022-01-09 22:37:40,Bupati Lumajang geram dengan aksi viral pria yang membuang dan menendang sesajen di lokasi erupsi Semeru. Pria itu dipastikan bukanlah warga Lumajang. https://t.co/C6M2q2qjkN,177,67,29,9,2022-01-09,22,Sunday,7,206,76
1480306781448552453,2022-01-09 22:33:34,"Piala FA sudah menuntaskan drawing babak keempat. Liverpool bertemu Cardiff City, sementara Manchester City ditantang Fulham. https://t.co/f2UuXL7Zjf",5,0,0,0,2022-01-09,22,Sunday,7,5,0
1480305742099976197,2022-01-09 22:29:26,Wamenag Zainut Tauhid menghadiri perayaan Natal GAMKI menggelar. Zainut menekankan pentingnya nilai toleransi untuk mencegah perpecahan. https://t.co/MwGnsaZL9p,10,1,1,1,2022-01-09,22,Sunday,7,11,2
1480304505853988866,2022-01-09 22:24:31,"Wali Kota Mojokerto, Ika Puspitasari mengatakan pihak Pemkot Mojokerto telah menangani persoalan stunting ini mulai dari hulu ke hilir secara preventif. https://t.co/90NeHOy0i3",4,0,2,0,2022-01-09,22,Sunday,7,6,0
1480303194286743554,2022-01-09 22:19:18,Djarot menilai kawasan Tanah Abang kini bak poco-poco karena semakin macet. NasDem DKI menilai kondisi Tanah Abang saat ini tergantung manajemennya. https://t.co/UkjQMre2kY,22,10,3,4,2022-01-09,22,Sunday,7,25,14
1480302136873398278,2022-01-09 22:15:06,"Kawasan Ngupit, Kecamatan Ngawen, Klaten, dikenal sebagai tempat para juru khitan atau bong supit. Beberapa nama bong masih dikenang masyarakat setempat. https://t.co/KaNjxB8kkz",5,0,1,0,2022-01-09,22,Sunday,7,6,0
1480301133910396933,2022-01-09 22:11:07,Petugas gabungan menggelar operasi di tempat hiburan di Kecamatan Sawahan. Operasi dilakukan sebagai antisipasi penyebaran omicron di Surabaya. https://t.co/zBTRDa2Doh,0,0,0,0,2022-01-09,22,Sunday,7,0,0
1480299825220530178,2022-01-09 22:05:55,"Dinas Pendidikan Kota Bandung (Disdik Bandung) mengizinkan 330 sekolah untuk melaksanakan pembelajaran tatap muka (PTM) 100 persen, 10 Januari 2022 https://t.co/Uyi4c33u7g",4,1,1,1,2022-01-09,22,Sunday,7,5,2
1480298833351426052,2022-01-09 22:01:59,Ia menyebut jika seorang memiliki tujuan yang mulia dan ingin mencapainya langkah pertama yang harus dilakukan yaitu yakin kemampuan diri mampu mencapai hal itu https://t.co/kot6Z5IkBN,2,0,0,1,2022-01-09,22,Sunday,7,2,1
1480297085056471040,2022-01-09 21:55:02,BMKG mengeluarkan prakiraan cuaca di DKI Jakarta hari ini. BMKG memprediksi potensi hujan lebat di Jakarta Selatan dan Jakarta Timur pada siang-malam hari. https://t.co/JkW2y3qce3,20,3,3,1,2022-01-09,21,Sunday,7,23,4
1480296616368160776,2022-01-09 21:53:10,"Seorang warga di Pandeglang, Banten, tewas dalam ledakan maut yang terjadi di dalam rumahnya sendiri. Polisi minta warga setop menyebar foto korban. https://t.co/xi4QpX1iQF",12,0,2,0,2022-01-09,21,Sunday,7,14,0
1480295824177389571,2022-01-09 21:50:01,"Hampir 14 juta penduduk Kota Tianjin, China Utara dilakukan tes massal COVID-19 setelah dua kasus varian COVID-19 Omicron terdeteksi. https://t.co/m0zWsZ1OET",4,1,0,1,2022-01-09,21,Sunday,7,4,2
1480294418787753986,2022-01-09 21:44:26,"Gempa berkekuatan magnitudo (M) 5,2 mengguncang Halmahera Utara, Maluku Utara (Malut). Gempa tak berpotensi tsunami. https://t.co/etz33KDzuF",7,0,0,0,2022-01-09,21,Sunday,7,7,0
1480294086527619081,2022-01-09 21:43:07,"Banyak warga di Kabupaten Lebak, Banten mengeluhkan air PDAM yang sering mati atau keruh. Bahkan air mati total ketika hujan deras. https://t.co/E0SNj2rreT",4,2,1,1,2022-01-09,21,Sunday,7,5,3
1480292706500980737,2022-01-09 21:37:38,"Tim bola Papua dijanjikan bonus Rp 1 miliar oleh Freeport Indonesia. Setelah tiga bulan yang lalu menjadi juara di PON Papua 2021, bonus itu tak kunjung cair. https://t.co/UaPNj8JjTi",14,1,3,0,2022-01-09,21,Sunday,7,17,1
1480291465087668228,2022-01-09 21:32:42,"""Kan kita evaluasi, kita lihat apa (tulisan spanduk) benar begitu. Kan pemilihannya belum, baru pembentukan panitia,"" kata Wali Kota Jakbar, Yani Purwoko. https://t.co/peBgTcOI9I",4,0,0,0,2022-01-09,21,Sunday,7,4,0
1480289367704936448,2022-01-09 21:24:22,Kawasan Ngupit Klaten merupakan tempatnya para bong supit tradisional. Salah seorang di antaranya membuka kuncian bong supit tradisional yakni putih telur. https://t.co/xX9lIy1Y5T,7,0,1,0,2022-01-09,21,Sunday,7,8,0
1480288017113829382,2022-01-09 21:19:00,"Aksi dua pria di Tanjungbalai, Sumatera Utara, mencuri pagar besi rumah warga saat sedang kosong terekam oleh tetangga korban menggunakan ponsel. https://t.co/hBxk58J3F9",11,3,2,0,2022-01-09,21,Sunday,7,13,3
1480285293467115520,2022-01-09 21:08:10,Piala Asia Wanita 2022 di India tinggal menghitung waktu. Timnas Indonesia Wanita memanfaatkannya sebaik mungkin dan terus bersiap hingga tanggal keberangkatan. https://t.co/wHwJvvjcH0,6,0,1,0,2022-01-09,21,Sunday,7,7,0
1480283977378316292,2022-01-09 21:02:57,"Pemerintah Kabupaten Labuhanbatu, Sumatera Utara (Sumut), merumahkan ribuan tenaga kontrak nya. Mereka dirumahkan karena kontraknya habis. https://t.co/BTDgd7N2pp",4,2,2,0,2022-01-09,21,Sunday,7,6,2
1480282551528927232,2022-01-09 20:57:17,"Tisu magic banyak dijadikan opsi oleh pasangan agar sesi bercinta jadi lebih tahan lama. Tapi, bagaimana cara pakai tisu magic yang benar? Begini caranya: https://t.co/whTR1Pmii6",10,0,0,0,2022-01-09,20,Sunday,7,10,0
1480281289630658567,2022-01-09 20:52:16,Gubernur Jawa Tengah Ganjar Pranowo menyatakan Pemprov Jateng siap melaksanakan vaksin booster atau pemberian vaksin dosis ketiga. https://t.co/Xfqr9GSCDz,8,1,3,1,2022-01-09,20,Sunday,7,11,2
1480279937789616135,2022-01-09 20:46:54,"Jika kamu masih penasaran dengan sifat dan kepribadianmu yang sesungguhnya, maka kamu bisa mencoba tes kepribadian yang satu ini. Berikut selengkapnya. https://t.co/Sc43c0SZVd",7,0,0,0,2022-01-09,20,Sunday,7,7,0
1480278681293672449,2022-01-09 20:41:54,AC Milan mengawali tahun dengan positif untuk memberi tekanan ke Inter Milan. Pelatih Rossoneri Stefano Pioli menyebut timnya masih terus mematangkan diri. https://t.co/xAJ6DsxH13,3,0,0,0,2022-01-09,20,Sunday,7,3,0
1480276415572492289,2022-01-09 20:32:54,Tim penyelamat mencari dua orang yang masih hilang saat jumlah korban tewas meningkat menjadi delapan dari tebing yang runtuh menimpa perahu wisata di Brasil. https://t.co/aRWBB84uii,10,0,0,0,2022-01-09,20,Sunday,7,10,0
1480274834995167233,2022-01-09 20:26:37,"Daerah Ngupit di Kecamatan Ngawen, Klaten, memiliki sejarah panjang profesi tukang sunat atau bong supit. Kampung ini ternyata telah eksis sejak era Mataram. https://t.co/LOX2QLg9Pr",7,0,3,1,2022-01-09,20,Sunday,7,10,1
1480270060849664002,2022-01-09 20:07:39,"Pohon tumbang menimpa kendaraan odong-odong di Indihiang, Tasikmalaya. Diduga kuat robohnya pohon akibat hujan disertai angin kencang. https://t.co/sFyl9oIvrs",7,0,0,0,2022-01-09,20,Sunday,7,7,0
1480267512856072193,2022-01-09 19:57:31,Survei IPI mencatat tingkat kepercayaan publik terhadap institusi Polri turun tajam. Penurunan itu dinilai lantaran maraknya pelanggaran yang dilakukan anggota. https://t.co/KmFXH15iUB,56,6,13,8,2022-01-09,19,Sunday,7,69,14
1480264401085243393,2022-01-09 19:45:09,Kamerun butuh dua penalti untuk bangkit dan menundukkan Burkina Faso di laga pembuka Piala Afrika 2021. Eksekusi Vincent Aboubakar memenangkan tuan rumah 2-1. https://t.co/3CogoGIbR1,3,0,0,0,2022-01-09,19,Sunday,7,3,0
1480262779240169479,2022-01-09 19:38:43,"Drama tersaji di Olimpico kala AS Roma menjamu Juventus di lanjutan Serie A. Dua kali unggul, Roma kalah 3-4 dari Juventus yang tampil gigih di babak kedua. https://t.co/VrYp76nrrG",13,1,2,2,2022-01-09,19,Sunday,7,15,3
1480260308308480002,2022-01-09 19:28:54,Gubernur DKI Jakarta Anies Baswedan memamerkan progres revitalisasi Taman Tebet di Jakarta Selatan menjadi Tebet Eco Park. Begini potretnya. https://t.co/r4VcdL9x2K,8,4,1,1,2022-01-09,19,Sunday,7,9,5
1480258049084465153,2022-01-09 19:19:55,Arsenal langsung tersingkir di babak ketiga Piala FA 2021/2022. Ini setelah Tim Gudang Peluru takluk 0-1 di kandang tim Championship Nottingham Forest. https://t.co/34WVfTrSkr,1,0,0,0,2022-01-09,19,Sunday,7,1,0
1480256325166718978,2022-01-09 19:13:04,"Polisi menangkap seorang pria berusia 51 tahun di Kabupaten Padang Lawas, Sumut. Dia ditangkap akibat tega mencabuli putrinya yang berusia 8 tahun. https://t.co/rKmOyYhmFn",7,1,0,0,2022-01-09,19,Sunday,7,7,1
1480254187405520904,2022-01-09 19:04:34,Ukuran penis besar diyakini para pria bisa memuaskan pasangan di ranjang. Memangnya berapa ukuran ideal penis yang bisa bikin klimaks? https://t.co/KP9debATkq,7,0,0,1,2022-01-09,19,Sunday,7,7,1
1480252722318348290,2022-01-09 18:58:45,"Ketua DPC PDIP Solo, FX Hadi Rudyatmo, menilai Gibran layak dicalonkan sebagai Gubernur Jateng. https://t.co/iLY4r7XuN9",9,8,2,0,2022-01-09,18,Sunday,7,11,8
1480251663306821637,2022-01-09 18:54:32,Barcelona terancam tak bisa mendaftarkan rekrutan anyar mereka Ferran Torres. Blaugrana kini harus segera melepas beberapa pemain agar Torres bisa didaftarkan. https://t.co/odGctucJta,2,0,1,0,2022-01-09,18,Sunday,7,3,0
1480249608446128134,2022-01-09 18:46:23,"Anna Sorokin menipu banyak orang dengan berpura-pura menjadi sosialita pewaris harta jutaan dolar. Ia pernah menipu kawan-kawannya lewat modus 'traktir liburan'.
 https://t.co/NzFcsDtQOU",7,0,1,0,2022-01-09,18,Sunday,7,8,0
1480248316055142406,2022-01-09 18:41:14,Tebak-tebakan receh tak pernah gagal untuk menghibur. Yuk! Main tebak-tebakan receh yang bisa mencairkan suasana jadi lebih santai. https://t.co/5ilTkEUiVy,14,0,4,0,2022-01-09,18,Sunday,7,18,0
1480247326186868740,2022-01-09 18:37:18,"Jaksa Agung, ST Burhanuddin, menyebut restorative justice kini menjadi merek atau brand kejaksaan. Hal itu diungkapnya saat memantau penghentian penuntutan. https://t.co/zqq7UB78Pz",5,0,0,0,2022-01-09,18,Sunday,7,5,0
1480246181439672323,2022-01-09 18:32:45,Napoli mengemas poin penuh saat melawan Sampdoria di lanjutan kompetisi Serie A. Gol Andrea Petagna memenangkan Il Partenopei 1-0. https://t.co/6QkN2G0bHb,1,0,0,0,2022-01-09,18,Sunday,7,1,0
1480245631721648130,2022-01-09 18:30:34,Liverpool sempat tertinggal duluan sebelum akhirnya menyingkirkan Shrewsbury Town. Juergen Klopp suka dengan respons para pemain muda The Reds. https://t.co/j1eC6j33Es,0,1,0,0,2022-01-09,18,Sunday,7,0,1
1480244606822461453,2022-01-09 18:26:30,"Reza Rahadian dalam series tersebut memang sering melakukan adegan-adegan panas dengan lawan mainnya, Anya Geraldine. Reza Rahadian pun memberikan jawaban mengenai hal itu. Ini penuturannya.  https://t.co/kzpdSrbP6H",1,1,0,0,2022-01-09,18,Sunday,7,1,1
1480240941772554241,2022-01-09 18:11:56,"Vicky Prasetyo mengaku jika Kalina Oktarani meminta pisah darinya. Ia mengatakan Kalina Oktarani sudah tidak tahan karena Vicky Prasetyo dekat dengan seorang perempuan yang diketahui rekan kerjanya.
 https://t.co/uzMnn6zTTo",5,1,0,1,2022-01-09,18,Sunday,7,5,2
1480239468254842888,2022-01-09 18:06:05,"Aliansi militer enam negara bekas Soviet yang dipimpin Rusia, mengizinkan pengiriman sekitar 2.500 tentara sebagian besar Rusia ke Kazakhstan sebagai penjaga perdamaian. https://t.co/JDzxxIPdh1",8,0,1,0,2022-01-09,18,Sunday,7,9,0
1480238429824770052,2022-01-09 18:01:57,Taliban telah menangkap seorang profesor universitas ternama Afghanistan lantaran kritik. Faizullah Jalal dituduh melakukan provokasi melawan pemerintah. https://t.co/USjP5NlMXx,5,2,3,0,2022-01-09,18,Sunday,7,8,2
1480236963189960709,2022-01-09 17:56:08,Badai COVID-19 belum juga beranjak dari skuat Liverpool. Terakhir Trent Alexander-Arnold harus dikarantina karena terpapar virus tersebut. https://t.co/Rq8eomKTOr,3,0,2,0,2022-01-09,17,Sunday,7,5,0
1480235946318651397,2022-01-09 17:52:05,"Selain adanya pantai, PIK juga dikelilingi tempat makan enak. Termasuk beragam pilihan tempat ngopi yang desainnya Instagramable. Ada yang bergaya Korea hingga Prancis. Ini tempatnya.  https://t.co/1k12PhZBYh",7,0,4,0,2022-01-09,17,Sunday,7,11,0
1480234213148401671,2022-01-09 17:45:12,Chef Eddrian Tjhia memprediksi bahwa makanan sehat masih diminati di tahun 2022. Menu makanan sehat apa saja yang akan jadi tren? https://t.co/6FRk3hWhT3,4,0,0,0,2022-01-09,17,Sunday,7,4,0
1480232923995516928,2022-01-09 17:40:05,"Jebakan tikus dengan aliran listrik di persawahan merenggut banyak nyawa 23 orang di Sragen sejak 2020 lalu. Jika tetap ada yang nekat memasangnya, bui menanti. https://t.co/G6Hhf0vdl2",26,5,5,2,2022-01-09,17,Sunday,7,31,7
1480231417070198789,2022-01-09 17:34:05,"Lenny Ratnasari, ibu Naufal Samudra membuat curahan hati yang mengharukan ketika status anaknya ditetapkan sebagai saksi kasus narkoba. Ini curahan hatinya. https://t.co/HoNzsVzoLe",8,0,1,0,2022-01-09,17,Sunday,7,9,0
1480229398221627394,2022-01-09 17:26:04,"Dulunya sempat sepi dan tidak ada pembeli, kini restoran jadul ini jadi tongkrongan favorit para penggemar K-Pop. Mereka sering makan siang di sana. https://t.co/HwJqVIni1s",6,0,0,0,2022-01-09,17,Sunday,7,6,0
1480228116694016001,2022-01-09 17:20:58,"Kasus dugaan pemerkosaan 3 mahasiswi UMY memasuki babak baru. Sabtu malam (8/1/2022), akun instagram dear_umycatcallers mengunggah 6 tuntutan korban. Apa saja? https://t.co/EYhsP1uHxY",16,0,2,0,2022-01-09,17,Sunday,7,18,0
1480226788169158659,2022-01-09 17:15:42,Gubernur DKI Jakarta Anies Baswedan memamerkan progres revitalisasi Taman Tebet di Jakarta Selatan menjadi Tebet Eco Park. Begini potretnya. https://t.co/mNa9yitmk6,33,9,5,2,2022-01-09,17,Sunday,7,38,11
1480225752826187783,2022-01-09 17:11:35,"Setelah kehebohan video ciuman dengan Ayu Aulia di Bali, Zikri Daulay terlihat tengah berlibur ke Turki. Dia diingatkan agar pulang jangan membawa virus. https://t.co/iZK0KtAtB0",5,1,1,1,2022-01-09,17,Sunday,7,6,2
1480224131434094594,2022-01-09 17:05:08,"Nama Wali Kota Solo, Gibran Rakabuming Raka kembali masuk dalam bursa calon gubernur DKI Jakarta 2024. Begini tanggapan Sekretaris Jenderal PDIP, Hasto Kristiyanto. https://t.co/1HBUFEzmrp",9,1,1,1,2022-01-09,17,Sunday,7,10,2
1480223065346912256,2022-01-09 17:00:54,Viral Video seorang pria membuang dan menendang sesajen di lokasi terdampak erupsi. Bupati Lumajang kecewa karena aksi itu mengganggu ketentraman masyarakat. https://t.co/ImFFEZ3n7k,55,11,11,3,2022-01-09,17,Sunday,7,66,14
1480221656274673678,2022-01-09 16:55:18,Kekejaman Taliban kembali disorot. Kali ini Profesor ternama ditahan Taliban lantaran dinilai memprovokasi masyarakat untuk melawan pemerintah. https://t.co/60kADgeLnU,19,12,4,0,2022-01-09,16,Sunday,7,23,12
1480221155038580741,2022-01-09 16:53:19,Otak harus sering dilatih berpikir supaya tidak terjebak atau kesulitan saat memecahkan masalah. Teka-teki berikut bisa membantu mengasah otak. https://t.co/RxC16vsqY3,7,5,3,0,2022-01-09,16,Sunday,7,10,5
1480220608126402573,2022-01-09 16:51:08,"Walkot Jakbar, Yani Wahyu Purwoko, buka suara atas polemik pemilihan ketua RW di Jelambar. Yani menegaskan siapapun boleh mencalonkan diri sebagai ketua RW. https://t.co/aoUTMhdMXX",7,2,3,0,2022-01-09,16,Sunday,7,10,2
1480219818737479681,2022-01-09 16:48:00,"Seorang pengendara motor menjadi korban dalam kecelakaan parah di flyover Pesing. Namun, kecelakaan ini tak membuat para pemotor jera. https://t.co/HmhvRUealC",5,1,1,1,2022-01-09,16,Sunday,7,6,2
1480219322769420294,2022-01-09 16:46:02,Berita di DIY hari ini diwarnai dengan kabar terkini dari kasus dugaan pemerkosaan oleh eks aktivis BEM UMY dan muntahan awan panas Gunung Merapi. https://t.co/P4YxCvsRLI,5,0,1,0,2022-01-09,16,Sunday,7,6,0
1480217953895432200,2022-01-09 16:40:35,"Melonjak, kasus Omicron di Indonesia kini mencapai 414 orang per Minggu (9/1/2022). Ada 31 kasus di antaranya transmisi lokal. https://t.co/F6q5VY833F",15,1,9,2,2022-01-09,16,Sunday,7,24,3
1480217430551150595,2022-01-09 16:38:31,Hari ini ada 211 orang di Indonesia yang sembuh dari COVID-19. Jumlah total yang telah sembuh dari Corona sebanyak 4.115.958 orang. https://t.co/n9Cg9F2pVn,5,3,1,0,2022-01-09,16,Sunday,7,6,3
1480216885601910788,2022-01-09 16:36:21,PDIP mengungkapkan Basuki Tjahaja Purnama (BTP) atau Ahok akan berkeliling Indonesia untuk mengajar para kader tentang kepemimpinan. Bagaimana persiapan Ahok? https://t.co/2VQkcDcYez,102,49,8,10,2022-01-09,16,Sunday,7,110,59
1480216390615412739,2022-01-09 16:34:23,"Saat bercinta, penetrasi maksimal dapat membuat pasangan lebih cepat mencapai orgasme. Cobalah 5 posisi ini agar bercinta semakin menggairahkan. https://t.co/xDyCR6QKTl",6,2,1,0,2022-01-09,16,Sunday,7,7,2
1480215906026500099,2022-01-09 16:32:27,"Melonjak, kasus Omicron di Indonesia kini mencapai 414 orang per Minggu (9/1/2022). Ada 31 kasus di antaranya transmisi lokal. https://t.co/xvltVrMO9m",25,7,4,5,2022-01-09,16,Sunday,7,29,12
1480215288570388481,2022-01-09 16:30:00,Gerindra minta Djarot melihat keberhasilan era Anies dalam aspek lain misalnya segi pembangunan dan pengembangan kota. https://t.co/1KmkWzvWCu,30,25,2,3,2022-01-09,16,Sunday,7,32,28
1480214713388707851,2022-01-09 16:27:43,"Seorang seniman paruh baya Dede Hendrik (64) di Kecamatan Cigugur, Pangandaran ditemukan meninggal dunia dalam kondisi sudah menjadi tengkorak. https://t.co/6BS4HTel3R",3,1,0,1,2022-01-09,16,Sunday,7,3,2
1480214227654692867,2022-01-09 16:25:47,"Satu warga Krukut, Jakbar, terkonfirmasi Corona dengan suspek varian Omicron. Kelurahan Krukut segera melakukan pelacakan warga yang kontak erat dengan pasien. https://t.co/4mty9hHu0p",3,0,1,0,2022-01-09,16,Sunday,7,4,0
1480214210185506819,2022-01-09 16:25:43,Mobil pikap yang ditumpangi rombongan pengajian dari Tasikmalaya terguling di Warung Peuteuy belasan orang mengalami cedera ringan hingga berat. https://t.co/oY96spylqw,5,1,0,0,2022-01-09,16,Sunday,7,5,1
1480213976038494211,2022-01-09 16:24:47,"Liverpool harus bersusah payah untuk bisa melewati adangan Shrewsbury Town di babak ketiga Piala FA 2021/2022. Tertinggal duluan, The Reds akhirnya menang 4-1. https://t.co/VUM4phY2US",5,0,1,0,2022-01-09,16,Sunday,7,6,0
1480213432741904391,2022-01-09 16:22:38,Anggaran tunjangan perumahan untuk DPRD DKI Jakarta naik menjadi Rp 102 miliar. Partai Demokrat menyebut lebih dari empat tahun tunjangan perumahan tidak naik. https://t.co/7IBsNrlnMT,5,5,4,7,2022-01-09,16,Sunday,7,9,12
1480212809938096134,2022-01-09 16:20:09,Inggris mencatatkan 178.250 kasus Covid-19 baru pada Jumat (7/1). Lonjakan angka kasus ini disebabkan penyebaran cepat Omicron. Berikut situasi RS di London. https://t.co/BZpUG7zaFr,6,1,1,0,2022-01-09,16,Sunday,7,7,1
1480212302594990086,2022-01-09 16:18:08,"Petenis Novak Djokovic dilarang masuk Australia karena tidak vaksin. Pelatih Bologna, Sinisa Mihajlovic, meminta para pemainnya mematuhi aturan negara. https://t.co/PLAhA0cM4G",7,1,0,0,2022-01-09,16,Sunday,7,7,1
1480211749265621003,2022-01-09 16:15:56,Direktur Utama PT HAS Sambilawang Heru Susilo membantah perusahaannya terlibat dalam skandal kasus korupsi proyek Pertamina https://t.co/svYdQBflXi,5,0,2,0,2022-01-09,16,Sunday,7,7,0
1480209789053542405,2022-01-09 16:08:09,"Tottenham Hotspur mesti bersusah payah lolos ke babak keempat Piala FA. Tertinggal dulu dari Morecambe, Spurs menang usai bangkit di babak kedua. https://t.co/o9yXFHt5NX",1,0,0,0,2022-01-09,16,Sunday,7,1,0
1480209314660990990,2022-01-09 16:06:16,Ade Puspitasari menyebut partai lain akan kandas di Pemilu 2024 jika partai kuning dan orange berkoalisi. Pernyataan itu direspons Wasekjen PKS Fathul Bari. https://t.co/JMOcRWsljN,2,1,1,0,2022-01-09,16,Sunday,7,3,1
1480208527587262465,2022-01-09 16:03:08,"Seorang sopir mobil travel dirampok penumpangnya di Duren Sawit, Jakarta Timur. Tak gentar, korban melawan perampok di mobilnya. https://t.co/RCmkQaGCym",6,0,1,1,2022-01-09,16,Sunday,7,7,1
1480208297789644802,2022-01-09 16:02:13,Seorang pria di Kota Kediri dilaporkan telah memukul seorang anak berusia 10 tahun. Pemukulan itu mengakibatkan si anak dirawat di rumah sakit. https://t.co/yTjrgarIcY,20,19,4,4,2022-01-09,16,Sunday,7,24,23
1480207630329131015,2022-01-09 15:59:34,Gubernur Jawa Tengah Ganjar Prabowo menanggapi santai dukungan para juru parkir di Solo agar dirinya maju capres 2024. Seperti apa? https://t.co/UqDekd9lom,6,2,3,0,2022-01-09,15,Sunday,7,9,2
1480206051400110083,2022-01-09 15:53:18,"Wanti-wanti peningkatan kasus Omicron, Kemenkes RI minta warga berkaca pada harian Corona India yang menembus 90 ribu per hari usai mencatat kasus Omicron. https://t.co/ToZsWRTs1j",6,4,3,3,2022-01-09,15,Sunday,7,9,7
1480204642835439622,2022-01-09 15:47:42,"Indonesia mencatat sebanyak 529 kasus baru COVID-19, Minggu (9/1/2022). DKI menyumbang kasus terbanyak dengan jumlah 393. https://t.co/xMgX5vqBQP",3,0,2,2,2022-01-09,15,Sunday,7,5,2
1480204158770847744,2022-01-09 15:45:46,Epidemiolog Pandu Riono pun menyebut masyarakat Indonesia ditakut-takuti dengan Corona varian Omicron. Apa kata Kemenkes? https://t.co/ROJdGVb29r,10,0,2,8,2022-01-09,15,Sunday,7,12,8
1480202931072868352,2022-01-09 15:40:54,Hasil survei Indikator Politik Indonesia mengindikasikan masyarakat Indonesia jenuh dengan Corona. Pandu Riono menyebut masyarakat RI ditakut-takuti Omicron. https://t.co/DC3TbeRsOt,47,13,13,6,2022-01-09,15,Sunday,7,60,19
1480202681335566340,2022-01-09 15:39:54,Pria penendang sesajen di lokasi erupsi Semeru dipastikan bukan warga Lumajang. Bupati Lumajang Thoriqul Haq menyebut pria tersebut merupakan seorang relawan. https://t.co/NB3GabPt0D,91,39,21,7,2022-01-09,15,Sunday,7,112,46
1480201916227649537,2022-01-09 15:36:52,The Dinner Set Gang adalah salah satu geng pencuri yang paling terkenal di AS. Cara mereka dalam mencuri diadopsi oleh para pencuri lain. Siapa mereka? https://t.co/gC3WUSY1cN,5,0,0,0,2022-01-09,15,Sunday,7,5,0
1480198983226204165,2022-01-09 15:25:13,Pakar Unnes menilai ada yang kurang dari Gibran Rakabuming Raka dan Hendrar Prihadi yang sama-sama masuk di bursa Pilgub DKI Jakarta. https://t.co/hIftGDcoHr,2,0,0,1,2022-01-09,15,Sunday,7,2,1
1480198211562356737,2022-01-09 15:22:09,Sopir dan kenek truk di Banyuwangi ini salah alias terbalik memasang bendera merah putih. Mereka pun dihukum hormat bendera. https://t.co/gQdctAONmd,14,1,2,3,2022-01-09,15,Sunday,7,16,4
1480197468541304845,2022-01-09 15:19:11,"Aurel Valen mulai dikenal sebagai seorang presenter sekaligus YouTuber. Di tengah ketenarannya, ada saja komentar para pengikut akan foto-fotonya. Ini sosoknya. #AurelValen  https://t.co/r3Iynsz9Im",11,2,1,0,2022-01-09,15,Sunday,7,12,2
1480196621744971787,2022-01-09 15:15:50,"Bandel! Masih banyak pengendara roda dua yang melintas di flyover Pesing, Daan Mogot, Jakarta Barat. Padahal sudah ada rambu larangan melintas untuk mereka. https://t.co/nv540cEl73",20,15,5,2,2022-01-09,15,Sunday,7,25,17
1480195609277747203,2022-01-09 15:11:48,Seorang pria di Kota Kediri dilaporkan telah memukul seorang anak berusia 10 tahun. Pemukulan itu mengakibatkan si anak dirawat di rumah sakit. https://t.co/FZ1DTq9grb,17,15,4,3,2022-01-09,15,Sunday,7,21,18
1480195359385264128,2022-01-09 15:10:49,"Selain unik, salah satu rumah di Desa Cibubuan, Kecamatan Conggeang, Sumedang, juga memiliki nilai sejarah. Rumah ini pernah disinggahi Jenderal A.H Nasution. https://t.co/ad08J5FqQL",9,0,2,0,2022-01-09,15,Sunday,7,11,0
1480193687934189576,2022-01-09 15:04:10,"Seorang pria asal India mendadak viral lantaran namanya bernama Kovid,mirip COVID-19 alias virus Corona. Kok bisa? Simak infonya di sini. https://t.co/ccePBKWZ1p",6,1,1,0,2022-01-09,15,Sunday,7,7,1
1480193006586187779,2022-01-09 15:01:28,Banjir di Jember membawa dua korban. Satu korban ditemukan meninggal dan satu lagi hilang dan masih dalam pencarian. https://t.co/cdoAcwvIDe,7,0,0,1,2022-01-09,15,Sunday,7,7,1
1480192391361736705,2022-01-09 14:59:01,Belakangan ini Tissa Biani kembali jadi sorotan usai terlihat mengunggah foto selfie dirinya. Foto unggahannya itu disebut mirip Lucinta Luna. https://t.co/6arriHZaUG,10,1,1,0,2022-01-09,14,Sunday,7,11,1
1480191596960305154,2022-01-09 14:55:52,Sopir dan kenek truk di Banyuwangi ini salah alias terbalik memasang bendera merah putih. Mereka pun dihukum hormat bendera. https://t.co/jdYdTsbpMA,7,2,1,1,2022-01-09,14,Sunday,7,8,3
1480189773822189592,2022-01-09 14:48:37,Ilmuwan mengklaim ada varian baru gabungan Delta dan Omicron. Dinamai 'Deltacron' bagaimana fakta di balik klaim varian tersebut? https://t.co/Pzb6tgCD2v,106,150,46,70,2022-01-09,14,Sunday,7,152,220
1480188727527985164,2022-01-09 14:44:27,"Turunnya kualitas seks yang rendah bisa menimbulkan persoalan dengan pasangan. Namun, tak perlu khawatir. Ini 6 makanan yang bisa meningkatkan kualitas seks. https://t.co/MaoBBNdOsA",25,4,3,6,2022-01-09,14,Sunday,7,28,10
1480187430502285320,2022-01-09 14:39:18,"Pemerintah melaporkan kasus baru Corona pada hari ini sebanyak 529 kasus. DKI Jakarta menjadi penyumbang terbanyak, sedangkan 14 provinsi nihil. https://t.co/QtpjGTIeSm",6,0,4,3,2022-01-09,14,Sunday,7,10,3
1480186075758960643,2022-01-09 14:33:55,"Banjir merendam Perumahan Bumi Mangli di Kaliwates, Jember, Jawa Timur. Ratusan rumah warga terendam dan rusak akibat banjir tersebut. Ini penampakannya. https://t.co/dhPkqE7VBw",4,2,2,0,2022-01-09,14,Sunday,7,6,2
1480184085318406148,2022-01-09 14:26:01,Sebanyak 18 petugas di Bandara Soekarno Hatta positif Corona. 10 di antaranya terkonfirmasi varian omicron. https://t.co/C4PnI3OhMY,94,14,39,12,2022-01-09,14,Sunday,7,133,26
1480184071531679746,2022-01-09 14:25:57,Polisi memeriksa 5 saksi terkait dugaan video mesum sejoli pelajar di Baubau. Kelima saksi yang diperiksa merupakan terduga pemeran video mesum dan rekannya. https://t.co/JQ3zJg8Au4,8,1,0,0,2022-01-09,14,Sunday,7,8,1
1480183532974653445,2022-01-09 14:23:49,Bupati Jember Hendy Siswanto meninjau sejumlah titik lokasi di Jember. Hendy ingin memastikan jajarannya sudah melakukan upaya maksimal tangani banjir. https://t.co/FBGvju5Wwj,6,0,0,0,2022-01-09,14,Sunday,7,6,0
1480183321682452491,2022-01-09 14:22:59,"Manchester United akan mencoba bangkit saat menjamu Aston Villa di babak ketiga Piala FA. Namun, misi bangkit MU menghadapi Villa yang tricky buat tim-tim top. https://t.co/KWuyiHfkfY",3,0,0,0,2022-01-09,14,Sunday,7,3,0
1480182986121400323,2022-01-09 14:21:39,Rider legendaris MotoGP Valentino Rossi memiliki karier yang panjang dan sukses. Rossi mengaku tak memiliki penyesalan meski dia menyimpan sebuah kesedihan. https://t.co/PK86KVcFZe,8,0,2,0,2022-01-09,14,Sunday,7,10,0
1480182170207539200,2022-01-09 14:18:24,"Ruko ekspedisi di Pamulang, Tangsel, menjadi sasaran aksi pencurian sebanyak dua kali dalam sebelum. Menerima laporan, polisi turun tangan mengusut. https://t.co/TFvLRXy6lv",7,1,0,0,2022-01-09,14,Sunday,7,7,1
1480181014437801993,2022-01-09 14:13:48,"Kebakaran yang melanda pabrik ember di Kabupaten Tangerang sudah padam. Setidaknya, petugas damkar membutuhkan waktu lima jam untuk memadamkan si jago merah. https://t.co/RGpVglwpoE",3,0,0,0,2022-01-09,14,Sunday,7,3,0
1480179612072173575,2022-01-09 14:08:14,Video seorang pria membuang dan menendang sesajen di lokasi erupsi Semeru viral. Bupati Lumajang Thoriqul Haq meminta agar pria tersebut dicari dan ditangkap. https://t.co/wkqiqszw9E,321,121,67,25,2022-01-09,14,Sunday,7,388,146
1480178612376641539,2022-01-09 14:04:16,Real Madrid akan melawan Barcelona di Piala Super Spanyol. Berikut ini rekor Carlo Ancelotti saat menjalani El Clasico. https://t.co/8Fw5uRa9ri,5,0,1,1,2022-01-09,14,Sunday,7,6,1
1480177818344595459,2022-01-09 14:01:06,"Ada beberapa jenis bumbu masakan yang memiliki kandungan haram untuk dikonsumsi oleh umat Muslim. Apa saja? Simak informasi selengkapnya di sini, ya. #detikNetwork  https://t.co/OzwoENyIDs",13,0,7,0,2022-01-09,14,Sunday,7,20,0
1480176734255423501,2022-01-09 13:56:48,"Banjir merendam kawasan perumahan Bumi Mangli Permai (BMP), Kecamatan Kaliwates. Banjir sempat membuat 4 orang warga terjebak di dalam rumah. https://t.co/uketN5RNid",10,0,2,0,2022-01-09,13,Sunday,7,12,0
1480175968312602626,2022-01-09 13:53:45,Seorang penjual lumpia terus berjuang mencari nafkah di tengah masa pandemi. Motor beroda tiga yang ditunggangi jadi kendaraannya menjemput rezeki. https://t.co/NwpGA5IqjY,45,1,3,0,2022-01-09,13,Sunday,7,48,1
1480175084375621636,2022-01-09 13:50:15,Manchester United sudah sekitar sebulan ditangani oleh Ralf Rangnick. Pemain belakang Setan Merah Harry Maguire mengungkapkan kesannya soal manajer Jerman itu. https://t.co/jDZ37gSzzj,6,1,2,0,2022-01-09,13,Sunday,7,8,1
1480174559512993798,2022-01-09 13:48:09,Formappi mengkritik kenaikan gaji dan tunjangan anggota DPRD DKI Jakarta. Salah satu yang disorot ialah kenaikan tunjangan rumah DPRD DKI menjadi Rp 102 miliar. https://t.co/O2WqQlMAam,12,4,16,2,2022-01-09,13,Sunday,7,28,6
1480173750612070400,2022-01-09 13:44:57,"Berikut fakta-fakta sabu, jenis narkotika yang sempat dipakai Abdel Achirian saat ngehost acara dakwah bersama Mamah Dedeh di salah satu televisi. https://t.co/tti9YOVppA",29,10,8,0,2022-01-09,13,Sunday,7,37,10
1480172925781258244,2022-01-09 13:41:40,AC Milan berhasil mengalahkan Venezia 3-0. Hasil itu untuk sementara membuat Rossoneri mengambil alih puncak klasemen Liga Italia. https://t.co/Cm6NX7v618,22,0,5,0,2022-01-09,13,Sunday,7,27,0
1480171589459234816,2022-01-09 13:36:21,"Anak Pepen, Ade Puspitasari, menyebut OTT KPK terhadap ayahnya pembunuhan karakter. Ketua KPK pun menepis hal tersebut. https://t.co/nTdp0hrC07",11,8,4,1,2022-01-09,13,Sunday,7,15,9
1480170324859797504,2022-01-09 13:31:20,Ini dia kronologi Ivan Gunawan tentang 'anaknya' yang berujung dihibahkan. https://t.co/Xmq8DsHODB,4,4,0,1,2022-01-09,13,Sunday,7,4,5
1480169279215517706,2022-01-09 13:27:11,"Sebuah kecelakaan menimpa mobil pickup pengangkut telur ayam. Ratusan butir telur terjatuh dan pecah di jalan raya, namun sang sopir bikin gagal fokus karena masih bisa tertawa.
 https://t.co/wxiSrODW5E",7,0,2,1,2022-01-09,13,Sunday,7,9,1
1480168491223334913,2022-01-09 13:24:03,Sebuah lempengan batu jatuh ke kapal wisata di dekat air terjun di Brasil pada hari Sabtu (8/1). Sedikitnya 6 orang tewas dan 20 lainnya masih hilang. https://t.co/3EAVXLcWln,10,0,0,0,2022-01-09,13,Sunday,7,10,0
1480167216863657989,2022-01-09 13:18:59,Song Kang memakai kemeja tenun ikat rancangan Didiet Maulana dalam iklan produk jelly asal Indonesia. Ini kisah di baliknya. https://t.co/6Oc6SGkGYX,15,1,0,0,2022-01-09,13,Sunday,7,15,1
1480166396440965120,2022-01-09 13:15:43,"Daerah Ngupit di Kecamatan Ngawen, Klaten, memiliki sejarah panjang profesi tukang sunat atau bong supit. Kampung ini ternyata telah eksis sejak era Mataram. https://t.co/Jg8JmOuKCV",15,0,3,0,2022-01-09,13,Sunday,7,18,0
1480164307035897865,2022-01-09 13:07:25,Gangster yang diamankan Polsek Panongan sempat membuang senjata tajam yang dibawanya. Hal ini dilakukan pelaku untuk menghilangkan barang bukti. https://t.co/mlzptJUrGd,9,2,4,1,2022-01-09,13,Sunday,7,13,3
1480164285892468750,2022-01-09 13:07:20,"Dampak kerusuhan yang terjadi di Kazakhstan terlihat di Almaty, kota terbesar negara itu. Kondisinya tampak porak-poranda bak di film berlatar bencana masif. https://t.co/ucvm13PKcT",21,2,5,1,2022-01-09,13,Sunday,7,26,3
1480163533484699650,2022-01-09 13:04:21,Fiorentina telah mendapatkan Krzysztof Piatek. Arsenal harus bisa memanfaatkan momen itu untuk mendapatkan Dusan Vlahovic. https://t.co/q7trndMGS3,2,0,0,0,2022-01-09,13,Sunday,7,2,0
1480163507786194947,2022-01-09 13:04:15,"Komplotan gangster kembali beredar viral di sosial media. Polsek Panongan Kabupaten Tangerang, Banten pun turun tangan. Begini akhirnya. https://t.co/wi0mVrAKDh",2,0,0,0,2022-01-09,13,Sunday,7,2,0
1480162952456060929,2022-01-09 13:02:02,Jateng Hari Ini. Jalan rusak dimural jadi viral di Klaten hingga ancaman pidana bagi pemasang jebakan tikus Listrik di Sragen. https://t.co/bk41TljqRE,10,1,3,0,2022-01-09,13,Sunday,7,13,1
1480162363521200130,2022-01-09 12:59:42,"Mengaku dukun, seorang pria, B (65), warga Sentolo, Kulon Progo, DIY, dilaporkan ke polisi karena diduga mencabuli anak di bawah umur. Berikut kisahnya. https://t.co/4eg10KpcA7",9,3,3,1,2022-01-09,12,Sunday,7,12,4
1480162116560637953,2022-01-09 12:58:43,"Wali Kota Solo, Gibran Rakabuming Raka, mencuat dalam bursa calon Gubernur Jateng. Apa kata Gubernur Jateng, Ganjar Pranowo? https://t.co/MBcxZUUscc",16,1,4,1,2022-01-09,12,Sunday,7,20,2
1480161113991962632,2022-01-09 12:54:44,Jagung dipercaya memiliki banyak manfaat untuk kesehatan. Khasiatnya tak perlu diragukan lagi untuk mencegah berbagai jenis penyakit. https://t.co/VQnslqSynu,9,1,1,1,2022-01-09,12,Sunday,7,10,2
1480160381217783811,2022-01-09 12:51:49,"Tahun ini, BTS dan IU kembali meraih penghargaan utama (Daesang) di ajang penghargaan Golden Disc Awards 2022. Berikut daftar lengkap pemenang Golden Disc Awards ke-36 lainnya.  https://t.co/D9zWi2lPGn",18,1,4,1,2022-01-09,12,Sunday,7,22,2
1480158061138481153,2022-01-09 12:42:36,"PDIP akan memperingati HUT ke-49 besok. Ketum PDIP Megawati Soekarnoputri akan memberikan pidato politik, sementara Presiden Jokowi memberi sambutan. https://t.co/IPlDORrrDI",16,8,1,0,2022-01-09,12,Sunday,7,17,8
1480157315223461891,2022-01-09 12:39:38,"""Saat itu masih ada sabu-sabunyalah. Makanya Mama Dedeh gedeg banget sama gue, 'Gue ditemenin sama orang kayak gini,'"" cerita Abdel https://t.co/SSxt3pG2pP",46,1,2,0,2022-01-09,12,Sunday,7,48,1
1480156048166109186,2022-01-09 12:34:36,"Demi mencegah penyebaran varian Omicron, RI menutup pintu bagi WNA asal negara-negara tertentu. Berikut daftar 14 negara beserta kriterianya. https://t.co/6VMHvifwsR",19,13,10,8,2022-01-09,12,Sunday,7,29,21
1480155249444900878,2022-01-09 12:31:26,Mantan penyanyi Sinead O'Connor kembali menjadi sorotan setelah pengakuannya di media sosial baru-baru ini. Ia menuliskan jika putranya yang berusia 17 tahun itu meninggal dunia dengan cara bunuh diri.  https://t.co/4GnJ0vS8yP,11,1,3,0,2022-01-09,12,Sunday,7,14,1
1480154400849022982,2022-01-09 12:28:03,Striker Atletico Madrid Antoine Griezmann mengungkapkan bahwa dirinya tidak ingin berganti klub lagi. Menyusul karier yang buruk di Barcelona. https://t.co/1yZjvlKi0W,8,0,0,0,2022-01-09,12,Sunday,7,8,0
1480153732616704004,2022-01-09 12:25:24,"Polisi masih menyelidiki dugaan penipuan hingga Rp 4,2 juta yang dialami tukang siomai inisial E di Jakut. Terlapor pekan ini akan diperiksa oleh penyidik. https://t.co/FvdfqJ5eOo",4,0,1,0,2022-01-09,12,Sunday,7,5,0
1480153187466240000,2022-01-09 12:23:14,Sebuah bus pariwisata sarat penumpang menabrak truk di Jalan Tol Pasuruan-Probolinggo. Kecelakaan ini menewaskan dua orang. https://t.co/W47Pykqoh5,13,1,1,0,2022-01-09,12,Sunday,7,14,1
1480152698028802049,2022-01-09 12:21:17,Bali United sukses mengalahkan Barito Putera 3-0 dalam lanjutan Liga 1 2021. Ilija Spasojevic menjadi bintangnya di laga ini. https://t.co/VjophQls5N,3,0,0,0,2022-01-09,12,Sunday,7,3,0
1480152683118047232,2022-01-09 12:21:14,Cristiano Ronaldo sedang diterpa kabar buruk di Manchester United. Dia pun membuat caption di Instagram yang sama seperti sebelum cabut dari Juventus. https://t.co/rhd0PqTDrk,18,1,1,1,2022-01-09,12,Sunday,7,19,2
1480151854340313088,2022-01-09 12:17:56,"Kota Tianjin, China melakukan tes Corona massal kepada 14 juta penduduknya. Hal ini dilakukan setelah ditemukan kasus positif Covid-19 terkait varian omicron. https://t.co/dDsFHw4bJ3",12,1,2,0,2022-01-09,12,Sunday,7,14,1
1480151059330912263,2022-01-09 12:14:47,"Perumahan Bumi Mangli Permai (BMP) di Jember, terendam banjir. Tingginya genangan dan derasnya arus air membuat mobil yang diparkir hanyut. https://t.co/6CNqIyN9Af",5,1,2,1,2022-01-09,12,Sunday,7,7,2
1480150538775941123,2022-01-09 12:12:42,"Peri Santoso (40), penjual makanan kecil lumpia duleg (sosis kecil) menjalani kesehariannya dengan kondisi terbatas. Dua kakinya hilang akibat kecelakaan. https://t.co/HOFzNhkNU7",16,0,5,0,2022-01-09,12,Sunday,7,21,0
1480150171426201602,2022-01-09 12:11:15,Presiden Jokowi kembali menghabiskan waktu akhir pekannya bersama cucu. Kali ini Jokowi menemani Jan Ethes dan Sedan Mirah bermain di Istana. https://t.co/yEnC2y91wX,33,4,2,2,2022-01-09,12,Sunday,7,35,6
1480149111924011016,2022-01-09 12:07:02,Salah satu fitur canggih yang jadi unggulan dari Mercedes-Benz kekinian adalah fitur parkir otomatis yang disebut dengan Active Parking Assist. Ternyata fitur ini sudah hadir di seluruh lini Mercy di Indonesia lho. https://t.co/Zfy86VvCyw,8,0,1,0,2022-01-09,12,Sunday,7,9,0
1480147804815347714,2022-01-09 12:01:51,"Indonesia melaporkan 529 kasus baru virus Corona COVID-19 pada Minggu (9/1/2022). Total kasus positif menjadi 4.266.195, sembuh4.115.9587, meninggal 144.129. https://t.co/8skBjF7tP5",12,2,5,0,2022-01-09,12,Sunday,7,17,2
1480147450031755266,2022-01-09 12:00:26,Piala AFF U-23 2022 akan digelar di Kamboja pada 14-16 Februari mendatang. Berikut 5 calon bintang baru Indonesia di Piala AFF U-23. #CNNIndonesia #detikNetwork  https://t.co/rdeLpsnbk9,13,0,5,0,2022-01-09,12,Sunday,7,18,0
1480146560809897989,2022-01-09 11:56:54,"Seorang wanita yang sehari-hari bekerja sebagai petani ditemukan tewas di ladang tebu, Brebes. Korban yang hilang sejak Sabtu itu diduga korban pembunuhan. https://t.co/LoX334EDTs",7,1,2,0,2022-01-09,11,Sunday,7,9,1
1480146334967603200,2022-01-09 11:56:00,Pemerintah dan penyelenggara diminta terus mensosialisasikan aturan baru keberangkatan umrah pada masa pandemi ini https://t.co/1GfH3jLJZO,5,0,3,0,2022-01-09,11,Sunday,7,8,0
1480145292439736328,2022-01-09 11:51:52,Halil adalah pria penyandang disabilitas penjual tisu di jalanan Jaksel. Dia juga merupakan atlet disabilitas berprestasi. Dia punya satu harapan. https://t.co/xEUJmiME5a,80,5,25,3,2022-01-09,11,Sunday,7,105,8
1480143782217666560,2022-01-09 11:45:52,"Banjir akibat hujan deras merendam kawasan perumahan Bumi Mangli Permai (BMP), Kaliwates, Jember. Banjir terjadi akibat luapan Kali Semampir. https://t.co/9VYxuoyVbN",8,0,2,0,2022-01-09,11,Sunday,7,10,0
1480143125943398404,2022-01-09 11:43:15,"Real Madrid ada di posisi yang lebih baik menatap laga dengan Barcelona di Piala Super Spanyol. Kendati begitu, Carlo Ancelotti menyebut El Clasico selalu sama. https://t.co/bkAbPxV28G",6,0,1,0,2022-01-09,11,Sunday,7,7,0
1480142211622789125,2022-01-09 11:39:37,"Menurut Limbad, boneka merupakan salah satu benda yang mudah dirasuki jin. Ketika hal itu terjadi, jin dalam boneka tersebut bisa saja memengaruhi pemiliknya agar memperlakukan boneka secara berlebihan.
 https://t.co/BgTRsZcSwR",214,50,33,21,2022-01-09,11,Sunday,7,247,71
1480141887059156997,2022-01-09 11:38:20,"Bayern Munich mesti malu dua kali saat menjamu Borussia Moenchengladbach. Bayern kalah, dan Jamal Musiala pakai jersey yang salah. Bagaimana ceritanya? https://t.co/Kiv2N6M2mi",1,0,1,1,2022-01-09,11,Sunday,7,2,1
1480141406098411521,2022-01-09 11:36:25,Kapal New Humeer diduga mengalami kebocoran di Dermaga 001 Pelabuhan Sunda. Kapal tersebut hampir tenggelam. https://t.co/maQpd6RE5N,2,0,1,0,2022-01-09,11,Sunday,7,3,0
1480140659071852545,2022-01-09 11:33:27,Presenter Abdel buka-bukaan ngaku masih nyabu saat membawakan acara dakwah bersama Mamah Dedeh di televisi. Apa saja sih efek sabu pada tubuh? https://t.co/tQlmOdLFkh,19,6,2,1,2022-01-09,11,Sunday,7,21,7
1480139554862555136,2022-01-09 11:29:04,"Sebagian pria mungkin sudah tahu eksistensi dari tisu magic. Tapi, bagaimana dengan fungsinya? Berikut ini 4 fungsi tisu magic yang perlu diketahui. https://t.co/SqynwtOSZb",15,7,3,5,2022-01-09,11,Sunday,7,18,12
1480138522388582407,2022-01-09 11:24:58,Akun Twitter Pemkot Depok unretweet unggahan berisi ajakan mencari informasi keluarga polisi yang menembak laskar FPI. Ini alasannya. https://t.co/HinkpDkF7Z,38,26,16,8,2022-01-09,11,Sunday,7,54,34
1480137485590147078,2022-01-09 11:20:50,Sedikitnya 7 orang tewas dan 3 hilang setelah bongkahan tebing batu menimpa kapal wisata di Brasil. Momen ini diabadikan oleh traveler lain dan viral di media sosial. https://t.co/uFH9VNYFEn,10,0,4,1,2022-01-09,11,Sunday,7,14,1
1480136464361005060,2022-01-09 11:16:47,Greta Irene diketahui masih menaruh bunga segar di atas kasur adiknya. Bunga segar itu dirangkai dalam bentuk Salib. Bahkan Greta Irene berharap adiknya segera datang ke mimpinya. https://t.co/NdWzekGK3A,22,2,1,1,2022-01-09,11,Sunday,7,23,3
1480134495923802112,2022-01-09 11:08:58,"Sejumlah fasilitas strategis di Kazakhstan kini berada di bawah penjagaan aliansi militer pimpinan Rusia, CSTO. Hal ini dilakukan untuk memulihkan ketertiban. https://t.co/reFBN6Qj70",12,0,1,1,2022-01-09,11,Sunday,7,13,1
1480134281859117061,2022-01-09 11:08:07,"Seorang Putri Arab Saudi dan anak perempuannya dibebaskan dari tahanan. Keduanya dibebaskan setelah mendekam di balik jeruji besi selama hampir 3 tahun tanpa dakwaan di Ibu Kota Riyadh, Arab Saudi. https://t.co/55V1DvDkun",15,0,1,0,2022-01-09,11,Sunday,7,16,0
1480132993842921477,2022-01-09 11:02:59,"Ketua Parade Nusantara Romo Sudir Santoso meninggal dunia, Minggu siang (9/1/2022) siang tadi. https://t.co/wCWbVYKTxV",5,1,1,0,2022-01-09,11,Sunday,7,6,1
1480132110300196866,2022-01-09 10:59:29,"Jaringan bioskop asal Kanada, Cineplex Inc memberhentikan sementara 6.000 karyawan paruh waktu. Kebijakan itu dilakukan karena melonjaknya kasus COVID-19 yang disebabkan oleh varian Omicron. https://t.co/cCL3WhEUP1",6,1,2,1,2022-01-09,10,Sunday,7,8,2
1480131081819070467,2022-01-09 10:55:24,Manchester United masih belum tampil oke meski ada Cristiano Ronaldo. Pemain asal Portugal itu dianggap banyak menyebabkan masalah di tim. https://t.co/a1ykgEMnka,23,3,3,5,2022-01-09,10,Sunday,7,26,8
1480130706713968640,2022-01-09 10:53:54,Video yang memperlihatkan potongan kertas menumpuk di tempat sampah usai Walkot Bekasi Rahmat Effendi terjaring OTT KPK beredar di media sosial. Ini kata KPK. https://t.co/rbHLsqxpBN,12,1,9,4,2022-01-09,10,Sunday,7,21,5
1480129655134904321,2022-01-09 10:49:43,"Hujan deras disertai angin kencang menumbangkan sebuah pohon di Jalan Raya Ponokawan, Krian, Sidoarjo tumbang. Pohon tumbang itu menimpa tiga pengendara motor. https://t.co/l4O0rXdO8z",5,0,0,0,2022-01-09,10,Sunday,7,5,0
1480129160202924041,2022-01-09 10:47:45,"Hujan deras disertai angin kencang menumbangkan sebuah pohon di Jalan Raya Ponokawan, Krian, Sidoarjo tumbang. Pohon tumbang itu menimpa tiga pengendara motor. https://t.co/iTSNCRTDqr",5,1,0,2,2022-01-09,10,Sunday,7,5,3
1480129127453708294,2022-01-09 10:47:38,Bupati Lumajang Thoriqul Haq memastikan polisi dan relawan di lokasi terdampak erupsi Semeru sedang mencari pria yang menendang sesajen. Siapa pria tersebut? https://t.co/pNpmvxg5Fo,1444,473,279,128,2022-01-09,10,Sunday,7,1723,601
1480128084787486726,2022-01-09 10:43:29,"Presiden Turkmenistan, Gurbanguly Berdymukhamedov mengatakan bahwa ia ingin memadamkan api di kawah gas alam Darvaza. Situs ini merupakan objek wisata populer di Asia Tengah dan dikenal sebagai Pintu Neraka. Apa alasannya?  https://t.co/hCTp2HkuVv",11,2,1,1,2022-01-09,10,Sunday,7,12,3
1480126505011355650,2022-01-09 10:37:12,"Indikator Politik Indonesia (IPI) merilis survei elektabilitas partai politik pada gelaran Pemilu 2024. Hasilnya, PDIP kokoh dengan elektabilitas tertinggi. https://t.co/qw0vq6VMHe",7,3,1,2,2022-01-09,10,Sunday,7,8,5
1480124490998857729,2022-01-09 10:29:12,Polisi menangkap 39 pelaku kejahatan di sejumlah daerah di Sumut. Begal yang memukul dan merampas sepeda motor penyapu jalan di Medan turut ditangkap. https://t.co/xDdp5VlVNw,5,0,1,0,2022-01-09,10,Sunday,7,6,0
1480123010296201216,2022-01-09 10:23:19,"Gunung Merapi kembali memuntahkan awan panas pada Minggu siang hari ini. Kali ini awan panas meluncur sejauh 2,5 km. https://t.co/6W3wlEhFlg",24,3,10,1,2022-01-09,10,Sunday,7,34,4
1480122989001781248,2022-01-09 10:23:14,"Penangkapan 11 gangster di Panongan, Tangerang sempat diwarnai aksi kejar-kejaran. Polisi bahkan hingga harus memblokade jalan. https://t.co/8BYYtj8uIH",8,1,4,0,2022-01-09,10,Sunday,7,12,1
1480122987936460808,2022-01-09 10:23:14,"Beredar video belasan anggota gangster diamankan Polsek Panongan, Kabupaten Tangerang, Minggu (9/1) dini hari. https://t.co/3rgw4SGVHG",11,1,4,2,2022-01-09,10,Sunday,7,15,3
1480121944578088961,2022-01-09 10:19:05,Sebuah pikap terbakar di Jalan Tol Gempol-Pasuruan. Pengemudi dan dua penumpang selamat meski kendaraan ludes. https://t.co/jdu8XBpfyM,5,1,3,0,2022-01-09,10,Sunday,7,8,1
1480121030337339397,2022-01-09 10:15:27,"Rizky Billar menuliskan jika berat badan anak mereka 2,8 kilogram. Ini lo penjelasan dokter obgyn yang menangani Lesti Kejora dan Rizky Billar soal berat badan anak yang disebut prematur. https://t.co/9u5bpuJLuk",17,11,1,13,2022-01-09,10,Sunday,7,18,24
1480118890499911682,2022-01-09 10:06:57,BMKG mengeluarkan peringatan dini cuaca untuk Daerah Istimewa Yogyakarta (DIY) sore ini. Masa berlaku peringatan dini mulai pukul 14.45 WIB.  https://t.co/86sDqnDJqz,15,2,4,0,2022-01-09,10,Sunday,7,19,2
1480118851690201089,2022-01-09 10:06:48,"Witan Sulaeman memanfaatkan betul Waktu senggang usai Piala AFF 2020. Pemain Timnas Indonesia itu melamar kekasihnya dengan mahar Rp 250 juta, Jumat (8/1/2022). https://t.co/5gE9pDO0jO",12,0,3,1,2022-01-09,10,Sunday,7,15,1
1480118298998153216,2022-01-09 10:04:36,"Ketua Parade Nusantara Romo Sudir Santoso meninggal dunia, Minggu siang (9/1/2022) siang tadi. https://t.co/sni8g5nGVV",10,1,1,0,2022-01-09,10,Sunday,7,11,1
1480117144591355906,2022-01-09 10:00:01,Mari kita ulas kilas balik peristiwa penting sepanjang 2021 selengkapnya di: https://t.co/UZFsXLg8ho https://t.co/25tmao0EDP,3,0,1,0,2022-01-09,10,Sunday,7,4,0
1480116217910288387,2022-01-09 09:56:20,"Usai visanya dicabut terkait pengecualian vaksinasi, Novak Djokovic kini ditahan di Park Hotel, Australia. Djokovic akan menjalani sidang pada Senin (10/01). https://t.co/L8eI3vfXZ7",8,0,0,0,2022-01-09,9,Sunday,7,8,0
1480114170360119298,2022-01-09 09:48:12,"Dahlan bercerita, kala itu direktur PLN menemuinya karena ada anggota DPR yang berasal dari komisi yang membawahi BUMN menanyakan THR. Berikut pernyataannya.  https://t.co/FqX6ZoIJQG",54,18,28,5,2022-01-09,9,Sunday,7,82,23
1480112105554653186,2022-01-09 09:39:59,Lebih dari 5.000 orang telah ditangkap di Kazakhstan imbas kerusuhan yang memanas selama sepekan terakhir. https://t.co/jerYCFU2er,7,1,0,1,2022-01-09,9,Sunday,7,7,2
1480112104178860044,2022-01-09 09:39:59,Video seorang pria membuang dan menendang sesajen di lokasi terdampak erupsi Semeru viral. Pria itu kini sedang dalam buruan polisi. https://t.co/yfzKBVHP3g,313,132,79,42,2022-01-09,9,Sunday,7,392,174
1480111133411446791,2022-01-09 09:36:07,"""Survei menjadi salah satu indikator Jateng satu, menguntungkan kita untuk mempertimbangkan, sehingga layaklah kalau Mas Gibran maju Jateng satu,"" kata FX Rudy. https://t.co/t3WR6aq7yA",12,1,0,5,2022-01-09,9,Sunday,7,12,6
1480108518632005633,2022-01-09 09:25:44,"Kalina Oktarani bertemu dengan Ivan Gunawna di salah satu tempat makan di Jakarta. Dalam Instagram Stories miliknya, Kalina Oktarani menyebut dirinya adalah perempuan single. https://t.co/0FuZxdecx4",19,7,1,2,2022-01-09,9,Sunday,7,20,9
1480107237163077635,2022-01-09 09:20:39,"Hari ini, Minggu (9/1/2022), Kate Middleton genap berusia ke-40. Untuk merayakannya, Kerajaan Inggris merilis foto resmi terbaru istri Pangeran William itu. Ini foto-fotonya.  https://t.co/al4sTqdXlf",57,2,13,2,2022-01-09,9,Sunday,7,70,4
1480105357879959555,2022-01-09 09:13:11,"Satu orang pelaku pengeroyokan keluarga di Cipinang Melayu, Jakarta Timur, kembali ditangkap polisi. Pelaku ternyata satpam. https://t.co/bMVQYOT8e5",10,2,1,2,2022-01-09,9,Sunday,7,11,4
1480105115377934341,2022-01-09 09:12:13,Sawangan merupakan salah satu tempat yang cocok untuk mencari hunian. Letaknya yang strategis menjadi kelebihan utama kawasan yang berada di Kota Depok ini. https://t.co/CMUnbqzOlq,16,7,2,3,2022-01-09,9,Sunday,7,18,10
1480102528188657666,2022-01-09 09:01:56,Seorang pria menendang sesajen yang disebut berada di wilayah Semeru. Aksi pria menendang sesajen itu viral. https://t.co/smIJIbxyUh,464,207,85,63,2022-01-09,9,Sunday,7,549,270
1480102159991595016,2022-01-09 09:00:28,"Adik Sandra Dewi yang selama ini jarang tersorot media ternyata menjalani karier dengan jabatan mentereng lho. Lihat potret-potretnya di sini, yuk. #detikNetwork  https://t.co/vUnGhTXjDp",8,0,0,1,2022-01-09,9,Sunday,7,8,1
1480101166684024833,2022-01-09 08:56:31,Studi baru mengungkap temuan mutasi yang merujuk pada dugaan varian Omicron berasal dari tikus. Benarkah begitu? Begini hasil risetnya. https://t.co/q1jfsGtgJU,18,12,10,1,2022-01-09,8,Sunday,7,28,13
1480099909344845825,2022-01-09 08:51:31,"Terus bertambah, kini ada 1.798 pasien COVID-19 yang dirawat di RSD Wisma Atlet Kemayoran. Begini perbandingan datanya. https://t.co/plbcvZogxC",12,1,2,3,2022-01-09,8,Sunday,7,14,4
1480098052694327298,2022-01-09 08:44:09,Li Jingwei menjadi korban penculikan 30 tahun silam dan berhasil bertemu ibu kandungnya kembali berkat peta yang ia buat sendiri. Begini kisahnya: https://t.co/YpKnuhDVnm,51,5,12,1,2022-01-09,8,Sunday,7,63,6
1480095506005118979,2022-01-09 08:34:02,"Dalam gelaran Consumer Electronics Show (CES) 2022 di Las Vegas, AS, sejumlah teknologi baru dan unik mencuri perhatian. Ada apa saja? https://t.co/FPgKF4uxy8",6,0,0,0,2022-01-09,8,Sunday,7,6,0
1480093892049522692,2022-01-09 08:27:37,Gubernur DKI Jakarta Anies Baswedan memamerkan progres revitalisasi Taman Tebet di Jakarta Selatan menjadi Tebet Eco Park. Begini potretnya. https://t.co/PtSEOhydLk,52,12,4,1,2022-01-09,8,Sunday,7,56,13
1480092660841033728,2022-01-09 08:22:43,Ketua Satgas COVID-19 Ikatan Dokter Indonesia (IDI) Prof Zubairi Djoerban sentil warga yang masih nekat berwisata ke luar negeri di tengah ancaman Omicron. Ini lho dampaknya.  https://t.co/miu7xMb9Ks,24,3,10,4,2022-01-09,8,Sunday,7,34,7
1480091144209981442,2022-01-09 08:16:42,"Sebenarnya cara memasak pasta sangat mudah, namun kalau dilakukan dengan cara yang tepat. Ada beberapa tips memasak pasta yang bisa kamu ikuti agar hasilnya al dente dan tidak lengket. Ini tipsnya.  https://t.co/gwIIEIGhyN",12,0,1,0,2022-01-09,8,Sunday,7,13,0
1480089915786412038,2022-01-09 08:11:49,"Percayakah jika ada seorang pria yang telah memiliki belasan istri hingga ratusan anak? Jika tidak, yuk kenalan dengan sosok Misheck Nyandoro ini!  https://t.co/lMkdoxxsF0",16,6,2,2,2022-01-09,8,Sunday,7,18,8
1480088179235508226,2022-01-09 08:04:55,"Ada 6 drama Korea yang bisa jadi pilihan tontonanmu selama bersantai di rumah.
Berikut daftarnya: https://t.co/E1YAOVFwFl",6,0,3,0,2022-01-09,8,Sunday,7,9,0
1480086732318158851,2022-01-09 07:59:10,"Momen sebuah lempengan batu tebing pecah dan jatuh ke kapal wisata di Danau Furnas, Brasil. Sedikitnya 6 orang tewas dan 20 lainnya masih hilang. Begini detik-detik kejadiannya. https://t.co/z6fUFnmuMH",11,0,4,0,2022-01-09,7,Sunday,7,15,0
1480085177141452802,2022-01-09 07:52:59,"Saat banyak negara kembali menghadapi wabah baru, mungkinkah kasus COVID-19 di Tanah Air tetap membaik karena 'super immunity'?
 https://t.co/xdgsB4yHa7",7,4,3,0,2022-01-09,7,Sunday,7,10,4
1480082047624527876,2022-01-09 07:40:33,"Lesti menegaskan jika kelak punya anak perempuan, dia ingin memberikan nama 'Kejora'. Ini alasannya. 
 https://t.co/QB1qP7XOY7",31,32,2,2,2022-01-09,7,Sunday,7,33,34
1480080036044722182,2022-01-09 07:32:33,Lima berita entertainment dan lifestyle terpopuler dalam minggu ini. Ashanty positif Covid-19 hingga Naufal Samudra kembali diamankan polisi terkait narkoba. https://t.co/FeVPQ3HPfq,4,0,1,0,2022-01-09,7,Sunday,7,5,0
1480078024720764929,2022-01-09 07:24:34,"Meski baru heboh sekarang, tahukah kamu bahwa kemunculan boneka arwah di Indonesia bukanlah hal yang baru. Bagaimana sih sejarahnya?  https://t.co/7pm7b1Uwbm",19,3,5,3,2022-01-09,7,Sunday,7,24,6
1480074718833225729,2022-01-09 07:11:26,Shakilla Kaif berulang tahun ke-23 pada 7 Januari kemarin. Sang model merayakan pesta pertambahan usia tersebut di Bali.  https://t.co/f3PwBxFb1d,9,0,1,1,2022-01-09,7,Sunday,7,10,1
1480073431089659907,2022-01-09 07:06:19,Viral video seorang pria yang terbang hingga 9 meter karena terbawa layang-layang. Netizen pun dibuat ngeri melihatnya.  https://t.co/beOk0VKgpK,43,5,16,6,2022-01-09,7,Sunday,7,59,11
1480072302821883907,2022-01-09 07:01:50,Ishak Ismail seorang kapten yang menakhodai Kapal Riset  Baruna Jaya didepak dari pekerjaan yang sudah dilakoninya selama 19 tahun. Padahal ia belum ingin dan belum waktunya pensiun. #CNNIndonesia #detikNetwork  https://t.co/ZDGV65QkIX,15,3,3,1,2022-01-09,7,Sunday,7,18,4
1480069198806147075,2022-01-09 06:49:30,Pencarian Efriyani (42) yang hilang enam bulan akhirnya membuahkan hasil. Wanita Klaten itu akhirnya pulang diantara dua orang warga yang menemukannya di Solo.  https://t.co/dj1TzjdJhv,12,1,3,0,2022-01-09,6,Sunday,7,15,1
1480067939273433092,2022-01-09 06:44:29,"Kawasan Bundaran HI, Jakarta Pusat ramai aktivitas warga Minggu (9/1) pagi. Tak hanya bersepeda, ada juga warga yang sekedar berswafoto. https://t.co/TJrq4SK85E",3,0,2,0,2022-01-09,6,Sunday,7,5,0
1480065979828822016,2022-01-09 06:36:42,Memiliki lambung yang sensitif membuat beberapa orang tak bisa mengonsumsi makanan secara bebas. Lantas apakah penderita asam lambung diperbolehkan konsumsi gula? https://t.co/0lXSvZYCxG,11,0,5,1,2022-01-09,6,Sunday,7,16,1
1480064448786280450,2022-01-09 06:30:37,Seorang kakek di Kota Semarang dikabarkan hilang. Saat ini pihak keluarga sedang melakukan pencarian dan sudah melaporkan ke Polsek Tembalang. https://t.co/0fwR6sk248,14,4,6,2,2022-01-09,6,Sunday,7,20,6
1480062647441760261,2022-01-09 06:23:28,"Bagian belakang gedung Dinas Kearsipan dan Perpustakaan Daerah (Arpusda) Kabupaten Sukoharjo, Jawa Tengah, terbakar pada Sabtu (8/1) malam. Begini kondisi terkininya.  https://t.co/XdkezRYkK8",9,0,3,0,2022-01-09,6,Sunday,7,12,0
1480059456792797187,2022-01-09 06:10:47,Pemerintah akan merekomendasikan penggunaan Molnupiravir dan Paxlovid bagi pasien COVID-19 Omicron tanpa gejala dan bergejala ringan. https://t.co/8p3EWOc4DI,8,1,8,0,2022-01-09,6,Sunday,7,16,1
1480058028972027905,2022-01-09 06:05:06,"Kerusakan jalan Kepoh-Juwiring, Desa Bulurejo, Kecamatan Juwiring, Klaten, Jawa Tengah digambar menjadi pola seekor burung. Lubang jalan yang digambar itu viral setelah ditulisi kalimat lomba mural dalan (jalan) rusak.
 https://t.co/UdjKFgmIuy",25,2,6,3,2022-01-09,6,Sunday,7,31,5
1480056463074725889,2022-01-09 05:58:53,Pesepakbola Riyad Mahrez dikabarkan diam-diam sudah melangsungkan ijab kabul untuk menikahi model Taylor Ward. Intip kisah cinta mereka dan potret sang model di sini.  https://t.co/BJRNE8op0I,6,3,2,1,2022-01-09,5,Sunday,7,8,4
1480055226468024321,2022-01-09 05:53:58,"Direktur Utama PT Waskita Sriwijaya Tol, Herwidiakto, mengatakan pihaknya melakukan beberapa rencana aksi. Rencana aksi itu seperti penambahan rambu-rambu di sepanjang tol hingga penutupan lubang di jalan. https://t.co/5lKud7PCik",28,43,7,7,2022-01-09,5,Sunday,7,35,50
1480053932051550212,2022-01-09 05:48:50,"Di usianya yang masih 16 tahun, ia sudah berhasil meraup untung hingga miliaran rupiah. Yuk simak kisahnya!
 https://t.co/eBIDIySqHZ",26,4,5,1,2022-01-09,5,Sunday,7,31,5
1480052669490372608,2022-01-09 05:43:49,"Ashanty positif COVID-19 sepulang dari Turki bersama keluarga. Ia menyebut tak ada masalah dengan indra perasa, hanya ini yang dikeluhkan. https://t.co/HSs264bWLt",7,17,1,2,2022-01-09,5,Sunday,7,8,19
1480051159788310528,2022-01-09 05:37:49,Valencia geram dengan keputusan wasit yang memberikan penalti kepada Real Madrid. Mereka merasa 'dirampok' dalam kekalahan di markas Madrid. https://t.co/rrTKFFZWKN,3,0,1,0,2022-01-09,5,Sunday,7,4,0
1480049915002773504,2022-01-09 05:32:52,Doddy Sudrajat mengadu ke Kementerian Sosial soal penggalangan rumah Gala yang diadakan Marissya Icha. Susi Pudjiastuti ikut berkomentar. Ini komentarnya.  https://t.co/j5zptfWaXE,39,10,8,2,2022-01-09,5,Sunday,7,47,12
1480048336556154883,2022-01-09 05:26:36,Lesti Kejora dan Rizky Billar akhirnya mengungkapkan nama hingga wajah dari buah hatinya yang lahir akhir Desember 2021 lalu. Begini momennya.  https://t.co/5Z3BsKqII8,7,5,0,0,2022-01-09,5,Sunday,7,7,5
1480047046312747014,2022-01-09 05:21:28,Nyoman Nuarta yang merupakan desainer istana ibu kota baru buka suara terkait pertemuan dengan Presiden Joko Widodo (Jokowi). Ini pernyataan Nyoman Nuarta.  https://t.co/JdhSlan4H0,8,3,1,1,2022-01-09,5,Sunday,7,9,4
1480045488816676866,2022-01-09 05:15:17,"Setelah lama dinantikan, wahana baru mobil listrik wisata Kota Solo akhirnya beroperasi. Meski banyak masyarakat antusias, rupanya operasional mobil ini menjadi polemik. Kenapa?  https://t.co/Mi8xEhXZzy",3,0,0,0,2022-01-09,5,Sunday,7,3,0
1480043980805091329,2022-01-09 05:09:17,Ini kata pakar komunikasi tentang orang yang nonaktifkan centang biru disebut tidak beradab.  https://t.co/JJ4C7G4D72,156,87,67,70,2022-01-09,5,Sunday,7,223,157
1480042474622136322,2022-01-09 05:03:18,Para publik figur kut menunjukkan pilihan cara memakan bubur ayam. Mulai dari chef para selebriti hingga presiden Indonesia. Tim bubur diaduk atau tidak ya mereka?  https://t.co/zBpeSnDgbs,5,3,2,2,2022-01-09,5,Sunday,7,7,5
1480041066439008257,2022-01-09 04:57:42,Banyak kisah diet sukses berawal dari rasa kesal akibat diejek orang sekitar. Seperti lima orang ini yang pernah diejek mirip kuda nil hingga kulkas 2 pintu. https://t.co/hmFltAQwKV,7,0,1,1,2022-01-09,4,Sunday,7,8,1
1480039817866010626,2022-01-09 04:52:45,"Pesinetron Naufal Samudra diamankan polisi terkait kasus narkoba pada Jumat (7/1) di kediaman orang tuanya di Ragunan, Jakarta Selatan. Berikut fakta-faktanya. #NaufalSamudra  https://t.co/JdzwY72P4j",3,0,0,0,2022-01-09,4,Sunday,7,3,0
1480038242317656065,2022-01-09 04:46:29,Anies memamerkan progres revitalisasi Taman Tebet menjadi Tebet Eco Park. Fasilitas yang ditambahkan yaitu Connecting Bridge yang pembangunannya hampir rampung. #TebetEcoPark  https://t.co/VsSQ2xBpeY,14,4,3,1,2022-01-09,4,Sunday,7,17,5
1480036708917948417,2022-01-09 04:40:23,Marcus Rashford buka suara soal isu miring di ruang ganti Manchester United. Rashford menegaskan komitmennya kepada klub dan Ralf Rangnick. https://t.co/H8KfwUMLBD,5,1,0,0,2022-01-09,4,Sunday,7,5,1
1480035142966169601,2022-01-09 04:34:10,Abdel memberikan pengakuan soal menggunakan sabu saat mengisi acara bareng Mamah Dedeh. Begini pengakuannya.  https://t.co/EcxhAtxq83,251,81,90,25,2022-01-09,4,Sunday,7,341,106
1480033775807569920,2022-01-09 04:28:44,Karim Benzema mendekati rekor gol Raul Gonzalez usai bikin brace ke gawang Valencia. Ia kini sudah bikin 301 gol untuk Real Madrid. https://t.co/QZexuY4FLd,7,0,0,0,2022-01-09,4,Sunday,7,7,0
1480032283004440577,2022-01-09 04:22:48,"Dua orang jurnalis bernama John Wesley Amady (30) dan Wilguens Louissaint (22), dibunuh oleh bandit bersenjata saat meliput di ibu kota Haiti.  https://t.co/mTaEHEMZgI",14,0,4,0,2022-01-09,4,Sunday,7,18,0
1480030973613981697,2022-01-09 04:17:36,Heboh postingan tentang menonaktifkan centang biru disebut tidak beradab langsung menuai kritik dari warganet. Kalau pendapatmu?  https://t.co/ajYgONzks0,96,89,19,54,2022-01-09,4,Sunday,7,115,143
1480029492563390464,2022-01-09 04:11:43,Sejumlah artis Indonesia merayakan momen pergantian tahun di luar negeri. Intip gaya artis Indonesia saat tahun baru di Turki hingga Amerika Serikat. https://t.co/rdaSWYGofI,8,11,1,1,2022-01-09,4,Sunday,7,9,12
1480028241872183298,2022-01-09 04:06:45,Ramalan zodiak Virgo masih perlu dijaga dana yang ada agar tidak menambah kacau suasana. Bagaimana dengan ramalan zodiak kamu hari ini?  https://t.co/BbZNe1crE2,4,0,0,0,2022-01-09,4,Sunday,7,4,0
1480026714247942146,2022-01-09 04:00:40,"Pada pertengahan tahun 2021, Olivia Zalianty membawa kabar bahagia telah menikah dengan Ndaru Kusumo. Intip foto terbaru keduanya yang kian mesra di sini. #detikNetwork  https://t.co/atcgjywXWI",8,1,0,0,2022-01-09,4,Sunday,7,8,1
1480025463854710785,2022-01-09 03:55:42,"Selama ini kami cuma TTM. Sering kali putus asa sama hubungan ini, menjauh, menghilang darinya. Tapi entah kenapa selalu kembali dekat lagi. detikers mengalami hal serupa?  https://t.co/01irfAmRv5",9,3,1,2,2022-01-09,3,Sunday,7,10,5
1480023451721216000,2022-01-09 03:47:43,"#Terpopuler  Lola Diara ikut terseret saat kisah Layangan Putus viral pada 2019. Kini, dia memberikan klarifikasi saat web series Layangan Putus viral. https://t.co/Zt0L8Mu3sB",8,0,1,0,2022-01-09,3,Sunday,7,9,0
1480021614943162371,2022-01-09 03:40:25,"Naufal Samudra kembali diamankan polisi dan ditetapkan sebagai saksi dari kasus narkoba yang sedang dikembangkan Polda Metro Jaya. Dinda Kirana mengaku tetap mendukung kekasih hatinya 100 % apapun yang tengah terjadi.
 https://t.co/PQ0CXvFPtN",3,1,0,0,2022-01-09,3,Sunday,7,3,1
1480019636934615042,2022-01-09 03:32:33,"Abdul Hamid (74) atau yang dikenal Pak Ogah, kini sedang terbaring lemah karena sakit komplikasi yang dideritanya. Tim detikcom menjenguk sekaligus memberikan kejutan dengan menghadirkan boneka Pak Ogah. Berikut kondisi terkini Pak Ogah. https://t.co/4Ax7yx6dm6",352,26,66,8,2022-01-09,3,Sunday,7,418,34
1480018053685522436,2022-01-09 03:26:16,"Pesepakbola perempuan Indonesia, Shalika Aurelika, dikontrak tim asal Italia, Roma CF. Yuk, kenali lebih dalam klub anyar penggawa timnas putri Indonesia itu. https://t.co/kJoqYSH52s",55,1,7,2,2022-01-09,3,Sunday,7,62,3
1480016513407111170,2022-01-09 03:20:08,Lionel Messi akan absen membela Paris Saint-Germain di laga melawan Lyon. Bintang asal Argentina itu masih melanjutkan pemulihan dari COVID-19. https://t.co/M6toVIw4np,9,2,1,0,2022-01-09,3,Sunday,7,10,2
1480015031035170822,2022-01-09 03:14:15,"Pencurian spion ambulans terjadi di Kebon Bawang, Tanjung Priok, Jakarta Utara (6/1). Berikut aksi kriminalnya yang terekam kamera CCTV. #Pencurian  https://t.co/EvhVgBBmEr",5,1,1,0,2022-01-09,3,Sunday,7,6,1
1480013551758716935,2022-01-09 03:08:22,"#Terpopuler ""Saya mengambil dari teman di luar negeri dan dia siap membantu. Saya dapat kemudahan, membayar jika barang yang saya pesan datang,"" ujar Suyanto. https://t.co/4lXNcPhnfY",20,0,3,1,2022-01-09,3,Sunday,7,23,1
1480012114211352576,2022-01-09 03:02:39,Barcelona harus puas pulang dengan 1 pion kala tandang ke markas Granada dengan skor 1-1. Tiga poin Blaugrana dibuyarkan oleh gol Granada semenit sebelum bubar.  https://t.co/vNcbI8PHY6,4,2,0,0,2022-01-09,3,Sunday,7,4,2
1480009890559148038,2022-01-09 02:53:49,Sebagian wilayah di Jawa Tengah berpotensi hujan pagi ini. Sedangkan pada siang hingga awal malam nanti hujan di Jawa Tengah berpotensi terjadi secara merata.  https://t.co/GtUnZz8ylS,2,0,0,0,2022-01-09,2,Sunday,7,2,0
1480008619366449152,2022-01-09 02:48:46,"Menurut survei terbaru, 60,9 persen pria Jepang lebih suka buang air kecil sambil duduk. Tren ini populer di kalangan pria muda usia 25-35 tahun. #Survei  https://t.co/XYsfKKPhP4",8,3,4,3,2022-01-09,2,Sunday,7,12,6
1480007338211880964,2022-01-09 02:43:41,Gisel mengaku sama sekali tidak masalah saat banyak orang di luaran sama mendoakan rujuk dengan Gading Marten. Ia pun mengamini semua doa yang datang padanya. https://t.co/gXmUYTSzWr,46,28,2,3,2022-01-09,2,Sunday,7,48,31
1480005569255727106,2022-01-09 02:36:39,"Walaupun sudah boleh pulang ke rumah, kesehatan Dorce masih harus dipantau. Dorce Gamalama harus menghindari makanan ini demi kesehatannya. #DorceGamalama  https://t.co/V299jpl46A",2,0,0,0,2022-01-09,2,Sunday,7,2,0
1480003518115332098,2022-01-09 02:28:30,"Banyaknya kasus penyalahgunaan identitas pribadi membuat bocah 14 tahun asal Yogyakarta ini membuat aplikasi yang sangat berguna, Watermark KTP. https://t.co/Hv1VhM2u4S",72,4,13,3,2022-01-09,2,Sunday,7,85,7
1480001932685021184,2022-01-09 02:22:12,"Selain menggunakan kendaraan pribadi, ada bus Trans Jogja yang menjangkau beberapa tempat wisata utama di Yogyakarta. Mana saja? https://t.co/dqQ406uga4",17,2,7,1,2022-01-09,2,Sunday,7,24,3
1480000159417356289,2022-01-09 02:15:09,Buya Yahya menjawab soal heboh spirit doll atau boneka arwah. Buya Yahya menegaskan tak ada roh masuk ke boneka. https://t.co/vfXq06JbZD,17,3,3,0,2022-01-09,2,Sunday,7,20,3
1479998320521228291,2022-01-09 02:07:51,"Selama delapan tahun, seorang pria mencari hard disk berisi 7.500 Bitcoin di tumpukan sampah. Nilainya Rp 5 triliun!   https://t.co/R5uppPDj2i",45,6,4,3,2022-01-09,2,Sunday,7,49,9
1479996502084890629,2022-01-09 02:00:37,"BlackBerry Ltd secara resmi menarik layanannya, meninggalkan sisa-sisa kenangan indah bagi para mantan pengguna ponsel legendaris tersebut. #CNNIndonesia #detikNetwork  https://t.co/9h7cOleJTR",20,3,5,7,2022-01-09,2,Sunday,7,25,10
1479993655813365767,2022-01-09 01:49:19,"Kasus Covid-19 di DKI Jakarta terjadi peningkatan signifikan, dengan jumlah kasus aktif mencapai 1.394 orang pada Jumat (7/1). Ini penjelasan Wakil Gubernur DKI Jakarta, Ahmad Riza Patria. https://t.co/EAAhkivDDK",9,5,4,2,2022-01-09,1,Sunday,7,13,7
1479989329753780231,2022-01-09 01:32:07,"Akhirnya Rizky Billar dan Lesti Kejora memperlihatkan wajah anaknya. Tidak hanya itu, pasangan itu juga memberitahukan nama anak mereka.  https://t.co/4rZGrLd0kH",32,45,4,3,2022-01-09,1,Sunday,7,36,48
1479987216763994114,2022-01-09 01:23:43,"Beginilah gaya Kevin saat berjualan Ikan Cue hasil olahannya sendiri dengan cara berkeliling komplek menggunakan setelah jas lengkap dengan motornya. Bagaimana menurut kamu? 
 https://t.co/AEycS30f8v https://t.co/gDabmR0Ifi",150,23,22,8,2022-01-09,1,Sunday,7,172,31
1479985453831012358,2022-01-09 01:16:43,"Abdul Hamid atau yang sering di panggil Pak Ogah saat ini kondisinya memprihatinkan, namun siapakah yang menyematkan sosok Pak ogah pada Abdul Hamid? #PakOgah  https://t.co/TqIZRaSG8a",28,1,5,3,2022-01-09,1,Sunday,7,33,4
1479983362702036993,2022-01-09 01:08:25,Pemerintah mengingatkan untuk tidak bepergian demi mencegah penularan. #Omicron  https://t.co/N0wYe15iYI,19,6,4,3,2022-01-09,1,Sunday,7,23,9
1479981435838779400,2022-01-09 01:00:45,Marcus Rashford buka suara soal isu miring di ruang ganti Manchester United. Rashford menegaskan komitmennya kepada klub dan Ralf Rangnick. https://t.co/gCL43lgHir,6,0,1,1,2022-01-09,1,Sunday,7,7,1
1479980934246064129,2022-01-09 00:58:46,"Ketua Komisi A DPRD DKI Jakarta, Mujiyono menyampaikan soal ngontrak rumah tak jadi syarat pencalonan ketua RW seperti yang diributkan di Jelambar https://t.co/yQqo2Jous6",3,1,1,1,2022-01-09,0,Sunday,7,4,2
1479980427892903938,2022-01-09 00:56:45,"Abdul Hamid atau yang sering di panggil Pak Ogah saat ini kondisinya memprihatinkan, namun siapakah yang menyematkan sosok Pak ogah pada Abdul Hamid? https://t.co/bY3ef8Nkga",82,7,14,0,2022-01-09,0,Sunday,7,96,7
1479979691012460544,2022-01-09 00:53:49,Kazakhstan sedang panas-panasnya. Sejumlah kerusuhan terjadi dikarenakan harga bahan bakar gas cair yang naik. https://t.co/xDQ9W6qSxL,10,6,2,2,2022-01-09,0,Sunday,7,12,8
1479979180766998534,2022-01-09 00:51:48,"Ashanty positif COVID-19 sepulang dari Turki bersama keluarga. Ia menyebut tak ada masalah dengan indra perasa, hanya ini yang dikeluhkan. https://t.co/ekQ6qzyIh0",9,3,1,0,2022-01-09,0,Sunday,7,10,3
1479978686002737157,2022-01-09 00:49:50,"Nama Gibran Rakabuming mencuat menjadi calon Gubernur DKI Jakarta. DPD PDI Perjuangan DKI Jakarta menyampaikan, saat ini partainya belum bicara nama. https://t.co/jxneioOKLU",18,21,2,0,2022-01-09,0,Sunday,7,20,21
1479978190684704770,2022-01-09 00:47:51,"Yoghurt mengandung probiotik atau bakteri baik yang bagus untuk proses pencernaan. Bahkan, bisa menjaga kesehatan tulang dan memperkuat daya tahan tubuh loh. https://t.co/jmhDwGU6Z8",5,1,4,0,2022-01-09,0,Sunday,7,9,1
1479977698298576901,2022-01-09 00:45:54,"Shalika Aurelia, pesepakbola wanita asal Indonesia ini tengah mencuri perhatian. Dirinya diketahui dikontrak tim Roma wanita di Serie B! https://t.co/pvaDJB08lO",38,7,8,3,2022-01-09,0,Sunday,7,46,10
1479976919395442688,2022-01-09 00:42:48,"Polisi menetapkan pengemudi mobil yang menabrak pemotor hingga terlempar dari atas flyover Pesing, Jakbar. Pengemudi mobil dinilai lalai berkendara. https://t.co/XHBmhuY04U",25,18,4,5,2022-01-09,0,Sunday,7,29,23
1479975406514094084,2022-01-09 00:36:48,"Putri Wali Kota Bekasi Rahmat Effendi, Ade Puspitasari berang ketika ayahnya ditetapkan sebagai tersangka kasus suap pengadaan barang dan jasa &amp; lelang jabatan. https://t.co/3NxAqPkq7c",65,96,15,12,2022-01-09,0,Sunday,7,80,108
1479975192675995650,2022-01-09 00:35:57,PDIP DKI Jakarta meminta agar lelang dan pengerjaan sumur resapan dilaksanakan dengan serius. Jangan menjadi proyek yang asal dikerjakan. https://t.co/kz33sQiMQ7,12,7,2,0,2022-01-09,0,Sunday,7,14,7
1479974696733052936,2022-01-09 00:33:58,Akhir-akhir ini marak joki vaksin di sejumlah daerah. Mulai dari Banjarmasin hingga Pinrang. Berikut aksi nekat kelima joki vaksin tersebut https://t.co/iE8Ay6td0t,3,3,0,0,2022-01-09,0,Sunday,7,3,3
1479974154912911368,2022-01-09 00:31:49,"Polisi mengungkap kasus begal payudara di Kemayoran, Jakpus. Pelaku, seorang kurir ekspedisi akhirnya ditangkap polisi. https://t.co/KTkZWcaXvr",19,5,6,3,2022-01-09,0,Sunday,7,25,8
1479973641152565255,2022-01-09 00:29:47,"Wali Kota Bogor, Bima Arya, melakukan sidak ke sejumlah kafe. Dalam sidak ini, Bima Arya juga mengecek penjualan miras. https://t.co/FxKkgDDl0R",4,0,0,0,2022-01-09,0,Sunday,7,4,0
1479973175073120258,2022-01-09 00:27:56,"Polisi menangkap pelaku pembacokan seorang pria di Jalan Karanggayam, Tambaksari. Pelaku dibekuk dua jam usai kejadian. https://t.co/ZaJKg0kaHr",5,0,3,0,2022-01-09,0,Sunday,7,8,0
1479973154118414339,2022-01-09 00:27:51,"Kemenkes melaporkan total kasus varian Omicron RI kini 318 orang, mayoritas kasus impor. Turki dan Arab Saudi disebut sebagai penyumbang kasus terbanyak. https://t.co/mwL2vUcpho",21,9,7,10,2022-01-09,0,Sunday,7,28,19
1479972668606713862,2022-01-09 00:25:55,LaNyalla menyampaikan bahwa nilai-nilai Pancasila harus kembali menjadi falsafah sekaligus way of life bangsa dalam merawat Indonesia. https://t.co/yIDjcF2SNw,20,10,5,0,2022-01-09,0,Sunday,7,25,10
1479972648616697857,2022-01-09 00:25:50,Tiga motor milik warga Probolinggo raib digondol pencuri dalam semalam. Kawanan pencuri ini membobol tembok belakang rumah korban yang berbatasan dengan sawah. https://t.co/uSpIWCuJhm,1,0,0,0,2022-01-09,0,Sunday,7,1,0
1479971242434252802,2022-01-09 00:20:15,PT JakPro telah membuka lelang untuk proyek lintasan Formula E di Ancol Rp 50 miliar. Golkar DKI menekankan adanya pengawasan agar kualitas lintasan terjaga. https://t.co/7V4sLgVkA1,12,4,2,5,2022-01-09,0,Sunday,7,14,9
1479971024242454536,2022-01-09 00:19:23,"Ia mengatakan selain mendapat izin dan otoritas kesehatan, alat kesehatan buatan anak bangsa kualitasnya tidak kalah dibandingkan dengan produk kesehatan impor. https://t.co/fVGk2IoLnD",14,4,3,0,2022-01-09,0,Sunday,7,17,4
1479970531587891200,2022-01-09 00:17:25,"Seorang pria ditemukan bersimbah darah di Jalan Karang Gayam I, Tambaksari. Pria itu menjadi korban pembacokan. https://t.co/eyjKQk1z7h",5,0,1,0,2022-01-09,0,Sunday,7,6,0
1479969982297645059,2022-01-09 00:15:14,PP Muhammadiyah mendukung sikap Menlu Retno yang menolak wacana normalisasi hubungan Indonesia dan Israel. RI dinilai tepat dukung kemerdekaan Palestina. https://t.co/QSSPV3kwLy,136,21,23,2,2022-01-09,0,Sunday,7,159,23
1479967638491222019,2022-01-09 00:05:56,Bogor PPKM level berapa dan bagaimana aturan yang berlaku hingga 17 Januari 2022 mendatang? simak informasinya berikut ini. https://t.co/XyM0L0VoCj,2,0,0,1,2022-01-09,0,Sunday,7,2,1
1479967146125971466,2022-01-09 00:03:58,"Naufal Samudra diamankan terkait kasus narkoba jaringan pemasok LSD ke Jeff Smith. Begini kronologi penangkapan Naufal Samudra, yang berawal dari Jeff Smith. https://t.co/F01rAXCGfD",2,0,0,0,2022-01-09,0,Sunday,7,2,0
1479966909412122626,2022-01-09 00:03:02,Napoli resmi meminjam Axel Tuanzebe dari Manchester United. Tuanzebe bakal membela Il Partenopei hingga akhir musim. https://t.co/x70eX6fiiQ,3,0,1,0,2022-01-09,0,Sunday,7,4,0
1479966273752739841,2022-01-09 00:00:30,Aksi begal kembali terjadi di Kota Bandung. Seorang remaja dipepet dan diacungi senjata tajam oleh begal. Kendaraan korban dibawa kabur pelaku. https://t.co/78eQPbPsNG,9,10,2,1,2022-01-09,0,Sunday,7,11,11
1479965227005497345,2022-01-08 23:56:21,Pengangkatan Mayjen Untung Budiharto sebagai Pangdam Jaya menuai kritik. Untung merupakan mantan anggota Tim Mawar yang diduga melakukan pelanggaran HAM berat. https://t.co/j5mSZCMMoF,16,9,9,0,2022-01-08,23,Saturday,6,25,9
1479964467127533575,2022-01-08 23:53:20,Komunitas sepakbola menjamur belakangan ini dan tak jarang yang berpotensi jadi pesepakbola profesional. Maka Open League ada untuk mewadahi itu. https://t.co/LQOE7IxMwL,4,0,3,0,2022-01-08,23,Saturday,6,7,0
1479963485421383680,2022-01-08 23:49:25,"Seorang pengemudi mobil dirampok penumpangnya di Duren Sawit, Jakarta Timur. Korban dijerat ikat pinggang oleh pelaku, tetapi untungnya selamat. https://t.co/6LlVZwlWfX",2,0,1,0,2022-01-08,23,Saturday,6,3,0
1479962467916779525,2022-01-08 23:45:23,"Pandemi Corona membuat kegiatan umroh di Arab Saudi sekitar 2 tahun terhenti. Saat umroh kembali dibuka, rasa haru dirasakan para jemaah. https://t.co/SHtMXo9O7P",20,1,0,1,2022-01-08,23,Saturday,6,20,2
1479958901856653317,2022-01-08 23:31:13,"Tercatat sudah ada 318 kasus varian Omicron di Indonesia, dan masih terus bertambah. Pemerintah mengingatkan untuk tidak bepergian demi mencegah penularan. https://t.co/eIHsyqxG1L",32,19,9,5,2022-01-08,23,Saturday,6,41,24
1479957915213701134,2022-01-08 23:27:17,"Kumpulan Bangkai pesawat menyita perhatian warga Desa Pondok Udik, Kecamatan Kemang, Kabupaten Bogor. Ternyata bangkai pesawat itu sudah ada sejak tahun 2019. https://t.co/U3GNLKnrGG",23,5,0,1,2022-01-08,23,Saturday,6,23,6
1479957424555573252,2022-01-08 23:25:20,"Hendrik Irwanto, (55) pria bertato garuda yang tewas di sungai di Banyuwangi telah diautopsi di RSUD Blambangan. Berikut hasil autopsinya. https://t.co/rc8HfqirII",5,1,0,0,2022-01-08,23,Saturday,6,5,1
1479956170089672708,2022-01-08 23:20:21,Senator Tamsil Linrung menjelaskan DPD akan terus menyuarakan Presidential Threshold 0 persen. https://t.co/NY1HjNQWEs,9,7,2,1,2022-01-08,23,Saturday,6,11,8
1479955415945211906,2022-01-08 23:17:22,"Pesepakbola perempuan Indonesia, Shalika Aurelika, dikontrak tim asal Italia, Roma CF. Yuk, kenali lebih dalam klub anyar penggawa timnas putri Indonesia itu. https://t.co/VMksr1ESPc",27,0,7,0,2022-01-08,23,Saturday,6,34,0
1479954640171151370,2022-01-08 23:14:17,Seorang pemobil wanita tewas kecelakaan di Tol Palembang-Lampung. Kecelakaan diakibatkan pemobil banting setir usai berupaya menghindari lubang di tengah jalan. https://t.co/9oSpu3bq8U,458,195,149,79,2022-01-08,23,Saturday,6,607,274
1479953653716901893,2022-01-08 23:10:21,Polisi belum mengetahui penyebab kematian wanita inisial S yang tewas di hotel di Tangerang. Namun polisi telah mengamankan pria teman kencan korban. https://t.co/dUDzeGAFrV,4,0,0,1,2022-01-08,23,Saturday,6,4,1
1479952674770538497,2022-01-08 23:06:28,"Menurut survei terbaru, 60,9 persen pria Jepang lebih suka buang air kecil sambil duduk. Tren ini populer di kalangan pria muda usia 25-35 tahun. https://t.co/kL9xNsjKun",48,19,7,5,2022-01-08,23,Saturday,6,55,24
1479951578043977732,2022-01-08 23:02:07,Massimiliano Allegri tidak akan bisa mendampingi Juventus kala menghadapi AS Roma. Allegri diskors karena komentar ofensifnya ke wasit. https://t.co/5CTY9x4rx0,1,0,1,0,2022-01-08,23,Saturday,6,2,0
1479949753500815364,2022-01-08 22:54:52,"Sebuah mobil terbakar di Jakarta Selatan, tadi malam. Belum diketahui ada tidaknya korban dari peristiwa ini. https://t.co/Yey9t3SwTX",6,0,0,0,2022-01-08,22,Saturday,6,6,0
1479949029077307396,2022-01-08 22:51:59,"Kemenkes melaporkan total kasus varian Omicron RI kini 318 orang, mayoritas kasus impor. Turki dan Arab Saudi disebut sebagai penyumbang kasus terbanyak. https://t.co/CNMP6cEIIo",35,7,11,4,2022-01-08,22,Saturday,6,46,11
1479947976365776910,2022-01-08 22:47:48,"Malaysia belum membuka penempatan untuk pekerja migran Indonesia (PMI). Hal ini dikonfirmasi oleh Dubes RI untuk Malaysia, Hermono. https://t.co/o1ZoXAYMnb",9,3,1,0,2022-01-08,22,Saturday,6,10,3
1479946666526580739,2022-01-08 22:42:36,"Sebuah mobil berputar 180 derajat ketika tertabrak KA Matarmaja. Walaupun bagian depan dan belakang mobil rusak parah, namun penumpangnya selamat. https://t.co/2adieoXRlQ",13,0,0,0,2022-01-08,22,Saturday,6,13,0
1479944150418083841,2022-01-08 22:32:36,"Total hingga saat ini ada 318 kasus varian Omicron di Indonesia. Sebagian besar merupakan kasus impor dari pelaku perjalanan luar negeri, dan bergejala ringan. https://t.co/GWLckd7w2e",8,2,1,1,2022-01-08,22,Saturday,6,9,3
1479943164022738945,2022-01-08 22:28:40,"Menurut Gubernur Banten Wahidin Halim, ada banyak faktor yang menyebabkan wilayahnya dilabeli paling tidak bahagia di tahun 2021. https://t.co/RjIIhWwVL5",29,18,4,4,2022-01-08,22,Saturday,6,33,22
1479941913117667330,2022-01-08 22:23:42,Real Madrid menang meyakinkan 4-1 atas Valencia dalam laga lanjutan LaLiga. Hasil ini bikin El Real semakin kukuh di puncak klasemen. https://t.co/thtsZ8OpXA,11,0,0,0,2022-01-08,22,Saturday,6,11,0
1479939795191226372,2022-01-08 22:15:17,KPAI meminta tenaga didik mampu mengendalikan emosi pelajar. Hal ini dikarenakan akhir-akhir ini marak aksi tawuran. https://t.co/JareS0MVxV,5,1,0,1,2022-01-08,22,Saturday,6,5,2
1479938504830369792,2022-01-08 22:10:10,"BMKG memprediksi potensi hujan disertai petir di Jakarta Pusat, Jakarta Selatan, dan Jakarta Timur pada sore dan menjelang malam hari. https://t.co/NVq26YuF1t",19,1,4,0,2022-01-08,22,Saturday,6,23,1
1479936718979702785,2022-01-08 22:03:04,Annisa tidak sadarkan diri tidak lama setelah mengetuk pintu rumahnya. Saat datang Annisa mengenakan masker dan kerudung hitam. https://t.co/pQWhfiZ9XF,72,12,23,1,2022-01-08,22,Saturday,6,95,13
1479934628144295939,2022-01-08 21:54:45,Puluhan kawanan hiu tutul atau whale shark muncul di Perairan Utara Probolinggo. Kawanan hiu ini muncul dalam sepekan terakhir. https://t.co/LVB96fAcnA,27,0,3,0,2022-01-08,21,Saturday,6,30,0
1479933402883440640,2022-01-08 21:49:53,"Sebuah batu Yoni berkepala naga selama puluhan tahun berada di pekarangan warga di Dusun Sogaten, Klaten, Jawa Tengah. https://t.co/mI6duTbgHr",40,4,6,0,2022-01-08,21,Saturday,6,46,4
1479931840182071297,2022-01-08 21:43:41,"Kieran Trippier menandai debut bersama Newcastle United dengan hasil memalukan. The Magpies ditumbangkan tim divisi tiga, Cambridge United, di ajang Piala FA. https://t.co/2HXC0Jatmz",7,0,0,0,2022-01-08,21,Saturday,6,7,0
1479929260911603714,2022-01-08 21:33:26,"Putri mahkota Swedia, Victoria, dinyatakan positif Corona. Diketahui, Victoria telah divaksinasi 2 kali dosis. https://t.co/lmj2zCmW9I",19,2,2,2,2022-01-08,21,Saturday,6,21,4
1479927980285702153,2022-01-08 21:28:20,"Kemenkes melaporkan total kasus Omicron RI kini mencapai 318, dengan penambahan 57 kasus baru pada Jumat (7/1/2022). Berapa banyak kasus lokalnya? https://t.co/zZZcvvn1jO",6,0,0,1,2022-01-08,21,Saturday,6,6,1
1479925712672993287,2022-01-08 21:19:20,RI mencatat 318 kasus Omicron. Sebagian besar pasien sudah menerima vaksin COVID-19 dosis lengkap dan bergejala ringan atau tidak bergejala sama sekali. https://t.co/puQFNo5ZUm,7,1,1,1,2022-01-08,21,Saturday,6,8,2
1479923922053312513,2022-01-08 21:12:13,Kurang lebih 150 ribu warga Inggris meninggal dunia akibat virus Corona. Inggris merupakan salah satu negara yang paling terdampak parah karena Corona. https://t.co/9aiA3sFthg,1,1,2,0,2022-01-08,21,Saturday,6,3,1
1479922444748083201,2022-01-08 21:06:21,"Setiap makhluk hidup, pasti akan mengalami kematian. Berikut ini beberapa tanda-tanda kematian yang menandakan ajal sudah dekat. https://t.co/nIMelJlpcx",31,2,8,4,2022-01-08,21,Saturday,6,39,6
1479920964486021125,2022-01-08 21:00:28,"Data terbaru Kemenkes Sabtu (8/1/2022) laporkan kasus Omicron RI sebanyak 318. Namun data GISAID terbaru Jumat (7/1/2022), RI sudah mencatat 337 kasus Omicron. https://t.co/mwes2AbUWg",1,0,0,1,2022-01-08,21,Saturday,6,1,1
1479919711634792450,2022-01-08 20:55:29,"Memiliki rambut kering memang bikin bete, terlebih bila rambut sedang kelihatan kusut-kusutnya. Berikut ini 8 cara mengatasi rambut kering secara alami. https://t.co/ZvyGgS0oXx",8,0,0,1,2022-01-08,20,Saturday,6,8,1
1479918382350807042,2022-01-08 20:50:12,"Borussia Dortmund melakukan comeback dramatis saat menghadapi Eintracht Frankfurt. Tertinggal dua gol di babak pertama, Die Borussen bangkit untuk menang 3-2. https://t.co/WJrZZfgvnE",7,0,0,0,2022-01-08,20,Saturday,6,7,0
1479916077912137728,2022-01-08 20:41:03,Sebanyak 754 petugas diturunkan untuk menangani penyelematan dan evakuasi akibat gempa ini. https://t.co/wlBwca9sip,12,1,1,0,2022-01-08,20,Saturday,6,13,1
1479914181570744323,2022-01-08 20:33:31,"Polisi menangkap seorang pria yang kedapatan menjadi joki vaksin COVID-19 di Banjarmasin, Kalsel. Bagaimana kasusnya terungkap? https://t.co/Mvw91QgLi9",7,1,2,2,2022-01-08,20,Saturday,6,9,3
1479912677958946819,2022-01-08 20:27:32,Seorang guru di Amerika Serikat telah ditangkap setelah diduga mengunci putranya yang positif COVID-19 di bagasi mobil. https://t.co/kdL5a6a1N3,3,0,1,1,2022-01-08,20,Saturday,6,4,1
1479911421148385286,2022-01-08 20:22:32,"#FOTO Elon Musk dan Jeff Bezos, mereka adalah dua orang terkaya di dunia yang tahtanya saling berebut naik turun. Tapi mereka punya kesamaan: suka meme. https://t.co/w7975AWG1g",8,1,1,0,2022-01-08,20,Saturday,6,9,1
1479909906899783688,2022-01-08 20:16:31,Wahana Ngopi In The Sky di Gunungkidul memunculkan berbagai pro dan kontra. Wisata semacam ini terinspirasi dari destinasi yang ada di luar negeri. https://t.co/E5fQ6VX3Qt,18,6,1,1,2022-01-08,20,Saturday,6,19,7
1479908643759955977,2022-01-08 20:11:30,Elon Musk membagikan lima nasihat untuk anak muda yang ingin sukses di kehidupan. Ini nasehat dari orang terkaya di dunia:  https://t.co/wzqMc0jLJR,15,2,4,4,2022-01-08,20,Saturday,6,19,6
1479907152999419908,2022-01-08 20:05:35,Ukuran penis besar diyakini para pria bisa memuaskan pasangan di ranjang. Memangnya berapa ukuran ideal penis yang bisa bikin klimaks? https://t.co/PcqFcVC4ck,6,6,0,1,2022-01-08,20,Saturday,6,6,7
1479906037562023942,2022-01-08 20:01:09,Barcelona gagal meraih poin sempurna kala bertandang ke markas Granada dalam lanjutan LaLiga. Duel tuntas 1-1 dalam laga yang diwarnai kartu merah Gavi. https://t.co/p1PF3lMRly,3,0,3,0,2022-01-08,20,Saturday,6,6,0
1479903655402905601,2022-01-08 19:51:41,Chelsea melangkah ke babak keempat Piala FA usai menyingkirkan Chesterfield. The Blues menang 5-1 atas tim divisi lima itu di babak ketiga. https://t.co/Ijot1eTgqs,8,0,0,1,2022-01-08,19,Saturday,6,8,1
1479903182214078465,2022-01-08 19:49:48,BPBD NTT mengungkapkan seorang warga tewas akibat tersambar petir. Dia sedang menge-charge HP saat tersambar. https://t.co/R73G0E9XkP,11,0,8,0,2022-01-08,19,Saturday,6,19,0
1479901166205116421,2022-01-08 19:41:47,"Apakah waktu due date sudah dekat? Jika iya, mungkin bisa membaca beberapa doa menjelang persalinan agar dilancarkan dan dikurangi rasa sakitnya. https://t.co/qX4JwTlces",27,0,1,0,2022-01-08,19,Saturday,6,28,0
1479899119388921856,2022-01-08 19:33:39,"Tisu magic banyak dijadikan opsi oleh pasangan agar sesi bercinta jadi lebih tahan lama. Tapi, bagaimana cara pakai tisu magic yang benar? Begini caranya: https://t.co/8ja8xNey7D",6,0,1,1,2022-01-08,19,Saturday,6,7,1
1479897051685175304,2022-01-08 19:25:26,Kurang lebih 150 ribu warga Inggris meninggal dunia akibat virus Corona. Inggris merupakan salah satu negara yang paling terdampak parah karena Corona. https://t.co/qA4kq9M6q7,5,1,0,0,2022-01-08,19,Saturday,6,5,1
1479896310715138056,2022-01-08 19:22:30,Banyak petugas kesehatan menolak bekerja di rumah sakit pemerintah dan sekarang memberi pelayanan medis secara sembunyi-sembunyi. https://t.co/3pjjP6IcQK,5,0,4,0,2022-01-08,19,Saturday,6,9,0
1479894977455001608,2022-01-08 19:17:12,"TNI AL mengkonfirmasi ada keluarga yang mendatangi jenazah diduga PMI ilegal. Jenazah diduga PMI ilegal itu, mengapung di perbatasan RI dan Malaysia. https://t.co/qOrgXcuaNg",5,0,1,1,2022-01-08,19,Saturday,6,6,1
1479892909075972108,2022-01-08 19:08:59,Kesehatan bunda Dorce sudah membaik. Seperti apa kondisinya? https://t.co/pVV8aYS25z,4,0,1,0,2022-01-08,19,Saturday,6,5,0
1479891762860675075,2022-01-08 19:04:25,"Telkomsel kembali menggelar #SurpriseDeal Unlimited. Program ini menawarkan kuota data internet unlimited mulai dari 50 GB dengan harga Rp 100 ribu, mau? https://t.co/brQ4RMX5yS",8,5,2,0,2022-01-08,19,Saturday,6,10,5
1479890409128083458,2022-01-08 18:59:03,"RI melaporkan total 254 kasus COVID-19 varian Omicron. Mayoritas bergejala batuk dan pilek, lantas bagaimana membedakan infeksi varian Omicron dengan flu biasa? https://t.co/9HwpJRTOPa",29,6,12,1,2022-01-08,18,Saturday,6,41,7
1479888372365770752,2022-01-08 18:50:57,"Sebuah bom meledak di perbatasan Turki-Suriah. Akibatnya, 3 tentara Turki tewas. https://t.co/ljGdZtaD6T",17,1,5,0,2022-01-08,18,Saturday,6,22,1
1479887868533301248,2022-01-08 18:48:57,Ivan Gunawan resmi menghibahkan 'anak' yang selama beberapa hari belakangan membuat gaduh masyarakat Indonesia. Ini momen kenangannya: https://t.co/R6X83YRY9s,9,9,1,6,2022-01-08,18,Saturday,6,10,15
1479886365319905283,2022-01-08 18:42:59,"Meski di tengah merebaknya virus Corona varian Omicron di dunia, Kementerian Agama tetap memberangkatkan jemaah umrah. Ini alasannya: https://t.co/WN3R3D4AlC",2,0,0,0,2022-01-08,18,Saturday,6,2,0
1479885083272224771,2022-01-08 18:37:53,"Gara-gara memberi anaknya kado mobil Alphard hingga Rubicon, seorang Sekdes di Pati bernama Nur Chamin viral. Dari mana sumber uangnya? https://t.co/6aC9KOhH7h",19,10,1,1,2022-01-08,18,Saturday,6,20,11
1479883691006603268,2022-01-08 18:32:21,"#Terpopuler Ivan Gunawan tanggapi pro kontra soal spirit doll. Sebagai orang yang mengadopsi dua spirit doll, Igun tegaskan 'anak-anaknya' bukan anak setan. https://t.co/Yu4HBrNlKI",4,1,1,0,2022-01-08,18,Saturday,6,5,1
1479882248065331207,2022-01-08 18:26:37,"India melaporkan 141.986 kasus baru COVID-19 pada Sabtu ini, terbesar sejak akhir Mei, seiring varian baru virus Corona, Omicron menyebar cepat di kota-kota. https://t.co/Z78WAfbUBV",11,0,1,2,2022-01-08,18,Saturday,6,12,2
1479880983298154501,2022-01-08 18:21:35,Pemerintah kembali membuka keberangkatan jamaah umrah asal Indonesia meski Omicron mewabah. https://t.co/rATZRM93hc,18,7,2,1,2022-01-08,18,Saturday,6,20,8
1479878392317161477,2022-01-08 18:11:18,"Ketum PSSI, Mochamad Iriawan meluruskan soal kabar Witan Sulaeman yang pulang naik mobil bak seusai mendarat di kampung halamannya. Ini penjelasannya: https://t.co/bE2Z8sxqQe",4,1,2,0,2022-01-08,18,Saturday,6,6,1
1479877255350427657,2022-01-08 18:06:47,Di Ciamis ada angkot yang memiliki interior mewah memiliki lantai keramik dan joknya menggunakan sofa. Begini penampakannya! https://t.co/scmhRKnpmg,15,1,0,0,2022-01-08,18,Saturday,6,15,1
1479875931003097093,2022-01-08 18:01:31,Gambar-gambar berikut menyusun kata-kata tersembunyi yang harus kamu tebak. Ini bisa menguji kreativitas berpikir kamu sambil mengisi waktu di akhir pekan. https://t.co/wcDp3DVyyE,7,9,1,1,2022-01-08,18,Saturday,6,8,10
1479874600733450243,2022-01-08 17:56:14,Yuk latih otak kamu agar bisa lancar memecahkan masalah. Teka-teki ini bisa membuktikan apakah kamu jenius. https://t.co/cfzBZgKfug,55,44,3,0,2022-01-08,17,Saturday,6,58,44
1479873378802618373,2022-01-08 17:51:22,"Cukup banyak perangkat BlackBerry yang dirilis di Tanah Air beberapa tahun lalu. 15 HP BlackBerry berikut terpopuler di Indonesia, kamu pernah pakai yang mana? https://t.co/Cv8snTBudT",5,6,3,1,2022-01-08,17,Saturday,6,8,7
1479871757494403074,2022-01-08 17:44:56,"Gempa berkekuatan magnitudo 4,5 terjadi di Kabupaten Halmahera Utara, Maluku Utara. Pusat gempa berada di darat. https://t.co/J0cR61BOYh",11,0,0,0,2022-01-08,17,Saturday,6,11,0
1479870481905893377,2022-01-08 17:39:52,"Sebuah batu Yoni selama puluhan tahun berada di kebun warga Klaten, Jateng. Yoni peninggalan abad 8 masehi itu memiliki tampilan unik, berornamen kepala naga. https://t.co/zWBecxcnLS",17,0,3,0,2022-01-08,17,Saturday,6,20,0
1479869380108431362,2022-01-08 17:35:29,Kimia Farma melalui anak usahanya membuka beberapa lowongan kerja. Mulai dari apoteker sampai perawat klinik. Cus! https://t.co/CRZhz5Wm5O,18,3,7,0,2022-01-08,17,Saturday,6,25,3
1479868135801253888,2022-01-08 17:30:32,Tahukah kamu siapa saja pengusaha besar tanah air yang menjalankan bisnis batu bara? Cek di sini daftarnya! https://t.co/TAwPHuAwQK,19,0,10,0,2022-01-08,17,Saturday,6,29,0
1479867394336202756,2022-01-08 17:27:36,AS Roma merekrut pemain baru di bursa transfer Januari. Roma mendatangkan Ainsley Maitland-Niles dari Arsenal. https://t.co/2DpOPTOwTG,9,1,1,0,2022-01-08,17,Saturday,6,10,1
1479866121096413187,2022-01-08 17:22:32,Dunia hiburan Hollywood berduka dengan kepergian Sidney Poitier. Aktor kulit hitam pertama yang meraih Oscar itu meninggal di usia 94 tahun. https://t.co/0rAxyXht5d,14,0,2,0,2022-01-08,17,Saturday,6,16,0
1479864837815648257,2022-01-08 17:17:26,Gubernur Banten Wahidin Halim meresmikan Tugu Pamulang yang baru selesai direvitalisasi. Revitalisasi tugu tersebut menghabiskan dana Rp 700 juta. https://t.co/R7z9bKyjud,10,3,2,3,2022-01-08,17,Saturday,6,12,6
1479863603461345287,2022-01-08 17:12:32,"Manajer Arsenal, Mikel Arteta, sudah memberi jalan kepada Ainsley Maitland-Niles untuk hengkang. Apa alasan Arteta melepas pemainnya itu? https://t.co/cuqEa3jZYT",7,0,0,0,2022-01-08,17,Saturday,6,7,0
1479862561805942785,2022-01-08 17:08:23,"Sembalun bisa dilihat dari satu spot, namanya Titik 360. Karena berbentuk kaldera purba, pemandangannya menyeluruh bisa dilihat dengan drone. https://t.co/OiNnFX1y1l",35,2,6,1,2022-01-08,17,Saturday,6,41,3
1479861529491255304,2022-01-08 17:04:17,Kakek perajin miniatur mobil truk di Kudus terpukul saat pandemi COVID-19 melarang kerumunan. Begini kisahnya bertahan. https://t.co/jdh2v85ILY,14,0,3,0,2022-01-08,17,Saturday,6,17,0
1479860615594356737,2022-01-08 17:00:39,Seorang warga India bikin geger usai mengaku telah mendapatkan 11 dosis vaksin COVID-19. Bahkan dua di antaranya ia dapat dalam waktu setengah jam. Kok bisa? https://t.co/20rdKztTYG,6,2,0,0,2022-01-08,17,Saturday,6,6,2
1479859862846816259,2022-01-08 16:57:40,"Tebak-tebakan ini sebenarnya tidak sulit dikerjakan, hanya butuh ketelitian. Cocok buat kamu yang suka matematika dan ingin mengasah ketajaman berpikir. https://t.co/QPwrIbcrxS",6,1,0,0,2022-01-08,16,Saturday,6,6,1
1479858833321345024,2022-01-08 16:53:34,Akun Instagram (@)dear_umycatcallers mengunggah adanya 3 dugaan pemerkosaan yang dilakukan seorang mahasiswa UMY berinisial MKA. Berikut perjalanan kasusnya. https://t.co/UGoKZr9iPH,29,0,8,0,2022-01-08,16,Saturday,6,37,0
1479857978840862723,2022-01-08 16:50:11,Penulis novel Layangan Putus Mommy ASF meet &amp; greet dengan penggemarnya di Malang. Mommy berfoto bersama penggemar dan juga memberikan tanda tangan. https://t.co/qPX5zHqvKn,5,0,3,0,2022-01-08,16,Saturday,6,8,0
1479856969284571138,2022-01-08 16:46:10,Elon Musk membagikan lima nasihat untuk anak muda yang ingin sukses di kehidupan. Ini nasehat dari orang terkaya di dunia:  https://t.co/2CoE93mIYV,32,1,10,5,2022-01-08,16,Saturday,6,42,6
1479856178557595657,2022-01-08 16:43:02,"Selain memberikan rasa bahagia dan kenikmatan, orgasme juga memiliki dampak yang baik bagi kesehatan wanita. Mulai dari melancarkan haid hingga awet muda. https://t.co/EwY0JTZZ8T",15,0,2,0,2022-01-08,16,Saturday,6,17,0
1479855120796037121,2022-01-08 16:38:49,"Kanye West mengonfirmasi hubungan cintanya dengan aktris Julia Fox. Ini sosok Julia, pacar baru Kanye West, pengganti Kim Kardashian di hati sang rapper. https://t.co/TEbHgg049g",10,0,1,2,2022-01-08,16,Saturday,6,11,2
1479854332791209998,2022-01-08 16:35:41,"""Menurut hukum Syariah, wanita Muslim harus mengenakan jilbab,"" bunyi poster itu, mengacu pada praktik menutup aurat. https://t.co/wmxKmeCCPp",15,3,2,0,2022-01-08,16,Saturday,6,17,3
1479853470018686983,2022-01-08 16:32:16,Kota Palangkaraya menjadi salah satu dari 275 kabupaten dan kota yang ditetapkan sebagai Kota Layak Anak tahun 2021. https://t.co/cFBtpLtOs1,17,0,3,0,2022-01-08,16,Saturday,6,20,0
1479852862578569217,2022-01-08 16:29:51,"Anak anggota Komisi II DPRD Pekanbaru Eri Sumarni, AR (21), yang memperkosa siswi SMP, terancam 5 tahun penjara. https://t.co/8yu8HzCW6M",64,7,14,4,2022-01-08,16,Saturday,6,78,11
1479852093687148549,2022-01-08 16:26:48,#Mostpop Pesawat terbang jenis STOL yang dibuat Suyanto membutuhkan dana setidaknya Rp 600 juta. Bahan pembuatan pesawat ini didatangkan dari luar negeri. https://t.co/z0ZrraekS0,21,1,1,0,2022-01-08,16,Saturday,6,22,1
1479851294521270275,2022-01-08 16:23:37,"Manchester United tidak rela ditinggal Paul Pogba. Gaji tinggi ditawarkan senilai Rp 9,7 miliar per pekan, tapi apakah itu layak? https://t.co/KeBzrvQgyi",9,0,1,3,2022-01-08,16,Saturday,6,10,3
1479850099429806080,2022-01-08 16:18:52,"Berawal dari hobi, warga Lumajang ini sukses membudidayakan ikan koi berbagai jenis. Hobi itu pun menghasilkan cuan hingga belasan juta perbulannya! https://t.co/VW3G2N8pji",14,0,0,0,2022-01-08,16,Saturday,6,14,0
1479849057782804486,2022-01-08 16:14:44,Viral video seorang pria yang terbang hingga 9 meter karena terbawa layang-layang. Netizen pun dibuat ngeri melihatnya.  https://t.co/1Wjf6bmlXJ,67,7,26,9,2022-01-08,16,Saturday,6,93,16
1479848298269786116,2022-01-08 16:11:43,Obyek wisata Teras Kaca Kabupaten Gunungkidul meluncurkan wahana 'Ngopi in The Sky'. Belakangan Pemda DIY menutup wahana tersebut karena dirasa kurang aman. https://t.co/iRKb2ZibGg,23,6,3,3,2022-01-08,16,Saturday,6,26,9
1479846177004736518,2022-01-08 16:03:17,Lorenzo Insigne resmi bakal hengkang dari Napoli ke Toronto FC. Insigne merapat ke klub MLS tersebut dengan status free transfer pada Juli mendatang. https://t.co/unYER5IJ9l,6,0,1,1,2022-01-08,16,Saturday,6,7,1
1479845378451193866,2022-01-08 16:00:07,Yuk latih otak kamu agar bisa lancar memecahkan masalah. Teka-teki ini bisa membuktikan apakah kamu jenius. https://t.co/sGRA1gDgPm,103,81,9,6,2022-01-08,16,Saturday,6,112,87
1479845090982248454,2022-01-08 15:58:58,"Kembaran Yumi Bai, Miko Bai turut angkat bicara terkait isu perselingkuhan yang menimpa saudarinya dengan Wang Leehom. https://t.co/zyp9rPpPMQ",2,0,1,0,2022-01-08,15,Saturday,6,3,0
1479844354760097793,2022-01-08 15:56:03,"Selama delapan tahun, seorang pria mencari hard disk berisi 7.500 Bitcoin di tumpukan sampah. Nilainya Rp 5 triliun!  https://t.co/w3GR01Qy7h",28,2,3,1,2022-01-08,15,Saturday,6,31,3
1479844050358444034,2022-01-08 15:54:50,Apa kabar Joanna Alexandra usai ditinggal selamanya oleh sang sang suami? https://t.co/P3WIoBn22e,6,1,1,0,2022-01-08,15,Saturday,6,7,1
1479842920131964932,2022-01-08 15:50:20,"Pemerintah akan mematikan TV analog dan beralih ke siaran TV digital mulai April 2022. Apa itu siaran TV digital, manfaat dan bagaimana cara menangkapnya? https://t.co/oY225cnOEZ",31,4,18,2,2022-01-08,15,Saturday,6,49,6
1479842185738694660,2022-01-08 15:47:25,Batas waktu pengerjaan pun sudah jatuh tempo pada 31 Desember 2021 lalu. https://t.co/rin0TjS2DD,16,8,4,2,2022-01-08,15,Saturday,6,20,10
1479840889962909696,2022-01-08 15:42:16,Para penerima bantuan laptop di dua lokasi berbeda ini pun mengucapkan rasa terima kasihnya kepada Relawan Sahabat Ganjar ini. https://t.co/LIYeEZuVhZ,8,0,0,0,2022-01-08,15,Saturday,6,8,0
1479840372352331780,2022-01-08 15:40:13,"Ibunda Gaga Muhammad, Janariyah, menjadi sorotan setelah mengomentari kondisi Laura Anna yang lumpuh usai kecelakaan. Begini proses pemulihan spinal cord. https://t.co/Th5feOrdRc",3,0,0,0,2022-01-08,15,Saturday,6,3,0
1479839375664029696,2022-01-08 15:36:15,Jonathan Barnett kesal kepada fans Real Madrid yang memperlakukan pemainnya sangat buruk. Umpatan Barnett berpotensi bikin Bale pergi tanpa penghormatan. https://t.co/5Y4iXA8hgI,16,1,2,0,2022-01-08,15,Saturday,6,18,1
1479838357366710278,2022-01-08 15:32:13,Penis yang berdiri mendadak bisa membuat pria merasa malu dan khawatir. Tetap tenang dan alihkan perhatian bisa jadi salah satu cara untuk menghentikannya lho. https://t.co/eJFr4EHBeJ,16,2,1,0,2022-01-08,15,Saturday,6,17,2
1479837103601033218,2022-01-08 15:27:14,Peraturan karantina terbaru penting untuk diketahui. Kini masa karantina jadi 7-10 hari. Ini ketentuannya. https://t.co/BtOJcqwEK0,7,0,3,1,2022-01-08,15,Saturday,6,10,1
1479835797276741638,2022-01-08 15:22:02,Bukan hanya menu dan porsi makan saja yang harus diperhatikan ketika sedang menjalani program diet. Jam makan juga memberi pengaruh nih! https://t.co/eQ8QfPpQyS,11,1,1,0,2022-01-08,15,Saturday,6,12,1
1479834857735966729,2022-01-08 15:18:18,"Saat kumpul keluarga, nasi liwet Sunda yang komplet dengan lauknya bisa jadi pilihan. Nasinya pulen wangi, cocok dimakan dengan teri dan petai. Raos pisan! https://t.co/BijTqxeL2P",20,1,0,1,2022-01-08,15,Saturday,6,20,2
1479833759579054086,2022-01-08 15:13:56,"Lalapan itu tak hanya membuat momen bersantap makin nikmat, tapi juga dapat menurunkan kadar kolesterol tinggi. https://t.co/DoJWdBcvK6",17,1,6,0,2022-01-08,15,Saturday,6,23,1
1479832844918734852,2022-01-08 15:10:18,Selebriti Instagram Furi Harun mendadak menjadi sorotan. Dia merupakan orangtua asuh 349 boneka arwah. Seperti apa sosok Furi dan bonekanya? https://t.co/5ruNFyzxpD,34,47,5,5,2022-01-08,15,Saturday,6,39,52
1479831449968721922,2022-01-08 15:04:46,Empat rumah warga tergolong rusak berat karena bagian atap rumahnya ambruk. https://t.co/8OEalLlin3,9,0,0,0,2022-01-08,15,Saturday,6,9,0
1479829699891236870,2022-01-08 14:57:49,Hujan deras di Surabaya pada Jumat (7/1) sore membuat sejumlah titik mengalami genangan air. Wali kota Eri menemukan penyebab sekaligus solusinya. https://t.co/BORbM2IaCL,2,0,0,0,2022-01-08,14,Saturday,6,2,0
1479829152157028360,2022-01-08 14:55:38,"PDI Perjuangan menuding adanya keganjilan dalam survei Charta Politika soal Pilgub Jateng, di mana elektabilitas Wali Kota Solo Gibran Rakabuming unggul. https://t.co/3LFlIPGIXa",9,11,0,2,2022-01-08,14,Saturday,6,9,13
1479828903506198531,2022-01-08 14:54:39,"Pensiunan tukang pos ini mengatakan suntikan vaksin membantunya ""mengatasi sakit, nyeri, dan agar tetap sehat"". Simak ceritanya: https://t.co/ZjoDs9lC01",5,0,0,2,2022-01-08,14,Saturday,6,5,2
1479827296928382976,2022-01-08 14:48:16,"Kecelakaan pemobil terobos lampu merah hingga menabrak pemotor di Jalan MH Thamrin, viral. Begini detik-detik kecelakaan mengerikan tersebut https://t.co/iDNhSgul4p",7,0,0,0,2022-01-08,14,Saturday,6,7,0
1479826386110062597,2022-01-08 14:44:38,Viral video seekor lumba-lumba mati dikubur di tepi pantai di Pacitan. Ada yang menghubungkan temuan tersebut dengan kasus lumba-lumba mati di atas kapal. https://t.co/Vytx8p1HCZ,3,0,0,0,2022-01-08,14,Saturday,6,3,0
1479826162897588233,2022-01-08 14:43:45,Pria kerap mengandalkan tisu magic untuk mengatasi ejakulasi dini. Tetapi seberapa lama sebenarnya efek tisu ini bisa bertahan? Ini penjelasannya. https://t.co/pjDMlU8mTw,5,0,0,0,2022-01-08,14,Saturday,6,5,0
1479825912220762114,2022-01-08 14:42:45,Kapolres Bojonegoro berganti dari AKBP Eva Guna Pandia kepada AKBP Muhammad. Prosesi apel penyambutan berjalan khidmat dengan menerapkan prokes ketat. https://t.co/OPhpKn6Ejv,5,1,0,0,2022-01-08,14,Saturday,6,5,1
1479824518889803780,2022-01-08 14:37:13,"Kebakaran terjadi di gedung Kearsipan dan Perpustakaan Daerah Sukoharjo, Sabtu (8/1/2022) malam. Api yang cukup besar melalap bagian belakang gedung. https://t.co/XQ1OaO3vz2",11,0,4,1,2022-01-08,14,Saturday,6,15,1
1479824222235115520,2022-01-08 14:36:03,"Putri Walkot Bekasi Rahmat Effendi yang sekaligus merupakan ketua DPD Golkar Kota Bekasi, Ade Puspitasari, keberatan soal OTT yang dilakukan KPK kepada ayahnya. https://t.co/v5mhyexhVJ",54,56,10,8,2022-01-08,14,Saturday,6,64,64
1479823386851303427,2022-01-08 14:32:43,Berikut beberapa menu MPASI tunggal yang bisa dibuat untuk bayi usia 6 bulan. #MPASI https://t.co/NF4GYpY3X0,10,2,2,0,2022-01-08,14,Saturday,6,12,2
1479822491874963466,2022-01-08 14:29:10,"Tugu Pamulang di Tangsel yang dulu disorot netizen karena penampakan asli tidak sesuai dengan design, kini sudah direvitalisasi. Bagaimana tanggapan warga? https://t.co/vErQzggqRQ",14,3,3,1,2022-01-08,14,Saturday,6,17,4
1479820778158030848,2022-01-08 14:22:21,"Putri Wali Kota Bekasi Rahmat Effendi, Ade Puspitasari, menyebut OTT yang dilakukan KPK terhadap ayahnya merupakan pembunuhan karakter. KPK buka suara https://t.co/AshVBg6axv",10,27,3,6,2022-01-08,14,Saturday,6,13,33
1479820310719471621,2022-01-08 14:20:30,"Tersangka Komar sudah 3 kali mencuri penutup saluran air di Pasar Ikan Muara Angke, Jakut. Pelaku sempat gagal di kesempatan pertama. https://t.co/wuccs0qW9Z",2,1,1,0,2022-01-08,14,Saturday,6,3,1
1479819775572389897,2022-01-08 14:18:22,"#FOTO Elon Musk dan Jeff Bezos, mereka adalah dua orang terkaya di dunia yang tahtanya saling berebut naik turun. Tapi mereka punya kesamaan: suka meme. https://t.co/XxnHA8dFvL",5,1,2,1,2022-01-08,14,Saturday,6,7,2
1479818919376568320,2022-01-08 14:14:58,"Steven Gerrard langsung tancap gas untuk memoles Aston Villa agar bersaing di level tertinggi. Kedatangan Philippe Coutinho, jadi salah satu buktinya. https://t.co/0jrBQF2Cf1",7,2,4,0,2022-01-08,14,Saturday,6,11,2
1479816913329000456,2022-01-08 14:07:00,"Liga ini telah digelar sejak 5 Januari 2022, dan diikuti oleh 26 tim dari desa-desa di Kabupaten Poso, Sulawesi Tengah yang terbagi dalam 8 grup. https://t.co/qcpuPaVszy",12,0,0,0,2022-01-08,14,Saturday,6,12,0
1479816911940632580,2022-01-08 14:07:00,Seekor lumba-lumba mati dikubur di tepi pantai yang disebut di Pacitan. Video penguburan lumba-lumba itu viral. https://t.co/oea0WYdyN8,8,1,3,0,2022-01-08,14,Saturday,6,11,1
1479815467439112196,2022-01-08 14:01:15,Apakah Bunda salah satu tipe orangtua yang santai dan selalu terlihat keren di mata anak? Berikut enam zodiak paling keren di mata anak. #detikNetwork  https://t.co/9imrXlrrYw,6,3,2,2,2022-01-08,14,Saturday,6,8,5
1479814137190371330,2022-01-08 13:55:58,"Kieran Trippier sudah resmi menjadi pemain Newcastle United. Dia mau bergabung dengan The Magpies, yangs sedang berjuang di zona degradasi, bukan karena uang. https://t.co/V6efgRvAUt",6,0,0,0,2022-01-08,13,Saturday,6,6,0
1479813348015452164,2022-01-08 13:52:50,Seorang anak 6 tahun di Jember tewas di tangan ibunya sendiri. Itu setelah si ibu berulang kali memukulinya. Tega! https://t.co/uvBCz0p4v1,38,18,9,5,2022-01-08,13,Saturday,6,47,23
1479812026809606144,2022-01-08 13:47:35,Masa jabatan Anies Baswedan menjadi Gubernur DKI Jakarta segera habis di 2022 ini. Wagub DKI Riza Patria tak banyak ambil pusing soal sosok pengganti Anies. https://t.co/RViITbqT0w,10,3,3,0,2022-01-08,13,Saturday,6,13,3
1479811016074616833,2022-01-08 13:43:34,Gibran Rakabuming disebut memiliki elektabilitas tertinggi dalam Pilgub Jateng dan juga disebut Sekjen PDIP sebagai calon kuat di Pilgub DKI. Gibran merespons. https://t.co/o9FecDqWGn,44,34,4,5,2022-01-08,13,Saturday,6,48,39
1479809755212304385,2022-01-08 13:38:33,"Banyaknya kasus penyalahgunaan identitas pribadi membuat bocah 14 tahun asal Yogyakarta ini membuat aplikasi yang sangat berguna, Watermark KTP. https://t.co/2kIoS8HMRq",92,2,28,1,2022-01-08,13,Saturday,6,120,3
1479808725930098692,2022-01-08 13:34:28,"Batu Yoni di pekarangan warga Desa Ngawen, Klaten, Jateng, unik karena berhias kepala naga. Sudah dua kali ada orang menawarkan motornya untuk ditukar Yoni. https://t.co/9dlwuWaFFK",17,0,3,0,2022-01-08,13,Saturday,6,20,0
1479807451071488007,2022-01-08 13:29:24,Song Hye Kyo tampil fresh dengan potongan rambut barunya. Intip pesona pemain drama Korea Now We Are Breaking Up yang menolak tua! https://t.co/rGi7K7Qrkm,43,0,4,2,2022-01-08,13,Saturday,6,47,2
1479805840269979650,2022-01-08 13:23:00,"Liga ini telah digelar sejak 5 Januari 2022, dan diikuti oleh 26 tim dari desa-desa di Kabupaten Poso, Sulawesi Tengah yang terbagi dalam 8 grup. https://t.co/AwzBVeEfvK",14,0,2,0,2022-01-08,13,Saturday,6,16,0
1479804868269420550,2022-01-08 13:19:08,"Bule Maroko berinisial ACE mengalami kecelakaan di Jl Prof Dr Satrio, Setiabudi, Jakarta Selatan. Korban dilaporkan tewas di lokasi setelah menabrak truk. https://t.co/leZNLidPEK",12,5,2,0,2022-01-08,13,Saturday,6,14,5
1479803821106909185,2022-01-08 13:14:59,"Indonesia mencatat sebanyak 479 kasus baru COVID-19, Sabtu (8/1/2022). DKI menyumbang kasus terbanyak dengan jumlah 278. https://t.co/3nZHr2VBjx",8,2,2,0,2022-01-08,13,Saturday,6,10,2
1479801617272963074,2022-01-08 13:06:13,"Ini dia wajah Baby L, anak Rizky Billar dan Lesti Kejora! https://t.co/b1Gux4plR0",57,57,6,12,2022-01-08,13,Saturday,6,63,69
1479801615502749698,2022-01-08 13:06:13,Viral lumba-lumba ditangkap dan mati di atas kapal nelayan yang disebut dari Pacitan. Ini respons dari Ketua Himpunan Nelayan Seluruh Indonesia cabang Pacitan. https://t.co/NcNCI6QH01,11,0,1,0,2022-01-08,13,Saturday,6,12,0
1479801127357059072,2022-01-08 13:04:16,"Gejala infeksi varian Omicron amat mirip dengan flu biasa. Hati-hati terkecoh, dokter jelaskan perbedaan paling mencolok antara gejala Omicron dengan flu. https://t.co/YvLJLzFPd0",16,1,4,0,2022-01-08,13,Saturday,6,20,1
1479799489544298505,2022-01-08 12:57:46,Dasar pemutusan kontrak kerja ini adalah rekomendasi Komnas HAM. https://t.co/OmtxsBws2c,21,0,3,0,2022-01-08,12,Saturday,6,24,0
1479798471649542144,2022-01-08 12:53:43,"Barcelona bakal dilema. Pemain mudanya Gavi dinilai punya potensi, tapi Manchester City siap datang membawa segepok uang untuk membelinya! https://t.co/bIC6s7OX74",14,0,0,0,2022-01-08,12,Saturday,6,14,0
1479796731185356803,2022-01-08 12:46:48,Seorang bocah lelaki berusia 5 tahun diikat dan dirantai besi di sebuah rumah di Sumedang. Sungguh nahas tatkala pelaku diketahui masih kerabat dari bocah itu... https://t.co/tXKPX6l7hi,12,3,3,1,2022-01-08,12,Saturday,6,15,4
1479795200578969600,2022-01-08 12:40:43,"sebuah rumah di kawasan Cilandak, Jakarta Selatan hangus dilalap si jago merah. Kini rumah tersebut dipasangi garis polisi. https://t.co/eQAP8xI5N0",3,0,1,1,2022-01-08,12,Saturday,6,4,1
1479794124891070464,2022-01-08 12:36:27,"Mevvah! Di Ciamis, Angkot 07 jurusan Ciamis-Dewasari menggunakan sofa, lantai keramik serta full music. Seperti ini penampakannya: https://t.co/HlV6XKVlX0",37,6,2,5,2022-01-08,12,Saturday,6,39,11
1479791578499661825,2022-01-08 12:26:20,Kasetpres Heru Budi Hartono didukung untuk menjadi Penjabat Gubernur DKI Jakarta. Apa kata Mensesneg Pratikno? https://t.co/7j23ogBIYT,8,0,4,0,2022-01-08,12,Saturday,6,12,0
1479789779302629379,2022-01-08 12:19:11,Princess April viral karena wajahnya yang awet muda. Model seksi itu baru-baru ini mengungkap bahwa karena tampilan awet muda ia justru kerap ditinggal pria. Loh? https://t.co/Fm9Joqs3P1,7,2,1,0,2022-01-08,12,Saturday,6,8,2
1479787928989614080,2022-01-08 12:11:50,"Ketua DPD Golkar Kota Bekasi yang juga putri kandung Wali Kota Bekasi Rahmat Effendi, Ade Puspitasari, berkomentar soal OTT yang dilakukan KPK terhadap ayahnya. https://t.co/SpuhbDQSbZ",172,221,27,66,2022-01-08,12,Saturday,6,199,287
1479786049085788165,2022-01-08 12:04:21,"Kamu bisa bantu Mujib dan teman-temannya untuk membeli sepatu lewat https://t.co/gJZ8ovBbIQ, begini caranya. https://t.co/bKpRv3Yt0a",19,3,8,1,2022-01-08,12,Saturday,6,27,4
1479785214826237954,2022-01-08 12:01:02,Polisi tak menemukan lumba-lumba di kapal nelayan yang diviralkan menangkap dan membikin mati lumba-lumba. Ke mana perginya bangkai lumba-lumba itu? https://t.co/bPINlpy8BE,1,3,4,0,2022-01-08,12,Saturday,6,5,3
1479782740702769153,2022-01-08 11:51:13,"Video memperlihatkan aksi pencurian spion viral di media sosial. Dua pelaku berboncengan motor mencuri spion mobil ambulans di Tanjung Priok, Jakarta Utara. https://t.co/anX3iBtpa6",10,2,5,3,2022-01-08,11,Saturday,6,15,5
1479781299846004741,2022-01-08 11:45:29,"Ucapan ibunda Gaga Muhammad, Janariyah, soal mendiang Laura Anna menuai kontroversi. Berikut deretan pernyataan ibunda Gaga yang ramai diperbincangkan... https://t.co/VBLzWqFJbi",12,8,5,3,2022-01-08,11,Saturday,6,17,11
1479780130281172996,2022-01-08 11:40:50,"Nelayan sekaligus fotografer Rusia, Roman Fedortsov memotret makhluk dasar laut yang mencengangkan dan bikin begidik. Begini penampakannya! https://t.co/vitWUUoj9Q",17,1,7,2,2022-01-08,11,Saturday,6,24,3
1479778563566055425,2022-01-08 11:34:37,"Bhayangkara FC ingin pertandingan melawan Arema FC dilakukan secara fair. Hal itu ditekankan pelatih The Guardian, Paul Munster. https://t.co/6QeHRGXbUG",3,0,1,1,2022-01-08,11,Saturday,6,4,1
1479778285668155392,2022-01-08 11:33:30,IM57+ Institute yang didirikan Novel Baswedan dan 56 eks pegawai KPK lainnya telah resmi berbadan hukum. Hal itu sesuai dengan SK Menteri Hukum dan HAM. https://t.co/DOZ3Ozopld,8,0,2,0,2022-01-08,11,Saturday,6,10,0
1479777824961703938,2022-01-08 11:31:41,50 HP bakal diblokir oleh WhatsApp di 2022 ini lantaran perangkat tersebut tidak menjalankan sistem operasi yang disyaratkan. Apa saja HP yang berdampak? https://t.co/iIs8arEkmc,19,2,8,2,2022-01-08,11,Saturday,6,27,4
1479776763651760128,2022-01-08 11:27:28,"""Mas Gading selalu ada dalam doaku, ya aku selalu membawa dia dalam doaku,"" ungkap Gisel. https://t.co/7Ile7jPPZy",306,132,19,28,2022-01-08,11,Saturday,6,325,160
1479775140963565575,2022-01-08 11:21:01,"Indonesia melaporkan 479 kasus baru virus Corona COVID-19 pada Sabtu (8/1/2022). Total kasus positif menjadi 4.265.666, sembuh 4.115.747, dan meninggal 144.127 https://t.co/lt3nalPSI0",9,0,4,0,2022-01-08,11,Saturday,6,13,0
1479773880667545605,2022-01-08 11:16:00,"Kebakaran melanda PLTU Teluk Sirih, Kecamatan Bungus Teluk Kabung, Kota Padang, Sumatera Barat. Satu orang dilaporkan tewas dalam peristiwa kebakaran ini. https://t.co/5p0nZeIjIO",7,2,4,1,2022-01-08,11,Saturday,6,11,3
1479771852092448768,2022-01-08 11:07:57,"Polisi agama Taliban telah memasang poster-poster di sekitar ibu kota Afghanistan, Kabul yang memerintahkan wanita Afghanistan untuk menutup aurat. https://t.co/Vi9r6rvBNT",15,5,2,0,2022-01-08,11,Saturday,6,17,5
1479771360440242177,2022-01-08 11:05:59,Polisi bertindak cepat menyelidiki viralnya kapal yang menangkap dan membikin mati lumba-lumba. Polisi telah menggeledah kapal tersebut. https://t.co/QlA5tI0jwh,6,0,4,0,2022-01-08,11,Saturday,6,10,0
1479771133813702656,2022-01-08 11:05:05,Siapakah yang bakal memenangi gelar ini? https://t.co/94BZRteDM4,5,1,2,0,2022-01-08,11,Saturday,6,7,1
1479769402606342147,2022-01-08 10:58:13,"Gempa bumi dengan magnitudo 5,1 terjadi di Halmahera Utara, Maluku Utara (Malut). Gempa ini dirasakan di sejumlah daerah. https://t.co/MzWKBNgn84",5,0,2,0,2022-01-08,10,Saturday,6,7,0
1479768156432486400,2022-01-08 10:53:15,Hari ini dilaporkan ada tambahan 479 kasus positif COVID-19 di Indonesia. Selain itu ada 175 orang di Indonesia yang sembuh dari COVID-19. https://t.co/3IMCInfFkD,8,4,2,1,2022-01-08,10,Saturday,6,10,5
1479767068337750016,2022-01-08 10:48:56,Sosialita dan bintang reality show The Real Housewives of Orange County Noella Bergener mengaku ditinggalkan suaminya begitu saja. Suaminya tak memberi nafkah. https://t.co/oEWXi7WHNX,8,0,1,0,2022-01-08,10,Saturday,6,9,0
1479765306843217925,2022-01-08 10:41:56,"Sebuah rumah warga di Cilandak, Jakarta Selatan (Jaksel), dilalap si jago merah. Kebakaran terjadi lantaran sofa yang terbakar di lantai dua. https://t.co/70ytZh4gmn",11,1,1,0,2022-01-08,10,Saturday,6,12,1
1479764514237292550,2022-01-08 10:38:47,Ahmad Riza Patria mengatakan ada peningkatan kasus COVID varian omicron. Dia menyebut penyebab kenaikan karena adanya libur Nataru. https://t.co/6v1vWyPFA4,20,20,6,4,2022-01-08,10,Saturday,6,26,24
1479763221322084356,2022-01-08 10:33:39,Tommy Soeharto mengaku dirinya tak punya utang BLBI. Menko Polhukam Mahfud MD pun merespons. https://t.co/9pGxbEGchl,16,13,2,1,2022-01-08,10,Saturday,6,18,14
1479762373275787266,2022-01-08 10:30:17,Penerus Galaxy S20 FE telah resmi diluncurkan Samsung. Ada 5 keunggulan Galaxy S21 FE yang patut dipertimbangkan. https://t.co/GtVZ0885qv,15,1,5,1,2022-01-08,10,Saturday,6,20,2
1479761229942042631,2022-01-08 10:25:44,"Annisa Naraya (16), gadis asal Sukabumi yang dikabarkan menghilang akhirnya pulang. Keluarga menyebut tatapan mata gadis itu kosong. https://t.co/ljMPW6m5aZ",33,3,5,1,2022-01-08,10,Saturday,6,38,4
1479759958136795145,2022-01-08 10:20:41,"Berbeda dengan ikan lain, netizen ini justru nekat goreng ikan arwana. Ikan hias berharga fantastis ini terpaksa digorengnya karena kelaparan. Hiks... https://t.co/quMzg6Qx9F",17,3,2,1,2022-01-08,10,Saturday,6,19,4
1479758721479753731,2022-01-08 10:15:46,Mantan kepala badan intelijen domestik Kazakhstan telah ditahan karena dicurigai melakukan pengkhianatan tingkat tinggi. https://t.co/0l8rnAHwjq,13,2,4,0,2022-01-08,10,Saturday,6,17,2
1479757728734134272,2022-01-08 10:11:49,Helm merupakan peranti penting saat mengendarai sepeda motor di jalan raya. Tapi perlikau siswi ini bikin siapa saja yang melihat bakal tertawa. Weleh weleh... https://t.co/Epw7F9C1Ol,9,0,0,0,2022-01-08,10,Saturday,6,9,0
1479756441913368582,2022-01-08 10:06:42,Seorang pedagang di Kota Kediri tewas tertabrak bus. Pedagang tersebut tertabrak bus satelah menghindari ranting pohon yang jatuh. https://t.co/idcnT8AOoQ,14,0,3,0,2022-01-08,10,Saturday,6,17,0
1479755057574858759,2022-01-08 10:01:12,Naufal Samudra menyampaikan pesan kepada generasi muda agar tidak coba-coba dengan narkoba. Apa katanya? https://t.co/5KnF0SZF9C,2,1,0,0,2022-01-08,10,Saturday,6,2,1
1479753923363758082,2022-01-08 09:56:42,"Sri Mulyani dan Basuki Hadimuljono melakukan kunjungan ke titik nol lokasi pembangunan ibu kota negara baru di Penajam Paser, Kalimantan Timur. Seperti apa? https://t.co/VC2H4RmPwJ",19,2,0,0,2022-01-08,9,Saturday,6,19,2
1479752661851381761,2022-01-08 09:51:41,"Kini, Ivan Gunawan terlihat menghabiskan waktunya dengan teman-temannya. https://t.co/MaiioT2ISi",8,0,0,0,2022-01-08,9,Saturday,6,8,0
1479751436456153090,2022-01-08 09:46:49,"Yang namanya orang tajir memang bisa beli apa saja yang dia mau meskipun orang lain menganggapnya aneh, bahkan berlebihan... https://t.co/5APK054wpU",5,0,2,0,2022-01-08,9,Saturday,6,7,0
1479750306401505282,2022-01-08 09:42:20,"#Terpopuler Selama di Negeri Paman Sam, kata Suyanto, ia bekerja di sebuah industri pembuatan pesawat terbang. Simak ceritanya: https://t.co/C4AUds4FAz",63,4,8,0,2022-01-08,9,Saturday,6,71,4
1479748014424088576,2022-01-08 09:33:13,"AS Roma lagi kesulitan, gagal menang di dua laga terakhir di Liga Italia. Selanjutnya lawan berat menanti, yakni Juventus! https://t.co/gfL3tnDW0C",3,1,2,0,2022-01-08,9,Saturday,6,5,1
1479747784844754944,2022-01-08 09:32:18,Gisel kali ini bicara lagi soal banyak yang mengharapkan dirinya kembali dengan Gading Marten. Apa katanya? https://t.co/mvRVg9HrLQ,29,18,4,0,2022-01-08,9,Saturday,6,33,18
1479746470878265349,2022-01-08 09:27:05,Begini kronologi mobil Brisia Jodie yang dibobol maling. https://t.co/g06JIqVLlv,6,0,5,0,2022-01-08,9,Saturday,6,11,0
1479745381076549634,2022-01-08 09:22:45,Video lumba-lumba ditangkap dan mati di atas kapal nelayan viral. Nelayan yang menangkap lumba-lumba disebut adalah nelayan Pacitan. https://t.co/bRb7wTtilj,27,10,20,4,2022-01-08,9,Saturday,6,47,14
1479744333523914760,2022-01-08 09:18:36,"Nur Chamin, Sekdes Gajihan di Pati viral setelah memberikan kado ulang tahun untuk anaknya berupa 2 unit mobil mewah sekaligus dan 1 unit lain untuk keponakan. Simak lagi ceritanya: https://t.co/AO9dw0OOiy",11,5,9,2,2022-01-08,9,Saturday,6,20,7
1479742849763708928,2022-01-08 09:12:42,"144.116 orang di Indonesia meninggal akibat COVID-19. Dampak lainnya, 30.766 anak di Indonesia jadi yatim, piatu dan yatim piatu karena orang tuanya meninggal. https://t.co/4MSSWwZgSw",21,7,27,4,2022-01-08,9,Saturday,6,48,11
1479742092511432706,2022-01-08 09:09:41,"Polisi menilang pemotor yang ditabrak mobil hingga terlempar dari flyover Pesing, Jakbar. Dalam aturan yang berlaku, motor dilarang melintasi flyover Pesing. https://t.co/JrpecMyYa6",61,33,15,7,2022-01-08,9,Saturday,6,76,40
1479740604171141120,2022-01-08 09:03:46,Ini penampakan perdana pesinetron Naufal Samudra usai ditangkap oleh Polda Metro Jaya. https://t.co/DQ1o4S38sb,3,0,2,0,2022-01-08,9,Saturday,6,5,0
1479740341989388288,2022-01-08 09:02:44,"Hasil geledah kantor dan rumah dinas Wali Kota Rahmat Effendi, KPK menyita berbagai dokumen proyek di Bekasi. https://t.co/Iq2JMP1AeW",6,0,3,0,2022-01-08,9,Saturday,6,9,0
1479739809975484421,2022-01-08 09:00:37,Lesti Kejora dan Rizky Billar akhirnya bakal memperlihatkan wajah sang buah hati malam ini. Hal itu terlihat dalam Instagram milik Lesti Kejora. https://t.co/HpmCkDNUyO,74,152,5,35,2022-01-08,9,Saturday,6,79,187
1479739786621558793,2022-01-08 09:00:32,"Sebelum memasukkan anak ke pesantren, sebaiknya coba cari tahu terlebih dahulu bagaimana pandangan orang-orang setempat tentang pesantren yang dipilih. #detikNetwork  https://t.co/IMXvBDK5YT",10,0,6,1,2022-01-08,9,Saturday,6,16,1
1479738397401010176,2022-01-08 08:55:00,Polisi menunjukkan kwitansi pembayaran sebagai barang bukti dengan berbagai nominal mulai dari 15 hingga 35 juta rupiah. https://t.co/PhvPgd0Vsc,9,0,5,0,2022-01-08,8,Saturday,6,14,0
1479737002111258625,2022-01-08 08:49:28,Video KSAD Jenderal Dudung Abdurachman menyanyikan lagu tentang kegemaran masyarakat Indonesia minum kopi. Seperti apa? https://t.co/1iQq4CtK3l,15,12,3,3,2022-01-08,8,Saturday,6,18,15
1479735739499913217,2022-01-08 08:44:27,"Desainer Istana Presiden di Ibu Kota Baru RI, Nyoman Nuarta, buka-bukaan hasil pertemuan dengan Jokowi di Istana. Simak di sini. https://t.co/swNdZd0Jca",12,1,9,0,2022-01-08,8,Saturday,6,21,1
1479734457880006660,2022-01-08 08:39:21,Ganjar Pranowo selalu menghindar ketika ditanya mengenai perhelatan Pilpres 2024. Bagaimana jika dia ditugaskan untuk maju di Pilgub DKI? https://t.co/d6QCDT7v43,16,12,1,3,2022-01-08,8,Saturday,6,17,15
1479733390777724936,2022-01-08 08:35:07,Tottenham Hotspur terancam kehilangan Son Heung-min hingga akhir bulan ini. Pemain asal Korea Selatan tersebut harus menepi akibat mengalami cedera otot. https://t.co/50vgXtbboV,5,1,2,0,2022-01-08,8,Saturday,6,7,1
1479732138652143617,2022-01-08 08:30:08,"Nama pekerjaannya 'Jasa Rancang Bangun Proyek Pembangunan Lintasan Balap Formula E'. Nilai harga perkiraan sendiri (HPS) Rp 50.157.633.916,00 https://t.co/y5vyyXcMBG",34,26,16,3,2022-01-08,8,Saturday,6,50,29
1479731633741778944,2022-01-08 08:28:08,Toyota Fortuner 2.8 VRZ dipastikan meluncur di Indonesia pekan depan. Catat tanggalnya! https://t.co/H3eyJgshRx,14,2,4,3,2022-01-08,8,Saturday,6,18,5
1479730604933586945,2022-01-08 08:24:02,Polisi mengungkap Naufal Samudra dikenalkan ke pemasok LSD oleh Jeff Smith. Pemasok itu bernama Ridwan. https://t.co/OnqDRBDSDw,4,0,3,0,2022-01-08,8,Saturday,6,7,0
1479729864739627008,2022-01-08 08:21:06,"Artis Naufal Samudra yang diamankan polisi, pernah memesan narkoba LSD kepada tersangka pengedar yang terkait dengan Jeff Smith. Pemesanan dilakukan 3 kali. https://t.co/7In9K6zyxV",6,0,3,0,2022-01-08,8,Saturday,6,9,0
1479729371875270656,2022-01-08 08:19:08,"Naufal Samudra sudah 3 kali pesan LSD ke pemasok. Di pesanan ketiga, dia tidak jadi mengambil LSD setelah tahu Jeff Smith ditangkap polisi. https://t.co/tLABhQ83VX",6,0,1,0,2022-01-08,8,Saturday,6,7,0
1479728594993750023,2022-01-08 08:16:03,"Naufal Samudra sempat diamankan terkait pengembangan kasus narkoba. Meski urine negatif narkoba, Naufal akan direhabilitasi di RSKO Cibubur. https://t.co/3GB601z2eI",0,1,2,1,2022-01-08,8,Saturday,6,2,2
1479726558663303168,2022-01-08 08:07:58,Intip lagi kebersamaan Naufal Samudra dan kekasihnya Dinda Kirana sebelum sang pesinetron ditangkap lagi karena narkoba! https://t.co/z7Mz1gHJGU,6,0,2,1,2022-01-08,8,Saturday,6,8,1
1479726047952314368,2022-01-08 08:05:56,Polisi mengatakan hasil tes urine Naufal Samudra negatif narkoba. Saat ini Naufal Samudra statusnya saksi di kasus narkoba untuk tersangka Ridwan. https://t.co/t0QZHtmzeO,3,0,2,0,2022-01-08,8,Saturday,6,5,0
1479725272479981569,2022-01-08 08:02:51,Anies Baswedan memperkenalkan kucing berkaki tiga bernama Lego yang ia pelihara. Ia pun menceritakan kisah dan tingkah laku Lego kala berada di rumahnya. Tonton di sini! https://t.co/iCGOdYA5BS,28,7,3,0,2022-01-08,8,Saturday,6,31,7
1479724785177407494,2022-01-08 08:00:55,Naufal Samudra kembali ditangkap terkait dugaan penyalahgunaan narkoba. Naufal mengaku sudah bersih dari narkoba. https://t.co/JBlAggcXMq,2,2,2,0,2022-01-08,8,Saturday,6,4,2
1479722731545444352,2022-01-08 07:52:45,"Pemilihan ketua RW 03 di Jelambar, Jakbar memanas karena ada spanduk penolakan warga yang mengontrak menjadi ketua RW. Lurah Jelambar memberi penjelasan. https://t.co/HdLq4KHit8",9,3,4,1,2022-01-08,7,Saturday,6,13,4
1479722233010569216,2022-01-08 07:50:46,Polisi menangkap Naufal Samudra karena ada jejak digital pernah pesan narkoba ke pengedar lingkaran Jeff Smith. https://t.co/NlsDomOw8y,16,3,2,1,2022-01-08,7,Saturday,6,18,4
1479721487686852608,2022-01-08 07:47:49,Polisi membeberkan motif tersangka begal payudara yang viral di Kemayoran. MMA merupakan pengagum korban. https://t.co/EEZe5YXd31,5,6,3,3,2022-01-08,7,Saturday,6,8,9
1479720137049657344,2022-01-08 07:42:27,"Amnesty International Indonesia mengkritik pengangkatan mantan anggota Tim Mawar, Mayjen Untung Budiharto, sebagai Pangdam Jaya. Apa alasannya? https://t.co/naxUnGgyHL",17,6,6,1,2022-01-08,7,Saturday,6,23,7
1479718899226746881,2022-01-08 07:37:32,"Jumlah total kasus COVID-19 di seluruh dunia telah menembus 300 juta, dengan penyebaran cepat Omicron membuat rekor jumlah kasus baru di puluhan negara. https://t.co/3a0H9IdJUm",9,0,4,0,2022-01-08,7,Saturday,6,13,0
1479717815863189504,2022-01-08 07:33:13,Perceraian antara Wang Leehom dan Lee Jinglei makin panas. Kini salah seorang staf penyanyi itu mengaku jika Jinglei bohong dan bisa bunuh diri dengan anaknya. https://t.co/KWnM2z9x98,3,1,0,1,2022-01-08,7,Saturday,6,3,2
1479716496586719234,2022-01-08 07:27:59,"Hewan pun bisa saling bersahabat layaknya manusia, bahkan tak sejenis pun mereka akur seperti anjing dan bebek, kuda dan anjing. Begini potret manisnya. https://t.co/wHZCMy4YPo",23,1,5,0,2022-01-08,7,Saturday,6,28,1
1479714409832488961,2022-01-08 07:19:41,Pengemudi mobil tewas usai mobilnya mengalami kecelakaan saat menghindari lubang di Tol Palembang-Lampung. Kondisi tol tersebut banyak dikeluhkan pengguna. https://t.co/gNjk7WszEy,201,63,66,33,2022-01-08,7,Saturday,6,267,96
1479713097623515142,2022-01-08 07:14:28,"Kate Middleton akan merayakan ultah ke-40 pekan depan. Jelang hari tersebut, seorang fotografer membeberkan salah satu foto lama istri Pangeran William itu. https://t.co/fleIgHubVa",9,1,2,0,2022-01-08,7,Saturday,6,11,1
1479711864753954818,2022-01-08 07:09:34,"Kode wilayah pelat nomor kendaraan di Indonesia berbeda-beda. Agar kamu lebih paham dan semakin luas menambah wawasan, berikut daftar kode pelat nomor kendaraan! https://t.co/X8og9PmyPm",30,1,10,0,2022-01-08,7,Saturday,6,40,1
1479710629556539399,2022-01-08 07:04:40,"Rumah di Desa Tegal Wangi Rt 03/03 Kecamatan Jasinga, Kabupaten Bogor terbakar. Nenek dan cucunya tewas dalam insiden ini. https://t.co/ZnPMNbiPXL",8,4,2,0,2022-01-08,7,Saturday,6,10,4
1479709785800990721,2022-01-08 07:01:19,Naufal Samudra ditangkap kedua kalinya terkait kasus narkoba. Begini penampakannya. https://t.co/LmkCSS5lxw,4,0,2,0,2022-01-08,7,Saturday,6,6,0
1479709763701194754,2022-01-08 07:01:14,"Pemerintah Provinsi DKI Jakarta bakal melarang penggunaan air tanah mulai 2023. Namun, larangan tersebut tidak diterapkan di semua wilayah. #CNNIndonesia #detikNetwork  https://t.co/crCio5vYky",10,1,4,0,2022-01-08,7,Saturday,6,14,1
1479708744196014080,2022-01-08 06:57:10,Komnas PA menyebut permintaan Doddy Sudrajat soal tes DNA terhadap Gala Sky adalah bentuk kekerasan anak dan harus segera dihentikan. https://t.co/o9ypTExy2a,32,0,8,2,2022-01-08,6,Saturday,6,40,2
1479707448453832706,2022-01-08 06:52:02,Youtuber ini menceritakan ia mendapatkan warisan dari kakek angkatnya yang berada di Arab Saudi. Seperti apa kisahnya? https://t.co/zc19Pk4tBU,7,0,3,0,2022-01-08,6,Saturday,6,10,0
1479706458925191170,2022-01-08 06:48:06,Pengajaran tenaga dalam jadi modus pemilik ponpes berinisial H ini melakukan pencabulan tiga santriwatinya. https://t.co/74nVkgM6jr,9,7,4,1,2022-01-08,6,Saturday,6,13,8
1479705720828448768,2022-01-08 06:45:10,"Pengemudi mobil yang menabrak 3 pengendara motor di Flyover Pesing, Jakbar, ADN, ditetapkan sebagai tersangka. Seorang pemotor sampai jatuh dari flyover. https://t.co/pp98UWRNB8",20,12,4,5,2022-01-08,6,Saturday,6,24,17
1479704458707849218,2022-01-08 06:40:09,"Percayakah jika ada seorang pria yang telah memiliki belasan istri hingga ratusan anak? Jika tidak, yuk kenalan dengan sosok Misheck Nyandoro ini!  https://t.co/YeSULMhBUt",7,0,3,0,2022-01-08,6,Saturday,6,10,0
1479703211120418823,2022-01-08 06:35:11,Doddy Sudrajat menjadi sorotan lagi dan lagi. Dirinya disebut mencari kesalahan Fuji dan Fadly saat Gala mengucapkan kata asin di live Instagram Fuji dan Fadly. https://t.co/C6G29jkpbq,19,22,3,4,2022-01-08,6,Saturday,6,22,26
1479701980985577476,2022-01-08 06:30:18,Sebuah laporan menuding Gerard Pique dan sejumlah pemain senior Barcelona masih menerima gaji tinggi. Pique meradang dan menunjukkan bukti transfer gajinya. https://t.co/EHTXyiraJV,6,0,3,1,2022-01-08,6,Saturday,6,9,1
1479700967910223873,2022-01-08 06:26:16,Keberadaan posisi wakil menteri (wamen) dalam beberapa kementerian akan diisi sesuai dengan situasi yang dibutuhkan. https://t.co/w5UPyDm6qU,3,1,2,0,2022-01-08,6,Saturday,6,5,1
1479699934807003136,2022-01-08 06:22:10,"KRI Parang-647 milik TNI AL menemukan mayat yang terapung di Perairan Kuala Tanjung, Sumut. Sosok mayat itu diduga merupakan TKI ilegal korban kapal tenggelam. https://t.co/3N7ph08BHw",9,2,6,0,2022-01-08,6,Saturday,6,15,2
1479697684063830018,2022-01-08 06:13:13,Apa bedanya super immunity dengan herd immunity? https://t.co/o6jUDN4CIr,9,1,6,0,2022-01-08,6,Saturday,6,15,1
1479696694497492996,2022-01-08 06:09:18,Pemuda Muhammadiyah menilai tak ada kaitannya pengakuan Ferdinand Hutahaean soal mualaf dengan proses hukum kasus cuitan 'Allahmu ternyata lemah'. https://t.co/qceM0gXMEG,63,18,23,3,2022-01-08,6,Saturday,6,86,21
1479695402983206914,2022-01-08 06:04:10,"Saat ulang tahun pacar, kamu tidak bisa membiarkannya berlalu tanpa memberi ucapan ulang tahun untuk pacar yang romantis. Intip idenya di sini! https://t.co/8YtF145qOy",4,0,2,0,2022-01-08,6,Saturday,6,6,0
1479694302406135810,2022-01-08 05:59:47,"""Saya tuh kalau gembira nangis, ada hal yang sensitif nangis, kadang-kadang lagi sholat nangis, lagi ceramah nangis, lagi pidato nangis, lagi ada kebahagiaan nangis. Nggak tahu kenapa, saya ini gampang nangis,"" ujar Rhoma Irama. https://t.co/tIZ3X5IkjN",41,36,17,29,2022-01-08,5,Saturday,6,58,65
1479693304635740161,2022-01-08 05:55:49,"Belakangan, gaya hijab Risty Tagor menjadi sorotan. Gaya hijab syar'i yang selama ini ia kenakan disebut tak lagi terlihat. https://t.co/B31HIip2pY",7,3,3,1,2022-01-08,5,Saturday,6,10,4
1479692253971075078,2022-01-08 05:51:39,"""Mereka ingin memperlihatkan bahwa adegan aksi terlihat bagus, namun mereka tidak ingin mengambil resiko atau merasakan kesulitan-kesulitan itu,"" ujar Jackie Chan. https://t.co/q0M9VL9EmY",45,2,10,1,2022-01-08,5,Saturday,6,55,3
1479691258868215808,2022-01-08 05:47:42,"Sebanyak 33 orang warga Krukut, Jakarta Barat, positif COVID-19 dan dilarikan ke RSDC Wisma Atlet. Saru dari 33 orang itu suspek Omicron. https://t.co/N5Gv6bgsol",30,9,14,7,2022-01-08,5,Saturday,6,44,16
1479690030230687747,2022-01-08 05:42:49,Cole Palmer mencuri perhatian saat Manchester City menang 4-1 atas Swindon Town. Ia berharap lebih banyak mendapat menit bermain dari Pep Guardiola. https://t.co/E3RDlgJStQ,5,1,2,1,2022-01-08,5,Saturday,6,7,2
1479689046909763586,2022-01-08 05:38:54,"Cegah varian Omicron, RI resmi menutup pintu masuk bagi WNA asal 14 negara tertentu. Lantas, bagaimana nasib WNI yang hendak pulang ke RI? https://t.co/ylSG4pM69A",19,7,12,3,2022-01-08,5,Saturday,6,31,10
1479688545619128330,2022-01-08 05:36:55,Gubernur DKI Jakarta Anies Baswedan mengenalkan kucing yang hanya memiliki kaki tiga. Kucing itu namanya Lego. https://t.co/WcUtusN9Ut,60,23,3,3,2022-01-08,5,Saturday,6,63,26
1479687797330042880,2022-01-08 05:33:56,Pemain drama Korea Snowdrop mengenang kepergian Kim Mi Soo. Jisoo BLACKPINK hingga Jung Hae In mengunggah potret kebersamaannya bersama mendiang. https://t.co/lVR5TgOcG2,11,0,2,0,2022-01-08,5,Saturday,6,13,0
1479687023527088129,2022-01-08 05:30:52,Ada tiga jembatan unik yang ada di Kabupaten Bandung Barat. Namun lokasinya cukup jauh dari pusat kota. https://t.co/8b4YjKMHnm,5,0,1,0,2022-01-08,5,Saturday,6,6,0
1479685917455572997,2022-01-08 05:26:28,Naufal Samudra ditangkap lagi oleh Polda Metro Jaya. Namun sang ibunda menegaskan tidak ada bukti narkoba yang ditemukan di kediamannya. https://t.co/eCAPW5eOVA,5,2,1,1,2022-01-08,5,Saturday,6,6,3
1479685415015702533,2022-01-08 05:24:28,"Sebagai pengungsi, mereka tak memiliki keleluasaan untuk mencari penghasilan di Indonesia. Simak kisahnya: https://t.co/ykROiZQdfg",7,0,1,0,2022-01-08,5,Saturday,6,8,0
1479684624360030212,2022-01-08 05:21:20,Ashanty bersama 5 orang dalam rombongannya sepulang dari Tuki disebut positif COVID-19. Ini kronologi dari pihak Kemenkes. https://t.co/9U1orfBITC,10,4,2,1,2022-01-08,5,Saturday,6,12,5
1479683339133063168,2022-01-08 05:16:13,Dirjen Haji dan Umroh Kemenag Hilman Latief bersyukur jemaah umroh kembali diberangkatkan setelah pandemi Corona. https://t.co/uD54bImFRF,12,4,11,6,2022-01-08,5,Saturday,6,23,10
1479683319298203651,2022-01-08 05:16:09,"Hey Aries, tak perlu banyak pertimbangan jika memang ada tawaran yang menguntungkan. Berikut ramalan zodiak selengkapnya hari ini! https://t.co/50PgS4XiZI",3,0,0,0,2022-01-08,5,Saturday,6,3,0
1479682084230901774,2022-01-08 05:11:14,"Prakirawan BMKG menjelaskan dampak sirkulasi siklonik terhadap cuaca di Indonesia. Simak di sini prakiraan cuaca untuk hari Sabtu, 8 Januari 2022. https://t.co/qtK0pOMBVG",4,1,1,0,2022-01-08,5,Saturday,6,5,1
1479680831245406214,2022-01-08 05:06:15,Kepolisian Italia berhasil menangkap seorang mafia kelas kakap yang telah menjadi buronan selama hampir 20 tahun lamanya berkat Google Maps. Gimana ceritanya? https://t.co/NfBt6HaZ0C,4,0,1,2,2022-01-08,5,Saturday,6,5,2
1479679332834590720,2022-01-08 05:00:18,Ivan Gunawan sudah tidak memiliki boneka arwah lagi. Boneka yang dianggap anaknya itu telah dihibahkan kepada orang lain. https://t.co/Uw5U3aXNYe,81,68,21,11,2022-01-08,5,Saturday,6,102,79
1479678588454641669,2022-01-08 04:57:21,"Meski Ferdinand Hutahaen kini mengaku mualaf, ajaran Islam tak mengizinkan pemeluknya melecehkan Tuhan. https://t.co/v3vNP9dLoj",110,50,11,4,2022-01-08,4,Saturday,6,121,54
1479677342247272448,2022-01-08 04:52:24,Buruan cek lowongan kerja sepekan ini! https://t.co/HTNoW1jNny,5,0,1,0,2022-01-08,4,Saturday,6,6,0
1479676361631543297,2022-01-08 04:48:30,Posisi kosong wamen di Kabinet Indonesia Maju menjadi sorotan. Menteri Sekretaris Negara Pratikno menjelaskan. https://t.co/rzqbY4YYEV,8,0,0,0,2022-01-08,4,Saturday,6,8,0
1479675118330781698,2022-01-08 04:43:33,"Skywalk Senayan Park menjadi buah bibir di media sosial, lokasi ini menyuguhkan pemandangan di jantung kota Jakarta. Penasaran? https://t.co/TaaFwZfjNd",26,0,5,1,2022-01-08,4,Saturday,6,31,1
1479673888518950914,2022-01-08 04:38:40,"Tidak ada program khusus kehamilan yang dilakukan oleh Roro Fitria saat ini. Tapi yang pasti, dia ingin punya anak banyak. https://t.co/wpcjTGpqXk",14,3,2,2,2022-01-08,4,Saturday,6,16,5
1479672754249084928,2022-01-08 04:34:10,Total perusahaan tambang yang akan dicabut izin usahanya sebanyak 2.078. Angka itu merupakan 40% dari total IUP 5.490. Simak penjelasannya: https://t.co/gsTMiN14H5,15,2,5,2,2022-01-08,4,Saturday,6,20,4
1479671535241764865,2022-01-08 04:29:19,"Ferdinand Hutahaean berkasus hukum karena cuitannya soal 'Allahmu Lemah'. Polisi bakal memeriksa Ferdinand. Tiba-tiba, Ferdinand menyatakan dirinya mualaf! https://t.co/OD3KYM8DQR",23,24,7,6,2022-01-08,4,Saturday,6,30,30
1479670306801397762,2022-01-08 04:24:26,"WHO optimistis pandemi COVID-19 bisa berakhir di 2022. Hanya saja untuk mencapainya, ada satu hal penting yang harus dilakukan dunia. Apa itu? https://t.co/YVKdwllfbz",5,2,1,0,2022-01-08,4,Saturday,6,6,2
1479668814103121922,2022-01-08 04:18:30,Luhut Binsar Pandjaitan pernah meminta seluruh masyarakat Indonesia tidak liburan ke luar negeri dahulu. Hal ini agar tidak membawa penyakit ke Tanah Air. https://t.co/HejMMa8lvu,19,19,7,3,2022-01-08,4,Saturday,6,26,22
1479667291465912322,2022-01-08 04:12:27,"Penumpang itu melihat jelas pesan yang dibuat oleh penumpang lain itu. Yakni, kami terkena Covid-19, sssttt. Nahloh? https://t.co/ESpotevyER",4,1,1,0,2022-01-08,4,Saturday,6,5,1
1479665813967839235,2022-01-08 04:06:35,"Tahukah traveler, ada sebuah benua baru bernama Zealandia. Benua ini telah lama hilang dan tersembunyi di bawah laut, namun kini sudah ditemukan lagi loh! https://t.co/tjnq27cjyp",34,1,16,1,2022-01-08,4,Saturday,6,50,2
1479664271101411331,2022-01-08 04:00:27,"Sandiaga Uno dan istri mengantarkan Anneesha untuk merantau. Saat itu, Sandi dan Nur Asia pun turut mengenang kembali kelahiran sang anak. Simak, yuk! #detikNetwork  https://t.co/eeeJBCsUzJ",0,1,0,0,2022-01-08,4,Saturday,6,0,1
1479662988646920205,2022-01-08 03:55:21,"Beberapa warga mengaku mereka tak mendapatkan makanan, perlengkapan dasar, bahkan perawatan medis... https://t.co/OTATOG85pS",3,1,0,1,2022-01-08,3,Saturday,6,3,2
1479661252406296578,2022-01-08 03:48:28,Kecelakaan maut terjadi di ruas tol Palembang-Lampung. Seorang mahasiswa tewas akibat mobilnya mengalami kecelakaan usai menghindari jalan berlubang. https://t.co/Yn7ECoDia5,981,298,390,358,2022-01-08,3,Saturday,6,1371,656
1479659708495634433,2022-01-08 03:42:19,"AMD memamerkan deretan produk barunya di CES 2022, dari mulai Ryzen 6000 untuk laptop sampai GPU baru.  https://t.co/3yPgvf2tei",2,0,2,1,2022-01-08,3,Saturday,6,4,1
1479658455355084803,2022-01-08 03:37:21,Pelaku berinisial MMA (20) diketahui bekerja sebagai kurir jasa ekspedisi. Begini tampangnya: https://t.co/NeBiNV2AOQ,3,2,0,2,2022-01-08,3,Saturday,6,3,4
1479657235034869760,2022-01-08 03:32:30,Berikut ini film-film yang sedang tayang di jaringan bioskop Indonesia untuk hiburan akhir pekan! https://t.co/pSPHRfo9Fz,4,0,0,0,2022-01-08,3,Saturday,6,4,0
1479655454921957379,2022-01-08 03:25:25,"Ivan Gunawan tanggapi pro kontra soal spirit doll. Sebagai orang yang mengadopsi dua spirit doll, Igun tegaskan 'anak-anaknya' bukan anak setan. https://t.co/TREimvuViD",63,89,7,11,2022-01-08,3,Saturday,6,70,100
1479654192981680132,2022-01-08 03:20:24,"Janariyah, ibu Gaga Muhammad, dan Ameilia Adelenyi, ibunda Laura Anna saling 'serang' di internet. Seperti apa? https://t.co/zrZ203dIJ3",3,2,0,0,2022-01-08,3,Saturday,6,3,2
1479651950236995585,2022-01-08 03:11:30,"#FOTO Janganlah cepat percaya dan terhasut dengan foto-foto viral yang beredar di dunia maya, seperti kumpulan foto ini yang sempat bikin geger dunia. https://t.co/EldPibcuPm",11,0,1,0,2022-01-08,3,Saturday,6,12,0
1479650390874505216,2022-01-08 03:05:18,"Sudah bukan rahasia lagi, banyak praktik booster vaksin COVID-19 ilegal dilakukan di masyarakat. Apa kata Kemenkes RI? https://t.co/OVxzCcU2F1",4,0,0,0,2022-01-08,3,Saturday,6,4,0
1479648715925336066,2022-01-08 02:58:39,Berhenti merokok merupakan langkah untuk menjaga kesehatan tubuh terkhusus paru-paru. Berikut 7 cara membersihkan paru-paru setelah berhenti merokok! https://t.co/5akmUb4lKT,23,2,8,1,2022-01-08,2,Saturday,6,31,3
1479646897510002688,2022-01-08 02:51:25,"Ashanty, dinyatakan positif COVID-19 dalam tes PCR SGTF. Tes ini merupakan salah satu deteksi awal varian Omicron. https://t.co/rUpaTnaWAI",14,1,3,1,2022-01-08,2,Saturday,6,17,2
1479645376596619264,2022-01-08 02:45:22,"""Beban negara kalau saya (karantina) di Wisma Atlet. Ini saya di rumah sakit dan tanggungan sendiri,"" kata Ashanty. https://t.co/ptoNFOiZ28",471,298,31,79,2022-01-08,2,Saturday,6,502,377
1479644120146759680,2022-01-08 02:40:23,"Ada kabar beredar bahwa Gading dan Gisel rujuk. Kabar tersebut mencuat dari Raffi Ahmad. Memang, bagaimana faktanya? https://t.co/rIhXpTFqO2",5,0,1,0,2022-01-08,2,Saturday,6,6,0
1479642628039884800,2022-01-08 02:34:27,Buya Yahya menjawab soal heboh spirit doll atau boneka arwah. Buya Yahya menegaskan tak ada roh masuk ke boneka. https://t.co/S4rwkk7RKl,23,2,0,1,2022-01-08,2,Saturday,6,23,3
1479641355127345152,2022-01-08 02:29:24,"RI melaporkan total 254 kasus COVID-19 varian Omicron. Mayoritas bergejala batuk dan pilek, lantas bagaimana membedakan infeksi varian Omicron dengan flu biasa? https://t.co/FGwVYqXDkh",6,1,7,2,2022-01-08,2,Saturday,6,13,3
1479640120106041345,2022-01-08 02:24:29,Andrew Garfield mengutarakan bahwa dirinya terbuka kalau diajak kembali jadi Spider-Man dalam sebuah film standalone. https://t.co/cvza08f73X,21,1,1,1,2022-01-08,2,Saturday,6,22,2
1479638874372677632,2022-01-08 02:19:32,"Mantan Ketua DPC Gerindra Blora, Setiyadji Setyawidjaja, menggugat sejumlah pihak termasuk Ganjar Pranowo. Ganjar menanggapi. https://t.co/jiLCv19dFY",11,0,0,0,2022-01-08,2,Saturday,6,11,0
1479637569298182148,2022-01-08 02:14:21,John Mayer absen manggung bareng Dead &amp; Company karena positif COVID-19. #JohnMayer  https://t.co/VdFH7fAGnd,10,2,5,1,2022-01-08,2,Saturday,6,15,3
1479636338018332674,2022-01-08 02:09:27,"Setiap makhluk hidup, pasti akan mengalami kematian. Berikut ini beberapa tanda-tanda kematian yang menandakan ajal sudah dekat. https://t.co/H8qdF7mWnb",16,1,8,3,2022-01-08,2,Saturday,6,24,4
1479634177775607809,2022-01-08 02:00:52,Harga minyak goreng di Korea Utara melonjak hingga mencapai KPW45 ribu atau sekitar Rp718 ribu per liter di tengah krisis pangan yang terjadi. #CNNIndonesia #detikNetwork  https://t.co/ZKldjNaH9j,43,6,11,5,2022-01-08,2,Saturday,6,54,11
1479632702957576192,2022-01-08 01:55:01,"Akun Wikipedia Indonesia mendadak nge-tweet soal influencer, asisten dosen, dan tanggung jawab. Netizen bereaksi. https://t.co/Jo5klw9BLI",27,1,3,2,2022-01-08,1,Saturday,6,30,3
1479630931421978627,2022-01-08 01:47:58,Pesinetron Naufal Samudra ditangkap lagi karena narkoba dan Dinda Kirana disebut berada di lokasi penangkapan. Kini ia mengunggah doa bagi kekasihnya tersebut. https://t.co/0zNZ6dkFw0,14,2,1,1,2022-01-08,1,Saturday,6,15,3
1479630439098863621,2022-01-08 01:46:01,Dinda Kirana tidak ikut diamankan saat penangkapan Naufal Samudra terjadi. https://t.co/v60gxWj9sj,29,4,7,2,2022-01-08,1,Saturday,6,36,6
1479629446315393024,2022-01-08 01:42:04,Presiden Kazakhstan memerintahkan untuk menembak di tempat tanpa peringatan untuk meredam situasi. #Kazakhstan https://t.co/ouApk0NMT4,11,0,7,0,2022-01-08,1,Saturday,6,18,0
1479627534622986243,2022-01-08 01:34:29,Jefri Nichol kembali berperan dalam film Dear Nathan: Thank You Salma. Ia mengaku karakternya hampir mirip dengan Nathan yang senang ikut unjuk rasa. https://t.co/IdiQxeX5Iz,14,0,1,0,2022-01-08,1,Saturday,6,15,0
1479625950115602437,2022-01-08 01:28:11,Bareskrim Polri mulai mengusut dugaan suap yang dilakukan Rachel Vennya. https://t.co/r78Y1C8DA1,16,1,4,4,2022-01-08,1,Saturday,6,20,5
1479624175203622922,2022-01-08 01:21:08,"Menteri Investasi/Kepala BKPM, Bahlil Lahadalia, menyebut pencabutan Izin Usaha Pertambangan (IUP) sebanyak 2.078 perusahaan tambang minerba akan berlaku mulai Senin (10/1).  https://t.co/a8ONhi6BkD",10,1,1,1,2022-01-08,1,Saturday,6,11,2
1479621637955895297,2022-01-08 01:11:03,"#FOTO Krisdayanti ke kantor tidak sendirian. Sang suami, Raul Lemos, menemaninya. Ini potretnya:  https://t.co/1qEuL5bzsQ",6,2,2,3,2022-01-08,1,Saturday,6,8,5
1479618994181136384,2022-01-08 01:00:32,"Kieran Trippier sudah resmi menjadi pemain Newcastle United. Dia mau bergabung dengan The Magpies, yangs sedang berjuang di zona degradasi, bukan karena uang. https://t.co/No4sG2ltph",8,2,0,0,2022-01-08,1,Saturday,6,8,2
1479618754346639360,2022-01-08 00:59:35,"""Ndak usahlah (ditunda). Kuwi nunggu apa? Ya berlanjut (relokasinya),"" kata Sultan HB X saat ditanya soal keinginan PKL Malioboro untuk menunda relokasi. https://t.co/z81rvpfcHY",8,2,2,0,2022-01-08,0,Saturday,6,10,2
1479618262740901888,2022-01-08 00:57:38,Selebriti Ashanty dinyatakan positif COVID-19. Ashanty positif COVID-19 sepulang dari Turki bersama keluarganya. Ini gejala yang ia alami. https://t.co/59N5YI1wbj,6,1,0,0,2022-01-08,0,Saturday,6,6,1
1479617770430021637,2022-01-08 00:55:41,"Kematian wanita inisial S di hotel di Tangerang masih menjadi tanda tanya. Belum diketahui penyebab kematian korban, tapi polisi mengamankan teman kencannya. https://t.co/cBbwgj3jws",5,0,2,1,2022-01-08,0,Saturday,6,7,1
1479617504167268355,2022-01-08 00:54:37,Penis yang berdiri mendadak bisa membuat pria merasa malu dan khawatir. Tetap tenang dan alihkan perhatian bisa jadi salah satu cara untuk menghentikannya. https://t.co/mzzWaGtZUY,5,1,1,1,2022-01-08,0,Saturday,6,6,2
1479616767370698752,2022-01-08 00:51:41,Cuitan Ferdinand Hutahaean yang disandingkan dengan Gus Dur menuai kritik. Sejumlah pihak tidak terima cuitan keduanya disamakan. https://t.co/jyWIweitnj,12,12,0,2,2022-01-08,0,Saturday,6,12,14
1479616277899624457,2022-01-08 00:49:45,Kakak adik di Magetan menjadi korban pencabulan. Pelaku adalah majikan atau bos tempat si kakak bekerja. Korban mengaku 7 kali dicabuli. https://t.co/HEmD5ePSxV,6,4,1,1,2022-01-08,0,Saturday,6,7,5
1479616031991676929,2022-01-08 00:48:46,"Seorang nelayan di Lhokseumawe mengajukan permohonan suntik mati. Lima tahun lalu, permohonan serupa pernah diajukan pria di Banda Aceh tapi ditolak hakim. https://t.co/mGXmzawcKi",5,0,2,0,2022-01-08,0,Saturday,6,7,0
1479615527022702592,2022-01-08 00:46:46,Penyanyi Ashanty dinyatakan positif COVID-19 sepulang dari liburan di Turki. Menko Polhukam Mahfud Md bilang begini. https://t.co/L3uADRs80G,3,3,0,1,2022-01-08,0,Saturday,6,3,4
1479615270335492101,2022-01-08 00:45:45,"Sudah bukan rahasia lagi, banyak praktik booster vaksin COVID-19 ilegal dilakukan di masyarakat. Kemenkes RI menegaskan program booster non nakes belum dimulai. https://t.co/PBob7pB8LY",2,1,0,0,2022-01-08,0,Saturday,6,2,1
1479614730549485573,2022-01-08 00:43:36,PPKM Makassar kini berstatus level 2. Ini aturan-aturan yang perlu diperhatikan. https://t.co/IK6E9kEAA9,0,0,1,0,2022-01-08,0,Saturday,6,1,0
1479614236598972422,2022-01-08 00:41:38,"""Kasus sedang dalam proses, dan sesuai rencana, penyidik akan mengambil keterangan kepada terlapor (Ferdinand),"" kata Brigjen Ahmad Ramadhan. https://t.co/vKCzW6wHzr",16,5,2,3,2022-01-08,0,Saturday,6,18,8
1479613998119149581,2022-01-08 00:40:41,"Nadeo Argawinata memang gagal membawa Indonesia juara Piala AFF 2020. Tapi, kiper Timnas Indonesia itu tetap diguyur bonus Rp 30 juta. https://t.co/TkQ8VGcNM9",30,1,0,0,2022-01-08,0,Saturday,6,30,1
1479612429877358595,2022-01-08 00:34:27,Tottenham Hotspur terancam kehilangan Son Heung-min hingga akhir bulan ini. Pemain asal Korea Selatan tersebut harus menepi akibat mengalami cedera otot. https://t.co/1mxGjvrZzs,4,0,1,0,2022-01-08,0,Saturday,6,5,0
1479612428673556483,2022-01-08 00:34:27,Erupsi Gunung Semeru terjadi 4 Desember 2021. Ada 50 dokter dan seorang bidan Fakultas Kesehatan Universitas Airlangga (FK Unair) yang diterjunkan ke Lumajang. https://t.co/6gYT7lBW9g,4,1,0,0,2022-01-08,0,Saturday,6,4,1
1479612195986157569,2022-01-08 00:33:32,Ferdinand mengaku masih awam terkait pemahaman agama. Ia pun meminta tolong agar bisa dibimbing. https://t.co/MKAetQlkyy,74,200,7,52,2022-01-08,0,Saturday,6,81,252
1479610949246070788,2022-01-08 00:28:34,Manajer Newcastle United Eddie Howe senang dengan kedatangan Kieran Trippier. Dia berharap Trippier jadi awal bergabungnya pemain top yang lain. https://t.co/undjsgoAdZ,5,0,0,1,2022-01-08,0,Saturday,6,5,1
1479610441424855044,2022-01-08 00:26:33,"Seorang siswi SMP di Makassar, Sulawesi Selatan (Sulsel) berusia 12 tahun dilarikan ke rumah sakit dan mengaku disiram air keras oleh rekannya. https://t.co/g6kIlJV3gz",10,0,2,1,2022-01-08,0,Saturday,6,12,1
1479609946350268416,2022-01-08 00:24:35,Tebak-tebakan ini belum tentu bisa dijawab oleh orang cerdas sekalipun. Coba pecahkan teka-teki receh ini sambil melatih otak. https://t.co/qsvTrTzf9I,350,350,55,14,2022-01-08,0,Saturday,6,405,364
1479609194596769799,2022-01-08 00:21:36,"Anggaran untuk gaji dan tunjangan anggota DPRD DKI naik jadi Rp 177,37 miliar. Wakil Ketua DPRD DKI Jakarta menganggap kenaikan anggaran itu sedikit. https://t.co/czE8gHWo12",75,125,21,75,2022-01-08,0,Saturday,6,96,200
1479608464045445120,2022-01-08 00:18:42,Penis yang berdiri mendadak bisa membuat pria merasa malu dan khawatir. Tetap tenang dan alihkan perhatian bisa jadi salah satu cara untuk menghentikannya. https://t.co/NWGmZeHRj4,3,0,1,1,2022-01-08,0,Saturday,6,4,1
1479607643106947073,2022-01-08 00:15:26,"Thomas Tuchel dapat dukungan penuh dari bos Roman Abramovich. Kalau ada pemain Chelsea yang nantinya bikin kontroversi seperti Lukaku, silakan dihukum! https://t.co/p1aumugDMJ",3,0,1,0,2022-01-08,0,Saturday,6,4,0
1479606905035239426,2022-01-08 00:12:30,"Hakim PN Tipikor Pekanbaru, Riau, menjatuhkan vonis 4 tahun ke mantan Bupati Kuantan Singingi, Mursini. Vonis hakim lebih rendah dari tuntutan jaksa. https://t.co/Br5xT6JvAG",6,0,1,1,2022-01-08,0,Saturday,6,7,1
1479606406215086081,2022-01-08 00:10:31,Berhenti merokok merupakan langkah untuk menjaga kesehatan tubuh terkhususparu-paru. Berikut 7 cara membersihkan paru-paru setelah berhenti merokok. https://t.co/5Q8TDitRDg,57,2,33,3,2022-01-08,0,Saturday,6,90,5
1479605659599618052,2022-01-08 00:07:33,Mantan Direktur WHO Asia Tenggara mengomentari peningkatan kasus Corona di India. Tren naik-turun kasus COVID-19 di India menurutnya hampir serupa dengan RI. https://t.co/FRkYxk5DVc,5,1,0,0,2022-01-08,0,Saturday,6,5,1
1479604922458902530,2022-01-08 00:04:37,Polisi memastikan tidak ada artis lain yang terlibat di kasus prostitusi Cassandra Angelie. https://t.co/8yF4Dwh28y,10,1,0,0,2022-01-08,0,Saturday,6,10,1
1479604667176955910,2022-01-08 00:03:37,Ketum PD AHY melantik para pengurus DPD Demokrat Provinsi Aceh. AHY tegaskan target PD tidak hanya mengejar kekuasaan https://t.co/FEgopaRm7N,4,1,0,0,2022-01-08,0,Saturday,6,4,1
1479603918304915457,2022-01-08 00:00:38,Penampilan Manchester United di bawah Ralf Rangnick sejauh ini belum meyakinkan betul. Apakah para pemain sudah benar-benar menjalankan instruksinya? https://t.co/zMIithVFcM,3,1,0,1,2022-01-08,0,Saturday,6,3,2
1484676753796866049,2022-01-21 23:58:16,Polisi mengungkapkan kronologi siswa SD disuntik vaksin kosong di Medan. Kejadian tersebut terjadi pada hari Senin (17/1) pukul 09.00 WIB. https://t.co/8l5b0xQJ1F,9,4,4,0,2022-01-21,23,Friday,5,13,4
1484675373820485633,2022-01-21 23:52:47,"Jangan pernah anggap remeh nyeri di area leher ya guys, karena bisa saja menandakan ada masalah yang lebih buruk. Segera periksa jika mengalami gejala ini. https://t.co/p3TaEhZSIA",15,1,6,1,2022-01-21,23,Friday,5,21,2
1484674058159546376,2022-01-21 23:47:34,"Korban mafia tanah, tukang servis AC, Ng Je Ngay (70), diwakili kuasa hukumnya mendatangi Bareskrim Polri. Dia menyurati Kapolri Jenderal Listyo Sigit Prabowo. https://t.co/UEguIvAVUx",12,1,2,0,2022-01-21,23,Friday,5,14,1
1484672797334982656,2022-01-21 23:42:33,Sejumlah tahanan di penjara yang dikelola Kurdi di timur laut Suriah melarikan diri usai kelompok ISIS menyerang penjara yang mereka tempati. https://t.co/lnH4tFqbx0,5,0,2,0,2022-01-21,23,Friday,5,7,0
1484671627224928260,2022-01-21 23:37:54,Kasus siswa SD disuntik vaksin kosong di Medan bikin geger. Polisi langsung turun tangan mengusut kasus itu. https://t.co/azlWCAWxe1,27,9,2,1,2022-01-21,23,Friday,5,29,10
1484670631119630339,2022-01-21 23:33:56,Tabrakan maut sopir truk tronton Balikpapan menyisakan tragedi. Aksi sopir truk tronton Balikpapan tidak membanting setir ke kiri menuai sorotan. https://t.co/apKNPinwyH,31,3,2,3,2022-01-21,23,Friday,5,33,6
1484669571411939330,2022-01-21 23:29:44,Ada delapan pemain baru masuk ke pelatnas Timnas Indonesia. Pelatih Shin Tae-yong masih mau meraba dulu kemampuan para pemain itu. https://t.co/QcPcqbZZgd,13,0,2,0,2022-01-21,23,Friday,5,15,0
1484668761529630720,2022-01-21 23:26:31,"Warga ibukota Jakarta, ada info lokasi sentra vaksin booster lagi nih. Sekarang lokasinya di mal loh. Yuk, kunjungi sekarang biar bisa menangkal Omicron. https://t.co/i4W0yctKsL",13,1,9,1,2022-01-21,23,Friday,5,22,2
1484666924478959617,2022-01-21 23:19:13,Hakim PN Surabaya Itong Isnaeni Hidayat menginterupsi jumpa pers KPK saat dihadirkan sebagai tersangka. KPK memaklumi apa yang dilakukan oleh Itong. https://t.co/CyIAy6bWwx,14,5,0,0,2022-01-21,23,Friday,5,14,5
1484666688834576387,2022-01-21 23:18:17,Balas berbalas Gubernur DKI Jakarta Anies Baswedan dengan Ketua Umum PSI Giring Ganesha belum tuntas. Saling balas Anies vs Giring malah makin panas. https://t.co/B7QZBsZj8q,46,73,9,11,2022-01-21,23,Friday,5,55,84
1484665003840086016,2022-01-21 23:11:35,"Menteri Kesehatan Budi Gunadi Sadikin memberikan respons terkait viralnya suntik vaksin COVID-19 kosong siswa di SD Wahidin, Medan, Sumatera Utara. https://t.co/lDLrsfQ3ri",7,6,2,1,2022-01-21,23,Friday,5,9,7
1484663047218155520,2022-01-21 23:03:48,Ada sosok 'sahabat' yang disebut menjadi saksi hidup Rasulullah SAW semasa kecilnya. Sosok sahabat ini dapat ditemukan di bagian Utara Yordania. Ini faktanya. https://t.co/8Flgju2lZa,46,1,10,2,2022-01-21,23,Friday,5,56,3
1484662392336576515,2022-01-21 23:01:12,Bakso Malang enak dan nikmat bisa kamu temui di pusat jajanan belakang Grand Indonesia (GI). Namanya Bakso Malang Gangsar yang menjual bakso mulai Rp 16 ribu!  https://t.co/hzhXcX3jEI,13,2,4,1,2022-01-21,23,Friday,5,17,3
1484661005372346370,2022-01-21 22:55:42,Kafe baru terus bermunculan di kawasan Jakarta Selatan (Jaksel). Ada yang punya area outdoor dan bergaya Amerika. Cocok jadi tempat nongkrong saat akhir pekan.  https://t.co/mVhvlTt0tY,13,0,2,0,2022-01-21,22,Friday,5,15,0
1484659712490627077,2022-01-21 22:50:33,Cara download video Twitter tidak serumit yang kalian bayangkan. Berikut ini cara download video Twitter di HP Android dan iPhone tanpa aplikasi. https://t.co/1JixDndodz,45,0,17,0,2022-01-21,22,Friday,5,62,0
1484657360819961857,2022-01-21 22:41:13,Nama resminya Masjid Roudhotul Musyawarah. Tapi masyarakat Surabaya lebih mengenalnya dengan sebutan Masjid Kemayoran. Inilah kisahnya.   https://t.co/t5Nt5x9NVV,5,2,1,0,2022-01-21,22,Friday,5,6,2
1484656042130690051,2022-01-21 22:35:58,"Kuliner enak di ITC Mangga Dua tersebar di berbagai titik. Di lantai 2, ada bakmi Bangka sedap. Lalu di lantai 5, kamu bisa menemukan siomay ikan tenggiri!  https://t.co/F3dYkXB31y",19,2,2,0,2022-01-21,22,Friday,5,21,2
1484653783728758788,2022-01-21 22:27:00,"Jika selama ini bakso identik dengan Kota Malang, ternyata ada kuliner khas lain patut dicoba. Yaitu orem-orem. Ini disajikan dengan ketupat dipadu tempe.  https://t.co/qpBeVTYZK9",15,1,1,0,2022-01-21,22,Friday,5,16,1
1484651922724372487,2022-01-21 22:19:36,BMKG mengimbau masyarakat waspada potensi hujan disertai petir di Jaksel dan Jaktim pada siang hingga sore hari. https://t.co/NqwAQEcMPG,5,0,1,0,2022-01-21,22,Friday,5,6,0
1484651188586958863,2022-01-21 22:16:41,Ternyata ada satu tempat bersantai dan membaca buku yang menawarkan pengalaman berbeda di tengah bangunan heritage Kotagede. Di mana itu?  https://t.co/sK0gia06gX,14,0,3,0,2022-01-21,22,Friday,5,17,0
1484650350070149122,2022-01-21 22:13:21,"Polisi mengungkap alasan sopir tronton maut di Balikpapan, M Ali (47), tak banting setir sebelum menabrak sejumlah kendaraan. Ali mengaku panik jelang kejadian. https://t.co/DAsOlIttc7",180,91,34,7,2022-01-21,22,Friday,5,214,98
1484649342208286720,2022-01-21 22:09:21,Zara Ruthford berhasil terbang sendirian dengan pesawat ringan dengan jarak mencapai 52 ribu kilometer yang terbentang dari Jambi hingga Tumaco di Kolombia.  https://t.co/dmj57dFXkN,21,2,6,0,2022-01-21,22,Friday,5,27,2
1484648328684048384,2022-01-21 22:05:19,Kim Pan-gon ditunjuk sebagai pelatih baru Timnas Malaysia. Kehadirannya menambah daftar juru taktik asal Korea Selatan yang berkarier di Asia Tenggara. https://t.co/Hn0slXb7BR,6,2,1,0,2022-01-21,22,Friday,5,7,2
1484647512073977859,2022-01-21 22:02:04,"Akbar Wicaksono telah jadi pengusaha digital sukses. Di balik itu, ia pernah dikecewakan teman baik, duitnya dibawa kabur Rp 100 juta. Waduh...  https://t.co/CLdgmrqX96",11,0,2,1,2022-01-21,22,Friday,5,13,1
1484646397903314945,2022-01-21 21:57:39,"Dubes Jerman di Israel dan Dubes Israel di Jerman mengeluarkan seruan bersama mengecam keras penyangkalan Holocaust. Memperingati 80 tahun Konferensi Wannsee, kedua diplomat menulis di harian Israel dan Jerman.  https://t.co/LeI2ZvutEa",8,3,1,0,2022-01-21,21,Friday,5,9,3
1484644584189792259,2022-01-21 21:50:26,Timnas Malaysia resmi menunjuk Kim Pan-gon sebagai pelatih anyar. Pria Korea Selatan itu pernah mendepak Shin Tae-yong dari kursi pelatih Taeguk Warriors. https://t.co/KJq5OltDnP,13,8,3,0,2022-01-21,21,Friday,5,16,8
1484642960255893504,2022-01-21 21:43:59,Sejumlah pedagang sembako di pasar tradisional Boyolali mengeluhkan kebijakan harga minyak goreng Rp 14.000 per liter di toko-toko modern. Begini curhatnya.  https://t.co/e2v54LqAbF,21,12,3,1,2022-01-21,21,Friday,5,24,13
1484641439040655366,2022-01-21 21:37:57,"Sebuah pesawat Perang Dunia II yang hilang telah ditemukan di wilayah terpencil Himalaya di India, setelah 77 tahun setelah jatuh tanpa ada yang selamat.  https://t.co/kNjL4aSE1p",26,1,3,0,2022-01-21,21,Friday,5,29,1
1484639979032694791,2022-01-21 21:32:08,"Polisi turut memberi tanggapan soal mengapa sopir truk kecelakaan Balikpapan, M Ali (47), tak membanting setir ke kiri sebelum melindas sejumlah kendaraan. https://t.co/zhimvHjpKr",46,16,8,3,2022-01-21,21,Friday,5,54,19
1484637895969366016,2022-01-21 21:23:52,Puluhan wartawan di Liberia berkumpul di luar gedung pengadilan dekat Ibu Kota Monrovia. Mereka melakukan aksi untuk mendukung rekan wanita yang diserang. https://t.co/YYOoigDXSm,8,0,0,0,2022-01-21,21,Friday,5,8,0
1484636533672091652,2022-01-21 21:18:27,Liverpool kembali ke final Piala Liga Inggris setelah enam tahun. Manajer Liverpool Juergen Klopp menepis anggapan kalau dia tidak serius di kompetisi ini. https://t.co/niya9cQh9K,10,2,1,0,2022-01-21,21,Friday,5,11,2
1484635174935699463,2022-01-21 21:13:03,TikTok telah mengkonfirmasi sedang menguji fitur langganan berbayar. Dengan fitur ini membuka jalan bagi kreator dapat penghasilan tambahan dari followersnya. https://t.co/jVWPifXB9g,6,0,1,0,2022-01-21,21,Friday,5,7,0
1484633766630936578,2022-01-21 21:07:27,"Polisi terus mengungkap pembunuhan yang dilakukan Warsoni (41) kepada istrinya. Terbaru, mengemuka tipu daya Warsoni yang tega membunuh istrinya usai bercinta. https://t.co/81UAJzYmCm",7,1,0,0,2022-01-21,21,Friday,5,7,1
1484632210284163078,2022-01-21 21:01:16,Baku tembak terjadi antara pasukan Taliban dan perjuangan perlawanan Afghanistan. Sebanyak 8 kelompok pejuang Afghanistan tewas ditembak Taliban. https://t.co/wlQHeWNTiI,17,2,1,2,2022-01-21,21,Friday,5,18,4
1484630805007712267,2022-01-21 20:55:41,"Bocah SD di Kapuas, Kalimantan Tengah (Kalteng), R, diduga diperkosa oleh kakak iparnya, RI alias Entong. https://t.co/ygR96jPARW",6,1,0,0,2022-01-21,20,Friday,5,6,1
1484629737737752584,2022-01-21 20:51:27,"Stt, pasutri, ini ada 5 tips foreplay sebelum bercinta. Wajib banget dijajal nih biar makin puas dan menggairahkan di ranjang. https://t.co/BVMZSG63oK",6,0,0,0,2022-01-21,20,Friday,5,6,0
1484627785134096388,2022-01-21 20:43:41,"Polisi menyebut penabrak polisi anggota Satlantas di sekitar PGC, Jaktim, RS, berkendara di dalam jalur khusus TransJakarta. https://t.co/fTjM9skGfM",5,0,0,0,2022-01-21,20,Friday,5,5,0
1484625980685754377,2022-01-21 20:36:31,Wisatawan yang naik Candi Borobudur wajib memakai sandal upanat. Pemakaian sandal ini salah satunya untuk meminimalisasi keausan batu Candi Borobudur.  https://t.co/zvfRfd62R7,6,0,2,0,2022-01-21,20,Friday,5,8,0
1484624068200513541,2022-01-21 20:28:55,"Instagram sedang mengujicoba fitur baru, yaitu langganan berbayar yang bisa diaktifkan oleh kreator konten atau influencer di platformnya.  https://t.co/hztmW6abFF",6,0,3,3,2022-01-21,20,Friday,5,9,3
1484621885790957568,2022-01-21 20:20:15,Nama Ridwan Kamil (RK) mencuat menjadi salah satu kandidat Kepala Otorita IKN Nusantara. Namun RK mengaku belum ada komunikasi dengan Jokowi terkait itu.  https://t.co/zQKM4bGq1B,8,5,1,1,2022-01-21,20,Friday,5,9,6
1484620487271530496,2022-01-21 20:14:41,Jessica Iskandar membuat heboh karena video sedang joget di kamar mandi dalam kondisi hamil besar. Ini pose Jedar saat hamil:  https://t.co/emgSd7GnTQ,4,0,1,0,2022-01-21,20,Friday,5,5,0
1484618792374312962,2022-01-21 20:07:57,"Instagram adalah salah satu media sosial yang paling populer di dunia. Sejumlah selebriti aktif di medsos ini dan punya follower ratusan juta, siapa mereka? https://t.co/V4swT3JgyD",2,1,2,0,2022-01-21,20,Friday,5,4,1
1484616778957393921,2022-01-21 19:59:57,Kementerian Pemuda dan Olahraga (Kemenpora) di bawah Zainudin Amali terbilang oke kinerjanya. Maka itu instansi pemerintah lain patut mencontoh. https://t.co/HyQRIIUHRv,3,1,0,1,2022-01-21,19,Friday,5,3,2
1484615230319742980,2022-01-21 19:53:48,Niken Anjani telah dikaruniai seorang putri bernama Anaia Alodie Dimaz yang kini berusia 9 bulan. Ia pun mengaku sangat menikmati perannya sebagai ibu. https://t.co/OnjSNERHPA,6,0,1,0,2022-01-21,19,Friday,5,7,0
1484612843567820800,2022-01-21 19:44:19,"Facebook dan Instagram kabarnya akan ikut terjun ke dunia NFT. Mereka dilaporkan sedang mengembangkan tools untuk menciptakan, menampilkan, dan jual beli NFT. https://t.co/7C7d2OOXux",12,1,3,1,2022-01-21,19,Friday,5,15,2
1484611532201906179,2022-01-21 19:39:06,"Video menunjukkan ayah di Sulawesi Utara (Sulut), menganiaya anak perempuan viral di media sosial (medsos). Pelaku akhirnya diciduk polisi. https://t.co/gCQOLMDBXX",11,0,1,1,2022-01-21,19,Friday,5,12,1
1484611290161102853,2022-01-21 19:38:08,"Menyambut awal tahun, Tya Ariestya kini memutuskan untuk menutup auratnya dan tampil berhijab. Dia dipuji lebih cantik usai memakai hijab. https://t.co/eKI6Ney1RP",55,3,3,2,2022-01-21,19,Friday,5,58,5
1484609136671268867,2022-01-21 19:29:35,Nahdlatul Ulama menyebut penyebaran paham radikal Negara Islam Indonesia (NII) sudah mengkhawatirkan di Garut. NII disebut menyebar di hampir seluruh kecamatan. https://t.co/uTWjo6jsES,19,6,7,1,2022-01-21,19,Friday,5,26,7
1484607480785166337,2022-01-21 19:23:00,Apakah kamu mengalami kelelahan dan sakit kepala setelah mendapatkan vaksin Covid-19? Efek samping itu dikenal dengan istilah nocebo. https://t.co/imstO6OVdR,9,1,3,1,2022-01-21,19,Friday,5,12,2
1484604540141854721,2022-01-21 19:11:19,"Ketua DPD PDIP Jabar, Ono Surono, mengaku tak resah dengan ramainya #SundaTanpaPDIP di Twitter. Ia sudah menduga isu Arteria akan digiring secara politik untuk menghadapi Pemilu 2024.  https://t.co/J4cx3FzdCf",17,5,6,4,2022-01-21,19,Friday,5,23,9
1484603192805572614,2022-01-21 19:05:58,Dear Nathan: Thank You Salma jadi penutup dari kisah cinta Nathan dan Salma. Ini akhir kisah mereka berdua: https://t.co/rnUsEa2Nwy,16,0,1,0,2022-01-21,19,Friday,5,17,0
1484601909495447557,2022-01-21 19:00:52,Akhir hayat layanan 3G semakin dekat. Telkomsel mengumumkan akan melakukan upgrade seluruh layanan 3G ke 4G secara bertahap di tahun 2022. https://t.co/6xxCcChxoU,5,0,2,0,2022-01-21,19,Friday,5,7,0
1484600444978704387,2022-01-21 18:55:03,"Kecelakaan terjadi di Jalan Jenderal Sudirman arah Bundaran Senayan, Jakarta Pusat (Jakpus). Kecelakaan ini melibatkan mobil dan beberapa motor. https://t.co/pdRwPWDAhH",20,0,5,2,2022-01-21,18,Friday,5,25,2
1484599347371454464,2022-01-21 18:50:41,"Riyad Mahrez diberikan waktu libur seminggu demi menenangkan dirinya. Setelah itu, Mahrez bisa beraksi lagi untuk Manchester City. https://t.co/Bigi4oNsSq",8,0,0,0,2022-01-21,18,Friday,5,8,0
1484598742217117705,2022-01-21 18:48:17,"Kecelakaan terjadi di Labuhanbatu Utara, Sumut. Seorang pengendara motor tewas terlindas truk. https://t.co/gZzbCbiJ7R",4,0,1,0,2022-01-21,18,Friday,5,5,0
1484598246924333060,2022-01-21 18:46:19,Kasus dugaan suap yang turut menyebut nama Kapolrestabes Medan Kombes Riko Sunarko terus bergulir. Kini Riko dicopot dari jabatannya. https://t.co/lLCtFPUszu,38,5,11,2,2022-01-21,18,Friday,5,49,7
1484596813151809541,2022-01-21 18:40:37,"Pembelajaran tatap muka (PTM) 100 persen masih berlangsung di tengah peningkatan kasus Covid-19. Ketua Komisi X DPR, Syaiful Huda, berharap sekolah tidak kembali menerapkan pembelajaran jarak jauh. https://t.co/K7RX5YAOXW",2,0,1,0,2022-01-21,18,Friday,5,3,0
1484595661186211855,2022-01-21 18:36:02,"Ghozali, mahasiswa asal Semarang viral dan dapat cuan sekitar Rp 1,5 miliar dari menjual foto selfie NFT. Mau buat apa uangnya? Ini kata Ghozali:  https://t.co/VOuGvu18s9",6,1,0,0,2022-01-21,18,Friday,5,6,1
1484594463213297672,2022-01-21 18:31:17,Sebuah viral di medsos soal nakes di Medan diduga suntikan vaksin Covid-19 kosong ke siswa SD. Nakes tersebut telihat langsung menyuntikan tanpa mengisi alat suntik. https://t.co/Zx58GNgCXN,11,1,4,1,2022-01-21,18,Friday,5,15,2
1484593286513938439,2022-01-21 18:26:36,#FOTO Masih ingat Suster Cecilia di telenovela Carita de Angel? Penampilan terbarunya jauh berbeda dengan perannya di cerita tersebut. Ini potretnya:  https://t.co/AnESbszSqK,11,1,2,0,2022-01-21,18,Friday,5,13,1
1484592040767889411,2022-01-21 18:21:39,Proyek pembangunan tol Jogja-Bawen segera dimulai. Lantas bagaimana nasib kawasan wisata Candi Borobudur?  https://t.co/uTHYjIOw11,5,1,0,1,2022-01-21,18,Friday,5,5,2
1484590564133806087,2022-01-21 18:15:47,"Telkomsel akan mematikan layanan 3G secara bertahap di Indonesia mulai tahun ini. Hal ini dilakukan untuk upgrade layanan ke 4G/LTE, sehingga membuka peluang masyarakat menikmati layanan lebih optimal. https://t.co/TuTnIgRiOH",7,1,4,2,2022-01-21,18,Friday,5,11,3
1484588941684744192,2022-01-21 18:09:20,Arteria Dahlan dari Dapil mana menjadi sorotan publik karena ucapannya yang menyinggung Kajati berbahasa Sunda harus dipecat. Berikut asal dan profilnya. https://t.co/G5fgoDbM15,14,15,1,2,2022-01-21,18,Friday,5,15,17
1484586368575721477,2022-01-21 17:59:07,Aktivitas vulkanik Gunung Merapi masih tinggi. Berikut laporan aktivitas Merapi sepekan terakhir.  https://t.co/mRR1jLfuN5,12,0,2,0,2022-01-21,17,Friday,5,14,0
1484585196905185280,2022-01-21 17:54:27,Menkes Budi Gunadi Sadikin menceritakan kasus Omicron yang membuat jumlah kasus baru COVID-19 melonjak dan membuat orang kaya kesal. Kok bisa?  https://t.co/ZCJYzhWSxi,2,1,0,2,2022-01-21,17,Friday,5,2,3
1484583612867567617,2022-01-21 17:48:10,"Contraflow diterapkan di Tol Jagorawi, tepatnya di ruas Km 5 sampai Km 13. Kemudian ada kemacetan terjadi di Km 8. https://t.co/1YNBIIrdBY",7,3,0,0,2022-01-21,17,Friday,5,7,3
1484581907174207492,2022-01-21 17:41:23,"Seperti halnya pisau, otak juga perlu diasah agar selalu tajam. Otak juga butuh diolahragakan agar lebih berstamina untuk menyambut awal pekan. Yuk dicoba! https://t.co/xx5fIS1MIH",17,18,2,3,2022-01-21,17,Friday,5,19,21
1484580479542116354,2022-01-21 17:35:43,Kasus COVID-19 di Jatim mulai naik. Seperti yang disampaikan Kadinkes Jatim Dr Erwin Astha Triyono.  https://t.co/EIgOUfAtNd,10,3,2,0,2022-01-21,17,Friday,5,12,3
1484577778087477250,2022-01-21 17:24:59,"Heni, (41) seorang emak-emak di Asahan, Sumut nyaris menjadi korban pembegalan sepeda motor. Heni sempat melawan saat pelaku hendak membegal motornya. https://t.co/OgZuOwWUFK",7,0,1,0,2022-01-21,17,Friday,5,8,0
1484577128767234061,2022-01-21 17:22:24,"Viral di media sosial peristiwa suntik vaksin Covid-19 kosong di SD Wahidin, Medan, Sumatera Utara. Menkes Budi Gunadi Sadikin pun memberikan respons terkait kejadian tersebut. Berikut pernyataannya. https://t.co/m9VS5725Mz",2,2,2,2,2022-01-21,17,Friday,5,4,4
1484575532188676099,2022-01-21 17:16:03,"Seekor anjing diseret oleh dua pria menggunakan sepeda motor di Mamasa, Sulbar. Video yang direkam oleh warga itu pun viral di media sosial. https://t.co/OHcj8ZqYk3",6,2,2,2,2022-01-21,17,Friday,5,8,4
1484574339026587652,2022-01-21 17:11:19,Nahdlatul Ulama menyebut penyebaran paham radikal Negara Islam Indonesia (NII) sudah mengkhawatirkan di Garut. NII disebut menyebar di hampir seluruh kecamatan. https://t.co/Ak3lFFwPFi,16,9,2,4,2022-01-21,17,Friday,5,18,13
1484572869417910275,2022-01-21 17:05:28,Yuk latih otak kamu agar bisa lancar memecahkan masalah. Teka-teki ini bisa membuktikan apakah kamu jenius. https://t.co/YIhpblVxAO,62,57,5,6,2022-01-21,17,Friday,5,67,63
1484572070394712064,2022-01-21 17:02:18,"Gempa bumi magnitudo (M) 6,4 mengguncang Jepang selatan. Tidak ada peringatan tsunami akibat gempa ini. https://t.co/C4mKTWNSxW",21,1,6,0,2022-01-21,17,Friday,5,27,1
1484571180770242561,2022-01-21 16:58:46,Ternyata Ari Wibowo doyan makanan kaki lima. Ini makanan favoritnya: https://t.co/OzM63nvA4l,22,37,7,5,2022-01-21,16,Friday,5,29,42
1484569977529290756,2022-01-21 16:53:59,Isu miring soal Nagita Slavina yang dituding punya video syur berdurasi 61 detik mulai terang. Ada potongan gambar yang disebut berasal dari video aslinya. https://t.co/hFEgMeGVtE,4,1,1,0,2022-01-21,16,Friday,5,5,1
1484568570864492546,2022-01-21 16:48:23,"Tisu magic banyak dijadikan opsi oleh pasangan agar sesi bercinta jadi lebih tahan lama. Tapi, bagaimana cara pakai tisu magic yang benar? Begini caranya: https://t.co/z7yI4tGI12",14,5,3,1,2022-01-21,16,Friday,5,17,6
1484567531239133186,2022-01-21 16:44:16,"Pria tak perlu operasi untuk memperbesar penis, lebih baik lakukan dengan cara alami yang terbukti aman. Ya memang nggak instan sih, tetapi relatif lebih aman. https://t.co/ZqaZy5pJzu",5,1,0,0,2022-01-21,16,Friday,5,5,1
1484566295500705803,2022-01-21 16:39:21,"#Terpopuler Gempi menginjak usia 7 tahun. Momen pergantian usia itu dirayakan oleh orang tuanya, Gading Marten dan Gisel. Ini potretnya:  https://t.co/kztrqUpDXU",14,1,0,0,2022-01-21,16,Friday,5,14,1
1484565097129431041,2022-01-21 16:34:35,Tisu magic sering digunakan oleh pria saat melakukan hubungan seksual. Benda ini biasa digunakan untuk menunda ejakulasi dini. Bagaimana efek sampingnya ya? https://t.co/betc33ocdE,1,5,0,2,2022-01-21,16,Friday,5,1,7
1484564104497012738,2022-01-21 16:30:39,Menjawab teka-teki adalah salah satu cara terbaik untuk menjaga fokus kita agar tetap terkendali. Bisa juga untuk meredakan stres. Biar agak santai dikit. https://t.co/sknILkWbAf,6,6,1,0,2022-01-21,16,Friday,5,7,6
1484562686155317252,2022-01-21 16:25:00,#Terpopuler Tim arkeolog menemukan yang diklaim sebagai sumber kekayaan Nabi Sulaiman sekitar 3.000 tahun yang lalu berupa situs pemisahan bijih tembaga. https://t.co/KKdZzs48Yp,52,1,15,4,2022-01-21,16,Friday,5,67,5
1484561510898843650,2022-01-21 16:20:20,"Wakil Ketua DPR RI, Lodewijk Freidrich Paulus, menduga kepemilikan pelat nomor mobil berlogo polisi yang sempat digunakan anggota Komisi III DPR Arteria Dahlan didapat karena adanya hubungan pribadi antara Arteria dengan kepolisian.  https://t.co/bkQeyBe1WE",18,12,3,3,2022-01-21,16,Friday,5,21,15
1484560362854924289,2022-01-21 16:15:46,"Sebanyak 31 paket sabu-sabu seberat 35,27 gram dan 40 butir pil double L diamankan petugas satuan operasional kepatuhan internal pemasyarakatan saat hendak diselundupkan ke dalam lapas.  https://t.co/sdmPkvdONs",10,0,3,1,2022-01-21,16,Friday,5,13,1
1484559205075984385,2022-01-21 16:11:10,Manga Tokyo Revengers laku di pasaran mencapai 50 juta eksemplar. Komik Jepang itu menjadi terpopuler setelah versi anime tayang tahun lalu. https://t.co/oPeQjFasvd,24,0,6,1,2022-01-21,16,Friday,5,30,1
1484558079077326849,2022-01-21 16:06:42,Sempat heboh seorang dokter berhasil mencangkokkan jantung babi ke manusia di Amerika Serikat. Ini kata Ustaz:   https://t.co/vKlj1avxmh,11,3,6,1,2022-01-21,16,Friday,5,17,4
1484556917213220866,2022-01-21 16:02:05,"Seperti halnya pisau, otak juga perlu diasah agar selalu tajam. Otak juga butuh diolahragakan agar lebih berstamina untuk menyambut awal pekan. Yuk dicoba! https://t.co/5LdfoEvjGv",26,21,7,0,2022-01-21,16,Friday,5,33,21
1484555858075959301,2022-01-21 15:57:52,Baim Wong dan Giovanni Tobing membuka rumah makan gratis bernama Silahkan Makan Gratis yang diperuntukkan orang-orang yang membutuhkan. https://t.co/DIxcyfQJHF,69,5,3,0,2022-01-21,15,Friday,5,72,5
1484555457989693443,2022-01-21 15:56:17,"Mikel Arteta punya rekor buruk, yaitu timnya hobi banget dapat kartu merah total sudah 14 kali! https://t.co/0vISSvWyE2",3,0,1,0,2022-01-21,15,Friday,5,4,0
1484554080034996229,2022-01-21 15:50:49,Di media sosial ramai soal video viral belatung. Netizen syok dengan video yang tampak menunjukkan vagina berisi belatung hidup.  https://t.co/JCcreHywhI,13,1,1,2,2022-01-21,15,Friday,5,14,3
1484553548645949444,2022-01-21 15:48:42,Tebak-tebakan ini belum tentu bisa dijawab oleh orang cerdas sekalipun. Coba pecahkan teka-teki receh ini sambil melatih otak. https://t.co/pLHaukj1x4,185,199,20,3,2022-01-21,15,Friday,5,205,202
1484552527588864002,2022-01-21 15:44:38,"Ketika para pria ini mengalami kondisi medis yang memengaruhi organ intimnya, tim dokter berusaha membantu dengan membuatkan penis bionik. Ini kisah mereka: https://t.co/ym9liPY7yI",5,0,3,0,2022-01-21,15,Friday,5,8,0
1484551864330948613,2022-01-21 15:42:00,"Studi di AS menyebut vaksin COVID-19 tak memengaruhi peluang hamil. Namun, pria yang sempat terkena COVID-19 memang bisa mengalami penurunan kesuburan. https://t.co/VAXdGr9Fnw",13,0,1,1,2022-01-21,15,Friday,5,14,1
1484549472701100040,2022-01-21 15:32:30,"Pangeran William dan Kate Middleton melakukan kunjungan ke Church on the Street, sebuah organisasi yang membantu tunawisma dan orang miskin. Duke of Cambridge itu menghabiskan waktu menghibur seorang anak laki-laki yang ibunya meninggal. https://t.co/3GJ8zIK1Jf",18,1,2,0,2022-01-21,15,Friday,5,20,1
1484548743303208960,2022-01-21 15:29:36,"Fabio Quartararo, juara bertahan MotoGP membagikan momen persiapannya jelang MotoGP 2022. https://t.co/SmRZq004Xc",12,0,2,0,2022-01-21,15,Friday,5,14,0
1484548017789222916,2022-01-21 15:26:43,Opera merilis browser khusus untuk kripto dan blockchain. Browser ini menyediakan dompet kripto sampai cara mudah untuk membeli aset kripto. https://t.co/EMvj4LfuxF,7,0,2,0,2022-01-21,15,Friday,5,9,0
1484547351498870789,2022-01-21 15:24:04,#Terpopuler Oki Setiana Dewi angkat bicara soal kabar Ria Ricis yang disebut sedang hamil. Ini kata Oki Setiana Dewi:  https://t.co/bzAzKoPCJ2,6,2,0,0,2022-01-21,15,Friday,5,6,2
1484546758097129482,2022-01-21 15:21:43,Mengonsumsi buah nanas kerap dipercaya dapat membuat cairan sperma atau air mani jadi terasa manis. Benarkah hal tersebut? Ini penjelasan dokter. https://t.co/f5ryIAWYZb,6,4,0,4,2022-01-21,15,Friday,5,6,8
1484545642995322890,2022-01-21 15:17:17,Gejala depresi pada orang dewasa bisa dilihat dari kehidupan sosialnya. Bagaimana dengan gejala depresi pada remaja? https://t.co/wXgpks0WQ9,23,0,2,1,2022-01-21,15,Friday,5,25,1
1484545274173345797,2022-01-21 15:15:49,Rafael Nadal melangkah ke babak 16 besar Australian Open 2022. https://t.co/nljlP89Ojd,9,0,0,0,2022-01-21,15,Friday,5,9,0
1484544719648608260,2022-01-21 15:13:37,Diet golongan darah dipercaya sebagai metode yang efektif menurunkan berat badan. Gimana ya cara diet berdasarkan golongan darah kamu? https://t.co/S3absDODpf,11,0,0,0,2022-01-21,15,Friday,5,11,0
1484544385857507333,2022-01-21 15:12:17,"#Terpopuler Warga Depok cari lokasi vaksin booster COVID-19? Cek di sini untuk jadwal, lokasi, dan cara daftar vaksin Booster COVID-19 di Depok dan sekitarnya. https://t.co/oTEAyRfoUM",2,0,0,0,2022-01-21,15,Friday,5,2,0
1484543417245917192,2022-01-21 15:08:26,"Carlo Ancelotti masih geram, padahal Real Madrid sedang oke sejauh ini dan baru saja menang Piala Super Spanyol! https://t.co/lsGTiIpq4I",4,0,0,0,2022-01-21,15,Friday,5,4,0
1484543070733582336,2022-01-21 15:07:04,"Javier ""Chicharito"" Hernandez kini menjalin asmara dengan seorang perempuan, Nicole, yang membuatnya bisa berbinar lagi usai masa-masa kelabu. https://t.co/Ze95dniL7p",11,0,2,1,2022-01-21,15,Friday,5,13,1
1484542439293652992,2022-01-21 15:04:33,"Tidak terima truk jadi korban pelemparan batu, kru truk pengangkut pasir di Klaten menggelar sayembara. Siapa yang bisa menunjukkan pelaku akan diberi hadiah.  https://t.co/2vgF64qzmX",13,1,4,0,2022-01-21,15,Friday,5,17,1
1484542093150277632,2022-01-21 15:03:11,"Hakim Pengadilan Negeri Surabaya terjaring OTT KPK. Sebelumnya, dia sempat ikut deklarasi anti korupsi!  https://t.co/WDArTPWPa9",17,0,6,8,2022-01-21,15,Friday,5,23,8
1484541428382453761,2022-01-21 15:00:32,Jisoo BLACKPINK dan Jung Hae In diminta untuk berdansa di salah satu adegan Snowdrop. Keduanya pun berbagi pengalaman saat adegan tersebut diambil. https://t.co/ht0RNxp59k,31,0,7,1,2022-01-21,15,Friday,5,38,1
1484541114061402119,2022-01-21 14:59:17,"Kasus Omicron di RI terus mengalami peningkatan. Adapun gejala yang umum dirasakan mulai dari batuk, pilek, dan demam. Total para ahli menemukan 14 gejalanya. https://t.co/mUxkEXH959",11,4,3,0,2022-01-21,14,Friday,5,14,4
1484540173622915072,2022-01-21 14:55:33,EA Sports mengumumkan FIFA 22 Ultimate Team of the Year hasil pilihan fans. Cristiano Ronaldo dan Mohamed Salah absen. https://t.co/GkTKiwngwb,6,0,0,0,2022-01-21,14,Friday,5,6,0
1484539860111269906,2022-01-21 14:54:18,"Endrick, pesepakbola 15 tahun yang sudah dilirik klub top macam MU, Barca, dan Real Madrid, bikin gol cantik dengan cara salto. Seperti apa golnya? https://t.co/a2btCOXJcH",5,2,0,0,2022-01-21,14,Friday,5,5,2
1484539605605040133,2022-01-21 14:53:18,Nadzira Shafa terus ingat kenangan manis bersama Ameer Azzikra. Dia mengungkap kisah pernah hamil anak Ameer. https://t.co/6mKrcqakGG,2,0,0,0,2022-01-21,14,Friday,5,2,0
1484538604240130052,2022-01-21 14:49:19,"Tencent telah mengungkapkan jadwal Grand Final PMGC 2021. Turnamen PUBG Mobile tingkat dunia ini, digelar mulai hari ini, Jumat, 21 - 23 Januari 2022. https://t.co/oWHp0wie5u",5,0,1,1,2022-01-21,14,Friday,5,6,1
1484538256851181568,2022-01-21 14:47:56,"Seorang pelaku teror alat kelamin di Sumenep ditangkap polisi. Dalam aksinya, Pelaku selalu mencari pelajar perempuan sebagai target korbannya.  https://t.co/5JqVP4T1ao",10,0,1,2,2022-01-21,14,Friday,5,11,2
1484538053582594048,2022-01-21 14:47:08,Salju turun di atas hamparan pasir Gurun Sahara. Es menyelimuti bukit pasir yang tandus merupakan fenomena langka di gurun terbesar di dunia tersebut. https://t.co/mMre8Dnb9k,52,12,14,3,2022-01-21,14,Friday,5,66,15
1484538022314090508,2022-01-21 14:47:00,"KPK menerima adanya informasi dari masyarakat soal adanya dugaan reklamasi tanpa izin di Danau Singkarak, Sumatera Barat.  https://t.co/yxQMYaFSvJ",12,5,4,0,2022-01-21,14,Friday,5,16,5
1484537451305738240,2022-01-21 14:44:44,"Kalah 0-18, Pelatih Rudy Eka Priyambada mengakui Timnas Putri Indonesia kalah kualitas dari lawan. https://t.co/76U6yMxybZ",20,26,4,1,2022-01-21,14,Friday,5,24,27
1484537190843568130,2022-01-21 14:43:42,"Perajin kayu asal Kampung Mekarsari, Baleendah yakni Abah Karun menjelaskan bahwa saat ini permintaan perahu kayu menurun. Saat musim banjir, orderan mencapai puluhan per bulannya. https://t.co/tEZZiu17k4",4,0,1,0,2022-01-21,14,Friday,5,5,0
1484536877835296774,2022-01-21 14:42:27,"Sampah kulit kabel kembali ditemukan di gorong-gorong Jakarta. Kali ini, kulit kabel ditemukan di Kemayoran, Jakpus.  https://t.co/6Sd2HY6rZ7",10,3,4,1,2022-01-21,14,Friday,5,14,4
1484535945152106496,2022-01-21 14:38:45,"Sebanyak 3,2 juta unit set top box gratis TV digital akan disalurkan ke rumah tangga miskin. STB ini membantu masyarakat mendapatkan siaran TV digital ketika TV analog dimatikan. https://t.co/yBb652EA1X",32,14,9,3,2022-01-21,14,Friday,5,41,17
1484535295781527560,2022-01-21 14:36:10,Warga di Magetan yang pernah COVID-19 mendapatkan akta kematian padahal masih hidup. Kiriman itu membuat keluarga dan tetangganya kaget! https://t.co/Vby8sr3vJJ,75,19,30,23,2022-01-21,14,Friday,5,105,42
1484535294544302086,2022-01-21 14:36:10,Hujan deras mengguyur lereng Gunung Argopuro Kabupaten Probolinggo pada Kamis (20/1) pukul 15.00 WIB hingga 20.00 WIB. Debit air Sungai Pekalen naik.  https://t.co/FtEKeK6xH2,9,0,0,0,2022-01-21,14,Friday,5,9,0
1484534231296614400,2022-01-21 14:31:56,"Seorang anak di Sukabumi meninggal seminggu setelah divaksinasi COVID-19, Pemkab dan Komda KIPI Sukabumi memberikan penjelasan. https://t.co/QBuVtQAHu0",15,0,11,1,2022-01-21,14,Friday,5,26,1
1484534100325277698,2022-01-21 14:31:25,Sebuah video yang menunjukkan anak SD di Medan disuntik vaksin kosong viral. Dokter G yang menyuntikkan vaksin kosong itu pun meminta maaf.   https://t.co/kA4Yn92vbT,48,40,15,14,2022-01-21,14,Friday,5,63,54
1484533931051528193,2022-01-21 14:30:45,"detikINET segera meluncurkan program 'Eureka!'. Temanya soal 'Indonesia Berburu Exoplanet, Alien dan UFO'. Yuk kirim pertanyaan di sini:  https://t.co/7tgJm7Hz4K",5,0,1,0,2022-01-21,14,Friday,5,6,0
1484533921614385162,2022-01-21 14:30:42,Banjir kembali menerjang sejumlah wilayah di Kabupaten Jember. 5 Rumah dilaporkan ambruk dan terbawa arus.  https://t.co/NwEi82L53d,5,0,1,1,2022-01-21,14,Friday,5,6,1
1484532753236467715,2022-01-21 14:26:04,"Ardhito Pramono ditangkap polisi karena narkoba. Selama 9 hari ditahan, ia telah membuat 3 buah lagu. https://t.co/fPuCMjmGbs",197,54,18,29,2022-01-21,14,Friday,5,215,83
1484532737822310410,2022-01-21 14:26:00,"Buat yang suka selfie atau streaming drakor, hati-hati bisa terkena text neck alias nyeri leher. Penasaran apa penyebabnya? Simak penjelasannya di sini: https://t.co/AcsFJU5mCn",11,0,2,2,2022-01-21,14,Friday,5,13,2
1484531731193647106,2022-01-21 14:22:00,"Patah hati terhadap Indonesia? ""Iya, it broke my heart,"" kata Nadine Kaiser, sang pengawal Susi Air, putri Susi Pudjiastuti. Simak kisahnya di sini:   https://t.co/im4uf2REsi",27,1,3,1,2022-01-21,14,Friday,5,30,2
1484529856637513729,2022-01-21 14:14:33,"Endrick, pesepakbola 15 tahun yang sudah dilirik klub top macam MU, Barca, dan Real Madrid, bikin gol cantik dengan cara salto. Seperti apa aksinya? https://t.co/fSt4jvyNQY",13,1,1,1,2022-01-21,14,Friday,5,14,2
1484528736552816643,2022-01-21 14:10:06,Situasi terkini di lokasi kecelakaan maut di Balikpapan terpantau lengang. Arus kendaraan terpantau lancar. https://t.co/LkXpjMWhWz,24,0,3,0,2022-01-21,14,Friday,5,27,0
1484526612980846592,2022-01-21 14:01:40,"DKI kembali mencatatkan penambahan kasus varian Omicron. Pada Jumat (21/1/2022), jumlah kasus secara kumulatif mencapai 1.177 dan masih didominasi kasus impor. https://t.co/EySWHq4fFe",7,1,0,0,2022-01-21,14,Friday,5,7,1
1484526359959552000,2022-01-21 14:00:40,"Mertuaku mengatur ini-itu sejak awal persiapan nikah, keluargaku yang diam saja ternyata digunakan untuk terus-menerus ditekan agar ia mendapat keinginannya. #detikNetwork  https://t.co/J669whZdrx",12,2,2,0,2022-01-21,14,Friday,5,14,2
1484525493386944520,2022-01-21 13:57:13,"Seorang pria yang hendak melakukan rehabilitasi narkoba di sebuah yayasan di Kecamatan Sei Bingai, Langkat, Sumatera Utara (Sumut) tewas dianiaya. https://t.co/rqHg3XfAEq",7,2,1,5,2022-01-21,13,Friday,5,8,7
1484524670737080322,2022-01-21 13:53:57,Beberapa makanan enak dan halal ini sempat ramai di media sosial karena disebut tak islami. Bahkan ada yang disamakan dengan bentuk illuminati.  https://t.co/j9q8Rut6uu,22,5,8,3,2022-01-21,13,Friday,5,30,8
1484523467840102406,2022-01-21 13:49:10,Gubernur DKI Jakarta Anies Baswedan tanggapi masalah pembangunan sirkuit yang belum mulai oleh Ketua Umum PSI Giring Ganesha sempat mendatangi venue Formula E di Ancol. Anies merasa kasihan karena waktu Giring terlalu longgar. https://t.co/lg81MhvsFC,39,22,9,3,2022-01-21,13,Friday,5,48,25
1484522341531017219,2022-01-21 13:44:41,"Polemik ucapan anggota komisi III DPR RI Fraksi PDIP Arteria Dahlan terkait ‘Kajati Bicara Sunda’ semakin berlarut. Kini, Arteria dilaporkan ke Polda Jawa Barat. Permintaan maaf pun terlontar di mulut Arteria. https://t.co/ASk5QiZGe4",13,3,3,1,2022-01-21,13,Friday,5,16,4
1484520927731896326,2022-01-21 13:39:04,"AEON Mall Sentul City, Bogor, Jawa Barat, alami kebakaran pada sore tadi (21/1). Diduga api muncul akibat korsleting listrik. https://t.co/pf7VnOJABT",9,0,6,2,2022-01-21,13,Friday,5,15,2
1484520910275190788,2022-01-21 13:39:00,"Gempa magnitudo (M) 4,4 terjadi Mandailing Natal, Sumatera Utara (Sumut). Pusat gempa berada di darat. https://t.co/4mCBA8xJpM",17,0,4,0,2022-01-21,13,Friday,5,21,0
1484520284136906755,2022-01-21 13:36:31,"Warga Desa Langensari, Kecamatan Lembang, Kabupaten Bandung Barat (KBB) dikagetkan dengan penemuan sebuah benda diduga mortir. https://t.co/aZYjVJWRWV",10,0,1,1,2022-01-21,13,Friday,5,11,1
1484519739397394434,2022-01-21 13:34:21,"Jumat (21/1) sore, kebakaran terjadi di AEON Mall Sentul City, Bogor, Jawa Barat. Tiga unit mobil pemadam kebakaran dengan belasan personel sudah diterjunkan ke lokasi. Seperti apa suasananya kini? https://t.co/Tkse9nWkXA",16,0,3,2,2022-01-21,13,Friday,5,19,2
1484518855028494336,2022-01-21 13:30:50,"Indonesia mencatat sebanyak 2.604 kasus baru COVID-19, Jumat (21/1/2022). DKI menyumbang kasus terbanyak dengan jumlah 1.484. https://t.co/fQYMoFOz1A",11,2,1,0,2022-01-21,13,Friday,5,12,2
1484518659410345991,2022-01-21 13:30:04,"Dua hari berturut-turut, penambahan kasus COVID-19 RI tembus angka dua ribu. Dengan tambahan 2.604 kasus pada Jumat (21/1/2021), total positif jadi 4.280.248. https://t.co/9PriAu7C2E",3,2,1,5,2022-01-21,13,Friday,5,4,7
1484517724860690447,2022-01-21 13:26:21,Arsenal kehilangan kesempatan tampil di final lagi bersama Mikel Arteta. Namun momen kegagalan seperti ini sangat berpotensi terjadi di skuad semuda Arsenal. https://t.co/XVpVo7feTZ,2,0,0,0,2022-01-21,13,Friday,5,2,0
1484517134101368849,2022-01-21 13:24:00,"Akhir pekan ini ada ajang UFC 270. Dua sabuk juara dipertaruhkan, Francis Ngannou vs Ciryl Gane dan Brandon Moreno vs Deiveson Figueiredo. https://t.co/4NK1DFbkqo",6,1,1,0,2022-01-21,13,Friday,5,7,1
1484516828860731399,2022-01-21 13:22:47,"Kapten Tottenham, Hugo Lloris, resmi meneken perpanjang kontrak berdurasi dua tahun. https://t.co/ZfsKTn1xT0",15,1,3,0,2022-01-21,13,Friday,5,18,1
1484516432415236100,2022-01-21 13:21:13,Piala Afrika 2021 telah menuntaskan perjalanan fase grup. Berikut negara-negara yang lolos ke babak 16 besar Piala Afrika 2021. https://t.co/Q5wBYWwdA9,13,1,1,0,2022-01-21,13,Friday,5,14,1
1484515364159557634,2022-01-21 13:16:58,Kini segera hadir destinasi wisata berkonsep edukasi wisata (eduwisata) bertema kedirgantaraan. https://t.co/pPJrkC186f,26,0,4,2,2022-01-21,13,Friday,5,30,2
1484514044207845380,2022-01-21 13:11:43,Masyarakat Sunda di Kabupaten Cianjur mengancam akan menyerukan boikot PDI Perjuangan dalam momentum pemilu jika Arteria Dahlan tidak dipecat. https://t.co/0fh0XFKcey,279,59,69,13,2022-01-21,13,Friday,5,348,72
1484513150674341890,2022-01-21 13:08:10,"Desa Ketapang, Kecamatan Mauk, Tangerang ini menjadi lokasi kawasan pesisir yang awalnya kumuh dan berubah menjadi kawasan wisata percontohan internasional. https://t.co/whIciy9MLE",26,0,4,1,2022-01-21,13,Friday,5,30,1
1484512212957937664,2022-01-21 13:04:27,"Ketua Eksekutif Forum Ekonomi Dunia (World Economic Forum) Klaus Schwab menyebut Indonesia masih sangat bergantung terhadap energi batu bara. Lantas, bagaimana Presiden Joko Widodo meresponsnya? https://t.co/3KRqhnsu13",14,0,3,3,2022-01-21,13,Friday,5,17,3
1484511296557133833,2022-01-21 13:00:48,"Dibeli Barcelona seharga Rp 2,2 triliun, Ousmane Dembele nyatanya tidak memenuhi ekspektasi. https://t.co/Di84nLH5hE",13,3,2,1,2022-01-21,13,Friday,5,15,4
1484510636818288641,2022-01-21 12:58:11,"Klub basket milik selebritas Raffi Ahmad, RANS PIK Basketball, meraih kemenangan pertamanya di seri I Jakarta Indonesia Basketball League (IBL) 2022. https://t.co/ugeNqGEz2O",12,1,8,0,2022-01-21,12,Friday,5,20,1
1484510288720560129,2022-01-21 12:56:48,"Berniat menunjukkan aksinya memasak mie goreng, netizen ini merekam proses memasak layaknya sebuah vlog. Namun apes, masakannya justru ketumpahan kecap sebotol!  https://t.co/ikLrd5T8S0",17,0,3,2,2022-01-21,12,Friday,5,20,2
1484509959677227009,2022-01-21 12:55:29,"Banyak makanan enak membuat orang penasaran, namun lokasi tempat makannya 'ngumpet' dan sulit dijangkau. Meski begitu makanan-makanan ini tetap laris manis.  https://t.co/su6DqAAV0G",30,1,11,2,2022-01-21,12,Friday,5,41,3
1484509610119729165,2022-01-21 12:54:06,"Venesia sepertinya telah bulat memutuskan untuk menagih tiket masuk kepada turis, tetapi mengenai detail aturan belum dipaparkan. https://t.co/WjDgDPmECc",11,0,5,1,2022-01-21,12,Friday,5,16,1
1484509188998971394,2022-01-21 12:52:26,"Kenapa banyak orang tega memviralkan jenazah dan kondisi korban kecelakaan maut Balikpapan? Stop sebar-sebar sembarangan, begini penjelasan psikolog: https://t.co/yQyD8gV5uC",40,3,17,3,2022-01-21,12,Friday,5,57,6
1484508610621329414,2022-01-21 12:50:08,"Kentang goreng sedang jadi menu langka di McD Jepang. Mengambil kesempatan ini, gerai ini hadirkan kentang goreng porsi 300% lebih besar dari buatan McD!  https://t.co/GnOIlyznn1",24,0,6,2,2022-01-21,12,Friday,5,30,2
1484508064682332160,2022-01-21 12:47:58,"Seorang chef menunjukkan keahlian memasaknya dengan cara yang unik. Meski ia memakai penutup mata, chef ini berhasil membuktikan bisa memasak mie goreng enak.  https://t.co/lxWKfsXmF6",17,3,3,3,2022-01-21,12,Friday,5,20,6
1484507509717344258,2022-01-21 12:45:45,"Pemerintah Kota Solo menyiapkan empat lapangan latihan untuk tim-tim peserta Piala Dunia U-20 2023 dan dibuka untuk umum, berapa harganya? https://t.co/VL4LznGdI0",19,0,5,4,2022-01-21,12,Friday,5,24,4
1484507062377852929,2022-01-21 12:43:59,"Wajah Dadang Firmansyah (41) tampak bahagia ketika menerima kaki palsu di Gedung Moh Toha, Soreang pada Jumat (21/1/2022).  https://t.co/zZwLjjUAPT",23,1,3,0,2022-01-21,12,Friday,5,26,1
1484506543387250692,2022-01-21 12:41:55,"#terpopuler Lukisan NFT (Non-fungible token) karya Gubernur Jabar Ridwan Kamil dibeli crazy rich asal Bangka, Lanang Cikal Narendra!  https://t.co/LwG22wXQ7l",9,1,2,1,2022-01-21,12,Friday,5,11,2
1484505861322072068,2022-01-21 12:39:12,"Putra Ahok dan Veronica Tan, Nicholas Sean Purnama akhirnya bisa bernapas lega. Ayu Thalia ditetapkan jadi tersangka. https://t.co/FCE0NsNQ5K",48,11,6,4,2022-01-21,12,Friday,5,54,15
1484505435575042049,2022-01-21 12:37:31,"Penampilan terbaru pemimpin Korea Utara, Kim Jong Un, yang semakin kurus kembali menarik perhatian. Sebenarnya apa yang terjadi? Begini bocorannya: https://t.co/rwieAyz7EG",10,3,1,1,2022-01-21,12,Friday,5,11,4
1484505414498717698,2022-01-21 12:37:26,"Tetangga ada yang menyenangkan, ada pula yang sebaliknya. Salah satu permasalahan adalah soal parkir mobil, terutama di perkotaan. Bagaimana solusinya? #detiksAdvocate  https://t.co/zWHVOrYOj3",11,0,2,3,2022-01-21,12,Friday,5,13,3
1484504088997994496,2022-01-21 12:32:10,Proyek revitalisasi Taman Mini Indonesia Indah (TMII) telah dimulai. Snowbay Waterpark merupakan wahana yang bakal dialihfungsikan. https://t.co/TqIUyk4AUI,31,9,10,5,2022-01-21,12,Friday,5,41,14
1484503039407013890,2022-01-21 12:27:59,Aksi unjuk rasa dari massa gabungan sejumlah forum masyarakat Subang berakhir ricuh. Diketahui aksi demo tersebut terkait pernyataan Arteria yang mengkritik seorang kepala kejaksaan tinggi yang berbahasa Sunda ketika rapat kerja https://t.co/h02JeyoO0z,21,5,1,0,2022-01-21,12,Friday,5,22,5
1484502190182080514,2022-01-21 12:24:37,"Mengingat kebanyakan orang menggunakan vaksin Sinovac saat dosis pertama dan kedua, banyak yang bertanya apa vaksin booster yang cocok untuk Sinovac. https://t.co/i1YkcpsUol",16,2,5,0,2022-01-21,12,Friday,5,21,2
1484501902809346048,2022-01-21 12:23:28,"KPK menerima adanya informasi dari masyarakat soal adanya dugaan reklamasi tanpa izin di Danau Singkarak, Sumatera Barat. https://t.co/teOo2jFdXv",16,0,4,1,2022-01-21,12,Friday,5,20,1
1484500735459012608,2022-01-21 12:18:50,Tim nasional Putri Indonesia menelan kekalahan 0-18 dari Australia di laga pertama Piala Asia Wanita 2022. https://t.co/62cNGNfF5e,70,38,6,16,2022-01-21,12,Friday,5,76,54
1484499748518301698,2022-01-21 12:14:55,"Jembatan Penyeberangan Orang (JPO) Jl Raya Bekasi, tepatnya di Tipar Cakung, Jakarta Timur sudah rusak. Pagar di JPO tersebut sebagian besar sudah hilang.  https://t.co/0m6qTL6zKE",13,4,3,3,2022-01-21,12,Friday,5,16,7
1484499727831945217,2022-01-21 12:14:50,"Aksi dua orang warga Kabupaten Mamasa, Sulawesi Barat, menuai kecaman lantaran tega menyeret seekor anjing hidup menggunakan sepeda motor. https://t.co/DodMsa0iMV",9,3,2,2,2022-01-21,12,Friday,5,11,5
1484499001412141061,2022-01-21 12:11:57,Witan Sulaeman benar-benar gabung dengan FK Senica dan resmi diumumkan jadi pemain baru FK Senica. https://t.co/NnqWuN9uGl,22,1,2,0,2022-01-21,12,Friday,5,24,1
1484497657997533191,2022-01-21 12:06:36,"Seperti sudah santer dispekulasikan, Witan Sulaeman benar-benar gabung dengan FK Senica. Witan sudah resmi diumumkan jadi pemain baru FK Senica. https://t.co/n24IG0BvoD",24,1,2,0,2022-01-21,12,Friday,5,26,1
1484497656105914369,2022-01-21 12:06:36,"Puluhan kilogram kulit kabel yang ditemukan di gorong-gorong Jalan Bungur Raya, Kemayoran, Jakarta Pusat, diduga menjadi salah satu penyebab banjir. https://t.co/3VPFziYAGy",51,19,13,2,2022-01-21,12,Friday,5,64,21
1484497654457507841,2022-01-21 12:06:36,Pedagang angkringan di Jakbar Muhammad Aslam kini mengajukan banding menyoal penunjukan Luhut sebagai Koordinator PPKM oleh Jokowi. https://t.co/J1sYdBykre,13,0,2,0,2022-01-21,12,Friday,5,15,0
1484497082677354496,2022-01-21 12:04:19,Ada yang baru nih dari @detikinet! Program ini bakalan bikin kamu kepoooo banget. Penasaran? Cek di sini ya! https://t.co/56l1R61xjy https://t.co/9Pf7uIPcWx,10,0,1,0,2022-01-21,12,Friday,5,11,0
1484496396736675842,2022-01-21 12:01:36,"""Ditangkapnya beberapa oknum di Kementerian Keuangan atau di DJKN, yang memalsukan surat-surat aset tanah (jaminan BLBI). Kalau tidak salah ada 10 sampai 11 orang ditahan Bareskrim Polri,"" kata Mahfud. #CNNIndonesia #detikNetwork  https://t.co/jrZ6rLV4QD",17,0,4,1,2022-01-21,12,Friday,5,21,1
1484495664579022850,2022-01-21 11:58:41,"Wakil Ketua KPK Nawawi Pomolango megungkap, kata ‘upeti’ digunakan Hakim Itong, Hamdan, dan pengacara PT SGP Hendro Kasiono sebagai kode suap. https://t.co/OKMl3SSkLg",7,2,2,0,2022-01-21,11,Friday,5,9,2
1484495038591774720,2022-01-21 11:56:12,"Para bintang TikTok semakin kaya raya, bahkan pendapatan sebagian dari mereka disebut menyamai bahkan melebihi penghasilan CEO di perusahaan top. https://t.co/JmTKgn0JTB",23,0,4,4,2022-01-21,11,Friday,5,27,4
1484494433404043264,2022-01-21 11:53:48,SM Entertainment merilis versi remastered dari MV SNSD Into the New World pada Jumat (21/1/2022). SONE bisa menikmati pesona debut SNSD dalam resolusi 4K! https://t.co/zQMHIWSRiV,15,1,5,4,2022-01-21,11,Friday,5,20,5
1484493636620406784,2022-01-21 11:50:38,"Sebuah studi baru merilis hasil studi komparatif, yang menunjukkan klaim vaksin COVID-19 ini lebih kuat ketimbang Pfizer dalam melawan Omicron. https://t.co/eG6FPOoXNb",6,0,1,0,2022-01-21,11,Friday,5,7,0
1484492938654937093,2022-01-21 11:47:51,"Ada 5 tips yang dapat diterapkan agar waktu 24 jam bisa dimanfaatkan dengan maksimal. Pelajar dan mahasiswa bisa terapkan ini. Bisa segera dicoba ya!

via: detikedu https://t.co/Rt1UkxJJso",13,0,2,0,2022-01-21,11,Friday,5,15,0
1484490761559322624,2022-01-21 11:39:12,Kecaman kepada Arteria Dahlan datang dari Cianjur dan Sukabumi sebagai buntut dari ucapan kontroversial Anggota DPR RI tersebut soal 'Kajari Bicara Sunda' https://t.co/WPepn9KrXN,28,0,6,0,2022-01-21,11,Friday,5,34,0
1484490483879620608,2022-01-21 11:38:06,"Sopir truk tronton Balikpapan menabrak sejumlah pengendara di Muara Rapak, Kota Balikpapan, Kalimantan Timur. Ini fakta terbarunya. https://t.co/xDhPwZMysK",14,0,1,1,2022-01-21,11,Friday,5,15,1
1484489923734523911,2022-01-21 11:35:52,"Nabilah alias Dila (50), istri yang dibakar suaminya, Ahmad Riyanto alias Ririn (35), di Musi Rawas, Sumatera Selatan. Sempat dirawat, Dila akhirnya meninggal. https://t.co/6O3yILgQov",9,0,2,0,2022-01-21,11,Friday,5,11,0
1484489732415721475,2022-01-21 11:35:07,"Lihatlah Fitriani, Ia begitu tegar dan semangat menjalani hidupnya. Meski lahir tidak sempurna, Fitri sering membantu orangtua dan tak malas bersekolah.

#sahabatbaik bisa membantu Fitriani memiliki kaki palsu dengan donasi di @berbuatbaik_id atau klik https://t.co/RCYTQJZc07. https://t.co/WRnsaeySZb",23,2,5,2,2022-01-21,11,Friday,5,28,4
1484488697475178497,2022-01-21 11:31:00,"Jumlah kasus COVID-19 di Indonesia bertambah 2.604, Jumat (21/1/2022). Total kasus positif menjadi 4.280.248, sembuh 4.121.928, dan meninggal 144.201. https://t.co/msdUJPPLTA",10,1,3,1,2022-01-21,11,Friday,5,13,2
1484488391760752641,2022-01-21 11:29:47,Pemerintah China geram dan mengutuk parlemen Prancis karena mengeluarkan resolusi yang menuduh Beijing melakukan genosida terhadap penduduk Muslim Uighurnya.  https://t.co/e8u6sea6yH,10,2,1,0,2022-01-21,11,Friday,5,11,2
1484486809547685894,2022-01-21 11:23:30,"Peneliti menganalisis nocebo, efek samping vaksin COVID-19 yang muncul akibat pikiran. Kok bisa sih? Siapa saja yang mengalaminya? Simak penjelasannya: https://t.co/55LxIvvmVG",6,0,1,0,2022-01-21,11,Friday,5,7,0
1484486787196243972,2022-01-21 11:23:25,"Kebakaran terjadi di AEON Mall Sentul City, Bogor, Jawa Barat (Jabar). Tidak ada korban dalam peristiwa tersebut. https://t.co/ZF6tcFqcG2",13,0,3,3,2022-01-21,11,Friday,5,16,3
1484486027658080260,2022-01-21 11:20:24,Taman Mini Indonesia Indah sempat viral di medsos karena kondisi bangunannya yang terlihat terbengkalai. 20Detik pun memantau kondisi beberapa bangunan yang memang terlihat tak terurus.  https://t.co/IvguCa7b3D,7,1,0,1,2022-01-21,11,Friday,5,7,2
1484484683794632705,2022-01-21 11:15:03,"Mutia Ayu istri menunjukkan potret terbaru dirinya melalui media sosial pribadinya nih, Bunda. Istri mendiang Glenn Fredly itu tampil makin langsing, lho. #detikNetwork  https://t.co/fLTLvD0LGS",11,0,1,0,2022-01-21,11,Friday,5,12,0
1484484668435144710,2022-01-21 11:15:00,"#Foto Epic! Proyek renovasi gedung Sarinah terus dikebut. Usai diperbaiki, tempat belanja itu akan kembali dibuka pada Maret 2022. Ini penampakannya. https://t.co/5ujuLRFgA3",14,2,7,0,2022-01-21,11,Friday,5,21,2
1484483490246795268,2022-01-21 11:10:19,"Api melahap Mall Aeon Sentul City, Bogor, tadi sore sekitar pukul 15.30 WIB. Namun begitu, api kini sudah berhasil dikenadalikan. https://t.co/XX6jEf2K7H",9,2,2,0,2022-01-21,11,Friday,5,11,2
1484483165272129536,2022-01-21 11:09:01,"Jumat (21/1), kebakaran terjadi di AEON Mall Sentul City, Bogor. Tiga unit mobil pemadam kebakaran dengan belasan personel diterjunkan. Seperti apa suasananya? https://t.co/uZCmWizWLY",16,0,5,1,2022-01-21,11,Friday,5,21,1
1484482674391724035,2022-01-21 11:07:04,Jung Hae In dan Jisoo BLACKPINK buka-bukaan soal keseruan syuting Snowdrop. Keduanya menunjukkan chemistry luar biasa melalui drama tersebut. https://t.co/1rS57xKGCF,16,0,0,0,2022-01-21,11,Friday,5,16,0
1484481880972050433,2022-01-21 11:03:55,"Viral suntik vaksin Covid-19 kosong di SD Wahidin, Medan, Sumatera Utara. Menkes Budi Gunadi Sadikin pun memberikan respons terkait kejadian tersebut. https://t.co/trKRNiK6PI",8,3,2,2,2022-01-21,11,Friday,5,10,5
1484481855516725248,2022-01-21 11:03:49,"Mencicipi buah sebelum membeli sudah menjadi kebiasaan di tengah masyarakat. Namun, apakah kebiasaan ini sejalan dengan ajaran agama Islam?  https://t.co/cIleGAxiRt",12,4,1,0,2022-01-21,11,Friday,5,13,4
1484480760736329732,2022-01-21 10:59:28,Harry Kane menyebut Antonio Conte sebagai salah satu manajer terbaik di dunia dan tidak menyia-nyiakan kesempatan dilatih Conte. https://t.co/9RiLs2VcnI,10,0,2,1,2022-01-21,10,Friday,5,12,1
1484480509010976770,2022-01-21 10:58:28,"Di tengah lonjakan kasus Omicron di berbagai negara, Spanyol dan Jepang malah mengklasifikasikan COVID-19 seperti endemik atau flu musiman. https://t.co/xHSxf3rbst",32,6,3,4,2022-01-21,10,Friday,5,35,10
1484479944331833344,2022-01-21 10:56:13,"Seiring menurunnya kasus COVID-19 &amp; pariwisata kembali dibuka, keadaan Kampung Batik Laweyan mulai berangsur membaik. https://t.co/5b3QWLFucI",9,0,1,0,2022-01-21,10,Friday,5,10,0
1484479411298656259,2022-01-21 10:54:06,Keluarga dari seorang penyanyi di Ceko mengatakan jika sebelum meninggal ia memilih untuk ketularan ketimbang divaksinasi.  https://t.co/UWcmMvT8fn,29,12,8,1,2022-01-21,10,Friday,5,37,13
1484478638775021568,2022-01-21 10:51:02,Klub Rusia CSKA Moskow bikin blunder saat memperkenalkan pemain barunya. https://t.co/KH4sgVgaQE,4,1,1,0,2022-01-21,10,Friday,5,5,1
1484478109441306624,2022-01-21 10:48:56,Hugo Lloris resmi bertahan lebih lama di Tottenham Hotspur. Kapten Spurs itu meneken perpanjang kontrak berdurasi dua tahun. https://t.co/IAsrm27lGx,5,2,0,0,2022-01-21,10,Friday,5,5,2
1484477883808722948,2022-01-21 10:48:02,"Makan nasi goreng di sebuah warung, wanita ini menghirup aroma tak sedap. Ternyata aroma itu berasal dari wadah sambal yang dipenuhi jamur.  https://t.co/abjfbW80rT",10,2,2,3,2022-01-21,10,Friday,5,12,5
1484476786549436416,2022-01-21 10:43:40,Kepolisian Israel dituduh menggunakan spyware kontroversial Pegasus untuk memata-matai warga. Jaksa Agung Israel pun memerintahkan penyelidikan menyeluruh.  https://t.co/tnfyyJRK4T,4,0,1,0,2022-01-21,10,Friday,5,5,0
1484476371049107458,2022-01-21 10:42:01,Seorang wanita di Taiwan terancam hukuman mati atas dakwaan sengaja memicu kebakaran paling mematikan dalam beberapa tahun terakhir di negara tersebut. https://t.co/yEORc1Na1e,1,0,0,0,2022-01-21,10,Friday,5,1,0
1484475358435024896,2022-01-21 10:38:00,"Tiga pria di Aceh ditangkap petugas Bea Cukai karena diduga menyelundupkan 3,3 juta batang rokok ilegal. Rokok senilai Rp 6,6 miliar dipasok lewat jalur laut. https://t.co/MIZfPCqKKr",15,0,4,1,2022-01-21,10,Friday,5,19,1
1484474375684427780,2022-01-21 10:34:06,Mie siput dikenal sebagai salah satu makanan yang memiliki aroma busuk menyengat. Tetapi kini menjadi tren kuliner baru selama masa pandemi di China.  https://t.co/Ep7ScaySbS,11,3,0,1,2022-01-21,10,Friday,5,11,4
1484472749032710148,2022-01-21 10:27:38,"Kebakaran terjadi di AEON Mall Sentul City, Bogor, Jawa Barat (Jabar). Salah satu pengunjung menceritakan detik-detik saat kebakaran terjadi. https://t.co/hRcNgtDL5m",16,0,2,0,2022-01-21,10,Friday,5,18,0
1484472747266822147,2022-01-21 10:27:37,UU IKN mengamanatkan Presiden Jokowi segera menunjuk Kepala Otorita untuk memimpin IKN Nusantara. Siapakah yang akan menjadi Kepala Otorita? https://t.co/LvhXrsxGNQ,13,6,2,1,2022-01-21,10,Friday,5,15,7
1484471836259794945,2022-01-21 10:24:00,"Penghuni bedeng belakang JIS menolak untuk pindah atau membongkar hunian. Padahal, mereka telah didatangi petugas dari PT KAI maupun kelurahan Papanggo.  https://t.co/qySyaiZzAz",14,0,0,0,2022-01-21,10,Friday,5,14,0
1484471549268832257,2022-01-21 10:22:52,"Kenalin, ini Zara Rutherford. Ia menjadi wanita termuda yang terbang sendiri dengan pesawatnya di usia yang baru menginjak 19 tahun. Keren! https://t.co/CTxb53utsz",43,4,9,2,2022-01-21,10,Friday,5,52,6
1484471064981819394,2022-01-21 10:20:56,"Kalah 0-2 dari Liverpool, Mikel Arteta begitu sedih, timnya remuk redam tidak berdaya. https://t.co/pXqfUqYmrV",6,1,1,0,2022-01-21,10,Friday,5,7,1
1484470398439854080,2022-01-21 10:18:17,UU IKN mengamanatkan Presiden Jokowi segera menunjuk Kepala Otorita untuk memimpin IKN Nusantara. Siapakah yang akan menjadi Kepala Otorita? https://t.co/P2U0YBFRQe,27,28,1,0,2022-01-21,10,Friday,5,28,28
1484469895156928515,2022-01-21 10:16:17,"Beredar video kecelakaan maut di Balikpapan, tak sedikit yang menunjukkan jenazah. Ini saran psikolog atasi rasa takut jika terlanjur melihat gambar tersebut. https://t.co/YObVI1ZpKc",5,1,1,1,2022-01-21,10,Friday,5,6,2
1484468508868202498,2022-01-21 10:10:47,Walkot Bekasi nonaktif Rahmat Effendi melakukan zoom meeting dari Rutan KPK dengan simpatisannya. Golkar meminta KPK evaluasi. https://t.co/4lbqQPgVFT,1,2,1,0,2022-01-21,10,Friday,5,2,2
1484466764545245184,2022-01-21 10:03:51,Harry Kane menyebut Antonio Conte sebagai salah satu manajer terbaik di dunia. Dia pun meminta Tottenham untuk tidak menyia-nyiakan kesempatan dilatih Conte. https://t.co/TLUxgMd0vc,3,0,0,0,2022-01-21,10,Friday,5,3,0
1484465751285243912,2022-01-21 09:59:49,Pandemi COVID-19 rupanya bukan hal yang berpengaruh pada penjualan mobil mewah di dunia. https://t.co/j7JN0rRhIO,8,0,1,0,2022-01-21,9,Friday,5,9,0
1484465729521041411,2022-01-21 09:59:44,"Menariknya, beredar tulisan yang menyertai pengumuman 'minyak goreng murah habis' yang ditempel pada rak-rak kosong diberbagai minimarket. Lucu banget... https://t.co/QZCB82oeao",11,0,2,1,2022-01-21,9,Friday,5,13,1
1484464988542615554,2022-01-21 09:56:47,Kemenangan melawan Arsenal yang diraih di masa-masa sulit ini terasa lebih manis buat mereka. https://t.co/1akITHL12Y,0,0,0,0,2022-01-21,9,Friday,5,0,0
1484464399284940805,2022-01-21 09:54:27,37 Pelajar dan Pengasuh Madrasah Aliyah Negeri (MAN) 2 Kota Malang karantina di salah satu gedung sekolah. Itu dilakukan setelah mereka positif COVID-19.  https://t.co/vcpkgeU8NE,6,0,1,0,2022-01-21,9,Friday,5,7,0
1484464056337580035,2022-01-21 09:53:05,"Ada 3 bacaan doa yang dapat dilafalkan bila seorang muslim hendak bepergian keluar rumah. Semoga dengan bacaan ini dapat terhindar dari marabahaya.

via: detikedu https://t.co/5nhnyINH0n",20,1,1,0,2022-01-21,9,Friday,5,21,1
1484463511367561217,2022-01-21 09:50:55,Ketua DPRD Karawang Pendi Anwar mendukung pemecatan anggota DPR RI Arteria Dahlan. Hal itu disampaikan Pendi di hadapan peserta unjuk rasa di DPRD Karawang.  https://t.co/b7krtUTEa6,38,4,3,0,2022-01-21,9,Friday,5,41,4
1484463275379208193,2022-01-21 09:49:59,Warsito (41) membunuh istrinya berinisial SS (29) usai berhubungan intim. Warsito sempat membuat sejumlah muslihat usai membunuh istrinya.  https://t.co/FWtBsivANU,2,1,1,1,2022-01-21,9,Friday,5,3,2
1484462940891889664,2022-01-21 09:48:39,"Proses revitalisasi Kalimalang, Bekasi, yang didesain Gubernur Jawa Barat Ridwan Kamil alias Kang Emil, sudah mulai menunjukkan kemajuan. Warga pun menyampaikan harapan mereka atas wajah baru Kalimalang tersebut. https://t.co/hdZyjIx5r2",9,0,1,0,2022-01-21,9,Friday,5,10,0
1484462398392184834,2022-01-21 09:46:30,Wakil Ketua DPR Lodewijk Paulus mengaku tidak tahu cara Arteria Dahlan dapat pelat dinas polri. Lodewijk menilai hal itu urusan pribadi.  https://t.co/MYTldLvtDL,17,19,1,1,2022-01-21,9,Friday,5,18,20
1484462385947713538,2022-01-21 09:46:27,Sandiaga Uno mendorong lebih banyak mencetak sumber daya manusia (SDM) berkualitas di bidang pariwisata menjelang rencana penggodokan kebijakan travel bubble. https://t.co/m5MNeJdjJM,7,1,1,0,2022-01-21,9,Friday,5,8,1
1484462129608601604,2022-01-21 09:45:26,"Warsoni (41) seorang hair stylist di Pondok Kelapa, Jakarta Timur, ditetapkan sebagai tersangka pembunuhan istrinya sendiri. Begini tampangnya.  https://t.co/CuVhU7tJIz",3,0,1,0,2022-01-21,9,Friday,5,4,0
1484462119261286403,2022-01-21 09:45:23,Pengendara sepeda motor tewas terlindas truk di Jalan Raya Laswi Baleendah pada Jumat (21/1/2022)  https://t.co/lfAb1D5Zma,1,0,2,2,2022-01-21,9,Friday,5,3,2
1484461873810620416,2022-01-21 09:44:25,"MDA (11), murid kelas enam Madrasah Ibtidaiyah asal Kabupaten Sukabumi meninggal usai menjalani vaksinasi. Satgas COVID-19 menyelidiki kasus tersebut.  https://t.co/cc8RBd5snv",400,66,272,41,2022-01-21,9,Friday,5,672,107
1484461608554348544,2022-01-21 09:43:22,"Kebakaran terjadi di AEON Mall Sentul City, Bogor, Jawa Barat (Jabar). Diduga api muncul akibat korsleting listrik.  https://t.co/gm3KIirsWb",3,0,2,3,2022-01-21,9,Friday,5,5,3
1484461370422833152,2022-01-21 09:42:25,Pemkot Malang tetap menerapkan pembelajaran tatap muka (PTM) 100 persen. Meski ada kenaikan kasus positif COVID-19 di MAN 2 Kota Malang.  https://t.co/jyZES1SKdU,7,0,0,0,2022-01-21,9,Friday,5,7,0
1484461087571513344,2022-01-21 09:41:17,Inilah daftar 10 pesepakbola dunia dengan followers Instagram terbanyak. Cristiano Ronaldo masih jadi yang teratas! https://t.co/hd8PdBbA0U,4,1,1,0,2022-01-21,9,Friday,5,5,1
1484460729445068802,2022-01-21 09:39:52,"Korlantas Mabes Polri mengerahkan traffic accident analysis (TAA) untuk mengusut penyebab kecelakaan beruntun di Balikpapan. Informasi awal dari sopir truk, kecelakaan terjadi akibat tak berfungsinya pompa angin rem sehingga menyebabkan rem blong. https://t.co/5TsPvYk9jm",2,0,3,0,2022-01-21,9,Friday,5,5,0
1484460240984854531,2022-01-21 09:37:56,#FOTO Masih ingat Suster Cecilia di telenovela Carita de Angel? Penampilan terbarunya jauh berbeda dengan perannya di cerita tersebut. Ini potretnya:  https://t.co/uRKbBsBjcv,14,0,2,1,2022-01-21,9,Friday,5,16,1
1484459966069100544,2022-01-21 09:36:50,"Kecelakaan maut terjadi di simpang Rapak Balikpapan, Kalimantan Timur (21/1). Sopir truk tronton yang menabrak sejumlah kendaraan telah diamankan. https://t.co/hmGGlCwKxp",7,2,1,0,2022-01-21,9,Friday,5,8,2
1484459508118298629,2022-01-21 09:35:01,"Empat pejabat dan mantan pejabat Ukraina dituduh sebagai ""pion"" dinas rahasia Rusia. Atas hal itu, Kementerian Keuangan AS menjatuhkan sanksi kepada mereka.  https://t.co/gxigDxIa6h",2,1,1,0,2022-01-21,9,Friday,5,3,1
1484459484982427648,2022-01-21 09:34:55,Kebijakan minyak goreng satu harga Rp 14.000/liter diikuti aksi panic buying alias membeli secara berlebihan. Jangan ditiru! https://t.co/MzJfQsDeLn,5,0,1,0,2022-01-21,9,Friday,5,6,0
1484458999718232070,2022-01-21 09:33:00,Pernikahan Pamela Anderson kembali berujung perceraian. Mantan bintang 'Baywatch' itu dikabarkan menggugat cerai suami keempatnya. https://t.co/pNl5bTVzbU,6,1,1,0,2022-01-21,9,Friday,5,7,1
1484458112123813888,2022-01-21 09:29:28,Vaksin menjadi syarat penting di saat pandemi dan Austria mewajibkan warganya untuk vaksin! https://t.co/Z4B0ND2x3h,12,3,1,1,2022-01-21,9,Friday,5,13,4
1484457502909599745,2022-01-21 09:27:03,"FPTI, melalui Yenny Wahid selaku ketum, menargetkan dua emas di Kejuaraan Dunia Panjat Tebing 2022. https://t.co/PV7ihZozUt",7,0,2,0,2022-01-21,9,Friday,5,9,0
1484457260541693955,2022-01-21 09:26:05,"PM Inggris, Boris Johnson, mencabut pembatasan pandemi virus Corona (COVID-19) termasuk aturan wajib masker setelah gelombang Omicron diyakini telah memuncak.  https://t.co/w3b2USDvv9",2,2,2,2,2022-01-21,9,Friday,5,4,4
1484457246042083328,2022-01-21 09:26:01,"Pria berinisial ES (54) memperkosa lima orang anak di bawah umur di Tenjolaya, Kabupaten Bogor. Korban ES berusia 8 hingga 9 tahun.  https://t.co/my8WbzAzDc",3,11,5,0,2022-01-21,9,Friday,5,8,11
1484456750929616898,2022-01-21 09:24:03,"Sudah divaksinasi bukan jaminan tidak bisa kena Omicron, meski gejalanya lebih ringan. Berikut ini gejala Omicron pada pasien yang sudah divaksinasi. https://t.co/8IrbeRVjP7",4,0,3,0,2022-01-21,9,Friday,5,7,0
1484456247004995584,2022-01-21 09:22:03,"Kasus COVID-19 varian Omicron kembali terdeteksi di Jakarta. Sebanyak empat warga Mampang Prapatan, Jakarta Selatan (Jaksel) positif COVID-19 varian Omicron.  https://t.co/nX64uIynZ4",8,0,0,0,2022-01-21,9,Friday,5,8,0
1484455143496208387,2022-01-21 09:17:40,"Kebakaran dilaporkan terjadi di AEON Mall Sentul City, Bogor, Jawa Barat (Jabar). Sebanyak 3 unit mobil pemadam kebakaran (damkar) dikerahkan ke lokasi.  https://t.co/GqgNFOrvwW",79,6,48,56,2022-01-21,9,Friday,5,127,62
1484455133513670656,2022-01-21 09:17:38,"Apa yang harus dilakukan jika seseorang berada di dalam hubungan yang merugikan salah satu pihak? Bertahan, atau tinggalkan. Simak jawabannya di e-Life  malam ini pukul 19.00 WIB LIVE hanya di detikcom. https://t.co/dmhqS29a4G",1,0,1,0,2022-01-21,9,Friday,5,2,0
1484455115629150210,2022-01-21 09:17:34,Ridwan Kamil (RK) menyempatkan diri mengunjungi Taman Brantas saat berada di Kediri. Taman Brantas merupakan hasil desain RK.  https://t.co/71FoN2Tepa,3,1,0,0,2022-01-21,9,Friday,5,3,1
1484454868047835142,2022-01-21 09:16:35,"6 jet tempur Rafale tiba di Yunani untuk memperkuat pertahanan udaranya. Pesawat yang sama itu yang hendak dibeli RI. Tak murah, satu unit Rp 1,6 triliun!  https://t.co/8h11ebEq2o",6,1,1,0,2022-01-21,9,Friday,5,7,1
1484454609930395651,2022-01-21 09:15:33,"Pertandingan Real Madrid tadi malam, sekaligus menandai laga ke-150 buat Carlo Ancelotti bersama Los Blancos! https://t.co/yP1TxTFKx7",1,1,0,1,2022-01-21,9,Friday,5,1,2
1484454346893008896,2022-01-21 09:14:30,"Detik-detik video kecelakaan maut di Simpang Rapak, Balikpapan, menunjukkan sopir truk tronton Balikpapan tersebut tidak membanting setir ke kiri.  https://t.co/1N7eFQnchl",7,3,2,3,2022-01-21,9,Friday,5,9,6
1484454112439767042,2022-01-21 09:13:34,Eko Yuli memberi apresiasi kepada Gugus Tugas Percepatan Penyelesaian WADA. Dia berterima kasih lantaran Merah Putih akhirnya berkibar lagi. https://t.co/6x4MhsEbBj,5,0,2,0,2022-01-21,9,Friday,5,7,0
1484453612491259906,2022-01-21 09:11:35,Polisi meringkus pelaku vandalisme di Jalan Babakan Siliwangi Bandung. Pelaku mengaku iseng mecoret-coret tembok penahan tanah (TPT). https://t.co/jitCPqEoDM,2,0,0,0,2022-01-21,9,Friday,5,2,0
1484453611212005376,2022-01-21 09:11:35,"Wuling Almaz berhasil menggulingkan rival dari Jepang. Selama 2021, penjualan Wuling Almaz lebih tinggi daripada Honda CR-V. https://t.co/L0UScGuUtD",14,2,2,0,2022-01-21,9,Friday,5,16,2
1484453366818344963,2022-01-21 09:10:37,Lapas Kelas IIA Pekalongan tergenang banjir sejak dua hari lalu. Ketinggian air yang mencapai 20-30 cm membuat aktivitas warga binaan dan petugas terganggu.  https://t.co/QjTy68WZq1,6,0,0,0,2022-01-21,9,Friday,5,6,0
1484452740130607105,2022-01-21 09:08:07,"Lelang headband pertama milik Atta Halilintar mencapai angka Rp 2,2 miliar. Masih adakah sultan yang bisa menawar di atas angka itu? https://t.co/AyzlOgcaGf",56,84,8,19,2022-01-21,9,Friday,5,64,103
1484452717988831245,2022-01-21 09:08:02,PT Yamaha Indonesia Motor Manufacturing membeberkan data penjualan peluncuran Yamaha Fazzio Hybrid Connected. Sebanyak 1.000 unit terjual dalam waktu 5 jam. https://t.co/V3eGqLKUG3,8,0,1,0,2022-01-21,9,Friday,5,9,0
1484451880503762946,2022-01-21 09:04:42,"Jembatan Rel Kereta Api Pangukan di Sleman, DIY, ternyata pernah menjadi saksi bisu kejayaan perkebunan tebu namun kini jadi sasaran vandalisme.  https://t.co/p5Pqyia9Rf",12,0,4,0,2022-01-21,9,Friday,5,16,0
1484451129316499459,2022-01-21 09:01:43,"Pedangdut Tiara Marleen mendatangi Polda Metro Jaya. Ia minta perlindungan usai dilaporkan Emma Waroka, terkait Vanessa Angel. https://t.co/JaabP6RWTw",5,0,1,0,2022-01-21,9,Friday,5,6,0
1484451113395007493,2022-01-21 09:01:39,Han So Hee saat zaman sekolah ini bikin netizen gagal fokus. Ini dia pesona Han So Hee:   https://t.co/duMX5TcP5q,10,0,0,0,2022-01-21,9,Friday,5,10,0
1484450404087779330,2022-01-21 08:58:50,Seorang pria asal Sumatera Selatan tega mencabuli ABG di teras masjid Bengkulu. Pelaku mengiming-imingi korban uang.  https://t.co/Jy0oKOzUKF,11,8,2,3,2022-01-21,8,Friday,5,13,11
1484449801488019458,2022-01-21 08:56:27,Menkes Budi Gunadi Sadikin meminta masyarakat tidak perlu panik dengan prediksi puncak kasus Omicron pada bulan Februari-Maret mendatang.  https://t.co/CNk0L6UzFb,9,5,0,2,2022-01-21,8,Friday,5,9,7
1484449301212418054,2022-01-21 08:54:27,"Dikarenakan rem blong, sebuah truk menabrak beberapa kendaraan roda dua dan roda empat di Balikpapan. https://t.co/5mQxJnZr1F",8,1,1,0,2022-01-21,8,Friday,5,9,1
1484449294694465539,2022-01-21 08:54:26,Seorang warga Kota Cimahi yang berprofesi sebagai asisten rumah tangga positif terpapar COVID-19 varian Omicron.  https://t.co/8ZTyAYDfY1,4,0,0,0,2022-01-21,8,Friday,5,4,0
1484449275849412609,2022-01-21 08:54:21,Kasus perselingkuhan aktor Jepang Masahiro Higashide kembali viral karena dianggap seperti kisah dalam Layangan Putus. Begini kisah akhirnya.... https://t.co/Ib9GfjcQDx,9,0,3,1,2022-01-21,8,Friday,5,12,1
1484448997758668801,2022-01-21 08:53:15,Akbar Wicaksono mendadak jadi sorotan. Ia ngaku menghasilkan puluhan miliar per tahunnya sampai tetangga sempat curiga.  https://t.co/nU31BR8CtW,89,10,20,6,2022-01-21,8,Friday,5,109,16
1484448733047701506,2022-01-21 08:52:12,KPK menerima 2.127 laporan gratifikasi sepanjang tahun 2021 dengan total nominal Rp 8 miliar. Paling banyak jenis gratifikasi berupa uang hingga kado pernikahan  https://t.co/ZP5jqHarXX,4,1,0,1,2022-01-21,8,Friday,5,4,2
1484448428600041473,2022-01-21 08:50:59,Istri bungkam usai antar Ardhito Pramono rehabilitasi. Jeanneta Sanfadelia diketahui menikah diam-diam dengan Ardhito.  https://t.co/e8uA8lqbOb,7,0,2,1,2022-01-21,8,Friday,5,9,1
1484448147900407817,2022-01-21 08:49:52,"Pengumuman! Universitas Pertamina sedang membuka tiga lowongan pekerjaan. Jika tertarik, simak penjelasan berikut ya! https://t.co/oq2kb5Ec2W",8,0,1,0,2022-01-21,8,Friday,5,9,0
1484447657644941312,2022-01-21 08:47:55,"Terdepak dari Copa del Rey, Xavi Hernandez merasa ini bukan kegagalan. https://t.co/ucsBFu45gT",5,2,1,0,2022-01-21,8,Friday,5,6,2
1484447347685875714,2022-01-21 08:46:42,"Jembatan Batujajar Cihampelas atau Jembalas di Kabupaten Bandung Barat (KBB) kembali dibuka, setelah ditutup nyaris sebulan karena ada kerusakan.  https://t.co/qDvzeX9gXt",2,0,0,0,2022-01-21,8,Friday,5,2,0
1484447099412484099,2022-01-21 08:45:42,"Meski diganjar kartu merah, Marcelo sempat unjuk skill yang mengundang kekaguman. https://t.co/t9Xn44kdsw",8,0,0,0,2022-01-21,8,Friday,5,8,0
1484446563116228608,2022-01-21 08:43:34,Sejumlah warga di Sukabumi mengeluhkan kondisi jalan yang rusak parah. Lokasi jalan yang rusak itu berada di Jalan Jalur Lingkar Selatan dan Jalan Pembangunan.  https://t.co/Fsu8bXopaL,5,0,0,0,2022-01-21,8,Friday,5,5,0
1484446311671808003,2022-01-21 08:42:35,Maudy Koesnaedi dituntut jadi sosok Kirana seorang istri yang mengalami Alzheimer dalam film Pelangi Tanpa Warna. https://t.co/MvWKluznMl,5,0,1,0,2022-01-21,8,Friday,5,6,0
1484446002627104772,2022-01-21 08:41:21,"Tim Advokasi Keadilan untuk Novia Widyasari mengungkapkan temuan berupa tangkapan layar percakapan WA, di mana Novia tidak setuju didesak Bripda Randy aborsi.  https://t.co/0yTGDtp7zb",23,0,8,0,2022-01-21,8,Friday,5,31,0
1484445989217964037,2022-01-21 08:41:18,Walkot Bekasi Rahmat Effendi minta maaf soal kegiatan zoom meeting bersama simpatisannya dari Rutan KPK. Rahmat mengaku tak merencanakannya.  https://t.co/8Pxd4MTrQF,2,1,3,0,2022-01-21,8,Friday,5,5,1
1484445614456725505,2022-01-21 08:39:48,UGM segera memiliki rektor baru periode 2022-2027. Proses seleksi akan dimulai dengan periode pendaftaran 24 Januari 2022.  https://t.co/7PmPfMashm,5,0,1,0,2022-01-21,8,Friday,5,6,0
1484445592751423491,2022-01-21 08:39:43,"PSI merespons komentar Gubernur DKI Jakarta, Anies Baswedan yang merasa kasihan dengan Giring Ganesha sampai harus ke lapangan mengecek lokasi Formula E.  https://t.co/N9Gjqh7gOy",13,29,0,2,2022-01-21,8,Friday,5,13,31
1484445065426706435,2022-01-21 08:37:37,Ratusan warga yang terhimpun dalam Gerakan Sunda Karawang Ngalawan berunjuk rasa di depan Kantor DPRD Karawang. Mereka menuntut Arteria Dahlan dipenjara!  https://t.co/VdubuqwJ0Q,31,4,6,0,2022-01-21,8,Friday,5,37,4
1484444836161888259,2022-01-21 08:36:43,Viral video seorang vaksinator menyuntikkan vaksinasi kosong ke siswi SD Wahidin Medan Labuhan pada Senin (17/01). Saat ini polisi telah melakukan pemeriksaan ke vaksinator. https://t.co/cO0fbkak65,5,0,4,4,2022-01-21,8,Friday,5,9,4
1484444817430040580,2022-01-21 08:36:38,Anak-anak Nia Ramadhani menangis dan rindu ingin bertemu. Mereka juga ingin liburan bareng lagi. https://t.co/OVLiKLtYPs,0,0,1,0,2022-01-21,8,Friday,5,1,0
1484444594599337985,2022-01-21 08:35:45,Seorang anak di Kabupaten Sukabumi meninggal dunia usai satu pekan menjalani vaksinasi COVID-19. Sebelum meninggal dia sempat mendapat perawatan di RS.  https://t.co/Pk831wx7C6,17,3,8,3,2022-01-21,8,Friday,5,25,6
1484444577155145728,2022-01-21 08:35:41,"Granit Xhaka kembali dikritik tajam setelah mendapat kartu merah lagi. Hal itu bagian dari permainannya, ujar Xhaka. https://t.co/9Z1K4svTxF",4,0,0,0,2022-01-21,8,Friday,5,4,0
1484444085633142784,2022-01-21 08:33:44,"Hasil asesmen Ardhito Pramono sudah keluar. BNNP merekomendasikan Ardhito untuk direhabilitasi selama enam bulan. Pihak kepolisian pun menegaskan meski Ardhito direhabilitasi, namun proses hukumnya tetap berjalan. https://t.co/SNptCzqEP8",5,0,2,0,2022-01-21,8,Friday,5,7,0
1484443840098586624,2022-01-21 08:32:45,"Anggota DPR RI dapil Kaltim, Hetifah Sjaifudian, menagih pembangunan flyover di Simpang Muara Rapak buntut insiden kecelakaan maut di Balikpapan.  https://t.co/8F6sAJEVLT",19,1,3,0,2022-01-21,8,Friday,5,22,1
1484443838823419904,2022-01-21 08:32:45,Kecelakaan maut Balikpapan melibatkan truk tronton dan sejumlah pengendara di wilayah Muara Rapak. Berikut data korban hingga dugaan penyebab kecelakaan.  https://t.co/TmZjdk8B72,5,0,2,3,2022-01-21,8,Friday,5,7,3
1484443321938464770,2022-01-21 08:30:42,Wali Kota Solo Gibran Rakabuming Raka sudah menjalani suntik vaksin booster. Dia mengaku mengalami kejadian ikutan pasca-imunisasi (KIPI) yang tergolong ringan.  https://t.co/ANOeKqm0pC,12,0,2,0,2022-01-21,8,Friday,5,14,0
1484443305463193601,2022-01-21 08:30:38,"Sopir pemicu kecelakaan maut Simpang Rapak, Balikpapan, Kalimantan Timur, M Ali (47) resmi jadi tersangka. Foto tersangka saat diamankan turut beredar.  https://t.co/ICxK4U7nV4",976,217,104,59,2022-01-21,8,Friday,5,1080,276
1484442782928408579,2022-01-21 08:28:33,Sebuah video diduga balapan liar di simpang tiga Bandara Adisutjipto Jogja beredar di salah saru grup media sosial Facebook. Apa kata polisi?  https://t.co/cIPaAyetkL,2,1,1,0,2022-01-21,8,Friday,5,3,1
1484442498227490818,2022-01-21 08:27:25,Taman Mini Indonesia Indah viral karena disebut terbengkalai. Kondisinya berbeda ketika detikcom datang ke sana. https://t.co/FnvX8mNEBy,15,2,2,2,2022-01-21,8,Friday,5,17,4
1484441281359237128,2022-01-21 08:22:35,"Gelaran MotoGP Mandalika yang semakin dekat, seluruh jajaran Dinas Pariwisata NTB melakukan aksi bersih-bersih di Kawasan Wisata Senggigi. https://t.co/ktCir0t8Fe",5,0,2,0,2022-01-21,8,Friday,5,7,0
1484440461171380225,2022-01-21 08:19:20,"Kecelakaan maut terjadi di simpang Rapak Balikpapan, Kalimantan Timur pada Jumat (21/1). Sebuah truk tronton yang mengalami rem blong menabrak sejumlah kendaraan yang tengah berhenti. https://t.co/MLHMj7PpUF",9,3,6,1,2022-01-21,8,Friday,5,15,4
1484440074884456449,2022-01-21 08:17:48,Sedikitnya 17 orang tewas dan puluhan orang lainnya luka-luka akibat ledakan dahsyat di wilayah Ghana.  https://t.co/53mWdQsnUq,2,0,1,0,2022-01-21,8,Friday,5,3,0
1484439519738933250,2022-01-21 08:15:35,"Israel mengumumkan kesepakatan untuk mengembangkan dan membeli tiga unit kapal selam buatan raksasa industri Jerman, Thyssenkrupp.  https://t.co/Etu6rUZEQ9",4,1,2,1,2022-01-21,8,Friday,5,6,2
1484439034713841667,2022-01-21 08:13:40,Sejumlah masyarakat mengeluhkan kehabisan stok minyak goreng. Salah satu akun di Twitter posting rak minyak goreng di salah satu minimarket sudah kosong. https://t.co/mkQfOy3PGZ,5,0,1,0,2022-01-21,8,Friday,5,6,0
1484438710695432193,2022-01-21 08:12:22,Layangan Putus tidak cuma menarik karena drama perselingkuhan. Di dalam cerita itu ada juga Lastri si asisten rumah tangga yang menarik perhatian.  https://t.co/ZT1SmaFbYM,7,0,1,0,2022-01-21,8,Friday,5,8,0
1484437997156192256,2022-01-21 08:09:32,Menteri Pertahanan Prabowo Subianto menyerahkan berbagai kendaraan fungsi khusus buatan PT Pindad (Persero) untuk TNI AD. https://t.co/wf1BQvHSYA,20,1,2,0,2022-01-21,8,Friday,5,22,1
1484437529680089088,2022-01-21 08:07:41,"Pendaftaran TNI AD untuk Taruna Akmil 2022 sudah dibuka. Rekrutmen ini dapat diikuti oleh lulusan SMA/MA tahun 2018-2022. Buruan daftar!

via: detikedu https://t.co/VyRyOxuFmo",12,0,3,1,2022-01-21,8,Friday,5,15,1
1484437505504129027,2022-01-21 08:07:35,"Ahmad Riyanto alias Ririn (35), suami yang bakar istrinya, Nabilah alias Dila (50) di Musi Rawas, Sumatera Selatan (Sumsel) ditangkap. Apa motifnya?  https://t.co/zXqBYn6dri",2,0,1,0,2022-01-21,8,Friday,5,3,0
1484436918293213187,2022-01-21 08:05:15,Bos Museum Rekor Dunia Indonesia (MURI) Jaya Suprana menyusul menggugat presidential threshold 20 persen ke Mahkamah Konstititusi (MK). Apa alasannya?  https://t.co/v8YaqZXg2d,152,5,32,4,2022-01-21,8,Friday,5,184,9
1484436908298182657,2022-01-21 08:05:13,DPD PDI Perjuangan Jawa Barat melayangkan surat kepada DPP PDI Perjuangan agar memberikan sanksi berat kepada Arteria Dahlan.  https://t.co/rSSYCHIkKi,8,2,4,0,2022-01-21,8,Friday,5,12,2
1484435969784913922,2022-01-21 08:01:29,Warga korban banjir menggugat Gubernur DKI Anies Baswedan ke PTUN Jakarta. Majelis hakim memeriksa Kali Mampang dalam agenda sidang pemeriksaan setempat.  https://t.co/EEPNT99vaD,13,0,3,1,2022-01-21,8,Friday,5,16,1
1484435969608716289,2022-01-21 08:01:29,Tok! Penundaan Kewajiban Pembayaran Utang (PKPU) Garuda Indonesia diperpanjang dalam 60 hari ke depan. PKPU akan berakhir pada 21 Maret 2022. https://t.co/oNdYTGndrc,3,0,2,0,2022-01-21,8,Friday,5,5,0
1484435947659874305,2022-01-21 08:01:24,"Barcelona usir Ousmane Dembele, karena belum juga memperpanjang kontrak. Secara khusus, Barca amat kesal dengan Dembele karena satu hal. https://t.co/Et8xSsUarU",2,0,1,0,2022-01-21,8,Friday,5,3,0
1484435661939687424,2022-01-21 08:00:15,Pemerintah Provinsi DKI Jakarta berharap gugatan warga korban banjir terhadap Gubernur DKI Jakarta Anies Baswedan ke PTUN Jakarta ditolak.  https://t.co/qQSCUb5h3F,7,0,2,1,2022-01-21,8,Friday,5,9,1
1484435642050400260,2022-01-21 08:00:11,"Melawan Inter Milan di perempatfinal Coppa Italia, Jose Mourinho diharapkan tidak terjebak nostalgia saat harus mengadapi mantan klubnya itu. https://t.co/4g4oc8KuuJ",6,0,0,0,2022-01-21,8,Friday,5,6,0
1484435132215922689,2022-01-21 07:58:09,Olahraga jet ski kini hadir di Sidoarjo. Untuk warga Jawa Timur pun tak perlu jauh-jauh untuk mencari olahraga ekstrem ini. https://t.co/lCmpa0kWXv,7,0,2,0,2022-01-21,7,Friday,5,9,0
1484434909078953988,2022-01-21 07:57:16,Polisi membantah kabar ada bayi yang menjadi korban kecelakaan Balikpapan dan kedua orang tuanya meninggal dunia. Polisi memastikan kabar tersebut tidak benar.  https://t.co/7KDpyiRvUV,11,1,2,0,2022-01-21,7,Friday,5,13,1
1484434894063386626,2022-01-21 07:57:12,"Tiga orang pria di Kabupaten Magelang menyekap dan memperkosa seorang santriwati selama empat hari. Dalam penyidikannya, polisi mengungkap fakta memilukan.  https://t.co/MECMBh0yYt",10,2,4,3,2022-01-21,7,Friday,5,14,5
1484434643898310656,2022-01-21 07:56:13,"Tebak-tebakan berikut mengharuskan kamu berpikir dua kali sebelum menjawabnya. Jangan dianggap remeh, belum tentu bisa dijawab semua orang. https://t.co/j9X3qwkUMJ",7,2,0,0,2022-01-21,7,Friday,5,7,2
1484434382492508164,2022-01-21 07:55:10,"Sejumlah orang menggelar aksi unjuk rasa di depan Kantor DPRD dan Bupati Subang, memprotes pernyataan Arteria Dahlan yang meminta Kajati Bicara Sunda diganti.  https://t.co/FBLBPh2pYY",1,1,1,1,2022-01-21,7,Friday,5,2,2
1484434372434534401,2022-01-21 07:55:08,"Kemhan kini telah resmi mengganti logo baru. Logo baru Kemhan punya makna mendalam, begitu juga logo lama. Begini perbandingannya.  https://t.co/dZONvUikGh",12,4,2,0,2022-01-21,7,Friday,5,14,4
1484433900826988544,2022-01-21 07:53:16,"Polisi menyebut jumlah korban tewas kasus kecelakaan maut di Balikpapan, Kaltim hanya berjumlah 4 orang usai 1 korban lainnya dinyatakan kritis.  https://t.co/sYzDg6hJnL",131,49,27,10,2022-01-21,7,Friday,5,158,59
1484433882892189698,2022-01-21 07:53:11,Salah satu gejala umum yang kerap dialami pasien terinfeksi COVID-19 Omicron adalah batuk-batuk. Ini tips supaya batuk tidak menimbulkan sesak dada: https://t.co/mJNPFsuh1L,5,1,1,0,2022-01-21,7,Friday,5,6,1
1484432127231987712,2022-01-21 07:46:13,"Polisi menetapkan M Ali sebagai tersangka kecelakaan maut Balikpapan, dimana truk tronton yang dikemudikannya melindas mobil dan motor hingga 4 orang tewas.  https://t.co/8ft6pEUPIC",44,15,5,4,2022-01-21,7,Friday,5,49,19
1484432123058696195,2022-01-21 07:46:12,"Budiono (61) warga asal Depok, Jawa Barat, yang hilang belum ditemukan. Tiga pekan berlalu, Budiono belum ditemukan.  https://t.co/VaNEAoLn4O",7,0,6,0,2022-01-21,7,Friday,5,13,0
1484430833096314883,2022-01-21 07:41:04,"Saat sopir dihadapkan dalam kondisi darurat, seharusnya memilih opsi yang bisa meminimalisir risiko. https://t.co/EpPgYa24uv",134,56,24,13,2022-01-21,7,Friday,5,158,69
1484430738711728128,2022-01-21 07:40:42,"Ridwan Kamil diisukan menjadi Kepala Otorita IKN, Golkar Jabar meminta agar pria yang akrab disapa Kang Emil itu menuntaskan tugasnya dulu sebagai gubernur.  https://t.co/cTTepFuhBY",10,10,4,0,2022-01-21,7,Friday,5,14,10
1484430494263611394,2022-01-21 07:39:43,Gubernur Sumut Edy Rahmayadi menyampaikan kegeraman dengan adanya anak SD di Medan yang disuntik dengan vaksin kosong. Edy meminta pelaku dihukum!  https://t.co/jh3FWXkzpb,16,3,3,0,2022-01-21,7,Friday,5,19,3
1484430492812283906,2022-01-21 07:39:43,Sebuah pesawat penumpang milik maskapai American Airlines memilih untuk putar balik di tengah penerbangan gegara seorang penumpang menolak untuk memakai masker.  https://t.co/YW4V1Qsbq5,8,0,0,0,2022-01-21,7,Friday,5,8,0
1484429785539379201,2022-01-21 07:36:54,Seorang wanita berhasil menurunkan berat badannya hingga 45 kilogram. Tips dietnya adalah dengan mengubah pola makan menjadi vegan.  https://t.co/cWTUxJ8Jna,8,0,1,1,2022-01-21,7,Friday,5,9,1
1484429761736843267,2022-01-21 07:36:49,Kecelakaan maut terjadi di Balikpapan saat truk tronton menabrak sejumlah kendaraan dari arah belakang. Akibatnya kendaraan yang ditabrak ringsek parah.  https://t.co/CDrSPuJZy4,9,0,2,0,2022-01-21,7,Friday,5,11,0
1484429527296135171,2022-01-21 07:35:53,Liga Italia akhir pekan ini akan menyajikan duel seru AC Milan vs Juventus. Berikut jadwal lengkapnya! https://t.co/DIDuEY8d6B,6,0,0,0,2022-01-21,7,Friday,5,6,0
1484429506014334981,2022-01-21 07:35:48,"Polisi menyebut sopir truk yang mengalami kecelakaan maut di Balikpapan, Kalimantan Timur (Kaltim) melanggar 2 aturan.  https://t.co/Hlx1Xyragg",128,25,39,3,2022-01-21,7,Friday,5,167,28
1484429008653758465,2022-01-21 07:33:49,"Javier ""Chicharito"" Hernandez sudah punya tambatan hati yang baru usai mengalami kegagalan dalam pernikahan dan perpisahan menyakitkan. https://t.co/wJWVvsjCHH",0,0,0,1,2022-01-21,7,Friday,5,0,1
1484428773885984769,2022-01-21 07:32:53,Supermusic NEXTZone Live 360 Virtual Concert kembali digelar. Kali ini akan ada kolaborasi yang tidak biasa.  https://t.co/vFeTR3tv35,9,0,2,1,2022-01-21,7,Friday,5,11,1
1484428234829746176,2022-01-21 07:30:45,"Pembelajaran tatap muka (PTM) di SMA Negeri Polanharjo, Klaten, Jawa Tengah ditutup. Penyebabnya seorang guru dinyatakan positif COVID-19 dari hasil PCR.  https://t.co/9nUgOgds7R",13,0,0,0,2022-01-21,7,Friday,5,13,0
1484426742722969602,2022-01-21 07:24:49,"Sejak akhir 2021, novelis Laksmi Pamuntjak meluncurkan Podcast Kitab Kawin yang bakal menanyangkan 12 episode dari 6 tema besar tentang perempuan.  https://t.co/l6V8TdD4yt",3,0,0,0,2022-01-21,7,Friday,5,3,0
1484426238311772164,2022-01-21 07:22:49,"Wuling Almaz berhasil menggulingkan rival dari Jepang, Honda CR-V. Selama setahun penuh 2021, penjualan Wuling Almaz lebih tinggi daripada Honda CR-V. https://t.co/FnZoJwdNOi",13,2,1,0,2022-01-21,7,Friday,5,14,2
1484426220578258945,2022-01-21 07:22:44,Pemerintah melalui Satgas BLBI telah menyita aset Grup Texmaco. Aset tersebut tersebut tersebar di 11 kabupaten/kota dengan total 746 bidang tanah. https://t.co/eCFZBKD3oL,10,1,0,0,2022-01-21,7,Friday,5,10,1
1484425738216484866,2022-01-21 07:20:49,"Truk tronton menabrak sejumlah kendaraan yang tengah berhenti di simpang Muara Rapak, Balikpapan, Kalimantan Timur menewaskan 5 orang. Para korban dievakuasi ke 3 rumah sakit. https://t.co/g4CZwrLZ64",9,0,2,0,2022-01-21,7,Friday,5,11,0
1484425250402193412,2022-01-21 07:18:53,Parlemen Austria menyetujui Undang-Undang (UU) baru yang menjadikan vaksinasi COVID-19 wajib untuk orang dewasa mulai bulan depan.  https://t.co/pEk7bf7EZW,9,0,1,1,2022-01-21,7,Friday,5,10,1
1484424504264863749,2022-01-21 07:15:55,"Gedung Sarinah akan kembali dibuka pada Maret 2022. Jelang pembukaan, penyelesaian proyek terus dikebut. Lihat, ini penampakan terbarunya. https://t.co/sRnxw0f4Zp",21,0,6,1,2022-01-21,7,Friday,5,27,1
1484423948712521728,2022-01-21 07:13:43,"Pakar komunikasi dari UI mengingatkan, ada bahaya di balik metaverse. Bahayanya meliputi aspek psikologis personal, sosial, hingga politik!  https://t.co/ACevNL7Wap",20,1,6,2,2022-01-21,7,Friday,5,26,3
1484423443529539584,2022-01-21 07:11:42,"Hujan deras mengakibatkan SD dan pustu di Desa Modongan, Mojokerto kebanjiran. Kegiatan belajar mengajar terganggu dan pustu ditutup sementara.  https://t.co/rJiBS0SvT2",8,0,3,0,2022-01-21,7,Friday,5,11,0
1484423165073833987,2022-01-21 07:10:36,"Shin Tae-yong ingin menilai kepercayaan diri pemain usai Piala AFF 2020, saat laga uji coba melawan Timor Leste.  https://t.co/OrZU5NjeZL",16,1,3,0,2022-01-21,7,Friday,5,19,1
1484423153002684417,2022-01-21 07:10:33,Pemerintah telah menetapkan harga minyak goreng menjadi Rp 14 ribu per liter. Wakil Presiden Ma’ruf Amin lalu meminta Menteri Perdagangan Muhammad Lutfi melakukan operasi pasar agar tidak terjadi kelangkaan minyak goreng. https://t.co/u8kIaeJz01,15,1,2,0,2022-01-21,7,Friday,5,17,1
1484422164182929411,2022-01-21 07:06:37,"Pria di Purwakarta ini nyaris diamuk massa. Dia buka jasa penukaran uang receh. Masalahnya, duit recehan Rp500 yang dibawanya di kantong plastik disebut berjumlah Rp300.000. Namun, saat ada korban yang menghitung, ternyata jumlah koinnya hanya Rp100.000. https://t.co/Xm4Fl9JSNk",6,1,2,0,2022-01-21,7,Friday,5,8,1
1484421038939283457,2022-01-21 07:02:09,"Nasib Arshaka Putra Fidianto tak seberuntung bayi lainnya. Betapa tidak, bayi berusia 7 bulan ini lahir dengan kelainan hidrosefalus.  https://t.co/TyCejGmVLt",9,0,1,0,2022-01-21,7,Friday,5,10,0
1484420189609472001,2022-01-21 06:58:47,Piala Afrika 2021 telah menuntaskan perjalanan fase grup. Berikut negara-negara yang lolos ke babak 16 besar Piala Afrika 2021! https://t.co/ZiTsBtXsV2,12,0,2,0,2022-01-21,6,Friday,5,14,0
1484419436174102529,2022-01-21 06:55:47,"Detik-detik kecelakaan maut tronton Balikpapan ramai di media sosial. Foto jenazah korban juga ikut tersebar. Awas, bisa picu trauma hingga cemas. https://t.co/tXaxOWjkx3",19,0,8,0,2022-01-21,6,Friday,5,27,0
1484419309120204807,2022-01-21 06:55:17,"Berkaca pada kecelakaan truk tronton di Balikpapan, penyelidikan diharapkan tak sebatas pada keterangan sopir saja. https://t.co/lxmsuFqHHT",29,3,5,3,2022-01-21,6,Friday,5,34,6
1484418429335572481,2022-01-21 06:51:47,Kartu merah yang didapatkan Arsenal di 2022 bahkan lebih banyak daripada golnya. https://t.co/si12AqoMlL,10,1,0,0,2022-01-21,6,Friday,5,10,1
1484417928523042817,2022-01-21 06:49:47,"Kompetisi Liga 1 memasuki jeda pertandingan selama 10 hari. Disaat beberapa tim kembali ke daerah asal, PSS Sleman lebih memilih untuk tetap berlatih di Bali.  https://t.co/kPOESin2hp",15,0,1,0,2022-01-21,6,Friday,5,16,0
1484417401097752576,2022-01-21 06:47:42,Tahu merupakan sumber protein nabati yang menyehatkan. Bisa dibuat olahan tahu bumbu tradisional yang murah sedap. Dari tahu campur hingga tahu gimbal.  https://t.co/dHeUO0tTST,17,0,2,0,2022-01-21,6,Friday,5,19,0
1484416653047775232,2022-01-21 06:44:43,Pelat kendaraan hitam bakal diganti warna putih. Pelat putih itu nantinya juga akan dipasangi chip canggih. Ini fungsinya:  https://t.co/OH2tRoSBnU,33,37,10,6,2022-01-21,6,Friday,5,43,43
1484416312751398915,2022-01-21 06:43:22,"Ngambek saat di ganti, lewat posting-an di sosial media, Ronaldo bilang yang penting tiga poin! https://t.co/ogKuRTTF9B",9,1,3,1,2022-01-21,6,Friday,5,12,2
1484415263579721729,2022-01-21 06:39:12,CDC resmi memperbarui pedoman masker usai AS diamuk Omicron. Ini jenis masker yang 95 persen efektif tangkal Omicron. https://t.co/eW4uBpg4Z1,21,5,8,1,2022-01-21,6,Friday,5,29,6
1484414769734033409,2022-01-21 06:37:14,Carlo Ancelotti mengatakan tentang kartu merah yang di terima Marcelo. Dia mengklaim tak sentuh lawan! https://t.co/RwqyW73PXh,8,0,1,0,2022-01-21,6,Friday,5,9,0
1484414515227906048,2022-01-21 06:36:14,Polisi menggerebek sebuah rumah di Kota Tasikmalaya yang dijadikan tempat pengemasan minuman keras (miras) tradisional jenis ciu.  https://t.co/DI7zY0YIhl,12,0,3,1,2022-01-21,6,Friday,5,15,1
1484413996157526016,2022-01-21 06:34:10,"Prancis akan memusnahkan lebih dari 1 juta unggas dalam beberapa pekan ke depan, untuk memerangi lonjakan wabah flu burung di peternakan-peternakan setempat.  https://t.co/odOLr1MKWV",12,0,7,1,2022-01-21,6,Friday,5,19,1
1484413437308452872,2022-01-21 06:31:57,"Anggota DPR dapil Kaltim Irwan menyoroti Simpang Rapak, yang merupakan TKP kecelakaan maut Balikpapan. Begini catatan Irwan perihal Simpang Rapak.  https://t.co/Oi1VX5yO7s",13,1,2,0,2022-01-21,6,Friday,5,15,1
1484413435928526848,2022-01-21 06:31:56,Ukuran makanan ringan alias camilan masa kecil makin lama makin menyusut. Bahkan ada yang ukurannya sebesar jempol tangan. Kenapa ya? https://t.co/49LkHeXzPt,168,33,64,16,2022-01-21,6,Friday,5,232,49
1484412817138716674,2022-01-21 06:29:29,"Masa karantina pelaku perjalanan yang masuk ke Malaysia kini dipersingkat dari 10 hari menjadi 5 hari. Namun, ada beberapa syarat yang wajib dipenuhi. https://t.co/1mEJE7NdLt",7,0,0,0,2022-01-21,6,Friday,5,7,0
1484412360555175937,2022-01-21 06:27:40,"Simpang Muara Rapak menjadi lokasi tragedi kecelakaan maut di Kota Balikpapan, Kalimantan Timur. Ini serba-serbi informasi soal lokasi kecelakaan maut.  https://t.co/tGxHEdcHmW",47,2,9,0,2022-01-21,6,Friday,5,56,2
1484412359292633089,2022-01-21 06:27:40,"Jadwal Liga Inggris menyajikan, Manchester United vs West Ham United dan Chelsea vs Tottenham Hotspur di akhir pekan ini https://t.co/9IIdv749hT",14,1,3,0,2022-01-21,6,Friday,5,17,1
1484411838385344513,2022-01-21 06:25:35,Jumpa pers KPK secara tiba-tiba diinterupsi. Adanya interupsi di tengah-tengah jumpa pers ini baru kali pertama terjadi sejak KPK mulai 'memamerkan' tersangka.  https://t.co/sfVAkmQqJd,7,0,4,0,2022-01-21,6,Friday,5,11,0
1484411344401088512,2022-01-21 06:23:38,"Ketika musim dingin tiba dan salju mulai turun, di saat itulah benda yang terselimuti es jadi ajaib penampilannya. Ini potretnya:  https://t.co/RRYJ657JPk",18,1,3,0,2022-01-21,6,Friday,5,21,1
1484410595516506112,2022-01-21 06:20:39,"Ini dia daftar lokasi dan tarif parkir resmi untuk mobil dan sepeda motor di kawasan Malioboro, Jogja. Jangan sampai salah, Lur!  https://t.co/Uj9bscDOlo",31,1,12,0,2022-01-21,6,Friday,5,43,1
1484410576033964033,2022-01-21 06:20:34,"Dalam perubahan direksi ini, Ricky Baheramsjah digantikan oleh pembalap Priandhi Satria sebagai Direktur Utama MGPA. https://t.co/KH65fTl2rL",6,0,2,0,2022-01-21,6,Friday,5,8,0
1484410091365449731,2022-01-21 06:18:39,"Perkenalkan Peter Waweru, sosok wasit yang viral dan disukai banyak penonton. https://t.co/PdbRBaxGmY",9,0,3,0,2022-01-21,6,Friday,5,12,0
1484409555912204288,2022-01-21 06:16:31,Angka kunjungan wisata di Lamongan selama libur Nataru 2021 mengalami kenaikan! https://t.co/66xWxScgTa,8,0,3,2,2022-01-21,6,Friday,5,11,2
1484409304111271936,2022-01-21 06:15:31,Kementerian Pertahanan resmi mengganti logo baru. Peresmian itu dilakukan langsung oleh Menteri Pertahanan Prabowo Subianto. Begini logonya.  https://t.co/NeBAyTfnri,12,7,4,3,2022-01-21,6,Friday,5,16,10
1484409060049002498,2022-01-21 06:14:33,Periset di NASA mengestimasi kekuatan erupsi jauh melebihi bom atom yang dahulu meluluhlantakkan Hiroshima di akhir Perang Dunia II.  https://t.co/MhMNyjtghU,13,0,4,0,2022-01-21,6,Friday,5,17,0
1484408559899136002,2022-01-21 06:12:34,Seorang pria berusia 57 tahun baru saja menerima transplantasi dua ginjal babi yang sudah dimodifikasi secara genetik. Seperti apa kondisinya kini? https://t.co/8CSPFUhXbj,20,6,6,4,2022-01-21,6,Friday,5,26,10
1484407032597950464,2022-01-21 06:06:30,"Kini, naskah akademik RUU IKN disorot lantaran sama sekali tidak mencantumkan referensi produk akademisi Indonesia.  https://t.co/A8nydmddQ0",22,3,10,2,2022-01-21,6,Friday,5,32,5
1484407018165358597,2022-01-21 06:06:26,Ini komentar Anies Baswedan soal Ketum PSI Giring Ganesha yang kejeblos di venue Formula E dan ketemu kambing.  https://t.co/24paA8Atng,15,7,3,1,2022-01-21,6,Friday,5,18,8
1484406699331104770,2022-01-21 06:05:10,"Sudah empat hari permukiman warga di Benda, Kota Tangerang tergenang banjir!  https://t.co/dkRcd8a3Sx",17,1,5,0,2022-01-21,6,Friday,5,22,1
1484406681316515841,2022-01-21 06:05:06,Aksi sejoli mesum di Pacitan yang menghebohkan media sosial terungkap. Kedua sejoli itu kini diamankan di kantor polisi.  https://t.co/JiGcBBu59s,14,5,2,2,2022-01-21,6,Friday,5,16,7
1484406171477946369,2022-01-21 06:03:04,"Samsung Galaxy A53 5G kedapatan mejeng di situs TENNA, Badan Sertifikasi Ponsel China. Terkuak tampilan &amp; spesifikasi lengkap penerus Galaxy A52s: https://t.co/Ne6AamKJwm",5,0,5,0,2022-01-21,6,Friday,5,10,0
1484406098723590146,2022-01-21 06:02:47,"Ada masalah pendirian permukiman di belakang JIS ini, letaknya dekat rel kereta. Kini, spanduk dipasang berisi permberitahuan penertiban kawasan dekat rel ini.  https://t.co/ICIsnbZ8Z5",16,2,4,4,2022-01-21,6,Friday,5,20,6
1484406078343454720,2022-01-21 06:02:42,Aksi Arteria Dahlan meminta Kajati berbicara Sunda saat rapat diganti berujung permintaan maaf anggota Komisi III DPR itu. Ketua PDIP pun meminta maaf.  https://t.co/rqv34iaQRP,14,9,4,0,2022-01-21,6,Friday,5,18,9
1484405172877021186,2022-01-21 05:59:06,"Menurut Stefan Arman, ada dua tantangan dalam mengembangkan bus listrik di Indonesia. https://t.co/TXmWhwd9dH",10,0,3,0,2022-01-21,5,Friday,5,13,0
1484405157735669761,2022-01-21 05:59:03,"Pria berinisial WRS (41) tega membunuh istrinya, S (29), usai berhubungan intim. Kepada polisi, WRS mengaku sakit hati karena istrinya hendak menikah lagi.  https://t.co/xzfhFQ8oTe",37,17,3,4,2022-01-21,5,Friday,5,40,21
1484404890243932160,2022-01-21 05:57:59,Kecelakaan maut terjadi di Balikpapan saat truk tronton bermuatan kontainer seberat 20 ton melindas sejumlah pemotor hingga mobil dari arah belakang.  https://t.co/wVM2FfSGOj,40,1,9,2,2022-01-21,5,Friday,5,49,3
1484404650128388097,2022-01-21 05:57:02,"The King Of Tears, Lee Bang Won jadi kontroversi usai diduga menyiksa hewan saat syuting. Pihak KBS angkat bicara dan meminta maaf. https://t.co/E9iTntjOku",8,0,1,1,2022-01-21,5,Friday,5,9,1
1484404635347660800,2022-01-21 05:56:58,Seorang polisi satlantas wilayah Jaktim berinisial N dilarikan ke rumah sakit. N ditabrak pemotor dari arah Utara ke Selatan saat kondisi lalin macet.  https://t.co/0oL8RT2cvq,5,1,3,0,2022-01-21,5,Friday,5,8,1
1484404335828258818,2022-01-21 05:55:47,Menteri Kesehatan RI Budi Gunadi Sadikin angkat bicara soal video viral seorang siswa SD disuntik dengan vaksin kosong di Kota Medan.  https://t.co/jwaq7wPEoa,9,4,2,0,2022-01-21,5,Friday,5,11,4
1484404076968390657,2022-01-21 05:54:45,"Polisi meralat jumlah korban tewas akibat kecelakaan maut truk tronton di Balikpapan, Kaltim. Polisi menyebut ada 4 orang yang tewas, bukan 5.  https://t.co/JFG64ZLd8h",93,9,29,0,2022-01-21,5,Friday,5,122,9
1484404075630403586,2022-01-21 05:54:45,Hanung Bramantyo dinyatakan mengidap penyakit saraf kejepit. Ia pun menceritakan gejala awal yang ia rasakan 4 tahun lalu. Hanung menyebut hal itu berawal dari keseringan main handphone. https://t.co/5q5MZ1axJM,11,1,2,0,2022-01-21,5,Friday,5,13,1
1484403574788567040,2022-01-21 05:52:45,"Kecelakaan beruntun di Balikpapan melibatkan truk tonton dan sejumlah kendaraan di wilayah Muara Rapak, Kota Balikpapan. Ini sejumlah faktanya.  https://t.co/LlnLGGdvEP",8,1,4,3,2022-01-21,5,Friday,5,12,4
1484403349629898754,2022-01-21 05:51:52,"Setelah sempat menjalani pemeriksaan intensif di Ditreskrimum Polda Jawa Timur, tersangka kasus pembuang sesaji di lokasi erupsi gunung semeru Hadfana Firdaus akhirnya dibawa ke Polres Lumajang.  https://t.co/NnXe47L92c",9,2,3,1,2022-01-21,5,Friday,5,12,3
1484403078514237441,2022-01-21 05:50:47,Didapati sejumlah toko modern tidak memajang minyak goreng di rak meski memiliki stok di gudang.  https://t.co/Dqx6StApLL,14,19,6,2,2022-01-21,5,Friday,5,20,21
1484402829741723650,2022-01-21 05:49:48,Gubernur DKI Jakarta Anies Baswedan menepis anggapan Formula E terlalu dipaksakan untuk terlaksana. Eks Mendikbud ini menegaskan Formula E harus terlaksana lantaran tertuang dalam Perda. https://t.co/TZAPhlHL5s,29,37,6,4,2022-01-21,5,Friday,5,35,41
1484402099446333440,2022-01-21 05:46:54,Victoria Azarenka melesat ke babak keempat Australian Open 2022. Azarenka cuma kehilangan dua gim di babak ketiga. https://t.co/rjRd0EwwZP,5,0,3,0,2022-01-21,5,Friday,5,8,0
1484401074152869889,2022-01-21 05:42:49,"Ketua Umum KADIN Arsjad Rasjid menjawab rumor dirinya masuk ke arena politik. Tak hanya itu, dalam Blak-blakan kali ini, Arsjad juga menjelaskan suara dukungan pengusaha terhadap perpanjangan masa jabatan presiden, hingga 3 periode. https://t.co/saDsgtjlcd",8,3,3,0,2022-01-21,5,Friday,5,11,3
1484400080388042752,2022-01-21 05:38:52,"Seminggu terakhir Non Fungiable Token (NFT) milik Sultan Gustaf Al Ghozali menjadi bahan perbincangan publik, lantaran menghasilkan miliaran rupiah. Karya seperti apa yang bernilai lebih di mata para kolektor? semua dibahas di dMentor. https://t.co/cUb2mWdggI",4,1,1,0,2022-01-21,5,Friday,5,5,1
1484399328311578625,2022-01-21 05:35:53,Gubernur DKI Jakarta Anies Baswedan menanggapi soal proyek Formula E sebagai batu loncatan menuju Pilpres 2024. Anies mengatakan hal ini sebagai pemberi manfaat untuk semuanya. https://t.co/xKuf48zz66,18,17,1,2,2022-01-21,5,Friday,5,19,19
1484398852161642498,2022-01-21 05:33:59,"Sebanyak 40 ekor anak penyu atau tukik berjenis penyu sisik dan penyu lekang dilepasliarkan di Taman Inspirasi Muntig Siokan, Pantai Mertasari, Bali. Pelepasan tukik bertujuan ingin mengembalikan Bali sebagai surganya penyu. https://t.co/Y30hho9hCO",10,0,3,0,2022-01-21,5,Friday,5,13,0
1484398317173940225,2022-01-21 05:31:52,Yorch Yongsin jadi perhatian usai terungkap dirinya adalah salah satu trainee BigHit Entertainment. Ia tergabung dalam tim Trainee A yang terdiri dari 7 member. https://t.co/6QhSpYpoKN,17,0,0,0,2022-01-21,5,Friday,5,17,0
1484397491869167618,2022-01-21 05:28:35,Anwar BAB malu-malu saat disinggung mendadak rajin olahraga demi Bella Aprilia. https://t.co/3toY8sNXFd,11,2,1,1,2022-01-21,5,Friday,5,12,3
1484396710608748544,2022-01-21 05:25:29,"Kecelakaan tragis dan maut terjadi di Simpang Rapak, Kota Balikpapan, Kalimantan Timur sebuah tronton menabrak sejumlah pengendara. Netizen berduka.  https://t.co/XLSiq1f6Ae",162,7,30,2,2022-01-21,5,Friday,5,192,9
1484396689565888512,2022-01-21 05:25:24,Carlo Ancelotti tak bisa menepikan peran besar Isco dan Eden Hazard saat Real Madrid comeback atas Elche. https://t.co/ZDmjyodcYr,12,0,2,0,2022-01-21,5,Friday,5,14,0
1484396293606846470,2022-01-21 05:23:49,"Pendaftaran Guru Penggerak Angkatan 6 dibuka hingga 18 Februari 2022. Cek syarat Guru Penggerak dan jadwal pendaftaran selengkapnya yuk!

via: detikedu https://t.co/ttlno9BTB8",9,0,2,0,2022-01-21,5,Friday,5,11,0
1484395444939677696,2022-01-21 05:20:27,"Kecelakaan maut terjadi di Simpang Rapak Balikpapan, Kalimantan Timur pada Jumat (21/1). Dari rekaman CCTV tampak sebuah truk menabrak sejumlah kendaraan. https://t.co/EamDgOf47g",18,2,4,2,2022-01-21,5,Friday,5,22,4
1484394953283444745,2022-01-21 05:18:30,"Sebelum ada jembatan gantung ini, akses Dusun Girpasang dilalui dengan jalan setapak naik turun jurang sedalam 150 m dan 1.001 anak tangga. https://t.co/OeeVDVb89s",15,5,3,0,2022-01-21,5,Friday,5,18,5
1484394459395674115,2022-01-21 05:16:32,Pasien Omicron umumnya bergejala ringan atau positif COVID-19 tanpa gejala. Kapan sebenarnya bisa dikatakan sembuh? Ini panduan Kemenkes RI: https://t.co/jRUmcHjNa0,5,0,2,0,2022-01-21,5,Friday,5,7,0
1484393704358137859,2022-01-21 05:13:32,Polda Metro Jaya menjaring 124 mobil berpelat nomor polisi 'RF' yang melanggar aturan. Terdapat tiga jenis pelanggaran yang dilakukan pelat nopol 'RF'. https://t.co/SvUrJun1RG,57,16,9,5,2022-01-21,5,Friday,5,66,21
1484392891980132353,2022-01-21 05:10:18,Tonga adalah negara yang didominasi pengikut aliran Mormon dan gereja di sana memainkan peran membantu masyarakat usai bencana.  https://t.co/APgvPDeN2K,16,3,5,0,2022-01-21,5,Friday,5,21,3
1484392401959636992,2022-01-21 05:08:21,Selain Wayne Rooney dan Frank Lampard yang menjadi kandidat manajer Everton. Nama Fabio Cannavaro meramaikan persaingan menjadi manajer Everton. https://t.co/qCy8mVSM0n,17,0,1,2,2022-01-21,5,Friday,5,18,2
1484391832163438598,2022-01-21 05:06:06,Konsumsi teh di pagi hari tentu menyegarkan. Apalagi ditemani cookies atau gorengan. Teh kulit kopi disebut menyehatkan dan menghaluskan kulit. Silahkan dicoba.  https://t.co/qhBF4l8moP,12,0,0,1,2022-01-21,5,Friday,5,12,1
1484391256289529856,2022-01-21 05:03:48,Jose Mourinho menegaskan komitmennya untuk AS Roma di tengah isu ketertarikan Everton. https://t.co/vkUkcIXBlD,5,2,0,0,2022-01-21,5,Friday,5,5,2
1484391237209755649,2022-01-21 05:03:44,"Wisatawan curhat tarif parkir bus sampai Rp 350 ribu. Berapa harga resminya, ya? https://t.co/wlwbx5sGH5",5,2,1,0,2022-01-21,5,Friday,5,6,2
1484390960964329476,2022-01-21 05:02:38,Pernyataan Arteria Dahlan yang meminta Bajati berbicara Sunda saat rapat dicopot menuai polemik. Dia bahkan dipolisikan oleh sejumlah tokoh Sunda.  https://t.co/5EsVNC1yHF,16,6,2,1,2022-01-21,5,Friday,5,18,7
1484390941842624513,2022-01-21 05:02:33,Berbagai negara kembali membuka gerbangnya untuk membangkitkan pariwisata dan terdapat negara yang menerapkan pajak untuk wisatawan. https://t.co/xrY59uG6jb,2,1,2,0,2022-01-21,5,Friday,5,4,1
1484390691182563330,2022-01-21 05:01:34,"Polisi mendatangi lokasi parkir tersebut. Hasilnya, pengakuan pengelola parkir dijelaskan bahwa Rp 350 ribu merupakan permintaan dari kernet bus. https://t.co/AwLe13OfNI",3,7,5,2,2022-01-21,5,Friday,5,8,9
1484390673197457408,2022-01-21 05:01:29,"Inilah kampung adat di Sukabumi yang paling unik, karena dalam kawasan desa wisata ini tak ada penjual nasi, karena memang dilarang. https://t.co/eQJn7H0vyF",26,1,6,3,2022-01-21,5,Friday,5,32,4
1484390402408927232,2022-01-21 05:00:25,"Polri mengungkapkan pengakuan sopir truk tronton, M Ali, yang menabrak sejumlah kendaraan di Balikpapan, Kaltim. Menurut Ali, pompa angin rem tak berfungsi.  https://t.co/XrGWUIWl5i",30,6,9,4,2022-01-21,5,Friday,5,39,10
1484390384008667143,2022-01-21 05:00:20,Diogo Jota menjadi bintang Liverpool di semifinal Piala Liga Inggris. https://t.co/qi0c9gbWGh,1,1,1,0,2022-01-21,5,Friday,5,2,1
1484390151945998341,2022-01-21 04:59:25,"Ardhito Pramono tiba di RSKO untuk rehabilitasi. Sang istri, Jeanneta Sanfadelia terus mendampingi. https://t.co/IiocTitHx1",6,3,2,1,2022-01-21,4,Friday,5,8,4
1484390138356633601,2022-01-21 04:59:22,Penumpang punya kebiasaan bertepuk tangan ketika pesawat mendarat. Berikut alasan psikologis dan budaya di balik ritual itu. https://t.co/X060gTriwH,8,2,3,1,2022-01-21,4,Friday,5,11,3
1484389876371968001,2022-01-21 04:58:19,Pierre-Emerick Aubameyang telah memberikan info terbaru soal kondisi jantungnya. https://t.co/oB16mPVzzX,3,0,0,0,2022-01-21,4,Friday,5,3,0
1484389655013249025,2022-01-21 04:57:27,Transplantasi jantung babi ke manusia untuk pertama kalinya jadi terobosan di dunia medis. Ini Muhammad Mohiuddin sosok di balik itu:  https://t.co/Vc3ags475c,20,0,6,4,2022-01-21,4,Friday,5,26,4
1484389631202185223,2022-01-21 04:57:21,Thariq Halilintar selesai karantina dan boleh pulang dari rumah sakit setelah negatif Corona. Thariq ternyata langsung datangi Fuji. https://t.co/ejKcHsiZLi,16,10,1,1,2022-01-21,4,Friday,5,17,11
1484389321146650625,2022-01-21 04:56:07,Arsenal berupaya merekrut Dusan Vlahovic di bulan ini. Berikut reaksi dari Antonio Conte! https://t.co/WE6Y8dlHmK,4,0,0,0,2022-01-21,4,Friday,5,4,0
1484389306919575557,2022-01-21 04:56:04,Kemenkes RI mengatakan tidak semua pasien varian Omicron bisa melakukan isolasi di rumah. Berikut kriteria pasien yang harus dirawat di rumah sakit: https://t.co/CxjBPd5Yfq,1,1,2,1,2022-01-21,4,Friday,5,3,2
1484388770233270272,2022-01-21 04:53:56,"Bikin heboh, seorang dokter viral lantaran melakukan live streaming saat operasi ginekologi. Vagina pasien wanita jelas terekspos, disaksikan banyak netizen. https://t.co/6LzAHhXWEg",5,0,1,0,2022-01-21,4,Friday,5,6,0
1484388768773652481,2022-01-21 04:53:55,Dua gol Diogo Jota mengantarkan Liverpool mengalahkan Arsenal 2-0 di semifinal leg kedua Piala Liga Inggris. https://t.co/TXKmAFXb9F,16,0,4,0,2022-01-21,4,Friday,5,20,0
1484388491064713217,2022-01-21 04:52:49,"PN Melonguane, Kepulauan Talaud, Sulut menjatuhkan hukuman 12 tahun penjara kepada YL yang terbukti mencabuli tetangganya yang masih SD!  https://t.co/CD0henxuNG",1,0,1,1,2022-01-21,4,Friday,5,2,1
1484387909709049857,2022-01-21 04:50:30,Warga Kota Sukabumi mengeluhkan kondisi jalan yang rusak dan berlubang di Jalur Lingkar Selatan dan Jalan Pembangunan.  https://t.co/LuNIdXwESo,7,1,0,1,2022-01-21,4,Friday,5,7,2
1484387646860365824,2022-01-21 04:49:28,Desa wisata punya potensi sangat besar untuk berkembang di masa depan. Berikut 4 hal yang mesti disiapkan agar bisa menarik wisatawan! https://t.co/Ex1qaw9iXz,4,0,3,0,2022-01-21,4,Friday,5,7,0
1484387620352372740,2022-01-21 04:49:21,Ardhito Pramono hari ini dipindah dari Polres Metro Jakarta Barat ke RSKO Cibubur. Proses itu ditemani oleh istrinya. Ini potretnya: https://t.co/o9ApSQxVGW,2,1,1,0,2022-01-21,4,Friday,5,3,1
1484387152838365185,2022-01-21 04:47:30,"Konser Adele di Las Vegas ditunda, setengah krunya positif COVID-19. https://t.co/RGWOV1ZRQa",11,0,3,1,2022-01-21,4,Friday,5,14,1
1484386827083685888,2022-01-21 04:46:12,"Barcelona memiliki kesempatan terakhirnya untuk juara, yaitu Liga Europa. https://t.co/VDEi3fxaPZ",4,0,1,0,2022-01-21,4,Friday,5,5,0
1484386551089954820,2022-01-21 04:45:07,"Real Madrid dan Chelsea akan berhadapan di babak 16 besar Liga Champions. Jika ada yang pemainnya yang belum vaksin, maka dilarang tampil. https://t.co/tcQ5M5T1kt",4,4,1,0,2022-01-21,4,Friday,5,5,4
1484386549630337025,2022-01-21 04:45:06,Komisi Pengawasan dan Perlindungan Anak Aceh (KPPAA) terancam bubar. Ketua DPR Aceh Dahlan Jamaluddin mengatakan lembaga pengawasan masih sangat diperlukan.  https://t.co/NhdxaD8qg6,4,0,1,0,2022-01-21,4,Friday,5,5,0
1484386282419671040,2022-01-21 04:44:02,"Ansu Fati menangis, setelah diganti karena cedera saat Barcelona disingkirkan Athletic Bilbao dari Copa del Rey. https://t.co/gWrHofp94p",2,0,0,0,2022-01-21,4,Friday,5,2,0
1484386261951467523,2022-01-21 04:43:58,"Jika bandar arisan online kabur, apa tindakan hukum yang bisa kita lakukan?  https://t.co/dZOqd2Y2Ca",5,0,1,0,2022-01-21,4,Friday,5,6,0
1484385685079535617,2022-01-21 04:41:40,Barcelona terdepak dari Copa del Rey usai kalah dari Athletic Bilbao. Berlangsung sengit hingga babak extra time! https://t.co/ylp8LILpFU,4,0,0,0,2022-01-21,4,Friday,5,4,0
1484385426244784130,2022-01-21 04:40:38,"Niat hati makan cuanki, pria ini malah dapat bonus gigi palsu di dalam makanan. Gigi palsu itu diduga milik penjual cuankinya.  https://t.co/A24gCvXA5P",17,13,9,7,2022-01-21,4,Friday,5,26,20
1484385410570539013,2022-01-21 04:40:35,Polri melalui Korlantas mengusut penyebab terjadinya peristiwa kecelakaan maut yang terjadi di Balikpapan. Tim traffic accident analysis diterjunkan.  https://t.co/aocJY0zvwh,11,0,7,1,2022-01-21,4,Friday,5,18,1
1484385107591016450,2022-01-21 04:39:22,Traveler mendambakan piknik lesehan menggelar tikar di Gunung Bromo? Sekarang adalah waktu yang tepat karena sudah tersedia paketnya! https://t.co/xf7O0fdxZV,8,1,2,1,2022-01-21,4,Friday,5,10,2
1484384847028228096,2022-01-21 04:38:20,Ardhito Pramono sudah jalani asesmen. Hasil asesmen berikan rujukan Ardhito Pramono direhabilitasi 6 bulan. https://t.co/bEYBGqRsfK,6,0,1,1,2022-01-21,4,Friday,5,7,1
1484384564445388802,2022-01-21 04:37:13,Seorang karyawan Raffi Ahmad dan Nagita Slavina yang bekerja di RANS Entertainment mengungkapkan biaya makan sehari:  https://t.co/hcuKWdbzp5,3,3,2,0,2022-01-21,4,Friday,5,5,3
1484384547282296834,2022-01-21 04:37:09,Ardhito Pramono akhirnya dilimpahkan ke RSKO untuk rehabilitasi sembari menunggu proses hukumnya. Ini potret Ardhito saat dibawa ke RSKO: https://t.co/UucfQr8bHj,5,0,1,0,2022-01-21,4,Friday,5,6,0
1484384230968754183,2022-01-21 04:35:53,Terlepas dari viral karya digital selfie Ghozali ada baiknya mengetahui lebih dulu esensi dari NFT. Simak #dmentor selengkapnya ya! https://t.co/aPGmBP5Ago,4,3,1,0,2022-01-21,4,Friday,5,5,3
1484384208394985480,2022-01-21 04:35:48,"Nia Ramadhani dan Ardi Bakrie divonis setahun bui, membuat putri sulung mereka histeris. Mikahyla tak henti nangis… https://t.co/JxQbeDO4Cj",9,3,2,1,2022-01-21,4,Friday,5,11,4
1484383631325945856,2022-01-21 04:33:30,Luhut minta masyarakat Indonesia bersiap menghadapi gelombang Omicron. Peningkatan kasus Omicron mulai terlihat di Jabodetabek. https://t.co/s82eVRFRoq,12,17,7,4,2022-01-21,4,Friday,5,19,21
1484383629652348929,2022-01-21 04:33:30,"Pesawat pertama yang membawa bantuan kemanusiaan tiba di Tonga, lima hari setelah negara kepulauan Pasifik Selatan itu dilanda erupsi gunung berapi dan tsunami.  https://t.co/XvzUqTTYou",8,1,3,0,2022-01-21,4,Friday,5,11,1
1484383433451180032,2022-01-21 04:32:43,"Perawatan terhadap eksterior body mobil sudah beragam, dari melakukan poles mobil hingga waxing cat mobil. Berikut perbedaannya! https://t.co/23IeCflcZJ",5,0,1,0,2022-01-21,4,Friday,5,6,0
1484383414035763200,2022-01-21 04:32:39,"Saking populernya di mata dunia internasional, Bali dianggap sebagai ibukota Indonesia. https://t.co/NNFMiFF189",6,0,1,0,2022-01-21,4,Friday,5,7,0
1484383371929309184,2022-01-21 04:32:29,Toni Kroos dikartu kuning karena dianggap menjatuhkan Tete Morente dalam kemenangan Real Madrid atas Elche. Padahal Kroos sama sekali tak menyenggol Tete. https://t.co/sH1UvAtDJY,33,27,4,14,2022-01-21,4,Friday,5,37,41
1484383364060639235,2022-01-21 04:32:27,Ahmad Muzani memuji Presiden Jokowi yang menutup ruang perwira TNI-Polri aktif jadi pj gubernur. Muzani menilai Jokowi berkomitmen menjaga amanah reformasi.  https://t.co/ER8wMxtdHz,8,0,2,0,2022-01-21,4,Friday,5,10,0
1484382476688666626,2022-01-21 04:28:55,Keseringan bekerja dari rumah dapat memicu rasa pegal dan nyeri pada leher bagian belakang. Bisakah kretek abal-abal menjadi solusinya? Simak penjelasannya: https://t.co/tR6ykJoYFf,7,2,2,1,2022-01-21,4,Friday,5,9,3
1484382182332420100,2022-01-21 04:27:45,"Polemik ucapan Arteria Dahlan terkait 'Kajati Bicara Sunda' tuai polemik. Arteria dilaporkan ke Polda Jabar. Di hari yang sama, akhirnya Arteria minta maaf. https://t.co/DXlhFwCpSV",6,5,1,2,2022-01-21,4,Friday,5,7,7
1484381937867243526,2022-01-21 04:26:47,BPOM resmi memberikan izin penggunaan darurat kepada lima merek vaksin sebagai dosis booster. Ini efek vaksin booster Moderna hingga Pfizer:  https://t.co/zUNT7XlWwd,9,1,2,0,2022-01-21,4,Friday,5,11,1
1484381911632039937,2022-01-21 04:26:40,"Berlangsung sengit, Real Madrid sempat di ujung tanduk tapi bisa comeback dengan dramatis untuk berbalik menang. https://t.co/IwbbosF5Zr",5,0,0,0,2022-01-21,4,Friday,5,5,0
1484381658513956866,2022-01-21 04:25:40,"Truk tronton kecelakaan maut yang menabrak sejumlah pengendara di Simpang Rapak, Balikpapan, diketahui membawa kontainer seberat 20 ton berisi kapur pembersih.  https://t.co/q1lnq12Abb",21,4,4,3,2022-01-21,4,Friday,5,25,7
1484381639719505922,2022-01-21 04:25:36,"Ayu Thalia dijadwalkan untuk diperiksa sebagai tersangka atas laporan anak Ahok, Nicholas Sean Purnama di Polres Jakarta Utara pada Kamis (20/1). Kuasa hukum Ayu mengungkapkan reaksi kliennya saat mengetahui statusnya yang kini jadi tersangka. https://t.co/pGSRwOlePJ",7,2,0,0,2022-01-21,4,Friday,5,7,2
1484381361431617536,2022-01-21 04:24:29,"Rossi sempat cemas ditolak Yamaha kembali, seperti ini ceritanya! https://t.co/1N6hU3uPim",5,0,1,0,2022-01-21,4,Friday,5,6,0
1484381056006508548,2022-01-21 04:23:16,"Saat ini, Toyota punya perwakilan mobil listrik yang datang dari merek premiumnya yakni Lexus UX 300e. https://t.co/0SIMnOqkQu",5,0,0,1,2022-01-21,4,Friday,5,5,1
1484381037274750976,2022-01-21 04:23:12,"Yamaha baru saja merilis skutik terbaru di Taiwan, EMF 2022. dengan dibekali mesin listrik full baterai dan desain yang futuristis. https://t.co/zt10DyJRrh",6,0,0,1,2022-01-21,4,Friday,5,6,1
1484380760660316160,2022-01-21 04:22:06,"Kabupaten Tasikmalaya menggelar Piala Soeratin tingkat Jawa Barat, jika ada pemain yang tampil apik dijanjikan bakal diambil Persib Bandung. https://t.co/Rf9xi2HNOp",6,0,0,0,2022-01-21,4,Friday,5,6,0
1484380745535660033,2022-01-21 04:22:02,Ardhito Pramono bakal direhabilitasi di RSKO Cibubur selama enam bulan. Dia yakin dengan menjalani rehabilitasi akan sembuh dari ketergantungan narkoba.  https://t.co/FNouwfoK7k,20,9,4,6,2022-01-21,4,Friday,5,24,15
1484380503339724802,2022-01-21 04:21:05,Ousmane Dembele melancarkan serangan balik ke Barcelona. Seperti ini kata Dembele! https://t.co/EummRU6A6w,3,0,0,0,2022-01-21,4,Friday,5,3,0
1484380484549296132,2022-01-21 04:21:00,"Sekjen DPC Partai Demokrat Balikpapan, Syamsudin, diperiksa KPK sebagai saksi terkait OTT Bupati Penajam Paser Utara (PPU) Abdul Gafur Mas'ud hari ini.  https://t.co/74MjeQ5hAg",5,4,1,1,2022-01-21,4,Friday,5,6,5
1484380193951154181,2022-01-21 04:19:51,Barcelona minta Ousmane Dembele angkat kaki di bulan Januari ini. Berikut potret saat Dembele masih menjalani masa-masa indah di Barca. https://t.co/Et2gIXGHDW,12,0,0,1,2022-01-21,4,Friday,5,12,1
1484380174908985344,2022-01-21 04:19:46,Harga emas hari ini keluaran Antam turun lagi setelah kemarin akhirnya sempat mengalami kenaikan yang signifikan. Mau beli emas? Jadi segini harganya: #HargaEmas https://t.co/FdBedUE5o1,7,1,0,0,2022-01-21,4,Friday,5,7,1
1484379905383022596,2022-01-21 04:18:42,Parlemen Prancis meloloskan resolusi yang mengecam genosida oleh China terhadap warga minoritas Muslim Uighur di Xinjiang.  https://t.co/oNK0xCluL5,11,1,1,1,2022-01-21,4,Friday,5,12,2
1484379890891821057,2022-01-21 04:18:39,"Korban kecelakaan maut yang terjadi di turunan Simpang Rapak, Balikpapan, Kalimantan Timur (Kaltim) dievakuasi ke tiga rumah sakit (RS) terdekat.  https://t.co/rnX6f3U3gs",7,0,1,0,2022-01-21,4,Friday,5,8,0
1484379631155351554,2022-01-21 04:17:37,Desa wisata menjadi salah satu tujuan liburan yang sedang dikembangkan pemerintah. https://t.co/o5NHmutBXE,7,0,0,0,2022-01-21,4,Friday,5,7,0
1484379629926461444,2022-01-21 04:17:36,Sudah banyak ditemukan pelaku usaha yang memanfaatkan kendaraan sebagai tempat jualan. Berikut daftar mobil bekas untuk bisa cari cuan! https://t.co/kYLDcI2MAz,5,0,0,0,2022-01-21,4,Friday,5,5,0
1484379504571150344,2022-01-21 04:17:06,"Angka kematian akibat Corona terus naik di Australia. Akibatnya, negara bagian Australia Barat membatalkan rencana membuka perbatasan domestik.  https://t.co/9kheBElFOn",14,0,2,2,2022-01-21,4,Friday,5,16,2
1484379487995252736,2022-01-21 04:17:03,"Anies Baswedan tanggapi masalah pembangunan sirkuit yang belum mulai oleh Ketum PSI, Giring Ganesha sempat mendatangi venue Formula E di Ancol.  https://t.co/z9PzRZkL9D",4,6,0,0,2022-01-21,4,Friday,5,4,6
1484379001896407043,2022-01-21 04:15:07,Sebuah video yang menunjukkan seorang siswa SD disuntik dengan vaksin kosong viral di media sosial. Peristiwa itu disebut terjadi di Kota Medan.  https://t.co/sBZqv3DQ8H,7,1,1,0,2022-01-21,4,Friday,5,8,1
1484378982518648842,2022-01-21 04:15:02,"Ardhito Pramono hari ini dibawa ke RSKO untuk rehabilitasi. Keluar dari Polres Jakarta Barat, Ardhito kelihatan segar dan stylish. https://t.co/zrEfx7NUbB",5,4,0,1,2022-01-21,4,Friday,5,5,5
1484378730311081984,2022-01-21 04:14:02,"5 orang tewas dalam kecelakaan maut truk tronton di wilayah Muara Rapak, Kota Balikpapan, Kaltim. 20 kendaraan rusak akibat diseruduk tronton maut tersebut.  https://t.co/OlQVVxX40m",22,3,8,0,2022-01-21,4,Friday,5,30,3
1484378716205551616,2022-01-21 04:13:59,"Australia Award Indonesia memberikan beasiswa S2 dan S3. Bagi detikers yang tertarik mencoba simak info di bawah ini ya!

via: detikedu https://t.co/Gq9x9nFStu",5,0,8,0,2022-01-21,4,Friday,5,13,0
1484378476165550082,2022-01-21 04:13:01,Polemik pelat nopol mobil politikus PDIP Arteria Dahlan belum usai. Salah satu mobil Arteria yang terparkir di DPR ternyata tercatat menunggak pembayaran pajak!  https://t.co/oesonZG0gK,176,108,46,21,2022-01-21,4,Friday,5,222,129
1484378461166841858,2022-01-21 04:12:58,"Ardhito Pramono direkomendasikan untuk menjalani rehabilitasi di RSKO Cibubur selama 6 bulan. Namun, polisi memastikan proses hukum Ardhito akan tetap berjalan.  https://t.co/QPT88iBc5S",4,0,1,0,2022-01-21,4,Friday,5,5,0
1484378208057237505,2022-01-21 04:11:57,Mommy ASF harus menghadapi kenyataan pahit saat anak kelimanya meninggal. Cerita itu juga membuat Zaskia dan Shireen menangis. https://t.co/mKbd1ypAoR,6,0,2,0,2022-01-21,4,Friday,5,8,0
1484378190487310339,2022-01-21 04:11:53,Ahli pemerintah di sidang MKmenyatakan organisasi epilepsi dunia (ILEA) belum sepakat ganja bisa dipakai untuk terapi kesehatan.  https://t.co/NRIzfm0Xgs,8,1,3,1,2022-01-21,4,Friday,5,11,2
1484377856562003971,2022-01-21 04:10:34,Bank investasi terbesar Amerika Serikat (AS) Goldman Sachs (GS.N) dan JPMorgan Chase (JPM.N) akan menaikkan bonus kepada pegawainya. Mantap banget! https://t.co/4HCCu9mimZ,6,0,0,1,2022-01-21,4,Friday,5,6,1
1484377615154565123,2022-01-21 04:09:36,Musisi sekaligus aktor Ardhito Pramono menyampaikan permintaan maaf sebesar-besarnya kepada masyarakat luas usai jadi tersangka narkoba.  https://t.co/b9d8Iaa3Zm,16,15,2,0,2022-01-21,4,Friday,5,18,15
1484377600822677504,2022-01-21 04:09:33,Tentu siapa saja boleh berandai-andai jika nama ibu kota baru bukan Nusantara. Dahlan Iskan sebut sempat muncul usulan agar nama itu adalah Atlantis. https://t.co/htvCzmCOOJ,48,26,6,9,2022-01-21,4,Friday,5,54,35
1484377359838953473,2022-01-21 04:08:35,"Enam pemuda di Kabupaten Mamuju, Sulawesi Barat (Sulbar) memperkosa gadis 19 tahun. Mereka memperkosa korban secara bergantian.  https://t.co/1NZAR1b7cS",15,1,3,3,2022-01-21,4,Friday,5,18,4
1484377294604959749,2022-01-21 04:08:20,"Ekspor mobil buatan Indonesia meningkat! Tahun 2021 lalu, mobil rakitan dalam negeri yang dikirim ke luar negeri bertambah banyak. https://t.co/o4TaHeXi7j",25,11,6,3,2022-01-21,4,Friday,5,31,14
1484377058390147076,2022-01-21 04:07:23,Beredar tangkapan layar profil WhatsApp mengaku Wakil Bupati Sukoharjo Agus Santoso menawarkan bantuan untuk masjid. Diskominfo tegaskan itu kabar palsu!  https://t.co/zUp2kdUKKs,4,0,0,0,2022-01-21,4,Friday,5,4,0
1484377037317963778,2022-01-21 04:07:18,Cataflam kerap dipakai untuk mengatasi rasa nyeri atau sakit dan peradangan. Kenali dulu serba-serbi obat ini sebelum meminumnya.  https://t.co/UtqbeLNSAl,8,0,2,0,2022-01-21,4,Friday,5,10,0
1484376237791342593,2022-01-21 04:04:08,"Ganjar Pranowo dan wakilnya tak disebut saat Puan Maharani meresmikan Pasar Legi Solo, kemarin siang. Malamnya, Ganjar utus wakilnya hadiri konser di ISI Solo.  https://t.co/brnUTGRppA",15,2,1,2,2022-01-21,4,Friday,5,16,4
1484376220540157953,2022-01-21 04:04:04,Seorang pemotor wanita bernama Titik Dwi Sumiati (60) yang hilang usai ditemukan dalam kondisi tewas. Jasad korban awalnya dikira boneka oleh tim pencari.  https://t.co/85Tf8ypp7R,5,3,0,0,2022-01-21,4,Friday,5,5,3
1484375963492237317,2022-01-21 04:03:02,"Saat ini Jakarta International Stadium (JIS) tengah dalam penyelesaian. Wisatawan sudah bisa berkunjung untuk melihatnya secara dekat, seperti ini caranya! https://t.co/lUsabWNYbG",26,4,2,1,2022-01-21,4,Friday,5,28,5
1484375943648976899,2022-01-21 04:02:57,"Ganjar Pranowo kembali tak muncul dalam acara Puan Maharani. Kali ini, Ganjar absen di peresmian Pasar Legi, Solo.  https://t.co/9P6dsiGPvx",13,3,0,1,2022-01-21,4,Friday,5,13,4
1484375694519848962,2022-01-21 04:01:58,"Air putih kaya manfaat terutama jika diminum di pagi hari setelah bangun tidur, sehingga penting untuk dilakukan setiap harinya.   https://t.co/CY4RRyIOqN",24,1,8,4,2022-01-21,4,Friday,5,32,5
1484375510297694213,2022-01-21 04:01:14,"Taman Mini Indonesia Indah (TMII) mendadak menjadi perbincangan netizen di Twitter, dikarenakan kondisi terkini dari TMII. https://t.co/meLyJ9YnRx",18,0,2,2,2022-01-21,4,Friday,5,20,2
1484375150254387204,2022-01-21 03:59:48,Zainal Hudha mengisi kursi kosong sebagai manajer baru dari Madura United.  https://t.co/rb5KdQfyQg,9,0,0,0,2022-01-21,3,Friday,5,9,0
1484374897996402689,2022-01-21 03:58:48,Kedatangan Doddy Sudrajat untuk menjemput Gala Sky di rumah Faisal saat itu memang sudah disiapkan. https://t.co/9PkcknqPqr,6,2,0,0,2022-01-21,3,Friday,5,6,2
1484374702709620741,2022-01-21 03:58:02,Kabar terbaru dari letusan gunung api bawah laut Tonga terus mencari perhatian. Dikatakan terdapat pulau-pulau baru bermunculan! https://t.co/oNUOYGx6DL,16,0,4,0,2022-01-21,3,Friday,5,20,0
1484374626411053056,2022-01-21 03:57:43,Ralf Rangnick menilai Bruno Fernandes lebih optimal dimainkan di nomor 8. Hal itu dibuktikan dengan performa apiknya saat jumpa Brentford. https://t.co/lnhbcHvRAZ,7,0,0,0,2022-01-21,3,Friday,5,7,0
1484374625115156481,2022-01-21 03:57:43,Lima pemain Arema FC yang berlaga pada Liga 1 2021 di Bali terkonfirmasi positif COVID-19. https://t.co/LtW3dwiCs9,9,0,2,0,2022-01-21,3,Friday,5,11,0
1484374354712412161,2022-01-21 03:56:39,BMKG memperkirakan seluruh wilayah di Sulawesi Selatan diguyur hujan hari ini. Warga juga diminta mewaspadai hujan disertai kilatan petir di wilayah tertentu.  https://t.co/dutejM8k25,7,0,0,0,2022-01-21,3,Friday,5,7,0
1484374335699648512,2022-01-21 03:56:34,"Kecelakaan maut menewaskan 5 orang terjadi di wilayah Muara Rapak, Kota Balikpapan, Katim, Jumat (21/1/2022). Begini kronologinya.  https://t.co/AHzyFdXwGm",836,87,185,62,2022-01-21,3,Friday,5,1021,149
1484373972389036041,2022-01-21 03:55:08,MA berterimakasih dan mengapresiasi langkah KPK yang melakukan OTT terhadap hakim PN Surabaya Itong Isnaeni Hidayat.   https://t.co/9is6ZVu7bw,11,0,3,1,2022-01-21,3,Friday,5,14,1
1484373588027187202,2022-01-21 03:53:36,Foto Wali Kota Bekasi nonaktif Rahmat Effendi menghadiri rapat zoom meski tengah ditahan di rutan KPK beredar di media sosial. KPK pun membenarkan bahwa Pepen menghadiri rapat di dalam rutan. https://t.co/3SmGOFE3HX,6,6,2,1,2022-01-21,3,Friday,5,8,7
1484373322942992385,2022-01-21 03:52:33,Polisi meringkus pelaku vandalisme di Jalan Babakan Siliwangi Bandung. Ada satu orang pelaku yang saat ini masih dalam pemeriksaan.  https://t.co/p6Sk3PUJEB,3,0,0,0,2022-01-21,3,Friday,5,3,0
1484373311924494339,2022-01-21 03:52:30,"Sebuah makam tiba-tiba muncul di gerbang masuk Perumahan Gading Residen, Cangkuang, Kabupaten Bandung. Begini faktanya!  https://t.co/7MJMlkRcxP",6,3,1,1,2022-01-21,3,Friday,5,7,4
1484373011520122882,2022-01-21 03:51:18,Polisi menyebut laporan yang dilayangkan Majelis Adat Sunda terkait pernyataan Arteria Dahlan bentuknya merupakan pengaduan.  https://t.co/TDW8BgyPEo,5,2,1,1,2022-01-21,3,Friday,5,6,3
1484372997305561099,2022-01-21 03:51:15,"Kecelakaan lalu lintas terjadi di Jl Raya Ciomas, Bogor. Sebuah truk menabrak pria yang sedang membantu Ibu yang membonceng anaknya parkir keluar sekolah.  https://t.co/pI0RXJiGvq",10,0,3,2,2022-01-21,3,Friday,5,13,2
1484372739653660672,2022-01-21 03:50:14,Barcelona lelah dengan Ousmane Dembele dan memintanya segera cabut. Sikap dari Barcelona tersebut dikecam Asosiasi Pesepakbola Spanyol. https://t.co/Egwqy4pKiP,8,0,0,1,2022-01-21,3,Friday,5,8,1
1484372712076111874,2022-01-21 03:50:07,"Kamera pengawas atau CCTV merekam detik-detik mengerikan kecelakaan maut truk tronton tabrak sejumlah pengendara di Balikpapan, Kaltim.  https://t.co/nQMYTlJYV0",15,0,5,4,2022-01-21,3,Friday,5,20,4
1484371626632179712,2022-01-21 03:45:48,"Polisi mengamankan sopir truk tronton yang menyebabkan kecelakaan maut di Simpang Rapak, Balikpapan, Kalimantan Timur (Kaltim).  https://t.co/hj5LYuZz8L",56,7,10,3,2022-01-21,3,Friday,5,66,10
1484371356988833801,2022-01-21 03:44:44,"Kecelakaan maut terjadi di turunan wilayah Muara Rapak, Kota Balikpapan, Kalimantan Timur (Kaltim).  https://t.co/P7TuAcOgS9",44,2,18,3,2022-01-21,3,Friday,5,62,5
1484370613690986497,2022-01-21 03:41:47,Sani Rizki Fauzi kembali dipanggil ke Timnas Indonesia dan bertekad membuktikan diri ke Shin Tae-yong. https://t.co/OStNg9FCwA,8,1,0,0,2022-01-21,3,Friday,5,8,1
1484370295888564226,2022-01-21 03:40:31,"Berhasil mengalahkan Lecce 3-1 di 16 besar Coppa Italia, ujian selanjutnya bagi AS Roma adalah melawan Inter Milan. https://t.co/RFjdKjzI36",9,0,1,0,2022-01-21,3,Friday,5,10,0
1484369775224496128,2022-01-21 03:38:27,"Muslim yang menyantap makanan halal akan mendapat banyak manfaat, salah satunya keberkahan. Makanan halal juga mudah didapat dan menyehatkan.  https://t.co/ExGyxjph4K",14,3,0,0,2022-01-21,3,Friday,5,14,3
1484369042450251786,2022-01-21 03:35:32,"Di warung Ayam Geprek Hanis di Jatipadang, Jakarta Selatan. Dilihat dari luar, warung makan ini tampak sepi. Tapi rasanya enak dan harganya murah meriah.  https://t.co/rXyaKo9tLM",14,0,2,0,2022-01-21,3,Friday,5,16,0
1484368251752632323,2022-01-21 03:32:24,"Google memigrasi layanan G Suite edisi lama ke Workspace. Imbasnya layanan tidak gratis lagi dan diharuskan berlangganan, bila tidak akun bakal ditangguhkan. https://t.co/Lhnu1IHX07",8,0,1,2,2022-01-21,3,Friday,5,9,2
1484367487877599232,2022-01-21 03:29:21,"Sempat tertinggal lebih dulu, Real Madrid berhasil mengalahkan Elche 2-1 di laga Copa del Rey. https://t.co/CnltjaMAOO",13,0,2,0,2022-01-21,3,Friday,5,15,0
1484366481060089857,2022-01-21 03:25:21,Polda Metro Jaya berhasil menilang ratusan kendaraan berpelat khusus dan rahasia. https://t.co/4AWJc36bcn,12,3,2,1,2022-01-21,3,Friday,5,14,4
1484365103570952195,2022-01-21 03:19:53,"Soal Nusantara terpilih jadi nama resmi calon Ibu Kota Negara menarik perhatian Sejarawan UGM. Ia tidak setuju dengan pemilihan nama tersebut. Kenapa?

via: detikedu https://t.co/RYiQgRvRHz",20,3,3,2,2022-01-21,3,Friday,5,23,5
1484364260071260162,2022-01-21 03:16:32,Akhirnya! Klub asal Slovakia itu memperpanjang kontrak Egy Maulana Vikri. https://t.co/WuGNn128cP,14,0,2,0,2022-01-21,3,Friday,5,16,0
1484363988678811651,2022-01-21 03:15:27,Hasil asesmen BNNP DKI terhadap musisi Ardhito Pramono sudah keluar. Ardhito direkomendasikan untuk menjalani proses rehabilitasi di RSKO Cibubur selama 6 bulan.  https://t.co/QDwF9wigPi,10,2,3,3,2022-01-21,3,Friday,5,13,5
1484363729873498114,2022-01-21 03:14:26,Liverpool berhasil mengalahkan Arsenal 2-0 di semifinal leg kedua Piala Liga Inggris dan menantang Chelsea di final. https://t.co/rqaqG9cH1X,11,0,2,3,2022-01-21,3,Friday,5,13,3
1484362717431353346,2022-01-21 03:10:24,"Dalam rangka mengantisipasi perubahan iklim, berbagai solusi dikemukakan, salah satunya adalah upaya meredupkan Matahari. Akan tetapi para ilmuwan ini teriak. https://t.co/HE2JxhPejb",30,16,8,9,2022-01-21,3,Friday,5,38,25
1484362209102753802,2022-01-21 03:08:23,PT Yamaha Indonesia membeberkan data penjualan pada hari peluncuran Yamaha Fazzio Hybrid Connected. Data tersebut menunjukan respons konsumen yang melakukan indent online melalui marketplace sebanyak 1.000 unit pertama dalam waktu kurang dari 5 jam. https://t.co/6Ur2rcEsok,8,1,3,1,2022-01-21,3,Friday,5,11,2
1484361690594496520,2022-01-21 03:06:19,"Minum kopi pakai gula jadi kebiasaan banyak penikmat kopi. Penambahan gula dianggap membuat kopi lebih nikmat. Dari sisi kesehatan, seperti apa risikonya?  https://t.co/tsVjAomdsU",14,0,4,1,2022-01-21,3,Friday,5,18,1
1484361669476159488,2022-01-21 03:06:14,Ardhito Pramono mengungkapkan penyesalan dan permintaan maafnya karena terjerumus narkoba. Dia berharap tak ada lagi kasus serupa terjadi.  https://t.co/STPM5UBEtu,16,4,2,3,2022-01-21,3,Friday,5,18,7
1484361443587739652,2022-01-21 03:05:20,"Banjir melanda Desa Kademangan, Kecamatan Mojoagung, Jombang. Sedikitnya 145 rumah warga terendam dan 25 orang terpaksa mengungsi.  https://t.co/nI8zBsMk8u",4,0,2,0,2022-01-21,3,Friday,5,6,0
1484361442430111744,2022-01-21 03:05:20,Tak ada manusia yang tak ingin masuk surga. Berikut amalan untuk para calon penghuni surga:  https://t.co/LuyCIs6hKU,11,1,2,1,2022-01-21,3,Friday,5,13,2
1484361193582067714,2022-01-21 03:04:21,Eunhyuk Super Junior terinfeksi Covid-19. Label SJ selaku agensi yang menaungi Super Junior telah mengumumkannya pada Kamis (20/1). Eunhyuk menjadi member ketiga Super Junior yang terpapar Corona setelah Siwon dan Shindong. https://t.co/YZo5tGvNvE,10,0,3,0,2022-01-21,3,Friday,5,13,0
1484361192000798727,2022-01-21 03:04:20,Pemindahan Ibu Kota Negara ke Kalimantan Timur dihitung akan membutuhkan biaya hingga Rp 466 triliun. Dari mana duitnya? https://t.co/N1klewvmJx,162,140,28,27,2022-01-21,3,Friday,5,190,167
1484360371653599238,2022-01-21 03:01:05,"Polisi tak butuh waktu lama mengungkap kasus video mesum viral di medsos. Usai penyelidikan, polisi berhasil mengidentifikasi kedua pelaku. Keduanya diamankan  https://t.co/mnE3hRu8dO",5,6,2,7,2022-01-21,3,Friday,5,7,13
1484359805091213315,2022-01-21 02:58:50,"James Ward-Prowse dianggap bakal cocok bermain di Liverpool, sebagai pengganti James Milner di lini tengah Si Merah. https://t.co/MMXjSUGIeN",12,1,3,2,2022-01-21,2,Friday,5,15,3
1484359790121811971,2022-01-21 02:58:46,Pemerintah sudah memulai program vaksinasi COVID-19 lanjutan untuk masyarakat umum. Ini cara cek jadwal vaksin ke-3 di PeduliLindungi:  https://t.co/JxA1W5ZLcx,12,1,7,0,2022-01-21,2,Friday,5,19,1
1484358528525488130,2022-01-21 02:53:45,Erika Carlina tak tertarik dengan bule meski didekati Charlie Puth. Erika Carlina lebih suka dengan cowok Indonesia. https://t.co/ApEKshvFug,32,14,3,5,2022-01-21,2,Friday,5,35,19
1484357473662242816,2022-01-21 02:49:34,"Fenomena langka kembali terjadi di Gurun Sahara, gurun tersebut berselimut salju! https://t.co/1AqzWEGBIb",57,5,10,3,2022-01-21,2,Friday,5,67,8
1484357267486961670,2022-01-21 02:48:45,Penampilan Daniel Adnan jadi sorotan lantaran masuk ke warteg masih memakai busana pesta. https://t.co/toTXnnD99o,13,2,2,1,2022-01-21,2,Friday,5,15,3
1484357263812820998,2022-01-21 02:48:44,"Kecelakaan truk kontainer terjadi di Jalan Enggano Raya arah Tanjung Priok, Jakarta Utara. Imbas kecelakaan itu, lalu lintas di lokasi dilaporkan macet parah.  https://t.co/Bon20FfaIE",14,1,4,3,2022-01-21,2,Friday,5,18,4
1484356772252958727,2022-01-21 02:46:47,Album Virus nampaknya jadi perbincangan dan sangat ikonik dengan grup band Slank. Ini fakta di balik cover album Slank:  https://t.co/LiLINAq8mw,16,0,1,1,2022-01-21,2,Friday,5,17,1
1484355770539855874,2022-01-21 02:42:48,Kementerian Komunikasi dan Informatika merespon terkait kebocoran data Bank Indonesia. Ini tanggapan Kominfo:  https://t.co/xjKiBPjdOX,15,5,7,8,2022-01-21,2,Friday,5,22,13
1484355516016967680,2022-01-21 02:41:47,"Aljazair yang berstatus juara bertahan, tidak lolos ke 16 besar Piala Afrika 2021. Berikut 16 negara yang lolos ke fase gugur. https://t.co/ZEahVii0aO",10,0,0,0,2022-01-21,2,Friday,5,10,0
1484355034288508934,2022-01-21 02:39:52,"Nadzira Shafa kembali aktif di Instagram. Ia mengunggah foto mendiang suaminya, Ameer Azzikra, di awal kemunculannya di media sosial lagi usai sebulan tampak sunyi. https://t.co/5JusGptIzv",9,0,0,0,2022-01-21,2,Friday,5,9,0
1484354513943207947,2022-01-21 02:37:48,"Akbar Wicaksono telah jadi pengusaha digital sukses. Di balik itu, ia pernah dikecewakan teman baik, duitnya dibawa kabur Rp 100 juta. Waduh...  https://t.co/ROM97XyhYf",24,2,2,0,2022-01-21,2,Friday,5,26,2
1484353076844662790,2022-01-21 02:32:06,"Kalah dari Athletic Bilbao dengan skor 2-3, Barcelona terdepak dari Copa del Rey 2021/2022. https://t.co/6toUSPtvgI",8,0,0,0,2022-01-21,2,Friday,5,8,0
1484353005306531846,2022-01-21 02:31:49,"Siapa yang zodiaknya Taurus? Pikiran harus tetap tenang terutama di dalam membuat keputusan sebaiknya jangan terburu-buru. Yuk, intip kata zodiak lainnya. https://t.co/dtFM42mx3N",3,1,1,1,2022-01-21,2,Friday,5,4,2
1484352431295119361,2022-01-21 02:29:32,Geng jalanan di Liberia menyerang sebuah acara keagamaan di sebuah gereja di ibu kota Monrovia. Sebanyak 29 orang tewas terinjak-injak akibat insiden ini.  https://t.co/BLW1CPsBmc,11,2,2,0,2022-01-21,2,Friday,5,13,2
1484351944810385419,2022-01-21 02:27:36,"Kejaksaan Tinggi Sumut menangkap wanita berinisial M (52) terpidana kasus korupsi pembelian minyak yang merugikan negara Rp 7,3 miliar yang menjadi buronan.  https://t.co/agNXwzun0J",14,0,2,0,2022-01-21,2,Friday,5,16,0
1484351411236184064,2022-01-21 02:25:29,"Meeting online parlemen Italia dibajak dan terjadi hal yang sangat mengejutkan. Sebuah cuplikan video porno, tayang selama kurang lebih 30 detik. https://t.co/QWl81FMvby",14,6,5,2,2022-01-21,2,Friday,5,19,8
1484351117290983430,2022-01-21 02:24:18,KPK mengawali tahun 2022 dengan melakukan 4 operasi tangkap tangan (OTT) hingga kini. Namun ICW ingatkan akan korupsi bansos jangan sampai terlupakan.  https://t.co/YWLImFpQU0,8,6,1,0,2022-01-21,2,Friday,5,9,6
1484350920397705216,2022-01-21 02:23:31,Gaga Muhammad telah divonis bersalah atas kasus kelalaian berkendara. Ini faktor pengacara serius ajukan banding. https://t.co/MlgeiC6Lgx,3,0,0,1,2022-01-21,2,Friday,5,3,1
1484350245027082242,2022-01-21 02:20:50,Pemindahan Ibu Kota Negara (IKN) dari Jakarta ke Kalimantan Timur (Kaltim) pasti dilakukan. Ini tahapan lengkapnya: https://t.co/SThRvFifsT,11,4,1,0,2022-01-21,2,Friday,5,12,4
1484348527665119232,2022-01-21 02:14:01,"Nantikan di minggu ini, @mommiesdaily Power Hour Vol. 2! #MDPHVol2 Berisi talkshow dan diskusi menarik ttg kesehatan mental, keuangan, dan sex &amp; relationship, langsung bersama ahlinya!😍💖

Nantikan streaming-nya di Instagram @mommiesdailydotcom &amp; subscribe YouTube Mommies Daily https://t.co/Hqzp5wjfI2",4,0,0,0,2022-01-21,2,Friday,5,4,0
1484348371934478339,2022-01-21 02:13:24,Ini deretan aktris Korea yang jadi istri konglomerat dan punya harta berlimpah:  https://t.co/sh2EU36Mpx,7,1,1,0,2022-01-21,2,Friday,5,8,1
1484347819213266947,2022-01-21 02:11:12,Ketua DPRD DKI Prasetyo Edi Marsudi berharap Jakarta nantinya jadi seperti New York usai Ibu Kota Negara dipindah. Dia berharap Jakarta jadi pusat bisnis.  https://t.co/N9khHTzC9j,39,14,5,6,2022-01-21,2,Friday,5,44,20
1484347266747961345,2022-01-21 02:09:00,"Kasus varian Omicron di DKI Jakarta terus mengalami peningkatan. Total hingga saat ini tercatat sebanyak 1.027 kasus, didominasi kasus impor. https://t.co/C8Lfpy0ZLe",5,0,1,2,2022-01-21,2,Friday,5,6,2
1484346703662628874,2022-01-21 02:06:46,Terdakwa kasus dugaan penistaan agama M Kace kembali masuk RSUD Ciamis. Ia dibawa ke rumah sakit karena kondisinya drop setelah mengikuti sidang di PN Ciamis.  https://t.co/ohHMBJRM91,6,3,0,2,2022-01-21,2,Friday,5,6,5
1484345811806744577,2022-01-21 02:03:14,"Oli tumpah di Jl Letjen Suprapto, Jakarta Pusat, tepatnya di underpass Senen. Akibatnya, beberapa motor terjatuh di lokasi kejadian.  https://t.co/GSPEacEmZU",2,0,0,0,2022-01-21,2,Friday,5,2,0
1484345170749321219,2022-01-21 02:00:41,Lionel Messi menuai kecaman dari media Jerman karena tak memilih striker Bayern Munchen Robert Lewandowski di The Best FIFA 2021. #CNNIndonesia #detiknetwork  https://t.co/jBPrd3QeSF,3,1,1,0,2022-01-21,2,Friday,5,4,1
1484344106457329667,2022-01-21 01:56:27,"Rumah tangganya sempat dikabarkan retak, Shandy Aulia terlihat bersama lagi dengan sang suami. Ini alasan Shandy soal kembali dengan sang suami:  https://t.co/ItMXPL9crn",7,1,0,1,2022-01-21,1,Friday,5,7,2
1484343317332574212,2022-01-21 01:53:19,Selebgram Ayu Wisya muncul dan bicara soal laporan Doddy Sudrajat. Ayu Wisya tak gentar dilaporkan Doddy ke polisi karena dianggap menghina Mayang. https://t.co/tgbSPPorlX,12,0,1,1,2022-01-21,1,Friday,5,13,1
1484342245696311301,2022-01-21 01:49:03,Ketum Kadin Arsjad Rasjid menekankan perpanjangan masa jabatan Jokowi harus berlandaskan hukum. Dia juga bicara soal kans jadi ketum partai politik. #blakblakan   https://t.co/ncZVCeGt2N,8,1,0,0,2022-01-21,1,Friday,5,8,1
1484341251776270344,2022-01-21 01:45:06,Kisah cinta negara sering jadi daya tarik sendiri. 5 pengakuan pria bule soal alasannya terpikat dengan wanita Indonesia ini viral. Apa saja ya? https://t.co/OCO2MLLVyR,13,6,1,0,2022-01-21,1,Friday,5,14,6
1484340323325071362,2022-01-21 01:41:25,Serba pertama Angel Karamoy. Dari dengar token listrik bunyi dan makan telor gulung. #AngelKaramoy  https://t.co/M8VkTHnqVQ,11,3,0,1,2022-01-21,1,Friday,5,11,4
1484339842280407050,2022-01-21 01:39:30,Eunhyuk Super Junior dinyatakan positif COVID-19. Label SJ merilis pernyataan dan membenarkan kabar tersebut. Lekas pulih Eunhyuk... https://t.co/2lBzqRIAk8,10,2,0,0,2022-01-21,1,Friday,5,10,2
1484334960978776065,2022-01-21 01:20:06,Pelaku diet dianjurkan mengonsumsi kopi hitam kalau ingin menurunkan berat badan. Kalau ingin meracik kopi lebih nikmat bisa memakai bahan yang aman berikut.  https://t.co/U7mDJJko3K,14,1,3,0,2022-01-21,1,Friday,5,17,1
1484333825031241728,2022-01-21 01:15:36,"Mobil dinas milik Lapas Gobah, Pekanbaru, Riau, dibakar orang tak dikenal. Mobil dibakar dini hari tadi saat diparkirkan di rumah. https://t.co/wCd3Hf4qoH",5,1,0,0,2022-01-21,1,Friday,5,5,1
1484333807587106819,2022-01-21 01:15:31,KPK menyayangkan Rahmat Effendi lantaran menyalahgunakan hak untuk melakukan zoom meeting dengan menghubungi pihak lain selain keluarga dari dalam rutan.  https://t.co/PLoOA4tSPc,8,2,0,0,2022-01-21,1,Friday,5,8,2
1484332548851335175,2022-01-21 01:10:31,Menparekraf Sandiaga Uno menyebut kunjungan wisatawan ke desa wisata sepanjang tahun 2021 mengalami kenaikan sebesar 30% dibandingkan periode https://t.co/jlowya8roq,10,0,0,1,2022-01-21,1,Friday,5,10,1
1484332528521465860,2022-01-21 01:10:27,"Sudah mulai menunjukkan hubungan mereka ke publik. Susan Sameh dan pebulutangkis Fajar Alfian makin mesra, apalagi saat makan bareng.  https://t.co/eb6AQLuCeU",10,0,1,0,2022-01-21,1,Friday,5,11,0
1484332269737168904,2022-01-21 01:09:25,Bruder Angelo divonis 14 tahun penjara. Terdakwa pelecehan seksual itu dinyatakan bersalah melakukan tindak pidana pencabulan terhadap anak di panti asuhannya.  https://t.co/Ekb5Xhsp63,17,0,1,0,2022-01-21,1,Friday,5,18,0
1484331771181240321,2022-01-21 01:07:26,"Anak berusia 5 tahun di Pamulang, Tangerang Selatan, menjadi korban perilaku bejat seorang kuli berinisial S (36). KPAI merasa prihatin atas kasus tersebut.  https://t.co/SNtIdLpvqs",7,2,3,1,2022-01-21,1,Friday,5,10,3
1484331013174030337,2022-01-21 01:04:25,Sani Rizki Fauzi kembali dipanggil ke Timnas Indonesia. Gelandang Bhayangkara FC itu bertekad membuktikan diri ke Shin Tae-yong. https://t.co/wytfWJ3vVB,7,0,0,0,2022-01-21,1,Friday,5,7,0
1484330488655335432,2022-01-21 01:02:20,Isu bocornya operasi tangkap tangan (OTT) KPK menyeruak setelah Bupati Langkat Terbit Rencana Perangin Angin dikabarkan sempat kabur saat hendak ditangkap.  https://t.co/cG6Udll8b9,5,1,0,1,2022-01-21,1,Friday,5,5,2
1484330471475482635,2022-01-21 01:02:16,"Asa berdamai dengan Nicholas Sean Purnama, diutarakan Ayu Thalia usai dirinya menjadi tersangka kasus pencemaran nama baik atas laporan dari anak Ahok itu.  https://t.co/ThP9ytoF2r",4,4,0,0,2022-01-21,1,Friday,5,4,4
1484330121066520587,2022-01-21 01:00:53,"Meski damai ditolak, keinginan Ayu Thalia agar kasusnya dengan anak Ahok bisa diselesaikan dengan baik-baik.  https://t.co/xETYQl1dXO",22,35,2,3,2022-01-21,1,Friday,5,24,38
1484330112208101383,2022-01-21 01:00:50,Tagar #SundaTanpaPDIP bergema di Twittter. Tagar tersebut muncul imbas dari ucapan Arteria Dahlan yang meminta Kajati berbahasa Sunda dicopot!  https://t.co/PFayNGSBwd,549,127,209,56,2022-01-21,1,Friday,5,758,183
1484329833001734144,2022-01-21 00:59:44,"Hakim Pengadilan Negeri (PN) Surabaya, Jawa Timur Itong Isnaeni Hidayat membantah omongan pimpinan KPK saat menggelar konferensi pers di Gedung KPK Jakarta.  https://t.co/d2zAsNhJWg",6,1,1,1,2022-01-21,0,Friday,5,7,2
1484329541132640258,2022-01-21 00:58:34,"Belum selesai dibanjiri kritik soal ""Kajati bicara Sunda', anggota DPRD Fraksi PDIP, Arteria Dahlan disorot lagi lantaran pelat nomor kendaraannya sama semua!  https://t.co/lFAfWCLYjx",18,9,1,4,2022-01-21,0,Friday,5,19,13
1484329539677286401,2022-01-21 00:58:34,Anggota Komisi III DPR RI Arteria Dahlan menuai kontroversi karena meminta Kajati yang memakai bahasa Sunda saat rapat diganti. Arteria pun meminta maaf. https://t.co/EHqUI1aWTG,5,1,0,2,2022-01-21,0,Friday,5,5,3
1484329299461099523,2022-01-21 00:57:37,"Makin melonjaknya kasus Omicron membuat banyak orang penasaran tentang gejala yang ditimbulkannya. Jadi, apa saja sih gejaanya? Ini penegasan Satgas COVID-19. https://t.co/kqzeyROdmR",5,1,0,2,2022-01-21,0,Friday,5,5,3
1484329019248021507,2022-01-21 00:56:30,"M Yusuf (40), suami di Palembang, tega menyiram istrinya SH (30) dan anak tirinya DA (7) dengan air keras. Aksi kejam M Yusuf itu berakhir di kantor polisi.  https://t.co/JLYhP0GQpZ",4,1,0,2,2022-01-21,0,Friday,5,4,3
1484329000931446784,2022-01-21 00:56:25,Hakim PN Surabaya Itong Isnaeni Hidayat ditetapkan KPK sebagai tersangka kasus dugaan suap. Itong menyebut suap yang disampaikan KPK hanyalah sebuah dongeng!  https://t.co/rUvxquvElO,5,0,0,1,2022-01-21,0,Friday,5,5,1
1484328491529031680,2022-01-21 00:54:24,"Belum selesai dibanjiri kritik soal ""Kajati bicara Sunda', anggota DPRD Fraksi PDIP, Arteria Dahlan disorot lagi lantaran pelat nomor kendaraannya sama semua. https://t.co/klUsCQ8VOX",17,14,8,5,2022-01-21,0,Friday,5,25,19
1484327723623354370,2022-01-21 00:51:21,"Hakim PN Surabaya, Itong Isnaeni Hidayat tak terima ditetapkan sebagai tersangka setelah terjaring OTT oleh KPK. Itong menyebut KPK omong kosong!  https://t.co/UVY7rYNcN3",10,0,2,3,2022-01-21,0,Friday,5,12,3
1484326649529180161,2022-01-21 00:47:05,Vaksinasi anak di bawah 12 tahun untuk COVID-19 kini sudah bisa dilakukan di seluruh Indonesia. Berikut persyaratan hingga jenis vaksin yang wajib diketahui. https://t.co/yqxJFXvkmN,12,1,1,0,2022-01-21,0,Friday,5,13,1
1484326129691332610,2022-01-21 00:45:01,Abdul Muhaimin Iskandar mengaku sangat percaya diri menyalonkan diri sebagai calon presiden di 2024. Sebab ia mendapat perintah dari para kiai. https://t.co/AbqIsFAJCF,15,22,1,1,2022-01-21,0,Friday,5,16,23
1484325866247098371,2022-01-21 00:43:58,Stres ialah suatu kondisi di mana seseorang berada di dalam ketegangan karena adanya tidak jelasan antara harapan dan kenyataan. https://t.co/eCkxFiMzUq,36,2,8,0,2022-01-21,0,Friday,5,44,2
1484325387312119815,2022-01-21 00:42:04,"Hendra menuturkan sesaat usai ditembak, ketiga prajurit dilarikan dengan helikopter. Mereka dievakuasi dari Maybrat ke RSAL di Sorong. https://t.co/afRcQ8FkYc",14,1,1,2,2022-01-21,0,Friday,5,15,3
1484324895576051719,2022-01-21 00:40:07,Sekjen PAN Eddy Soeparno bersyukur Arteria Dahlan sudah minta maaf kepada masyarakat Sunda. Eddy mengingatkan anggota DPR harus peka terhadap kultur masyarakat. https://t.co/QY89eQ39of,16,0,1,3,2022-01-21,0,Friday,5,17,3
1484324376501637121,2022-01-21 00:38:03,"Sungguh keji aksi seorang suami di Duren Sawit, Jakarta Timur, berinisial W (41). Ia membunuh istrinya sendiri setelah berhubungan intim. https://t.co/KkrkRKpkO6",6,0,1,1,2022-01-21,0,Friday,5,7,1
1484323888855093248,2022-01-21 00:36:07,"Belasan kuburan di TPU Gunung Dangdeur, Kecamatan Mangkubumi, Kota Tasikmalaya ditemukan dalam keadaan rusak. Belum diketahui siapa pelaku perusakan tersebut. https://t.co/waO36W4F2q",7,2,1,0,2022-01-21,0,Friday,5,8,2
1484323378710269955,2022-01-21 00:34:05,Negosiasi antara Juventus dan Arsenal terkait transfer Arthur Melo belum menemui kata sepakat. Kedua tim belum setuju soal durasi dan status kontrak. https://t.co/fVuSCqtzYn,6,1,2,0,2022-01-21,0,Friday,5,8,1
1484322819437522944,2022-01-21 00:31:52,Pameran seni rupa bertanjuk After Mooi Indie Minangkarta digelar di Galeri RJ Katamsi ISI Yogyakarta. Pameran ini menampilkan 54 karya seni dari 54 pameris. https://t.co/BbtynmfaDT,14,0,3,0,2022-01-21,0,Friday,5,17,0
1484322294696591360,2022-01-21 00:29:47,"Dinas Pendidikan Kabupaten Lebak membantah banyak warga Lebak tak lulus SMP. Disdik mengklaim, banyak warga Lebak yang bergelar sarjana. https://t.co/Jbh5ztnp77",14,1,3,1,2022-01-21,0,Friday,5,17,2
1484321782483996675,2022-01-21 00:27:44,"Puluhan orang menggelar demo di sekitar kantor pusat Koperasi Sejahtera Bersama, di Bogor. Mereka menuntut pihak koperasi mengembalikan uang Rp 8,6 triliun. https://t.co/7uY2JIDrss",28,4,6,3,2022-01-21,0,Friday,5,34,7
1484321262767800323,2022-01-21 00:25:41,Arteria Dahlan menjelaskan alasan memarkir 5 mobilnya di DPR. Arteria beralasan kelima mobilnya diparkir di DPR karena rumahnya sedang renovasi. https://t.co/ubOrRcGia6,175,306,44,49,2022-01-21,0,Friday,5,219,355
1484320500922781699,2022-01-21 00:22:39,Dosen IPB masuk dalam daftar pemeringkatan dunia yang dikeluarkan oleh AD Scientific Index. Apa saja keahliannya? https://t.co/SebNcxo87I,47,2,6,1,2022-01-21,0,Friday,5,53,3
1484318768121597955,2022-01-21 00:15:46,Isu bocornya operasi tangkap tangan (OTT) KPK menyeruak setelah Bupati Langkat Terbit Rencana Perangin Angin dikabarkan sempat kabur saat hendak ditangkap. https://t.co/XjRqhmQXny,14,1,5,0,2022-01-21,0,Friday,5,19,1
1484318263592898560,2022-01-21 00:13:45,"Resmi! Kemenkes mengizinkan pasien Omicron isolasi mandiri. Namun tak semua pasien bisa mengikuti ketentuan ini, simak sejumlah syaratnya. https://t.co/Csium1dJjn",7,1,7,1,2022-01-21,0,Friday,5,14,2
1484317488410021894,2022-01-21 00:10:41,Efektivitas vaksin booster COVID-19 sudah melalui sejumlah riset dan kajian. Badan Pengawas Obat dan Makanan (BPOM) sudah mengungkap hasilnya. https://t.co/KJeVefmAgH,11,1,5,0,2022-01-21,0,Friday,5,16,1
1484316696441544710,2022-01-21 00:07:32,"Pria di Kota Balikpapan, Kaltim, tega memperkosa anak kandungnya sebanyak 2 kali. Pelaku memberi korban Rp 10 ribu untuk tutup mulut. https://t.co/DIfiVYKLcL",28,17,13,6,2022-01-21,0,Friday,5,41,23
1484316113299144706,2022-01-21 00:05:13,Hati-hati nih buat yang suka main ponsel secara berlebihan bisa terkena text neck syndrome loh. Kok bisa sih? Simak infonya di sini. https://t.co/m9QZ4Ano6O,16,1,5,0,2022-01-21,0,Friday,5,21,1
1484315244960698369,2022-01-21 00:01:46,"Atap masjid yang dibongkar warga karena mirip bangunan gereja di Bima, NTB, akan dibangun ulang. Desain terbaru atap masjid itu akan dibangun menggunakan kubah. https://t.co/n4yOFnllwH",16,8,4,1,2022-01-21,0,Friday,5,20,9
1482139988884131843,2022-01-14 23:58:04,"Derasnya arus modernisasi tak membuat warga Kampung Adat Ciptagelar, Sukabumi, melupakan tradisi. Warga masih terus merawat tradisi di kampung itu hingga kini. https://t.co/YOmUc60Lrs",13,0,4,1,2022-01-14,23,Friday,5,17,1
1482139226527481860,2022-01-14 23:55:03,"Razia tersebut dilakukan di area Jati Baru, Jembatan Tinggi, Kebon Jati, dan Jembatan Besi. https://t.co/SfLIfSaFmt",6,0,0,0,2022-01-14,23,Friday,5,6,0
1482137902679216128,2022-01-14 23:49:47,"Sejumlah wilayah di Cilegon, Banten, dilanda banjir usai diguyur hujan semalaman. Sekitar 315 kepala keluarga terdampak banjir tersebut. https://t.co/hCrD1R3eKC",8,0,3,0,2022-01-14,23,Friday,5,11,0
1482137672659394569,2022-01-14 23:48:52,Cristiano Ronaldo kabarnya mengeluhkan satu hal soal rekan-rekannya di Manchester United. Terkait kebugaran fisik yang dipermasalahkan CR7. https://t.co/4N4XdpAfrb,17,2,3,0,2022-01-14,23,Friday,5,20,2
1482136684204638208,2022-01-14 23:44:56,"Harga minyak goreng (Migor) kemasan mahal. Selain migor kemasan, harga migor curah juga melonjak. Penjual gorengan mengaku santai dengan kenaikan tersebut. https://t.co/BrDn3hlyuK",7,0,1,0,2022-01-14,23,Friday,5,8,0
1482135894400409601,2022-01-14 23:41:48,Sebuah foto wanita dalam keadaan telanjang dada beredar di media sosial. Foto itu disebut mirip seorang anggota DPRD Kota Medan. https://t.co/YRHCITvuzt,7,1,1,1,2022-01-14,23,Friday,5,8,2
1482134035619094528,2022-01-14 23:34:25,Partai Golkar terbuka berkoalisi dengan PKS dalam koalisi nasionalis-religius. PPP menyebut tak ada keterikatan koalisi Jokowi untuk tetap bersama pada 2024. https://t.co/CYpUy9nJ3Q,3,3,1,4,2022-01-14,23,Friday,5,4,7
1482133186679353351,2022-01-14 23:31:03,"Diklaim sebagai model yang paling andal, MacBook Pro ukuran 14 inci dan 16 inci mengusung spek paling bertenaga. #MacBook   https://t.co/E5oYu1cPXa",14,0,4,1,2022-01-14,23,Friday,5,18,1
1482131422525927424,2022-01-14 23:24:02,"Bupati Penajam Paser Utara, Abdul Gafur Mas'ud menjadi tersangka kasus dugaan suap proyek jalan. KPK akan menyelidiki aliran suap ini ke Partai Demokrat. https://t.co/85D1rjiUpl",26,9,1,5,2022-01-14,23,Friday,5,27,14
1482130655760855040,2022-01-14 23:20:59,Kisah lain terungkap di balik kasus pencurian besi bekas PT KAI oleh tiga pria di Subang. Mereka menjual besi untuk membeli susu anak. https://t.co/7pa0AGmcI3,15,0,1,3,2022-01-14,23,Friday,5,16,3
1482129911397691393,2022-01-14 23:18:02,Ratusan pedagang pasar menggelar demo di depan kantor Pemkab Bojonegoro. Demo digelar karena mendengar Bupati Anna Mu'awanah akan menutup pasar induk Bojonegoro https://t.co/xj0tjHuew8,10,1,3,1,2022-01-14,23,Friday,5,13,2
1482129404323151872,2022-01-14 23:16:01,"Seorang pria di Kota Batu terekam CCTV menodongkan pistol di Jalan Raya Pandanrejo, Kecamatan Bumiaji. Pemeriksaan yang dilakukan polisi mengungkap motif pelaku https://t.co/9LIOiSSbR7",4,0,0,1,2022-01-14,23,Friday,5,4,1
1482128907969126406,2022-01-14 23:14:02,Komika Fico Fachriza ditangkap dan jadi tersangka usai keciduk gunakan tembakau sintetis. Fico Fachriza menangis. https://t.co/fwgkBSAZQE,14,1,3,5,2022-01-14,23,Friday,5,17,6
1482128377377132547,2022-01-14 23:11:56,Polisi masih mendalami kasus penyekapan Sulistyawati gegara utang. Polisi mengungkap ada indikasi lain di kasus dugaan penyekapan itu. https://t.co/mVqyzC0ijV,3,0,0,1,2022-01-14,23,Friday,5,3,1
1482126834682802182,2022-01-14 23:05:48,Ubedillah Badrun mengadukan Gibran dan Kaesang ke KPK. Aduan Ubedillah itu dibalas JoMan dengan melaporkannya ke polisi atas tuduhan penyebaran hoax. https://t.co/uyhj0D41YI,32,34,1,7,2022-01-14,23,Friday,5,33,41
1482126341193482242,2022-01-14 23:03:50,Pemprov DKI melanjutkan kegiatan PTM 100% meski ada siswa-guru di 12 sekolah positif Corona. Ini alasan Pemprov DKI melanjutkan PTM 100%. https://t.co/hvG4cZSfzb,4,0,3,2,2022-01-14,23,Friday,5,7,2
1482125975093710848,2022-01-14 23:02:23,Tiga orang jadi tersangka menyusul pertunjukan striptis di sebuah kafe di Banyuwangi. Apa peran ketiga tersangka dalam kasus tersebut? https://t.co/VBjxDWCTXW,8,1,1,0,2022-01-14,23,Friday,5,9,1
1482124331387965445,2022-01-14 22:55:51,"""Pastinya 2024 peta koalisi akan berubah seiring dinamika politik dan tantangan zamannya,"" kata Waketum PKB, Jaizulul Fawaid. https://t.co/N3eCIdh9kc",3,2,1,2,2022-01-14,22,Friday,5,4,4
1482123547728302080,2022-01-14 22:52:44,"Menerima gelar Raden Mas Satria, LaNyalla menyatakan siap memperjuangkan aspirasi dan amanat para Raja dan Sultan Nusantara. https://t.co/CcCZUlDu7C",13,1,7,1,2022-01-14,22,Friday,5,20,2
1482122198018109441,2022-01-14 22:47:23,"Salah satu kota di Australia melaporkan suhu ekstrem hingga 50,7 derajat Celcius. Suhu itu menyamai rekor suhu terpanas dalam sejarah Australia. https://t.co/lj0UDe9qjX",10,2,5,0,2022-01-14,22,Friday,5,15,2
1482121157461610503,2022-01-14 22:43:15,Fico Fachriza ditangkap polisi karena kasus tembakau sintetis. Komika itu menangis saat dihadirkan dalam jumpa pers. https://t.co/PETYUydkgL,66,30,7,11,2022-01-14,22,Friday,5,73,41
1482119901481422857,2022-01-14 22:38:15,Komnas HAM menolak tuntutan hukuman mati kepada Herry Wirawan pemerkosa 13 santriwati di Bandung. Kejati Jabar buka suara terkait penolakan tersebut. https://t.co/KMWOd0M4Qz,4,2,0,2,2022-01-14,22,Friday,5,4,4
1482118668620283904,2022-01-14 22:33:21,Masa depan Donny van de Beek dan Dean Henderson di Manchester United serba tak menentu. Kedua pemain ini dikabarkan sudah tak betah dan ingin pergi. https://t.co/U5Y5oX2Z9A,6,1,0,0,2022-01-14,22,Friday,5,6,1
1482116843422765062,2022-01-14 22:26:06,Seorang bocah perempuan di Tangsel lolos dari usaha penculikan. Korban berhasil kabur setelah melompat dari atas sepeda motor pelaku. https://t.co/IjzJTrgCvR,8,0,2,1,2022-01-14,22,Friday,5,10,1
1482116188847194113,2022-01-14 22:23:30,Ini deretan buku baru menyambut awal tahun yang diterbitkan Gramedia Pustaka Utama:  https://t.co/mKRsXaH0Ew,5,1,0,0,2022-01-14,22,Friday,5,5,1
1482114899216056320,2022-01-14 22:18:22,"Anak kiai di Jombang tersangka pencabulan santriwati, MSAT, masuk Daftar Pencarian Orang (DPO). Penerbitan DPO karena MSAT kerap mangkir dalam panggilan polisi. https://t.co/FKaTy27DRP",74,13,27,6,2022-01-14,22,Friday,5,101,19
1482113429523648515,2022-01-14 22:12:32,"BMKG melaporkan gempa berkekuatan 6,7 M terjadi di Sumur, Banten, pada Jumat (14/1). Saat terjadi gempa, apa yang sebaiknya dilakukan? Berikut penjelasannya. https://t.co/ceREHQ2pHC",16,1,3,0,2022-01-14,22,Friday,5,19,1
1482111792197390336,2022-01-14 22:06:02,JoMan menuding laporan Ubedillah Badrun ke KPK soal dugaan KKN Gibran dan Kaesang adalah sebuah pesanan politikus hitam. JoMan siap buktikan. https://t.co/INM5bQBGas,36,27,5,3,2022-01-14,22,Friday,5,41,30
1482110287780143106,2022-01-14 22:00:03,"Gempa bumi dengan magnitudo (M) 4,7 terjadi di Pandeglang, Banten. Pusat gempa ini berada di laut. https://t.co/zSkjfyrWCF",18,0,0,0,2022-01-14,22,Friday,5,18,0
1482109576916910080,2022-01-14 21:57:14,"Kasus positif COVID-19 varian Omicron di DKI Jakarta bertambah. Tercatat, ada 725 kasus Omicron dengan didominasi oleh pelaku perjalanan luar negeri. https://t.co/xWRDxsdSNc",37,15,10,2,2022-01-14,21,Friday,5,47,17
1482108467796189185,2022-01-14 21:52:49,"Polisi mengungkap kasus pencurian tiang pembatas trotoar (bollard) di Menteng, Jakpus. Ternyata ada 110 bollard yang telah hilang di Jakpus. https://t.co/siWmjCqYPd",10,2,3,0,2022-01-14,21,Friday,5,13,2
1482107163363483648,2022-01-14 21:47:38,Satpol PP Kota Bandung melaporkan pelaku vandalisme ke polisi. Pelaku berjumlah dua orang itu terekam kamera CCTV saat melakoni aksinya di Jalan Siliwangi. https://t.co/MMiyTOhcyy,4,0,0,1,2022-01-14,21,Friday,5,4,1
1482106627490824194,2022-01-14 21:45:30,Vaksinasi Corona dosis ketiga atau booster telah dimulai. Warga lanjut usia (lansia) yang diprioritaskan pun rela menunggu demi mendapat vaksinasi ketiga. https://t.co/K7GkL4GzIb,6,0,1,1,2022-01-14,21,Friday,5,7,1
1482105076542062598,2022-01-14 21:39:21,"Polda Metro Jaya serahkan berkas perkara dan tersangka kasus mafia tanah ibu dari Dino Patti Djalal, ke Kejari Jaksel. Tersangka pun akan segera disidangkan. https://t.co/YJM31oX6Ly",5,0,2,0,2022-01-14,21,Friday,5,7,0
1482103706694918149,2022-01-14 21:33:54,"Gempa M 6,6 di Pandeglang, Banten, membuat ratusan warga memilih mengungsi ke hunian tetap tsunami Selat Sunda lantaran takut terjadi gempa susulan. https://t.co/QD7q5cd3Wg",15,0,4,0,2022-01-14,21,Friday,5,19,0
1482103477790720003,2022-01-14 21:32:59,"Dana BPUM sebanyak Rp 5,8 miliar dikembalikan Pemkab Blitar ke kas negara. Ini karena bantuan selama pandemi Corona itu tidak diambil yang berhak menerimanya. https://t.co/8dOAD1nZvX",11,4,4,0,2022-01-14,21,Friday,5,15,4
1482102126239223810,2022-01-14 21:27:37,"Obat COVID-19 Molnupiravir telah berizin BPOM. Jadi 'senjata' RI menghadapi gelombang Omicron, ini efek samping Molnupiravir. https://t.co/43tIbeF2QR",15,0,2,0,2022-01-14,21,Friday,5,17,0
1482101324539961345,2022-01-14 21:24:26,#Terpopuler Pak Ogah yang terbaring sakit sempat tidak mau berobat ke Rumah Sakit karena belum membayar BPJS selama 4 tahun.  https://t.co/kKjKwt4J73,67,3,10,2,2022-01-14,21,Friday,5,77,5
1482099825638354947,2022-01-14 21:18:29,"Wapres Ma'ruf Amin kunjungi hunian sementara korban erupsi gunung Semeru di Candipuro, Lumajang. Ia minta pembangunan hunian itu dipercepat. https://t.co/79NHoa6VuM",8,0,3,0,2022-01-14,21,Friday,5,11,0
1482097461191659520,2022-01-14 21:09:05,"Sebuah video tawuran pelajar di Jalan Raya Pondok Labu, Cilandak, Jaksel, viral di medsos. Para terduga pelaku tawuran menyenggol driver ojol hingga terluka. https://t.co/5xVw9KoHx7",4,2,0,3,2022-01-14,21,Friday,5,4,5
1482096988166533138,2022-01-14 21:07:12,HIPMI Jatim meminta anggotanya untuk lebih berdikari dan tidak menggantungkan pada proyek pemerintah. Anggota dituntut menciptakan lapangan pekerjaan baru. https://t.co/UTozYW48Cm,3,1,0,0,2022-01-14,21,Friday,5,3,1
1482095556780605444,2022-01-14 21:01:31,"Kabar Ardhito Pramono sudah memiliki istri cukup mengejutkan publik. Istrinya tak lain adalah kekasihnya, Jeanneta Sanfadelia. Berikut lima fakta tentangnya. #detikNetwork  https://t.co/ltlVFwaeVN",5,4,0,0,2022-01-14,21,Friday,5,5,4
1482094390151680005,2022-01-14 20:56:53,"Polisi masih menyelidiki laporan dugaan penyekapan perempuan di Tanjung Priok, Kota Tangerang. https://t.co/jU0aYkA8eH",1,0,1,0,2022-01-14,20,Friday,5,2,0
1482093878807252994,2022-01-14 20:54:51,AC Milan mendapat kabar buruk di balik kelolosan mereka ke perempatfinal Coppa Italia. Fikayo Tomori mungkin harus absen beberapa pekan karena cedera lutut. https://t.co/hQtEEJkfjp,3,0,0,0,2022-01-14,20,Friday,5,3,0
1482091180338946052,2022-01-14 20:44:07,"Belanda akan melonggarkan beberapa aturan terkait pembatasan aktivitas karena COVID-19. Toko-toko, salon hingga pusat kebugaran memungkinkan dibuka kembali. https://t.co/LT8U0Bf6Mf",5,1,0,0,2022-01-14,20,Friday,5,5,1
1482090912549416961,2022-01-14 20:43:04,Hari Pers Nasional 2022 akan terasa berbeda karena ada sosialisasi Desain Besar Olahraga Nasional (DBON). Menpora Zainudin Amali senang dengan ide itu. https://t.co/WPHA5sY9sx,1,5,0,0,2022-01-14,20,Friday,5,1,5
1482089405527609348,2022-01-14 20:37:04,Apa saja yang dilakukan nelayan asal Indonesia di Australia? Mari kita simak kisah mereka: https://t.co/mXCLeHsdva,12,1,2,0,2022-01-14,20,Friday,5,14,1
1482086805629546496,2022-01-14 20:26:44,Elon Musk membagikan video jadul yang diambil pada tahun 1995 di mana Bill Gates diledek soal internet. #ElonMusk  https://t.co/25hCABM9Ha,8,1,1,0,2022-01-14,20,Friday,5,9,1
1482085569580699660,2022-01-14 20:21:50,"Video polisi dihalau saat hendak masuk sebuah kompleks pondok pesantren di Jombang, beredar luas. Dalam video tampak puluhan massa yang menghalau polisi. https://t.co/4lsB6MQEFr",16,13,3,4,2022-01-14,20,Friday,5,19,17
1482084036755533824,2022-01-14 20:15:44,"Korea Utara dilaporkan melakukan peretasan 7 kali pada platform cryptocurrency. Hasilnya, aset digital senilai hampir $400 juta (setara Rp 5,7 T) diekstraksi. https://t.co/p82VSO6t7v",11,2,1,0,2022-01-14,20,Friday,5,12,2
1482082513942155265,2022-01-14 20:09:41,PKS membuka peluang membangun koalisi dengan poros nasionalis religius di Pilpres 2024 nanti. Apakah Golkar tertarik? https://t.co/oNGIbj3fGv,14,11,3,4,2022-01-14,20,Friday,5,17,15
1482081213720498176,2022-01-14 20:04:31,Pemkot Bandung memasang baliho dan spanduk di Jalan Siliwangi yang berisikan foto pelaku vandalisme. Ada satu spanduk dan satu baliho berukuran besar yang menampilkan foto pelaku vandalisme tengah mencoret tembok di jalan tersebut. https://t.co/mPs3JyduNo,4,1,0,0,2022-01-14,20,Friday,5,4,1
1482079909904330759,2022-01-14 19:59:20,Penyelamatan seekor rusa yang terjebak di dalam gorong-gorong di Mojokerto berlangsung dramatis. Pada akhirnya rusa tersebut berhasil dievakuasi. Seperti apa? https://t.co/bm4fcLy7J2,7,0,1,0,2022-01-14,19,Friday,5,8,0
1482078399644450819,2022-01-14 19:53:20,"Petani di Kabupaten Polman, Sulbar, ditangkap setelah menyetubuhi putri kandungnya hingga melahirkan. https://t.co/r5b1VTcPbB",13,12,2,1,2022-01-14,19,Friday,5,15,13
1482076848884494345,2022-01-14 19:47:11,"Mampukah Jeep Compass mendobrak dominasi mobil asal Jerman tersebut? Seperti apa impresi berkendaranya dan secanggih apa fiturnya? Simak video tes Jeep Compass kami kali ini!
 https://t.co/0AvdU3TYkq",4,0,0,0,2022-01-14,19,Friday,5,4,0
1482075645442240514,2022-01-14 19:42:24,Massa buruh dari berbagai elemen menggelar aksi unjuk rasa di depan Gedung DPR RI. Simak potretnya: https://t.co/DCsH4uaoLE,8,1,4,0,2022-01-14,19,Friday,5,12,1
1482074326782332936,2022-01-14 19:37:09,"Polisi menangkap pria yang menodongkan pistol di Jalan Raya Pandanrejo, Kota Batu. Ia yakni MS (50) warga Kecamatan Bumiaji. https://t.co/uUaOuPtUHn",6,1,2,0,2022-01-14,19,Friday,5,8,1
1482072458270326799,2022-01-14 19:29:44,50 HP bakal diblokir oleh WhatsApp di 2022 ini lantaran perangkat tersebut tidak menjalankan sistem operasi yang disyaratkan. Ini daftarnya:  https://t.co/44J4nZthkh,6,0,3,0,2022-01-14,19,Friday,5,9,0
1482071165455802370,2022-01-14 19:24:36,"Hmm, kira-kira berapa kenaikan harga yang ditawarkan Honda untuk produk Brio Satya nih?
 https://t.co/6NqMI27qQE",0,0,1,0,2022-01-14,19,Friday,5,1,0
1482069756089970693,2022-01-14 19:19:00,"Gintan Maryani (6), bocah yatim piatu asal Garut yang mengidap penyakit TBC meninggal dunia. Sebelum meninggal bocah itu tengah menjalani perawatan di RS. https://t.co/pWKmOV33aU",12,1,2,1,2022-01-14,19,Friday,5,14,2
1482068036064530440,2022-01-14 19:12:09,"Sebuah truk gandeng mengalami rem blong dan terguling di jalan raya Desa Sempolan, Silo. Truk menabrak sejumlah kendaraan dan 3 orang mengalami luka. https://t.co/PzGBt4FC3c",4,0,0,0,2022-01-14,19,Friday,5,4,0
1482066343293865989,2022-01-14 19:05:26,"Hadfana Firdaus, penendang sesajen di lokasi erupsi Semeru ditangkap polisi. Ditetapkan sebagai tersangka, Hadfana pun meminta maaf. https://t.co/dBGxre9aWM",9,13,2,2,2022-01-14,19,Friday,5,11,15
1482065734004002824,2022-01-14 19:03:01,"Arsenal tak kuasa menahan badai virus corona di tubuh klub saat ini. Maka dari itu, The Gunners meminta duel kontra Tottenham Hotspur ditunda. https://t.co/Qy6YwM1uOG",3,0,0,0,2022-01-14,19,Friday,5,3,0
1482064610886930433,2022-01-14 18:58:33,Jaksa Agung ST Burhanuddin menerima kunjungan perdana dari Panglima TNI Jenderal Andika Perkasa. Ini isi pembicaraan keduanya. https://t.co/73kXqdJKZa,3,1,1,0,2022-01-14,18,Friday,5,4,1
1482062973757796360,2022-01-14 18:52:02,"Pemkab Pandeglang menetapkan status tanggap bencana akibat gempa magnitudo (M) 6,6 mengguncang Banten. https://t.co/8ntt7MLCy7",12,0,2,0,2022-01-14,18,Friday,5,14,0
1482061541897908227,2022-01-14 18:46:21,"Seorang pria di Kota Batu terekam CCTV menodongkan pistol di Jalan Raya Pandanrejo. Monang Sihombing, warga Kecamatan Bumiaji itu juga pernah menembak polisi. https://t.co/k1FAQlYIvA",9,2,0,0,2022-01-14,18,Friday,5,9,2
1482059890839408642,2022-01-14 18:39:47,Tahun 2021 nyatanya jadi momen menggembirakan bagi Porsche. Wilayah Asia Pasifik (termasuk Indonesia) turut menyumbang pundi-pundi bagi Porsche. https://t.co/DDEvQkWT2v,10,2,4,1,2022-01-14,18,Friday,5,14,3
1482057437372989450,2022-01-14 18:30:03,"Bahasa gaul atau kekinian juga menjadi entri baru yang masuk KBBI karena sering muncul dalam percakapan sehari-hari. Apa saja bahasa gaul itu ya?

via: detikedu https://t.co/dajGbJk4Za",11,0,1,1,2022-01-14,18,Friday,5,12,1
1482055775686205446,2022-01-14 18:23:26,"Petani di Kabupaten Polman, Sulbar, ditangkap setelah menyetubuhi putri kandungnya hingga melahirkan. https://t.co/UM36FA48vH",15,3,1,1,2022-01-14,18,Friday,5,16,4
1482053730476478464,2022-01-14 18:15:19,"Anies Baswedan menjenguk sastrawan Remy Sylado yang terbaring sakit. Ternyata aktor senior itu sudah lama terbaring sakit, tapi tak ada biaya untuk berobat. https://t.co/LkwS3UOY99",27,3,4,0,2022-01-14,18,Friday,5,31,3
1482050697612955649,2022-01-14 18:03:16,Tebak-tebakan ini belum tentu bisa dijawab oleh orang cerdas sekalipun. Coba pecahkan teka-teki receh ini sambil melatih otak. https://t.co/E6YiRz9kMi,271,299,33,10,2022-01-14,18,Friday,5,304,309
1482049803370573826,2022-01-14 17:59:42,"Seperti halnya pisau, otak juga perlu diasah agar selalu tajam. Otak juga butuh diolahragakan agar lebih berstamina untuk menyambut awal pekan. Yuk dicoba! https://t.co/PArkQX5UmK",26,14,3,2,2022-01-14,17,Friday,5,29,16
1482048262999883785,2022-01-14 17:53:35,Satwa itu ditemukan terdampar pada Kamis (13/1) sekitar pukul 11.00 WITA. Bagaimana ceritanya? https://t.co/33JiJtf9nT,9,0,2,0,2022-01-14,17,Friday,5,11,0
1482046869161263104,2022-01-14 17:48:03,Kondisi penglihatan Marc Marquez mulai membaik. Apakah bisa menjajal Sirkuit Mandalika? https://t.co/FMbPftCLca,13,1,3,1,2022-01-14,17,Friday,5,16,2
1482045542867869698,2022-01-14 17:42:47,"BPBD Pandeglang mencatat hingga malam ini sudah ada 263 rumah warga yang mengalami kerusakan imbas gempa M 6,6 di Banten. https://t.co/cntWawgFuc",13,1,5,0,2022-01-14,17,Friday,5,18,1
1482045312927731716,2022-01-14 17:41:52,"Setiap makhluk hidup, pasti akan mengalami kematian. Berikut ini beberapa tanda-tanda kematian yang menandakan ajal sudah dekat. https://t.co/GZOxE0YYfa",18,1,8,2,2022-01-14,17,Friday,5,26,3
1482043552498659335,2022-01-14 17:34:52,Tisu magic sering digunakan oleh pria saat melakukan hubungan seksual. Benda ini biasa digunakan untuk menunda ejakulasi dini. Bagaimana efek sampingnya ya? https://t.co/XkP7XxEhRv,3,0,1,0,2022-01-14,17,Friday,5,4,0
1482042608306343938,2022-01-14 17:31:07,Momen pertemuan Prabowo dan SBY jadi perbincangan hangat. Simak lagi pembahasannya di sini. https://t.co/SmLYZ82XdH,18,2,5,1,2022-01-14,17,Friday,5,23,3
1482041549076762641,2022-01-14 17:26:54,"Absennya Mohamed Salah dan Sadio Mane memang mempengaruhi ketajaman Liverpool. Tapi, The Reds tak boleh cengeng karena harus ""mandiri"" tanpa dua mesin golnya. https://t.co/b1m69UgHI3",7,0,0,0,2022-01-14,17,Friday,5,7,0
1482040938193211392,2022-01-14 17:24:29,Beberapa waktu lalu Nagita Slavina sempat viral dan ramai dibicarakan lantaran ada video syur mirip dirinya dengan durasi 61 detik. Netizen tak percaya. https://t.co/5L206K9c2A,33,1,2,1,2022-01-14,17,Friday,5,35,2
1482039632690913281,2022-01-14 17:19:18,"Setelah lebih dari dua bulan dirilis, seberapa besar penjualan Creta?
 https://t.co/6VvfOcGBJO",7,0,1,1,2022-01-14,17,Friday,5,8,1
1482037767198679047,2022-01-14 17:11:53,"Gempa bumi dengan magnitudo (M) 5,0 terjadi di Bima, Nusa Tenggara Barat (NTB). Gempa ini tak berpotensi menimbulkan gelombang tsunami. https://t.co/lzm9P9z4Ih",16,0,1,0,2022-01-14,17,Friday,5,17,0
1482036453790072835,2022-01-14 17:06:40,Wakil Ketua Komisi V DPR RI mewanti-wanti kenaikan tarif KRL Commuter Line menjadi Rp 5.000. Dia meminta wacana kenaikan tarif itu dikaji hati-hati. https://t.co/BVtCP0FNQf,6,1,2,0,2022-01-14,17,Friday,5,8,1
1482035634940358661,2022-01-14 17:03:24,Ternyata kegiatan itu merupakan tradisi turun temurun dan sudah berlangsung selama 27 angkatan. Namun tanpa sepengetahuan sekolah. https://t.co/W1wof5WoPT,9,1,2,0,2022-01-14,17,Friday,5,11,1
1482035006704963593,2022-01-14 17:00:55,DFR (22) pelaku penculikan bocah perempuan A (12) di Tangsel ternyata juga sempat melakukan tindakan pencabulan. https://t.co/R7hIyod1NE,3,0,2,0,2022-01-14,17,Friday,5,5,0
1482034384278540296,2022-01-14 16:58:26,"Kemenkes RI mengeluarkan surat edaran pelaksanaan vaksin booster. Dalam edaran, diatur tentang kelompok yang tidak masuk kriteria penerima vaksin booster. https://t.co/qTvPIx2OPL",16,1,3,0,2022-01-14,16,Friday,5,19,1
1482034042556108800,2022-01-14 16:57:05,"Kakek di Manado, Sulut, tak kuasa menahan tangis saat menuntut ganti rugi lahan Rp 2 miliar dari pihak Citraland Manado. https://t.co/jPcph3x3vb",34,0,9,0,2022-01-14,16,Friday,5,43,0
1482033584152141826,2022-01-14 16:55:15,"Guna mengantisipasi banjir, PT Jakarta Propertindo (JakPro) selaku pemegang proyek JIS menyiapkan tempat penampungan air hujan di sejumlah titik. https://t.co/YGPmH1FLQz",9,2,1,0,2022-01-14,16,Friday,5,10,2
1482033582738710529,2022-01-14 16:55:15,"Banjir merendam Kabupaten Pidie, Aceh, akibat curah hujan yang tinggi. Dampaknya, 4 sekolah di Pidie diliburkan. https://t.co/MppsWsN45R",4,0,0,0,2022-01-14,16,Friday,5,4,0
1482033349740879874,2022-01-14 16:54:20,"Hadfana, penendang sesaji Semeru telah ditangkap polisi dan ditetapkan tersangka. Pihak UIN Yogya minta masyarakat maafkan Hadfana dan menyudahi proses hukum. https://t.co/2JWzZ70Xul",670,351,126,116,2022-01-14,16,Friday,5,796,467
1482033007330484227,2022-01-14 16:52:58,Dustin Poirier terlihat lebih bulky alias lebih berisi. Apa petarung UFC ini bakal pindah dari kelas ringan ke kelas welter? https://t.co/vXyMm4xG1j,6,0,1,1,2022-01-14,16,Friday,5,7,1
1482032426419433473,2022-01-14 16:50:39,Berbagai cara dapat dilakukan untuk meningkatkan kualitas seks agar nggak gampang loyo di ranjang. Salah satunya dengan mengkonsumsi nutrisi yang baik. https://t.co/kvFFLe9pua,6,1,0,0,2022-01-14,16,Friday,5,6,1
1482032405036900362,2022-01-14 16:50:34,"Hubungan pernikahan kami dimulai dari ta'aruf, hingga di tahun pertama saya mengetahui bahwa dia menyukai video-video berisi pria seksi dan marah kalau ditanya. #detikNetwork  https://t.co/rClRvdYbRu",6,2,0,7,2022-01-14,16,Friday,5,6,9
1482032112094044161,2022-01-14 16:49:25,Seorang anak perempuan di Tangsel berhasil kabur dari insiden penculikan. Korban melompat dari atas motor penculiknya. https://t.co/sFQuxqtxFV,21,0,7,2,2022-01-14,16,Friday,5,28,2
1482031465441415169,2022-01-14 16:46:50,"PKS ingin membangun koalisi lintas poros di Pilpres 2024, yakni poros nasionalis-religius. Siapa yang digandeng PKS? https://t.co/q8leGTSctW",24,9,6,4,2022-01-14,16,Friday,5,30,13
1482029664071786502,2022-01-14 16:39:41,Koalisi 'kuning-oranye' diyakini adalah Golkar dan PKS. Golkar dan PKS dinilai berpeluang koalisi karena pernah beberapa kali satu 'perahu' saat pilpres. https://t.co/fkRNa49zlQ,9,0,0,0,2022-01-14,16,Friday,5,9,0
1482029421091512323,2022-01-14 16:38:43,Hadfana Firdaus telah ditetapkan sebagai tersangka. Ini dua pasal yang menjeratnya: https://t.co/F0wiODopDR,25,12,3,1,2022-01-14,16,Friday,5,28,13
1482029399927136261,2022-01-14 16:38:38,Sebanyak 29 Kabupaten/Kota di Jatim telah memulai vaksinasi booster untuk lansia dan warga sejak Rabu (12/1). Bagaimana stok vaksin di Jatim saat ini? https://t.co/jigEJpUqaH,7,0,0,0,2022-01-14,16,Friday,5,7,0
1482028830910996480,2022-01-14 16:36:22,"Pemprov Sulut menyebut PNS Heince J Keintjem tidak hilang melainkan pergi meninggalkan rumah. Sang istri, Inggrid Sagune, buka suara. https://t.co/rGpS7sGnPE",3,1,0,0,2022-01-14,16,Friday,5,3,1
1482028275018964996,2022-01-14 16:34:10,"Ledakan terjadi di rumah Tahfiz Qura Annur, Jatiluhur, Jatiasih, Kota Bekasi. Ledakan menewaskan satu orang santri bernama Abdul Jamil. https://t.co/iQdmuA4Fhl",21,1,2,1,2022-01-14,16,Friday,5,23,2
1482028252839432194,2022-01-14 16:34:04,"Ledakan di Rumah Tahfiz Qur'an di Jatiasih, Bekasi, menewaskan 1 orang santri. Korban, yang bernama Cosain Abdul Jamil (15), merupakan WN Filipina. https://t.co/l0RSNegFTe",12,1,3,1,2022-01-14,16,Friday,5,15,2
1482027550511710209,2022-01-14 16:31:17,"PNS asal Manado, Heince J Keintjem, ternyata tidak hilang. Dia minggat dari istrinya. https://t.co/3P13OUzAU5",10,3,3,4,2022-01-14,16,Friday,5,13,7
1482026651173150728,2022-01-14 16:27:43,"Pengalaman pertama dalam hubungan seksual bisa jadi salah satu momen penting. Namun, kerap pasangan merasa gugup dan malu. Ini 7 tips agar malam pertama lancar. https://t.co/pliWQJ3sfT",4,1,1,1,2022-01-14,16,Friday,5,5,2
1482026112981114885,2022-01-14 16:25:34,"Pemerintah telah menerapkan PPnBM berdasarkan emisi. Dengan skema pajak baru, Fortuner 4x4 lebih murah, tak sampai Rp 700 juta. https://t.co/ZQ2FyMHWZG",12,0,0,0,2022-01-14,16,Friday,5,12,0
1482025556942200839,2022-01-14 16:23:22,"MUI Jatim menyarankan Hadfana Firdaus, penendang sesajen di lokasi erupsi Semeru tidak diproses hukum terlebih dulu. Ini alasannya. https://t.co/G7TVFKVqyy",89,100,15,11,2022-01-14,16,Friday,5,104,111
1482024369769623560,2022-01-14 16:18:39,Toyota meluncurkan Fortuner dengan mesin yang lebih besar dengan kode 1GD 2.800 cc. Apakah mesin 1GD dipakai Innova juga? https://t.co/IVWgn5cO3r,15,1,2,0,2022-01-14,16,Friday,5,17,1
1482024043838590977,2022-01-14 16:17:21,"Ledakan di Rumah Tahfiz Qur'an di Jatiasih, Bekasi, menewaskan 1 orang santri. Korban, yang bernama Cosain Abdul Jamil (15), merupakan WN Filipina. https://t.co/UezHIgmV3o",17,5,5,0,2022-01-14,16,Friday,5,22,5
1482022311884636169,2022-01-14 16:10:28,"Gempa magnitudo (M) 6,6 di Banten berdampak di Kabupaten Lebak. BPBD Lebak mendata guncangan gempa mengakibatkan dua orang luka dan 32 rumah rusak. https://t.co/iBWxYDgDQ1",15,1,3,0,2022-01-14,16,Friday,5,18,1
1482021951623340033,2022-01-14 16:09:02,Empat pelaku pecah kaca mobil di Kediri diringkus. Satu di antara pelaku bahkan harus dilumpuhkan karena berusaha melarikan diri saat ditangkap. https://t.co/0ewjVHa26f,7,0,0,0,2022-01-14,16,Friday,5,7,0
1482021700346822666,2022-01-14 16:08:02,"Di tengah meningkatnya kasus Omicron, BPOM mengeluarkan izin penggunaan obat Molnupiravir sebagai pengobatan COVID-19. Perlu tahu, begini penggunaannya: https://t.co/8FZqcB1F8g",12,0,3,0,2022-01-14,16,Friday,5,15,0
1482021070517514246,2022-01-14 16:05:32,Kabid Humas Polda Jatim Kombes Gatot Repli Handoko mengatakan Hadfana terkena pasal 156 dan 158 KUHP tentang ujaran kebencian terhadap suatu golongan. https://t.co/uvYdD4ruRU,22,10,3,1,2022-01-14,16,Friday,5,25,11
1482019300772913153,2022-01-14 15:58:30,"Rombongan polisi Banyuwangi yang tengah patroli dikepung warga viral. Warga memprotes aktivitas polisi yang berpatroli di kawasan perkebunan Pakel, Licin. https://t.co/aGJJJbOYMn",13,7,2,0,2022-01-14,15,Friday,5,15,7
1482017904002576384,2022-01-14 15:52:57,"Pemprov Banten masih mendata kerusakan bangunan dan korban berkaitan dampak gempa M 6,6 yang berpusat di pesisir selatan Pandeglang. https://t.co/4KqqlKVqc2",8,1,2,1,2022-01-14,15,Friday,5,10,2
1482015834650382336,2022-01-14 15:44:44,"Chelsea akan melawan Manchester City di lanjutan Liga Inggris. Kalau The Blues kalah dari The Citizens, peluang juara mereka bisa tertutup. https://t.co/4lWHruEyjA",3,3,2,1,2022-01-14,15,Friday,5,5,4
1482015810948370434,2022-01-14 15:44:38,"Dampak gempa M 6,6 di Banten mengakibatkan empat rumah rusak di tiga kecamatan wilayah Kabupaten Sukabumi, Jawa Barat. https://t.co/fLQC8fDT1G",4,1,6,1,2022-01-14,15,Friday,5,10,2
1482015542533832704,2022-01-14 15:43:34,Karantina wilayah alias lockdown secara mendadak di China menyebabkan seorang perempuan terjebak di rumah teman kencannya selama beberapa hari. Waduh? https://t.co/q19XH44ONY,18,8,2,1,2022-01-14,15,Friday,5,20,9
1482014095486373888,2022-01-14 15:37:49,Seorang ibu-ibu di Asahan bernama Nova Sariayu Siregar (36) nyaris kena hukuman karena dianggap sebagai penadah. Hal itu dikarenakan Nova membeli ponsel curian. https://t.co/1zsnUpSOGc,9,1,2,2,2022-01-14,15,Friday,5,11,3
1482013536964562950,2022-01-14 15:35:36,Menerima tongkat estafet dari Wes Craven bukan hal yang mudah dan sederhana. Buat Matt Bettinelli-Olpin dan Tyler Gillet ini merupakan sebuah kehormatan. https://t.co/3i6XdsIDOk,4,0,0,0,2022-01-14,15,Friday,5,4,0
1482013142322454531,2022-01-14 15:34:02,Ia menilai pihak Sudin SDA Jaktim beserta Kepala Satuan Pelaksana (Kasatpel) belum dapat mengatasi persoalan banjir di wilayah Kecamatan Duren Sawit. https://t.co/4yPpS0tYd7,7,2,1,0,2022-01-14,15,Friday,5,8,2
1482012609117409282,2022-01-14 15:31:55,Syarat vaksin anak 6-11 tahun penting diketahui para orang tua agar anak-anak bisa mendapat dosis vaksin secara lengkap. Ini syaratnya:  https://t.co/O9o1NzdLQw,12,1,4,0,2022-01-14,15,Friday,5,16,1
1482011939400208390,2022-01-14 15:29:15,Manchester City berhadapan dengan Chelsea di Liga Inggris akhir pean ini. Berikut rekor Pep Guardiola saat beradu taktik dengan Thomas Tuchel. https://t.co/otZKXG7i2u,6,0,2,0,2022-01-14,15,Friday,5,8,0
1482010760066830339,2022-01-14 15:24:34,"Sejumlah pegiat sejarah meminta nama Alun-alun Suroboyo dikembalikan menjadi Balai Pemuda. Lalu, di mana sebenarnya lokasi Alun-alun Surabaya berada? https://t.co/uVYTohO8tL",8,0,2,0,2022-01-14,15,Friday,5,10,0
1482009961261682695,2022-01-14 15:21:23,PT Yamaha Indonesia Motor Manufacturing (YIMM) memberikan penyegaran pada XSR 155. Ini hasilnya.  https://t.co/kY4CX4W9IY,33,1,4,1,2022-01-14,15,Friday,5,37,2
1482009302567211009,2022-01-14 15:18:46,Mereka menambang dengan alat sehingga merusak lingkungan. https://t.co/wPkoFgLDgq,10,0,2,2,2022-01-14,15,Friday,5,12,2
1482009049768026117,2022-01-14 15:17:46,"Ledakan tabung gas di Rumah Tahfiz Qur'an Annur, Jatiluhur, Jatiasih, Kota Bekasi, Jawa Barat, menewaskan 1 santri. Begini detik-detik ledakan maut itu terjadi. https://t.co/rKcaDaastl",9,1,1,1,2022-01-14,15,Friday,5,10,2
1482008138463289352,2022-01-14 15:14:09,Teriyaki merupakan sajian daging khas Jepang yang populer di dunia. Hidangan ini mudah dibuat sendiri dengan memakai bahan dan bumbu sederhana. https://t.co/hOJ9BaPNQp,32,2,4,1,2022-01-14,15,Friday,5,36,3
1482007522911436807,2022-01-14 15:11:42,Edy Rahmayadi dilaporkan Gerakan Semesta Rakyat ke KPK terkait dugaan gratifikasi serta klarifikasi LHKPN. Gubsu Edy geram ingin melaporkan balik pelapor. https://t.co/3EPRrRNcvp,12,9,3,3,2022-01-14,15,Friday,5,15,12
1482007167469244422,2022-01-14 15:10:17,Siapa yang tak asing dengan nada dan lagu Baby Shark Dance? Kini video musiknya sukses menggeser Gangnam Style karya PSY.  https://t.co/7ipf0v2Occ,15,1,1,2,2022-01-14,15,Friday,5,16,3
1482006577196552200,2022-01-14 15:07:57,Mohammed Abad adalah salah satu pria di dunia yang memiliki penis bionik. Pasangannya menceritakan pengalaman mereka saat bercinta. Seperti apa ya? https://t.co/m0518QGERW,9,2,1,2,2022-01-14,15,Friday,5,10,4
1482006084319547397,2022-01-14 15:05:59,"RI harus berhati-hati, tiga negara terdekatnya sudah dihantam badai virus Corona varian Omicron. Mengakibatkan lonjakan kasus yang cukup tinggi. https://t.co/C4aodYRLH6",20,4,14,6,2022-01-14,15,Friday,5,34,10
1482005184930852867,2022-01-14 15:02:25,"Gajah liar mengais makanan di tempat pembuangan sampah di desa Pallakkadu, Sri Lanka. Puluhan ekor gajah telah mati setelah mengkonsumsi sampah plastik. https://t.co/Q5qjNGEvBv",53,14,29,4,2022-01-14,15,Friday,5,82,18
1482004483605512205,2022-01-14 14:59:37,detikcom berkesempatan mewawancarai ONEWE untuk comeback Planet Nine: VOYAGER. Simak di sini: #KTalk  https://t.co/2sjr7Ur1GI,8,0,2,0,2022-01-14,14,Friday,5,10,0
1482003826248925188,2022-01-14 14:57:01,Shaloom Razade hingga Adhisty Zara tampil sebagai bintang di Virgin the Series. Mereka pun berbagi keseruan dalam proyek tersebut:  https://t.co/3hu6FNmQDP,4,0,2,0,2022-01-14,14,Friday,5,6,0
1482003127868002306,2022-01-14 14:54:14,Ketua Fraksi PDIP DKI Jakarta Gembong Warsono meminta data uang tunjangan Gubernur dan Wakil Gubernur DKI Jakarta dibuka ke publik agar tak ada kecurigaan. https://t.co/P5AfOtPSnR,27,20,4,3,2022-01-14,14,Friday,5,31,23
1482002579412467712,2022-01-14 14:52:03,"Gempa 6,7 M mengguncang Lebak, Banten, dan terasa hingga Jakarta dan sekitarnya. Kerap kali, guncangan gempa membuat perut mual dan kepala pusing. Kenapa? https://t.co/LBfE6pJ4xv",24,0,4,1,2022-01-14,14,Friday,5,28,1
1482002307789340679,2022-01-14 14:50:59,"Ketika mengalami sakit perut tentu rasanya tidak nyaman. Selain minum obat, ada beberapa makanan yang bisa dikonsumsi untuk meredakan sakit perut yang menyerang. https://t.co/0yJ8BAqlkc",14,0,3,1,2022-01-14,14,Friday,5,17,1
1482002046702211086,2022-01-14 14:49:56,"Dalam dunia seni, medium adalah sebuah terminologi yang dapat diartikan sebagai dua prinsip yang saling bertumpangan. https://t.co/IPCbp5v7qV",9,0,3,0,2022-01-14,14,Friday,5,12,0
1482001471453503488,2022-01-14 14:47:39,"JoMan membuka peluang mencabut laporan terhadap Ubedillah Badrun. Asalkan, Ubedillah Badrin menyampaikan permintaan maaf ke publik. https://t.co/ZT2MdAbowx",58,156,6,23,2022-01-14,14,Friday,5,64,179
1481999776401051649,2022-01-14 14:40:55,"Banten hari ini diguncang gempa. Selain itu, kabar di Jabar soal insiden 'Lingkaran Setan' yang korbannya berjumlah 18 pelajar. https://t.co/Knka26Vsmy",15,0,5,0,2022-01-14,14,Friday,5,20,0
1481997908190937095,2022-01-14 14:33:30,Tottenham Hotspur lagi adem ayem di bursa transfer Januari ini. Apakah Spurs mau kabulkan permintaan Antonio Conte untuk datangkan pemain baru atau sebaliknya? https://t.co/Z5NAfuBW7D,8,0,0,1,2022-01-14,14,Friday,5,8,1
1481997905598763019,2022-01-14 14:33:29,"Dua kapal perang RI diresmikan di Koarmada II, Surabaya, Jatim. KRI dr Wahidin Sudirohusodo-991 dan KRI Golok-688 resmi memperkuat armada TNI Angkatan Laut. https://t.co/kF9k8hylJD",12,0,7,0,2022-01-14,14,Friday,5,19,0
1481997148908568584,2022-01-14 14:30:29,Bisakah kamu menemukan hal yang aneh di gambar ini? Bila ketemu artinya kamu memiliki penglihatan dan kemampuan berpikir logika yang baik. https://t.co/4zdmSUUi3C,9,0,4,0,2022-01-14,14,Friday,5,13,0
1481996477048279042,2022-01-14 14:27:48,Regulator nuklir Prancis melaporkan bahwa retakan yang berpotensi menjadi masalah keamanan kembali teridentifikasi pada pembangkit nuklir di negara tersebut. https://t.co/jwOGilDs7k,15,0,1,1,2022-01-14,14,Friday,5,16,1
1481996105525211136,2022-01-14 14:26:20,Aurel Valen bicara soal kehidupan asmara. Selama ini sang presenter yang kini jadi YouTuber hindari opini masyarakat dan pilih tutupi kehidupan asmara. https://t.co/pSmTpR8wEj,9,0,1,1,2022-01-14,14,Friday,5,10,1
1481995419324399628,2022-01-14 14:23:36,Tempat Istirahat dan Pelayanan (TIP) atau rest area di sejumlah jalan tol rencananya akan dibangun fasilitas penginapan. Ini tujuannya.  https://t.co/UhI9fPFpEy,18,2,3,4,2022-01-14,14,Friday,5,21,6
1481995036288036866,2022-01-14 14:22:05,"Toyota Fortuner 2.8 VRZ resmi meluncur, Kamis (13/1/2022). Kamu bisa menggunakan Fortuner dengan modal Rp 14 juta sebulan tanpa pikir servis dan pajak. https://t.co/ASlQ1urF1f",7,0,6,2,2022-01-14,14,Friday,5,13,2
1481994238275604480,2022-01-14 14:18:55,Aktor Bryan Domani dan Hanggini didapuk untuk menjadi pemeran dalam film Cek Ombak (Melulu).  https://t.co/OgiJ9jeWjC,19,3,0,2,2022-01-14,14,Friday,5,19,5
1481993326672891912,2022-01-14 14:15:17,"Kesuksesan Sultan Ghozali menjual foto selfie NFT dan dapat miliaran rupiah, tidak mengagetkan teman dan dosennya. Ghozali dikenal kreatif dan unik. https://t.co/5sIPyxGg2D",117,12,20,8,2022-01-14,14,Friday,5,137,20
1481993305839878148,2022-01-14 14:15:12,"Gempa bumi berkekuatan magnitudo (M) 6,6 mengguncang Banten hingga terasa di Jakarta. Akibatnya, 3 rumah di Cinangka, Kabupaten Serang ambruk. https://t.co/2r5YpSLCZh",9,1,6,1,2022-01-14,14,Friday,5,15,2
1481992890347839494,2022-01-14 14:13:33,Presiden Jokowi kembali menggeber motor kustom miliknya saat meninjau kesiapan MotoGP Mandalika. Tampilan motornya berbeda. Barikut wajah baru motor Jokowi. #MotoGPMandalika  https://t.co/ZGUl9tEFGv,10,3,3,1,2022-01-14,14,Friday,5,13,4
1481992151521189893,2022-01-14 14:10:37,"Kasus Omicron meledak di banyak negara termasuk Inggris dan AS. Banyak pasien mengeluh gejala berbeda dari varian sebelumnya, kali ini terjadi saat BAB. https://t.co/vGqWztw0tS",22,3,6,2,2022-01-14,14,Friday,5,28,5
1481991461713465352,2022-01-14 14:07:53,"Presiden Joko Widodo beserta rombongan melakukan kunjungan kerja ke Mandalika, Lombok Tengah, guna meninjau sejumlah fasilitas untuk MotoGP 2022. Jokowi sempat menjajal jalanan di bandara dengan motor custom. Seperti ini gayanya: https://t.co/ldGznTBVOi https://t.co/NVfJSkYGDt",33,1,2,2,2022-01-14,14,Friday,5,35,3
1481991397947367427,2022-01-14 14:07:37,"Tetangga ada yang menyenangkan, ada pula yang sebaliknya. Salah satu permasalahan adalah soal parkir mobil, terutama di perkotaan. Bagaimana solusinya? #detiksAdvocate https://t.co/i85dC5slYH",3,0,6,0,2022-01-14,14,Friday,5,9,0
1481990589801508865,2022-01-14 14:04:25,Pernyataan FX Rudy menuai reaksi usai mengomentari soal kader PDIP Temanggung yang mengembalikan bantuan dari Ganjar Pranowo. https://t.co/2WkX5njgo1,16,4,0,0,2022-01-14,14,Friday,5,16,4
1481989991555387395,2022-01-14 14:02:02,"Imam Syafi'ie atau Bang Pi'ie dikenal sebagai jagoan dari Pasar Senen, Jakarta. Terlibat perang melawan pasukan Sekutu dan Belanda. Ini kisahnya. https://t.co/fnCrE8D8x4",27,0,6,0,2022-01-14,14,Friday,5,33,0
1481989973146492928,2022-01-14 14:01:58,Insiden penganiayaan yang membuat warga Medan berlumuran darah gegara persoalan klakson bikin geger. Pelaku penganiayaan kini telah ditangkap polisi. https://t.co/vz7LpRPdxQ,3,1,2,2,2022-01-14,14,Friday,5,5,3
1481989272043413504,2022-01-14 13:59:11,Ghozali Everyday menjual foto selfie-nya sebagai NFT di plaftorm OpenSea dan laris manis dengan bayaran Ether. Ini penjelasan Ethereum:  https://t.co/0P0r3KVVku,12,0,4,0,2022-01-14,13,Friday,5,16,0
1481988907520729091,2022-01-14 13:57:44,"Sopir pikap salah injak pedal rem menyebabkan ibu hamil tua tewas di Banjarmasin, Kalimantan Selatan (Kalsel). https://t.co/X1qOtlIiw3",17,1,5,0,2022-01-14,13,Friday,5,22,1
1481988897441726467,2022-01-14 13:57:41,"Hadfana Firdaus, penendang sesajen di lokasi erupsi Semeru yang videonya viral ditangkap polisi di Bantul. Penasihat hukum Hadfana menyayangkan penangkapan itu. https://t.co/zQ6eFiyQgm",11,11,4,0,2022-01-14,13,Friday,5,15,11
1481987037653782534,2022-01-14 13:50:18,"Tim detikcom menyambangi kamar 308 yang merupakan kamar Nyi Roro Kidul di hotel Grand Inna Samudra Beach Sukabumi. 5 menit berada di sana, seperti ini kesan yang kami dapatkan: https://t.co/TqUHC73SR4",6,0,4,2,2022-01-14,13,Friday,5,10,2
1481987009656852483,2022-01-14 13:50:11,Cedera salah satu masalah yang biasa dialami atlet. Hal terpenting dalam proses pemulihan adalah membantu atlet untuk bisa kembali adaptasi ke pertandingan. https://t.co/63OuQjgxWK,10,0,2,0,2022-01-14,13,Friday,5,12,0
1481986460152700932,2022-01-14 13:48:00,"Honda Prospect Motor pastikan belum menjual Honda Brio Satya produksi 2022, artinya Honda mobil masih menjual Brio model lama dengan stok yang ada.
 https://t.co/3QALXmqnAD",16,1,4,0,2022-01-14,13,Friday,5,20,1
1481984856536064003,2022-01-14 13:41:38,Bupati Pandeglang Irna Narulita dan Dirjen Dukcapil Zudan Arif F turut merasakan goncangan gempa Banten saat mengikuti suatu acara di Panimbang. https://t.co/BegU7AKhvb,8,0,2,2,2022-01-14,13,Friday,5,10,2
1481984267366412290,2022-01-14 13:39:17,"Warga di pesisir selatan Kecamatan Sumur, Kabupaten Pandeglang, Banten, banyak yang mengungsi ke dataran tinggi akibat gempa M 6,6. https://t.co/xOASctqMNI",21,1,7,0,2022-01-14,13,Friday,5,28,1
1481984046158725126,2022-01-14 13:38:25,Manga One Piece kembali menyapa penggemarnya akhir pekan ini pada 16 Januari 2022 di situs resmi MANGAPlus Shueisha. #OnePiece  https://t.co/a6CzeucDv0,37,3,12,1,2022-01-14,13,Friday,5,49,4
1481983493030694919,2022-01-14 13:36:13,Sejumlah netizen Korea menuding Jung Hae In dan Jisoo BLACKPINK berpacaran dari cocoklogi. Seperti apa ya cocoklogi netizen? https://t.co/k0n2VtHS3d,41,1,8,1,2022-01-14,13,Friday,5,49,2
1481982950514307073,2022-01-14 13:34:03,Neve Campbell kembali ke semesta Scream. Sang aktris sangat puas dengan visi dari sutradara baru. #Scream  https://t.co/8VlJyNa6ua,14,0,1,0,2022-01-14,13,Friday,5,15,0
1481981777388388358,2022-01-14 13:29:24,"Berbagi di media sosial memang tidak bisa sembarangan. Salah-salah, hukuman denda bahkan penjara bisa mengancam. https://t.co/rjq3SayFYf",14,3,4,0,2022-01-14,13,Friday,5,18,3
1481981525218533382,2022-01-14 13:28:24,Bryan Domani menceritakan caranya untuk terhindar dari jerat narkoba. Salah satunya dengan mewaspadai lingkup pergaulan. Simak pengakuannya berikut ini: https://t.co/hw7Lxq5R7G,18,4,3,1,2022-01-14,13,Friday,5,21,5
1481979777368178689,2022-01-14 13:21:27,"Sebanyak 3 kecamatan di Kapuas Hulu, Kalimantan Barat (Kalbar) terendam banjir. Tinggi air mencapai 50 cm. https://t.co/g3Da0zIqFP",10,1,2,0,2022-01-14,13,Friday,5,12,1
1481979303168520194,2022-01-14 13:19:34,"Bank BCA membuka 4 lowongan kerja untuk lulusan S1 hingga S2. Jika kamu tertarik, simak yuk informasi lengkapnya:

via: detikedu https://t.co/57dlEnNNbN",28,2,13,2,2022-01-14,13,Friday,5,41,4
1481978385475776517,2022-01-14 13:15:55,Motor kustom dari basis W175 itu punya gaya baru. Katros Garage sebagai bengkel yang melakukan modifikasi memenuhi permintaan Presiden Jokowi. Apa saja? https://t.co/4ZnfhYqVYV,31,1,4,1,2022-01-14,13,Friday,5,35,2
1481977756585967621,2022-01-14 13:13:25,Satgas COVID-19 menerbitkan aturan baru terkait perjalanan luar negeri selama pandemi Corona. Seperti apa? https://t.co/UsxeCPtpQT,13,3,3,1,2022-01-14,13,Friday,5,16,4
1481977226803486736,2022-01-14 13:11:19,"Kartika Berliana diketahui sudah menikah dengan Gillian Pangalila. Ia mau punya banyak anak, bikin TK, dan Panti Asuhan. https://t.co/s8GOEpnUnS",21,0,2,0,2022-01-14,13,Friday,5,23,0
1481975834768510978,2022-01-14 13:05:47,"Gempa berkekuatan M 6,6 di Sumur, Banten, merusak sejumlah rumah. Salah satunya di Kadu Agung Timur, Lebak, Banten, ini. https://t.co/9UMCPzJcr1",15,0,2,1,2022-01-14,13,Friday,5,17,1
1481975294517026822,2022-01-14 13:03:38,"Menkes Budi Gunadi Sadikin mengatakan gelombang baru Corona yang disebabkan oleh varian Omicron sulit dihindari. Lalu, sejauh mana persiapan untuk menanganinya? https://t.co/pztPmAnih6",12,12,6,4,2022-01-14,13,Friday,5,18,16
1481974960247746561,2022-01-14 13:02:18,"Sepeninggalan Messi, kini Karim Benzema rajanya gol di El Clasico. Benzema meninggalkan jauh pencetak gol lain, baik dari Real Madrid atau dari Barcelona! https://t.co/Von1yQQYYz",14,1,3,0,2022-01-14,13,Friday,5,17,1
1481974661567102979,2022-01-14 13:01:07,"Ledakan terjadi di Rumah Tahfiz Qur'an Annur, Jatiluhur, Jatiasih, Kota Bekasi. Ledakan menewaskan satu orang santri. https://t.co/Rpx7AB0h31",8,2,2,0,2022-01-14,13,Friday,5,10,2
1481974608794431493,2022-01-14 13:00:55,Gempa berpusat di Banten dirasakan masyarakat sejumlah daerah Jabar. BPBD Jabar mencatat dua rumah di Kabupaten Sukabumi yang mengalami kerusakan. https://t.co/rz4XvxbN2b,17,0,5,0,2022-01-14,13,Friday,5,22,0
1481974308352233472,2022-01-14 12:59:43,"Damkar Kabupaten Bogor mengevakuasi monyet di Parakansalak, Kemang yang sudah beberapa pekan berkeliaran di sekitar permukiman. https://t.co/iUi9tXW5RS",11,0,2,2,2022-01-14,12,Friday,5,13,2
1481974283094142981,2022-01-14 12:59:37,"Lagi ramai soal pelatih Timnas Indonesia, Shin Tae-yong yang bertemu dengan pemain Persib Bandung, Marc Klok. Ngobrolin apa sih, sepertinya seru betul!  https://t.co/cHoPc1m4rE",13,2,1,0,2022-01-14,12,Friday,5,14,2
1481974031675015171,2022-01-14 12:58:37,"Serangan jantung dialami Ousmane Coulibaly di pertandingan Liga Qatar. Pemain itu berterima kasih kepada malaikat penyelamatnya, James Rodriguez. https://t.co/lfEJdxK8lo",15,0,3,0,2022-01-14,12,Friday,5,18,0
1481973790879985670,2022-01-14 12:57:40,Polisi mengungkap Fico Fachriza beli narkoba lewat media sosial. Begini penuturan pihak kepolisian:  https://t.co/AJlt6xOSKT,27,0,6,12,2022-01-14,12,Friday,5,33,12
1481973774559989760,2022-01-14 12:57:36,"Manchester City vs Chelsea akan tersaji di akhir pekan ini. Manajer Thomas Tuchel harus putar otak, agar The Blues tak lagi jatuh di lubang yang sama! https://t.co/KnC6RgI2X4",9,1,0,0,2022-01-14,12,Friday,5,9,1
1481973511585423361,2022-01-14 12:56:33,"Carlo Ancelotti mengungkapkan kelemahan besar Barcelona. Bagi pelatih Real Madrid itu, Barcelona begitu lemah soal keseimbangan permainan!  https://t.co/ZGjsdKWzHP",10,1,0,0,2022-01-14,12,Friday,5,10,1
1481973498704797697,2022-01-14 12:56:30,"Bila disebut demi konten, Andi mengaku putrinya bahkan tak tahu pengeroyokan itu direkam video. https://t.co/QeFYMwB688",7,0,2,1,2022-01-14,12,Friday,5,9,1
1481973238200684556,2022-01-14 12:55:28,Stasiun Cawang dipadati calon penumpang sore tadi. Antrean calon penumpang terlihat mengular hingga ke trotoar. https://t.co/PvO1iloSMt,8,0,1,1,2022-01-14,12,Friday,5,9,1
1481973220773449728,2022-01-14 12:55:24,Tagar #ReneOut menggema di jagad media sosial. Bobotoh mendesak manajemen Persib Bandung mencopot Pelatih Robert Rene Alberts dari kursi pelatih Maung Bandung.  https://t.co/NC1y0tm3Eo,7,3,2,1,2022-01-14,12,Friday,5,9,4
1481972920368914435,2022-01-14 12:54:12,"Tira Persikabo meraih poin sempurna saat bersua Persik Kediri dalam lanjutan BRI Liga 1. Laskar Padjajaran menang 2-1, meski sempat tertinggal lebih dulu. https://t.co/9ByQsNbuSD",9,0,1,0,2022-01-14,12,Friday,5,10,0
1481972902857695240,2022-01-14 12:54:08,"Bella Sulian rugi Rp 1,4 M gegara sunmod alkes. Bella Sulian sampai jual mobil BMW untuk biaya hidup.  https://t.co/N8ewCkFLo7",15,1,6,0,2022-01-14,12,Friday,5,21,1
1481972124902469635,2022-01-14 12:51:02,"Mohamed Salah dikabarkan minta naik gaji demi memperpanjang kontraknya di Liverpool. Bagi jamie Carragher, Salah tidak salah kalau memang minta hal itu!  https://t.co/AwWZdvnu5B",20,24,1,7,2022-01-14,12,Friday,5,21,31
1481971519605596161,2022-01-14 12:48:38,"BPBD Pandeglang merilis data sementara dampak gempa Banten 6,6 M yang terjadi pada Jumat (14/1/2022) sekitar pukul 16.05 WIB. https://t.co/0qLrpx1KmE",16,0,9,2,2022-01-14,12,Friday,5,25,2
1481970179487719426,2022-01-14 12:43:19,"KPK telah melimpahkan berkas perkara Bupati Probolinggo nonaktif Puput Tantriana Sari (PTS) dan suaminya, Hasan Aminuddin ke pengadilan. https://t.co/CxoQIUxwWB",8,0,2,1,2022-01-14,12,Friday,5,10,1
1481968748022181894,2022-01-14 12:37:37,Beredar sebuah video yang memperlihatkan sejumlah pasien COVID-19 di RSDC Wisma Atlet berhamburan. Pihak Wisma Atlet memastikan kondisinya sudah kondusif lagi. https://t.co/VwnfLeAIFs,8,1,0,1,2022-01-14,12,Friday,5,8,2
1481968744683483139,2022-01-14 12:37:37,BPBD Kabupaten Lebak mencatat ada enam rumah warga dan satu sekolah rusak di wilayahnya akibat gempa bumi. https://t.co/QuSKgiyjte,8,0,2,0,2022-01-14,12,Friday,5,10,0
1481968223029501953,2022-01-14 12:35:32,Hendra Setiawan/Mohammad Ahsan melangkah ke babak semifinal India Open 2022. The Daddies kalahkan wakil Norwegia dalam dua set langsung.  https://t.co/xFIKWORGF9,35,1,1,0,2022-01-14,12,Friday,5,36,1
1481967991671693315,2022-01-14 12:34:37,#FOTO Polisi menggelar konferensi pers terkait kasus narkoba yang menjerat Fico Fachriza. Ini momen Fico Fachriza berurai air mata:  https://t.co/vbzyKGMSd7,73,43,18,5,2022-01-14,12,Friday,5,91,48
1481967990488936451,2022-01-14 12:34:37,"Indonesia melaporkan 850 kasus COVID-19 pada Jumat (14/1/2022). Total kasus positif menjadi 4.269.740, sembuh 4.117.700, dan meninggal 144.163. https://t.co/aBID20uTw8",5,0,0,1,2022-01-14,12,Friday,5,5,1
1481967666709549059,2022-01-14 12:33:20,"Gempa berkekuatan 6,6 magnitudo di Banten mengguncang sejumlah daerah seperti Jabodetabek. Kondisi air laut di sejumlah pantai di Banten terpantau normal. https://t.co/PrxW66EbuE",16,0,2,0,2022-01-14,12,Friday,5,18,0
1481967625693536270,2022-01-14 12:33:10,"Saat gempa mengguncang, pasien COVID-19 di Krukut, Jakarta Barat, yang sedang melakukan isolasi mandiri sempat berhamburan keluar rumah. https://t.co/HAPsAzlCIn",10,0,2,1,2022-01-14,12,Friday,5,12,1
1481965677024100354,2022-01-14 12:25:25,Komedian Fico Fachriza diamankan pihak kepolisian lantaran kasus penyalahgunaan narkoba. Ini barang bukti yang ditemukan polisi di TKP:  https://t.co/A9bRD15rAg,9,1,1,1,2022-01-14,12,Friday,5,10,2
1481965662167830531,2022-01-14 12:25:22,DKI Jakarta dan sekitarnya diguncang gempa pada Jumat (14/1/2022). BMKG mengimbau agar warga mewaspadai gempa susulan. Apa yang harus dilakukan saat gempa? https://t.co/djORxISld1,18,0,9,1,2022-01-14,12,Friday,5,27,1
1481965534359003136,2022-01-14 12:24:51,"Indonesia mencatat 850 kasus baru COVID-19, Jumat (14/1/2022). DKI menyumbang jumlah kasus terbanyak dengan total 554 kasus. https://t.co/hh5MQ6z2j5",9,0,3,0,2022-01-14,12,Friday,5,12,0
1481965392465731587,2022-01-14 12:24:17,Buaya betina tersebut tengah berada di kandang milik warga saat evakuasi. Proses evakuasi pun memakan waktu sekitar 15 menit. https://t.co/kMd94tfc8B,13,1,4,0,2022-01-14,12,Friday,5,17,1
1481964729040003075,2022-01-14 12:21:39,"Gempa bumi bermagnitudo 6,7 mengguncang Sumur, Banten. Gempa terasa sampai di Jakarta. Karyawan di salah satu gedung di Jakarta berlomba turun keluar dari gedung. https://t.co/2ZSPSmIR8h",12,0,0,0,2022-01-14,12,Friday,5,12,0
1481964529915514884,2022-01-14 12:20:52,"Gempa bumi kembali dirasakan di Jakarta yang menimbulkan kepanikan. Berikut daftar istilah gempa bumi yang wajib diketahui detikers.

via: detikedu https://t.co/jMa21SIo0M",11,0,1,0,2022-01-14,12,Friday,5,12,0
1481964508713299974,2022-01-14 12:20:47,"Bayi kembar siam dengan kondisi satu badan dua kepala lahir dengan kondisi sehat di RSMH Palembang, hari ini. Kedua bayi itu kondisinya stabil. https://t.co/WkOJgSJA79",7,2,0,1,2022-01-14,12,Friday,5,7,3
1481963039133941762,2022-01-14 12:14:56,"Pusat Vulkanologi dan Mitigasi Bencana Geologi (PVMBG) mengungkap penyebab gempa M 6,7 di Sumur, Banten. https://t.co/MCwSsOdvBo",10,2,3,0,2022-01-14,12,Friday,5,13,2
1481962787693862913,2022-01-14 12:13:56,"Sejak diluncurkan ke berbagai negara, website resmi Shonen Jump+ juga sukses disukai para pembaca seluruh dunia. https://t.co/VfhOiupTGl",9,0,2,0,2022-01-14,12,Friday,5,11,0
1481961975865389057,2022-01-14 12:10:43,Wacana kenaikan tarif KRL untuk 25 km pertama dari Rp 3.000 menjadi Rp 5.000 menuai pro dan kontra dari anak kereta (anker). Apa kata mereka? https://t.co/ZZsXMWdEjI,6,4,3,2,2022-01-14,12,Friday,5,9,6
1481961958693875712,2022-01-14 12:10:39,Fico Fachriza tersangka kasus narkoba membeli tembakau sintetis Gorilla dari media sosial. Polisi kini mulai intensif memburu bandar narkoba di media sosial. https://t.co/z7nF1f6NYN,7,1,4,4,2022-01-14,12,Friday,5,11,5
1481960343689646082,2022-01-14 12:04:14,"Gempa besar terjadi di DKI Jakarta, banyak warga merasa pusing setelahnya. Apa bedanya dengan pusing beneran, misalnya karena kurang tidur? https://t.co/6RCsH1kpBS",38,19,5,9,2022-01-14,12,Friday,5,43,28
1481960342288801798,2022-01-14 12:04:13,"Gempa M 6,6 di Sumur, Banten, terasa kuat hingga wilayah Tangerang Raya. BPBD wilayah di Tangerang Raya sedang mengumpulkan informasi ada atau tidak kerusakan. https://t.co/9HKde6PkXT",68,0,10,1,2022-01-14,12,Friday,5,78,1
1481959380656529411,2022-01-14 12:00:24,Bupati Penajam Paser Utara Abdul Gafur Mas'ud berharap masyarakat Penajam Paser Utara tetap bersemangat meskipun dirinya bersama lima orang lainnya diproses hukum oleh KPK. #CNNIndonesia #detikNetwork  https://t.co/gxp8yTDJHk,15,2,5,2,2022-01-14,12,Friday,5,20,4
1481959347844534277,2022-01-14 12:00:16,Kepala BMKG Dwikorita Karnawati menyebut gedung bertingkat di Jakarta belum siap dari evakuasi gempa. Dia meminta hal ini jadi perhatian. https://t.co/RN6mYWWojY,15,0,9,3,2022-01-14,12,Friday,5,24,3
1481958960274063360,2022-01-14 11:58:44,"Gempa magnitudo (M) 6,7 terjadi di Sumur, Pandeglang, Banten. Berdasarkan laporan sementara, sudah ada 44 rumah warga di Kecamatan Muncul yang rusak. https://t.co/qoHVUeqkNE",14,3,8,1,2022-01-14,11,Friday,5,22,4
1481958350883635202,2022-01-14 11:56:18,"Zara Adhisty bermain dalam serial Virgin The Series. Memerankan Thalita, Zara jadi cewek ambisius.  https://t.co/tc9JfdDVno",9,7,1,3,2022-01-14,11,Friday,5,10,10
1481957559368134659,2022-01-14 11:53:10,Vega Darwanti kembali menjenguk Tukul Arwana. Ini kondisi terkini Tukul yang disebutkan Vega:  https://t.co/vOzZcIMXzk,97,7,6,0,2022-01-14,11,Friday,5,103,7
1481957272234479617,2022-01-14 11:52:01,"Benyamin mengaku juga merasakan getarannya. Saat gempa terjadi, ia sedang di Rumah Dinas Wali Kota Tangsel yang berada di Serpong. https://t.co/1m746sm890",10,1,1,0,2022-01-14,11,Friday,5,11,1
1481956455209226246,2022-01-14 11:48:46,Adhisty Zara menceritakan jika momen yang paling sulit dilupakannya kala tampil di Virgin the Series yakni adegan bersama DJ Winky.  https://t.co/ZzzKaEsdPZ,7,0,1,0,2022-01-14,11,Friday,5,8,0
1481956437811159045,2022-01-14 11:48:42,"Baru saja terjadi gempa M 6,6 di Selat Sunda. BMKG mencatat aktivitas gempa bumi meningkat sebulan terakhir ini. Pemda Banten, Jabar, hingga Jatim perlu siap. https://t.co/PEsIJhGqVD",10,0,7,0,2022-01-14,11,Friday,5,17,0
1481956436519395336,2022-01-14 11:48:42,"""Jadi prediksi tidak berpotensi tsunami nampaknya terverifikasi tidak terjadi tsunami,"" tutur Kepala BMKG Dwikorita. https://t.co/Sof4CTvkDp",9,0,1,0,2022-01-14,11,Friday,5,10,0
1481955561994346496,2022-01-14 11:45:14,"Mohamed Salah dikabarkan minta naik gaji demi memperpanjang kontraknya di Liverpool. Bagi jamie Carragher, Salah tidak salah kalau memang minta hal itu! https://t.co/w0uiWvPTL5",36,14,10,18,2022-01-14,11,Friday,5,46,32
1481955308725538818,2022-01-14 11:44:13,"Video menunjukkan gedung Kantor Wali Kota Jakarta Barat disertai narasi gedung rusak akibat gempa M 6,6 yang terjadi di Jakarta viral. Bagaimana faktanya? https://t.co/Q9mcJeq2J7",6,0,1,0,2022-01-14,11,Friday,5,7,0
1481955024351928320,2022-01-14 11:43:05,"Puluhan ribu umat Hindu di India, yang dipimpin kepala kuil dan para pertapa, berkumpul dan mengikuti ritual suci di Sungai Gangga. https://t.co/QyFlkS5mOj",48,37,13,8,2022-01-14,11,Friday,5,61,45
1481954999685066758,2022-01-14 11:42:59,"Badan Meteorologi, Klimatologi dan Geofisika (BMKG) menjelaskan perbedaan gempa yang terjadi hari ini di Sumur, Banten dengan gempa dan tsunami tahun 2018. https://t.co/5BMYJ6rMOP",7,0,1,0,2022-01-14,11,Friday,5,8,0
1481954469659258882,2022-01-14 11:40:53,Para arkeolog dibuat takjub melihat Pagoda Kyaiktiyo di Myanmar. Pagoda ini menyimpan bongkahan batu yang melawan gravitasi sehingga tidak jatuh. https://t.co/VcqdC7bjjb,14,1,1,0,2022-01-14,11,Friday,5,15,1
1481954456883408896,2022-01-14 11:40:50,Thariq Halilintar mengaku sedih dan panik saat Ashanty terpapar Corona yang kedua kalinya. Ia menceritakan kondisi terkini Ashanty:  https://t.co/Cy2CQ5NUIK,5,0,1,0,2022-01-14,11,Friday,5,6,0
1481954165588959232,2022-01-14 11:39:41,BPOM secara resmi memberikan izin penggunaan darurat untuk lima merek vaksin sebagai dosis booster. Ketahui efek samping Moderna hingga Pfizer di sini:  https://t.co/76LUBBtaHh,14,0,7,0,2022-01-14,11,Friday,5,21,0
1481954139944988674,2022-01-14 11:39:34,"Timnas Tunisia mengajukan banding, usai laga melawan Mali di Piala Afrika berakhir dengan banyak kontroversi. Permintaan tanding ulangnya ditolak. https://t.co/oNUtVblnWB",12,1,2,0,2022-01-14,11,Friday,5,14,1
1481953910860529665,2022-01-14 11:38:40,"Krafton, pembuat PUBG mendaftarkan gugatan yang sangat besar, yaitu mereka menggugat pengembang Free Fire dan Free Fire Max serta Apple dan Google. https://t.co/IxjdMhKYzU",11,0,4,1,2022-01-14,11,Friday,5,15,1
1481953898596380676,2022-01-14 11:38:37,Microsoft telah mengonfirmasi bahwa mereka telah menghentikan pembuatan semua konsol Xbox One.  https://t.co/Si0FQE0UG6,5,0,1,1,2022-01-14,11,Friday,5,6,1
1481953616881766402,2022-01-14 11:37:30,"Berdasarkan hasil penelitian terbaru, curah hujan tinggi ternyata berdampak pada kondisi ekonomi, bahkan skalanya global. Kok bisa? https://t.co/apEGmAtoXG",7,0,3,0,2022-01-14,11,Friday,5,10,0
1481953349142470658,2022-01-14 11:36:26,Komedian Fico Fachriza ditangkap polisi terkait dugaan memakai narkoba jenis tembakau gorila. Apa sih arti nama tembakau gorila itu? Berikut penjelasannya: https://t.co/fnCid1Tke0,34,1,4,4,2022-01-14,11,Friday,5,38,5
1481953034636779521,2022-01-14 11:35:11,Gerakan Semesta Rakyat Indonesia melaporkan Gubernur Sumut Edy Rahmayadi ke KPK dugaan gratifikasi. Edy bakal lapor balik mereka. https://t.co/QAmD7gL2lQ,8,2,2,1,2022-01-14,11,Friday,5,10,3
1481952629827809288,2022-01-14 11:33:34,Manchester City akan menjamu Chelsea di lanjutan Liga Inggris akhir pekan ini. Gabriel Jesus memburu gol kedua ke gawang The Blues. https://t.co/aMFWnhqgA1,7,0,1,0,2022-01-14,11,Friday,5,8,0
1481952627143417865,2022-01-14 11:33:34,Dia menyampaikan para pasien berhamburan keluar gedung. Namun Mintoro memastikan pasien tetap ada dalam zona merah. https://t.co/uG1Z7ZNVvh,6,0,3,0,2022-01-14,11,Friday,5,9,0
1481951983070330880,2022-01-14 11:31:00,"Komika Fico Fachriza ditangkap karena narkoba di kediaman pribadinya kawasan Pancoran Mas, Depok, pada Kamis (13/1) pukul 18.15 WIB. #FicoFachriza  https://t.co/6aV9fBuXT8",21,7,1,4,2022-01-14,11,Friday,5,22,11
1481951944944009217,2022-01-14 11:30:51,"Gempa M 6,6 berpusat di laut dekat Selat Sunda terasa hingga di beberapa wilayah. Gempa dirasakan dengan intensitas yang berbeda-beda dari Banten-Jakarta. https://t.co/djEAdLHGKv",9,0,0,0,2022-01-14,11,Friday,5,9,0
1481951691427794944,2022-01-14 11:29:51,"Dalam penelitian terbaru yang digelar perusahaan monitoring aplikasi, App Annie, orang rata-rata menghabiskan waktu 4,8 jam tiap hari mengakses ponsel. https://t.co/kta7UaDUWP",10,1,0,0,2022-01-14,11,Friday,5,10,1
1481951369791746048,2022-01-14 11:28:34,BMKG menyampaikan mengenai sejarah gempa dan tsunami di Banten sebelum gempa yang mengguncang hari ini. Berikut selengkapnya. https://t.co/CleEJA0tZK,6,0,1,0,2022-01-14,11,Friday,5,7,0
1481951368504033280,2022-01-14 11:28:34,Polda Metro Jaya buka suara soal maraknya artis yang ditangkap terkait kasus narkoba awal tahun ini. Polisi membantah ada kaitan dari penangkapan para artis itu https://t.co/XoSp247593,1,1,0,0,2022-01-14,11,Friday,5,1,1
1481951109438709765,2022-01-14 11:27:32,"Gempa dengan magnitudo 6,6 yang berpusat di Banten mengguncang wilayah Jakarta. BPBD DKI Jakarta mencatat setidaknya 2 bangunan mengalami keretakan. https://t.co/LQzCYx0k8o",16,0,5,0,2022-01-14,11,Friday,5,21,0
1481951107232456707,2022-01-14 11:27:31,Beredar sebuah video yang memperlihatkan sejumlah pasien COVID-19 di RSDC Wisma Atlet berhamburan. Pihak Wisma Atlet memastikan kondisinya sudah kondusif lagi. https://t.co/NhetsW9098,3,0,0,0,2022-01-14,11,Friday,5,3,0
1481950898796515334,2022-01-14 11:26:42,Nike akan mulai pecat karyawan yang belum vaksinasi COVID-19. Langkah ini diambil menyusul varian baru Omicron yang diketahui menyebar empat kali lebih cepat. https://t.co/3UBrQj2ca6,10,0,1,1,2022-01-14,11,Friday,5,11,1
1481950880085819392,2022-01-14 11:26:37,#FOTO Selfie dari Ghozali yang dijual sebagai NFT benar-benar diminati. Bahkan sebagian netizen ramai memburu posenya yang disebut langka. https://t.co/oPZLRiL9TW,4,0,0,1,2022-01-14,11,Friday,5,4,1
1481950276319948809,2022-01-14 11:24:13,Ariana Grande dan Kid Cudi menyanyikan lagu di film fiksi ilmiah 'Don't Look Up'mengenai ancaman yang menghadang Bumi. Pesannya: dengarkan ahli! https://t.co/GCuZHh7dlW,6,0,0,1,2022-01-14,11,Friday,5,6,1
1481950269407739904,2022-01-14 11:24:12,"Game mobile berjudul Sakura School Simulator, terungkap dapat melakukan beberapa adegan dewasa. Duh!  https://t.co/sqGpxyYsdV",6,1,1,4,2022-01-14,11,Friday,5,7,5
1481949947159318529,2022-01-14 11:22:55,"Salah satu tersangka kasus suap pemeriksaan pajak tahun 2016-2017, Alfred Simanjuntak diperiksa KPK. Ia menjalani pemeriksaan perdana usai ditahan KPK. https://t.co/onYtmATkYL",5,0,1,0,2022-01-14,11,Friday,5,6,0
1481949945020178433,2022-01-14 11:22:54,"Gempa bumi berkuatan M 6,6 yang berpusat di Sumur, Banten, dirasakan warga Palembang, Sumatera Selatan. Warga yang berada di gedung tinggi berhamburan ke luar. https://t.co/YnwBpHDmjP",8,1,0,0,2022-01-14,11,Friday,5,8,1
1481949554962489346,2022-01-14 11:21:21,"BMKG melaporkan update terkini seputar gempa M 6,6 di sekitar Selat Sunda. Akibat gempa tersebut, terdapat sejumlah bangunan yang rusak. https://t.co/s5L7lyeYku",11,0,2,0,2022-01-14,11,Friday,5,13,0
1481949553087717383,2022-01-14 11:21:21,"Gempa dengan magnitudo 6,6 terjadi di Banten. BMKG mengimbau warga tetap tenang dan tidak terpengaruh informasi yang tidak dapat dipertanggung jawabkan. https://t.co/S1znpnzg3X",9,0,0,0,2022-01-14,11,Friday,5,9,0
1481948994788114432,2022-01-14 11:19:08,"Gempa berkekuatan M 6,7 yang kemudian diperbarui menjadi M 6,6 mengguncang Sumur, Banten. BMKG mencatat ada 5 kali gempa susulan pascagempa tersebut. https://t.co/GmMFqZTGZA",134,5,23,4,2022-01-14,11,Friday,5,157,9
1481948748779556868,2022-01-14 11:18:09,"PS5 saat ini masih sulit dicari meski sudah diluncurkan setahun yang lalu. Untuk mengatasi kekosongan stok PS5, Sony justru memproduksi lebih banyak PS4. https://t.co/xCsUNamdz3",13,4,1,3,2022-01-14,11,Friday,5,14,7
1481948460400140290,2022-01-14 11:17:00,117 KK warga Majene masih bertahan di pengungsian meski gempa bumi sudah setahun berlalu. https://t.co/2A8i7rm9Zb,11,0,8,0,2022-01-14,11,Friday,5,19,0
1481948120653172738,2022-01-14 11:15:39,"Kasus narkoba di dunia hiburan terjadi lagi, kali ini menimpa komika Fico Fachriza yang ditangkap kepolisian karena penggunaan narkoba. Ini reaksi netizen:  https://t.co/yeqnJecPPm",13,5,1,0,2022-01-14,11,Friday,5,14,5
1481948098209456136,2022-01-14 11:15:34,Nagita Slavina tengah diterpa isu tak sedap. Lagi-lagi heboh video syur mirip Nagita yang tersebar di media sosial. https://t.co/3a7AFtVkTI,30,10,12,0,2022-01-14,11,Friday,5,42,10
1481947381549654016,2022-01-14 11:12:43,Komika Fico Fachriza ditangkap terkait kasus narkoba jenis tembakau sintetis Gorilla. Fico Fachriza dinyatakan positif narkoba. https://t.co/Vl3IjgMwXp,15,0,6,5,2022-01-14,11,Friday,5,21,5
1481947379813265414,2022-01-14 11:12:43,"Gempa M 6,6 di sekitar Selat Sunda keras mengguncang sampai Jakarta. BMKG menjelaskan penyebab gempa ini. https://t.co/qQQ8z0j21A",18,1,3,0,2022-01-14,11,Friday,5,21,1
1481947126263336963,2022-01-14 11:11:42,"Komplotan begal yang menebas tangan pemuda di Kabupaten Kudus, Jawa Tengah ditangkap polisi. Empat pelaku diamankan dan dua pelaku lainnya masih menjadi buron. https://t.co/22aPVaOFRR",6,3,2,2,2022-01-14,11,Friday,5,8,5
1481947110031466500,2022-01-14 11:11:38,"Big match seru Liga Inggris akhir pekan ini, Manchester City vs Chelsea. Duel dua tim papan atas yang rasanya seperti laga final!  https://t.co/55lPTlcZ43",6,0,0,0,2022-01-14,11,Friday,5,6,0
1481946784213704704,2022-01-14 11:10:21,"Gempa bumi berkuatan M 6,6 yang berpusat di Sumur, Banten, dirasakan warga Palembang, Sumatera Selatan. Warga yang berada di gedung tinggi berhamburan keluar. https://t.co/URKCrH66oP",11,0,2,1,2022-01-14,11,Friday,5,13,1
1481946780879175685,2022-01-14 11:10:20,Komedian Fico Fahriza diamankan polisi karena diduga memakai narkoba. Polisi menyebut ada barang bukti tembakau gorila atau ganja sintetis. https://t.co/FIWwsLPeqA,8,1,2,3,2022-01-14,11,Friday,5,10,4
1481946354221998085,2022-01-14 11:08:38,Pacitan tiga kali diguncang gempa dalam enam jam. Gempa pertama pukul 09.02 WIB dengan magnitudo 2.7. https://t.co/ZXjggygn3L,11,0,4,1,2022-01-14,11,Friday,5,15,1
1481946352963801089,2022-01-14 11:08:38,"Gempa M 6,6 dirasakan getarannya hingga ke Kabupaten Bogor. Sejauh ini dua rumah warga di Kecamatan Cigudeg dan Sukajaya dilaporkan rusak akibat gempa. https://t.co/66zdMNuCvW",6,0,3,0,2022-01-14,11,Friday,5,9,0
1481946351692877825,2022-01-14 11:08:38,"Gempa dengan magnitudo 6,6 terjadi di Banten dan terasa hingga Bekasi. Pegawai Pemkot Bekasi pun berlarian keluar gedung akibat guncangan gempa. https://t.co/QNd07OavQQ",6,0,1,0,2022-01-14,11,Friday,5,7,0
1481946350375870465,2022-01-14 11:08:37,"Ibu hamil yang bekerja di kawasan Jakarta Selatan, terpaksa menyelamatkan diri dengan menuruni tangga darurat dari lantai 17 saat gempa mengguncang Jakarta. https://t.co/WmTIrW61qf",15,1,4,3,2022-01-14,11,Friday,5,19,4
1481945462605238272,2022-01-14 11:05:06,"Gempa mengguncang Jakarta dan sekitarnya dengan kekuatan M 6,7. Masyarakat bisa mengecek informasi gempa terbaru lewat BMKG. Ini caranya:  https://t.co/W3e14EdtFV",10,0,6,0,2022-01-14,11,Friday,5,16,0
1481945439947603969,2022-01-14 11:05:00,"Aksi polwan mengimbau warga dengan menggunakan bahasa China di Singkawang, Kalimantan Barat, bikin heboh media sosial. Usut-diusut, ternyata ada alasan di balik penggunaan bahasa China tersebut. https://t.co/DB7iGBEmXr",6,1,1,0,2022-01-14,11,Friday,5,7,1
1481945175844868098,2022-01-14 11:03:57,"Non prioritas sudah banyak yang mendapat tiket vaksin booster, jadi boleh langsung datang ke fasilitas kesehatan terdekat? Ini penjelasan Kemenkes RI. https://t.co/PwZROOESRo",15,2,5,0,2022-01-14,11,Friday,5,20,2
1481944696532439043,2022-01-14 11:02:03,"Atang (50), petani yang ditembak pria koboi, kini menjalani perawatan di RSUD Karawang. Kondisi pria tersebut stabil. https://t.co/ZjKoebNwWu",4,2,4,0,2022-01-14,11,Friday,5,8,2
1481944373344485377,2022-01-14 11:00:46,New Jeep Compass merupakan Jeep termurah dan sudah ada di tanah air sejak akhir 2021. Simak ulasan kami! https://t.co/is6fqpPmZe,14,0,1,0,2022-01-14,11,Friday,5,15,0
1481943565529931782,2022-01-14 10:57:33,Fico Fachriza diamankan polisi karena kedapatan mengkonsumsi narkoba. Ini alasan Fico mengkonsumsi tembakau gorila:   https://t.co/ilGG2Tk8HA,17,2,3,1,2022-01-14,10,Friday,5,20,3
1481943545145704450,2022-01-14 10:57:28,Polisi menangap komika Fico Fachriza terkait kasus narkoba. Fico Fachriza ditangkap dalam kondisi masih terpengaruh narkoba. https://t.co/cRjniJnGCo,30,2,4,1,2022-01-14,10,Friday,5,34,3
1481942997596098561,2022-01-14 10:55:18,Komika Fico Fahcriza diciduk polisi terkait penggunaan tembakau sintetis. Fico Fachriza terancam hukuman 4 tahun penjara. https://t.co/14eH7rePTx,8,4,1,1,2022-01-14,10,Friday,5,9,5
1481942232848547842,2022-01-14 10:52:16,#terpopuler Sepak terjang Mike Tyson di luar ring dulu sebegitu liar. Ia bisa bercinta dengan 15 perempuan per hari. Lokasinya bisa di ruang ganti jelang naik ring dan di penjara!  https://t.co/u83LYoVDjr,9,3,0,0,2022-01-14,10,Friday,5,9,3
1481942209738031104,2022-01-14 10:52:10,"Wilayah Jabodetabek diguncang gempa M 6,7 yang berpusat di Banten. Banyak yang merasakan pusing setelahnya. Bagaimana mengatasi pusing setelah gempa? https://t.co/CJ5KGPratt",9,4,4,2,2022-01-14,10,Friday,5,13,6
1481941987930800132,2022-01-14 10:51:17,"#Foto Beberapa rumah di Kecamatan Sumur dan Kecamatan Munjul Kabupaten Pandeglang, mengalami kerusakan akibat gempa M 6,6. Kerusakan terjadi di bagian atap-teras. Berikut fotonya:

https://t.co/3DnD0xtHXr",10,1,3,1,2022-01-14,10,Friday,5,13,2
1481941983681986561,2022-01-14 10:51:16,"Sejumlah warga di Desa Teluk, Kecamatan Labuan, Kabupaten Pandeglang, Banten, mengungsi ke masjid sewaktu gempa terjadi.

https://t.co/Pp89EQsNYh",6,1,3,1,2022-01-14,10,Friday,5,9,2
1481941857668116485,2022-01-14 10:50:46,"Gempa berkekuatan magnitudo 6,7 terasa di wilayah DKI Jakarta. Pengunjung Mal Taman Anggrek di Jakarta Barat berhamburan ke luar gedung saat gempa terjadi. https://t.co/bSrS14e6oG",7,0,1,0,2022-01-14,10,Friday,5,8,0
1481941855516467200,2022-01-14 10:50:46,"Beberapa rumah di Kecamatan Sumur dan Kecamatan Munjul Kabupaten Pandeglang, mengalami kerusakan akibat gempa M 6,6. Kerusakan terjadi di bagian atap-teras. https://t.co/nSDLIjPGKy",10,0,2,0,2022-01-14,10,Friday,5,12,0
1481940914423672833,2022-01-14 10:47:01,"Warga Desa Teluk, Pandegalng, Banten berhamburan mengungsi ke masjid saat gempa 6,6 M mengguncang Sumur, Banten. https://t.co/3jD4iUVlSX",18,2,1,1,2022-01-14,10,Friday,5,19,3
1481940081904656387,2022-01-14 10:43:43,"Real Madrid bertransisi dengan manis, setelah era Cristiano Ronaldo. Los Blancos sudah menemukan para pemain muda yang bisa jadi pemain top di masa depan!  https://t.co/5KJbDnCKCi",10,0,0,0,2022-01-14,10,Friday,5,10,0
1481939796532547586,2022-01-14 10:42:35,Guncangan gempa yang berpusat di Banten terasa hingga Cianjur. BPBD Cianjur langsung memantau titik rawan bencana yang berpotensi terdampak gempa. https://t.co/B5d3nqlbJm,18,0,4,1,2022-01-14,10,Friday,5,22,1
1481939419506561026,2022-01-14 10:41:05,"Gempa M 6,6 di Sumur, Banten, terasa kuat hingga ke Jakarta. Penghuni apartemen di wilayah Jakbar memperkirakan guncangan akibat gempa terasa sampai 5 menit. https://t.co/QWUo8xMuw8",7,0,2,0,2022-01-14,10,Friday,5,9,0
1481939417375911944,2022-01-14 10:41:04,"Gempa M 4,6 mengguncang Pacitan, Jumat (14/1/2022) pukul 15.23 WIB. BPBD Pacitan menyebut sejauh ini belum ada informasi kerusakan akibat gempa tersebut. https://t.co/pVYcmF4G5d",15,0,1,2,2022-01-14,10,Friday,5,16,2
1481938754407481344,2022-01-14 10:38:26,Riza juga berterima kasih kepada aparatur sipil negara (ASN) serta seluruh tamu di Balai Kota DKI yang tetap tenang ketika merasakan gempa hari ini. https://t.co/BgLZmAQuhQ,6,0,1,0,2022-01-14,10,Friday,5,7,0
1481938752972988420,2022-01-14 10:38:26,Sebuah video menunjukkan seorang warga berlumuran darah diduga dianiaya viral di media sosial. Polisi pun menangkap pelakunya. https://t.co/2ffYjMPO9J,3,0,0,0,2022-01-14,10,Friday,5,3,0
1481938751001485312,2022-01-14 10:38:25,"Gempa bumi dengan magnitudo (M) 6,7 terjadi di Kecamatan Sumur, Pandeglang, Banten. Akibat gempa ini dilaporkan, ada bangunan MTs di Pandeglang yang rusak. https://t.co/5s4pXfi0xQ",3,0,0,0,2022-01-14,10,Friday,5,3,0
1481938748791300098,2022-01-14 10:38:25,"Gempa susulan kembali mengguncang wilayah Banten. Kali ini, gempa berkekuatan magnitudo 4,0. https://t.co/b1SNsPeRke",18,0,3,0,2022-01-14,10,Friday,5,21,0
1481938746681569284,2022-01-14 10:38:24,Gempa bumi berpusat di Banten guncangannya terasa ke sejumlah daerah di Jawa Barat. Gempa tersebut dirasakan warga di Kota Sukabumi. https://t.co/uzv3h9dPpP,18,0,2,0,2022-01-14,10,Friday,5,20,0
1481938744299212803,2022-01-14 10:38:24,"Gempa bumi dengan magnitudo (M) 6,6 di Banten dirasakan kuat guncangannya di Jakarta. Getaran gempa sempat membuat panik pasien dan keluarga di RS. https://t.co/RkUTUPlN4i",6,1,2,1,2022-01-14,10,Friday,5,8,2
1481937481540980736,2022-01-14 10:33:23,Siapa yang tidak kenal dengan kedai kopi Starbucks? Kini ia memiliki 20 ribu lebih kedai di 61 negara. Tapi gugatan mereknya kandas di PN Jakpus. Kok bisa? https://t.co/yuq116GX5U,14,1,8,5,2022-01-14,10,Friday,5,22,6
1481937461223862275,2022-01-14 10:33:18,"Wilayah Banten kembali diguncang gempa susulan. Gempa susulan ini berkekuatan M 3,7. https://t.co/mURpEGkvLI",28,0,16,5,2022-01-14,10,Friday,5,44,5
1481937458782777344,2022-01-14 10:33:17,"Gempa berkekuatan magnitudo 6,7 terasa di wilayah DKI Jakarta. Pengunjung mal Taman Anggrek di Jakarta Barat berhamburan keluar saat gempa terjadi. https://t.co/C4ANNNQz5t",9,0,5,0,2022-01-14,10,Friday,5,14,0
1481937107321073667,2022-01-14 10:31:54,"Fico Fachriza dipamerkan oleh polisi usai ditangkap karena narkoba. Memakai baju tahanan oranye, Fico Fachriza terlihat menangis dan memeluk erat Rispo.  https://t.co/LwJM3VP5ca",136,24,36,37,2022-01-14,10,Friday,5,172,61
1481937106192809986,2022-01-14 10:31:53,Menurut peraturan baru mobil berkategori Low Cost and Green Car (LCGC) akan dikenakan pajak 3 persen. https://t.co/ELab6oMDB0,4,0,1,1,2022-01-14,10,Friday,5,5,1
1481936714948124672,2022-01-14 10:30:20,"Gempa M 6,7 yang terjadi di Banten terasa kuat hingga ke Jakarta. Para pegawai di kantor BPK, Jakarta, berhamburan ke luar gedung untuk menyelamatkan diri. https://t.co/AXDmBYjOnB",9,2,1,0,2022-01-14,10,Friday,5,10,2
1481935428127236097,2022-01-14 10:25:13,Komika Fico Fachriza ditangkap polisi karena penyalahgunaan narkoba. Dia ditangkap di rumahnya pada Kamis (14/1) malam. https://t.co/pwbikYJp6H,8,9,3,3,2022-01-14,10,Friday,5,11,12
1481935426369818632,2022-01-14 10:25:13,Warga di Kecamatan Bayah Kabupaten Lebak panik dan keluar rumah setelah merasakan getaran gempa sekitar 30 detik yang berpusat di wilayah Sumur Lebak Banten. https://t.co/gUqD1IvJI0,7,0,1,0,2022-01-14,10,Friday,5,8,0
1481935425107369987,2022-01-14 10:25:13,"Gempa terjadi di Laut Banda, Kepulauan Maluku. Gempa ini berkekuatan magnitudo (M) 5,2. https://t.co/Cy00EA0ktt",7,2,3,1,2022-01-14,10,Friday,5,10,3
1481935423807098884,2022-01-14 10:25:12,"Gempa dengan magnitudo 6,6 (sebelumnya disebut 6,7) mengguncang wilayah Banten hingga Jakarta. Akibatnya, sejumlah rumah mengalami kerusakan. https://t.co/OBu8lywFCR",5,0,3,0,2022-01-14,10,Friday,5,8,0
1481935337010380800,2022-01-14 10:24:52,"""Gempanya kerasa, kalo warga panik nggak. Kalau kondisi di Anyer sih aman, ada yang berenang juga,"" ujar pengelola Pantai Lagundi Anyer.

https://t.co/wq2IjytAZl",12,3,1,2,2022-01-14,10,Friday,5,13,5
1481935334657388544,2022-01-14 10:24:51,"Warga Bandar Lampung merasa guncangan beberapa saat. Guncangan dirasakan salah seorang polisi yang bertugas di Bandar Lampung.

https://t.co/erLcjAO4k0",1,1,2,0,2022-01-14,10,Friday,5,3,1
1481934996499841031,2022-01-14 10:23:30,Komika Fico Fachriza ditangkap polisi karena penyalahgunaan narkoba. Dia ditangkap di rumahnya pada Kamis (14/1) malam. https://t.co/8a66w2EwIV,14,0,5,2,2022-01-14,10,Friday,5,19,2
1481934994352267264,2022-01-14 10:23:30,"Gempa M 6,7 terjadi di Kecamatan Sumur, Kabupaten Pandeglang, Banten. Berdasarkan laporan sementara, sejumlah rumah warga rusak. https://t.co/DAVFbuUbDN",8,0,2,0,2022-01-14,10,Friday,5,10,0
1481934992586547200,2022-01-14 10:23:29,"Gempa bumi berkekuatan magnitudo (M) 6,6 yang berpusat di Sumur Banten terasa hingga Bandar Lampung. Warga Bandar Lampung merasa guncangan beberapa saat. https://t.co/NAn7SRwyI6",8,0,3,0,2022-01-14,10,Friday,5,11,0
1481934676126224385,2022-01-14 10:22:14,"Saat kejadian, Mendes PDTT Abdul Halim Iskandar tengah berada di teras Imah Gede bersama Ketua Adat Kasepuhan Ciptagelar. https://t.co/Gz2X2vxAET",6,0,1,1,2022-01-14,10,Friday,5,7,1
1481934547550093319,2022-01-14 10:21:43,"Berikut analisis BMKG soal jenis gempa M 6,6 Banten yang terasa kuat di Jakarta:

https://t.co/CBKxqK3CSW",2,2,5,0,2022-01-14,10,Friday,5,7,2
1481934323880284162,2022-01-14 10:20:50,"BMKG melaporkan dampak gempa magnitudo (M) 6,6 (data terbaru BMKG, sebelumnya dinyatakan M 6,7) yang berpusat di Banten. Berikut wilayah yang terdampak. https://t.co/jMt3CmCXjJ",10,0,3,0,2022-01-14,10,Friday,5,13,0
1481934322449985539,2022-01-14 10:20:50,"Gempa berkekuatan M 6,6 mengguncang Sumur, Banten. Gempa kuat ini terasa hingga Jakarta, membuat warga panik di sejumlah titik Ibu Kota. https://t.co/aKTQgWpHGC",4,0,2,0,2022-01-14,10,Friday,5,6,0
1481933833327230978,2022-01-14 10:18:53,"""Sekarang warga udah pada pulang khawatir ada apa-apa di rumahnya. Tadinya kan ada ratusan orang di sini, sekarang paling sisa puluhan,"" kata Andre warga Pandeglang.

https://t.co/pu98DISIw9",7,2,4,0,2022-01-14,10,Friday,5,11,2
1481933181238530048,2022-01-14 10:16:18,"Para pegawai di kantor BPK, Jakarta, berhamburan keluar gedung untuk menyelamatkan diri. https://t.co/NNIYun5VE9",7,0,2,0,2022-01-14,10,Friday,5,9,0
1481932855244636163,2022-01-14 10:15:00,"Gempa bumi dengan magnitudo (M) 6,7 terjadi di Sumur, Pandeglang, Banten. Gempa ini pun membuat kepanikan warga yang langsung berhamburan keluar rumah. https://t.co/qOlBSgNivr",9,0,2,1,2022-01-14,10,Friday,5,11,1
1481932853936070657,2022-01-14 10:15:00,Jakarta diguncang gempa dari Selat Sunda. Pegawai Negeri Sipil (PNS) atau Aparatur Sipil Negara (ASN) di Balai Kota Jakarta dipersilakan pulang. https://t.co/lse14USmQJ,5,6,1,3,2022-01-14,10,Friday,5,6,9
1481932852572966919,2022-01-14 10:14:59,Gempa bumi terjadi di Banten dan getarannya terasa kuat hingga Jakarta. Berikut ini analisis BMKG. https://t.co/Sx98bUqcRU,7,1,4,0,2022-01-14,10,Friday,5,11,1
1481932482262052867,2022-01-14 10:13:31,"Gempa kuat di Banten yang mengguncang Jakarta magnitudo 6,7 tak berpotensi tsunami. Gempa-gempa susulan tersebut juga dilaporkan tak berpotensi tsunami. https://t.co/tj445u86A7",11,0,0,1,2022-01-14,10,Friday,5,11,1
1481932480974409728,2022-01-14 10:13:31,"Jakarta diguncang gempa yang berpusat di Selat Sunda dengan magnitudo (M) 6,7. Orang-orang di Balai Kota DKI Jakarta keluar dari gedung dan panik! https://t.co/ssE2y6HchP",6,0,0,0,2022-01-14,10,Friday,5,6,0
1481932479732793347,2022-01-14 10:13:30,"Gempa magnitudo (M) 6,6 (data terbaru BMKG) mengguncang Sumur, Banten. Gempa ini juga dirasakan kuat di Jakarta, Bandung hingga Lampung. https://t.co/BB6RYRsKUv",111,2,16,4,2022-01-14,10,Friday,5,127,6
1481932382769156096,2022-01-14 10:13:07,"Update! Gempa M 6,7 yang berpusat di pesisir selatan Banten mengakibatkan sejumlah rumah warga di Kecamatan Munjul Pandeglang mengalami kerusakan.

https://t.co/SWAUw6wL5h",15,3,5,0,2022-01-14,10,Friday,5,20,3
1481932141151887360,2022-01-14 10:12:10,Warga di Lembang berhamburan keluar dari rumah dan tempatnya masing-masing usai merasakan getaran gempa bumi yang cukup kencang. https://t.co/ocqaHYkuPM,3,0,2,0,2022-01-14,10,Friday,5,5,0
1481931827904491526,2022-01-14 10:10:55,"Getaran gempa M 6,7 yang mengguncang Banten dirasakan juga oleh warga di Kabupaten Karawang. https://t.co/MvFp7krbIH",13,0,3,0,2022-01-14,10,Friday,5,16,0
1481931778608750597,2022-01-14 10:10:43,Jakarta dan sekitarnya digoyang gempa cukup kuat. Masyarakat kaget bukan kepalang. Rasanya seperti kena vertigo. https://t.co/ZuAGJNsXsB,12,3,2,3,2022-01-14,10,Friday,5,14,6
1481931754105720834,2022-01-14 10:10:37,"Gempa M 6,7 yang berpusat di pesisir selatan Sumur, Banten, mengakibatkan sejumlah rumah warga di Kecamatan Munjul Pandeglang mengalami kerusakan. https://t.co/ko5DpixBUr",36,3,21,3,2022-01-14,10,Friday,5,57,6
1481931739190956034,2022-01-14 10:10:34,"""Sampai sekarang belum ada laporan kerusakan gedung dan rumah,"" ujar Kabid Humas Polda Banten, AKBP Shinto Silitonga kepada wartawan, Jumat (14/1/2022).

https://t.co/jvuerpjsua",5,1,2,0,2022-01-14,10,Friday,5,7,1
1481931735797743619,2022-01-14 10:10:33,"Gempa susulan kembali mengguncang Jakarta. Pusat gempa masih sama, yaitu di Sumur, Banten, dengan kekuatan M 5,7.

https://t.co/nvWSyj1eZr",12,2,13,2,2022-01-14,10,Friday,5,25,4
1481931732450680832,2022-01-14 10:10:32,"Untuk mengantisipasi bahaya berhentinya lift akibat gempa yang mengguncang Jakarta, Pemprov DKI mematikan lift di Balai Kota.

https://t.co/ivxpUCpNkZ",2,1,1,0,2022-01-14,10,Friday,5,3,1
1481931729091067904,2022-01-14 10:10:31,"Karyawan di salah satu gedung di Jakarta berlomba turun keluar dari gedung. Berikut videonya:

https://t.co/r4jo6XJR8S",4,1,1,1,2022-01-14,10,Friday,5,5,2
1481931723516825600,2022-01-14 10:10:30,"Gempa juga oleh warga di Kabupaten Karawang. Husein Sinatria Galuh (31), salah satu warga di Karawang mengaku merasakan gempa sekitar pukul 16.05 WIB.

https://t.co/VOiWlfp3cP",2,1,2,0,2022-01-14,10,Friday,5,4,1
1481931720186535942,2022-01-14 10:10:29,"Akibat gempa yang terjadi, sejumlah warga yang sedang berada di kantor Polresta Depok juga dilaporkan berhamburan keluar.

https://t.co/LHnC9Q0gYT",2,1,2,0,2022-01-14,10,Friday,5,4,1
1481931714285154304,2022-01-14 10:10:28,"Getaran gempa terasa kuat hingga membuat karyawan di gedung perkantoran panik dan berhamburan keluar gedung.

https://t.co/uPJeHrMGC9",3,1,1,0,2022-01-14,10,Friday,5,4,1
1481931711231717381,2022-01-14 10:10:27,"Pantauan detikcom, pukul 16.10 WIB, di gedung Kejaksaan Agung, Jakarta Selatan, Jumat (14/1/2022), tampak pegawai di ruangan terlihat berhamburan ke luar gedung.

https://t.co/2C07yxikky",3,1,2,1,2022-01-14,10,Friday,5,5,2
1481931708178235394,2022-01-14 10:10:26,"""Saran BMKG, hati-hati terhadap gempabumi susulan yang mungkin terjadi,"" tulis BMKG dalam peringatannya, Jumat (14/1/2021).

https://t.co/FkMaAfI6l8",1,1,1,0,2022-01-14,10,Friday,5,2,1
1481931704420175880,2022-01-14 10:10:25,"#Thread Gempa bumi dengan kekuatan magnitudo (M) 6,7 yang berpusat di Sumur, Banten terasa hingga Jakarta. BMKG mengimbau warga hati-hati gempa susulan. 

Baca berita selengkapnya dalam utas berikut ⬇️⬇️ https://t.co/HXuCSlsvQC",122,12,37,4,2022-01-14,10,Friday,5,159,16
1481931419769352195,2022-01-14 10:09:18,"Tira Persikabo meraih poin sempurna saat bersua Persik Kediri dalam lanjutan BRI Liga 1. Laskar Padjajaran menang 2-1, meski sempat tertinggal lebih dulu. https://t.co/pbkRVpxuYq",5,0,0,0,2022-01-14,10,Friday,5,5,0
1481931418246782978,2022-01-14 10:09:17,"Gempa berkekuatan M 6,7 terjadi di Sumur, Banten dan terasa di Jakarta. Begini kepanikan karyawan perkantoran saat gempa terjadi. https://t.co/USgqJ1zofM",5,0,0,0,2022-01-14,10,Friday,5,5,0
1481931416346759169,2022-01-14 10:09:17,"Gempa mengguncang Sumur, Banten sebesar 6,7 magnitudo. Polisi menyebut sejauh ini belum ada laporan kerusakan gedung &amp; rumah. https://t.co/CCz1mfjzEw",4,0,1,0,2022-01-14,10,Friday,5,5,0
1481930950154010626,2022-01-14 10:07:26,Fico Fachriza rupanya mengkonsumsi tembakau sintetis sejak tahun 2016. https://t.co/wkaIr1vSfS,43,19,10,23,2022-01-14,10,Friday,5,53,42
1481930586293944324,2022-01-14 10:05:59,"Dalam jumpa pers di Polda Metro Jaya, Fico Fachriza turut dihadirkan polisi. Seperti apa penampakannya? https://t.co/bTZdaCZoIy",4,1,1,1,2022-01-14,10,Friday,5,5,2
1481930570254929921,2022-01-14 10:05:55,Seorang selebgram dihujat dan disebut penipu karena terungkap bahwa penampilan aslinya ketika filter saat live streaming eror. Bikin kaget! https://t.co/5cAiRnVL5E,1,0,0,0,2022-01-14,10,Friday,5,1,0
1481930554362806275,2022-01-14 10:05:51,"Gempa mengguncang Sumur, Banten sebesar 6,7 magnitudo. Polisi menyebut sejauh ini belum ada laporan kerusakan gedung &amp; rumah. https://t.co/5ijCbnN8sJ",6,0,2,1,2022-01-14,10,Friday,5,8,1
1481930552538284033,2022-01-14 10:05:51,Polisi menangkap Fico Fachriza terkait kasus narkoba. Alasan komika Fico Fachriza mengonsumsi barang haram itu pun terungkap. https://t.co/eFBrqpFs33,3,2,0,0,2022-01-14,10,Friday,5,3,2
1481930550470496259,2022-01-14 10:05:50,"Gempa berkekuatan magnitudo 6,7 terasa di Cilegon, Banten, dan sekitarnya. Warga di Cilegon hingga Merak merasakan gempa cukup kuat. https://t.co/jE3oMNPpbA",5,0,3,0,2022-01-14,10,Friday,5,8,0
1481930548784287744,2022-01-14 10:05:50,"Gempa berkekuatan M 6,7 yang berpusat di Sumur Pandeglang, Banten terasa hingga wilayah Jabodetabek. Gempa itu membuat panik sejumlah warga di Tangsel. https://t.co/kmVHkjxdw1",8,0,2,0,2022-01-14,10,Friday,5,10,0
1481930546485899270,2022-01-14 10:05:49,"Gempa susulan kembali mengguncang Jakarta. Pusat gempa masih sama, yaitu di Sumur, Banten, dengan kekuatan M 5,7. https://t.co/IybLshdGHn",1238,32,208,52,2022-01-14,10,Friday,5,1446,84
1481930466970198016,2022-01-14 10:05:30,"Karena kondisi sedang hujan, warga berkumpul di area luar gedung sambil berteduh. https://t.co/WvfeDsRV3S",5,0,2,0,2022-01-14,10,Friday,5,7,0
1481930198287273990,2022-01-14 10:04:26,"Gempa berkekuatan M 6,7 yang berpusat di Banten, dirasakan kuat hingga Kota Depok. Sejumlah warga berhamburan keluar dari gedung. https://t.co/3J7LZDsNmt",12,0,5,0,2022-01-14,10,Friday,5,17,0
1481929964727513092,2022-01-14 10:03:31,"Di lantai 9 sebuah gedung di wilayah Tendean, Jaksel, getaran gempa terasa kuat hingga membuat bingkai-bingkai foto di dinding hampir jatuh. https://t.co/I33vFapCDd",12,2,5,0,2022-01-14,10,Friday,5,17,2
1481929814542098437,2022-01-14 10:02:55,"Warga Kelurahan Regol Wetan Sumedang merasakan guncangan gempa M 6,7 yang berpusat di Banten. https://t.co/wVrtVop9Fg",8,0,4,0,2022-01-14,10,Friday,5,12,0
1481929812017045509,2022-01-14 10:02:54,"Gempa magnitudo (M) 6,7 yang terasa pusat di Sumur, Banten, terasa kuat hingga Jakarta. Berikut langkah-langkah yang perlu anda lakukan saat terjadi gempa. https://t.co/ueWGxnOH7Z",5,0,2,0,2022-01-14,10,Friday,5,7,0
1481929699177734148,2022-01-14 10:02:27,"Gempa bumi yang berpusat di Sumur, Banten, terasa hingga ke Kabupaten Bandung, Jawa Barat. Warga berhamburan keluar rumah. https://t.co/J2DHuK6XCu",107,2,15,6,2022-01-14,10,Friday,5,122,8
1481929519309148162,2022-01-14 10:01:44,"Gempa dengan magnitudo 6,7 terjadi di Sumur, Banten, terasa kuat di Jakarta. Pegawai yang berada kantor Kejaksaan Agung berhamburan keluar dari gedung. https://t.co/XHG8zQjmqf",8,0,1,0,2022-01-14,10,Friday,5,9,0
1481929073748320260,2022-01-14 09:59:58,Laporan JoMan terhadap Ubedillah Badrun telah disubmit di Polda Metro Jaya. Ubedillah dilaporkan soal dugaan fitnah ke Gibran dan Kaesang. https://t.co/l7aR1zXv7V,54,66,5,6,2022-01-14,9,Friday,5,59,72
1481928983520423939,2022-01-14 09:59:37,Komika Fico Fachriza ditangkap polisi karena kasus penyalahgunaan narkoba. Fico Facriza resmi ditetapkan sebagai tersangka. https://t.co/eu7uXgiIsh,13,1,2,3,2022-01-14,9,Friday,5,15,4
1481928621082259459,2022-01-14 09:58:10,"Wisatawan yang ada di Pangandaran tidak terlalu mengalami kepanikan. Kendati begitu, sejumlah wisatawan terlihat menjauh dari tepi pantai. https://t.co/dnU8dDapAo",9,0,2,1,2022-01-14,9,Friday,5,11,1
1481928351900176387,2022-01-14 09:57:06,Fico Fachriza dihadirkan polisi di hadapan awak media. Ia menangis saat mengenakan baju tahanan. Ini potretnya:  https://t.co/V1IW31KjOl,4102,697,548,633,2022-01-14,9,Friday,5,4650,1330
1481928347152175104,2022-01-14 09:57:05,"Gempa Magnitudo 6,7 terjadi di Banten dan membuat panik warga. Mereka berhamburan ke luar untuk menyelamatkan diri. https://t.co/0GWPOojNZD",5,0,2,0,2022-01-14,9,Friday,5,7,0
1481928266269265920,2022-01-14 09:56:46,"Beredar viral video Tiktok yang menampilkan pengunjung Istana Boneka turun dari perahu, kemudian foto-foto. Ini respon pihak Ancol:  https://t.co/NnFK5JIQLU",3,1,1,1,2022-01-14,9,Friday,5,4,2
1481927911133298695,2022-01-14 09:55:21,"Gempa magnitudo 4.6 mengguncang Pacitan, Jawa Timur. Namun, getaran gempa tidak dirasakan masyarakat. https://t.co/lAMpYSeKNB",43,2,16,4,2022-01-14,9,Friday,5,59,6
1481927478331551747,2022-01-14 09:53:38,Para pegawai hingga sekarang pun masih berada di jalan depan gedung. https://t.co/T9w7zpROLS,11,1,1,0,2022-01-14,9,Friday,5,12,1
1481927088357715969,2022-01-14 09:52:05,Nama Celine Evangelista kembali terseret isu kandasnya rumah tangga Vicky Prasetyo dan Kalina Oktarani. Ia disebut-sebut sebagai orang ketiganya. https://t.co/8Vo0MHfXee,6,2,1,1,2022-01-14,9,Friday,5,7,3
1481926664720306176,2022-01-14 09:50:24,Para pekerja di gedung tersebut berhamburan panik keluar untuk menyelamatkan diri masing-masing. https://t.co/A2xEmgIoOA,13,0,2,0,2022-01-14,9,Friday,5,15,0
1481926321420869633,2022-01-14 09:49:02,Seorang karyawan Raffi Ahmad dan Nagita Slavina yang bekerja di RANS Entertainment mengungkapkan biaya makan sehari:  https://t.co/AQw3cKrJ9H,16,7,3,0,2022-01-14,9,Friday,5,19,7
1481926244228870147,2022-01-14 09:48:44,"Seluruh warga di Kompleks Parlemen, Senayan, Jakarta berhamburan ke luar gedung. https://t.co/TInffYJ6J4",25,13,4,0,2022-01-14,9,Friday,5,29,13
1481925989189967874,2022-01-14 09:47:43,"Mobil-mobil Toyota memiliki fitur yang canggih, yaitu fitur Toyota Safety Sense (TSS). Tapi kok Fortuner belum punya TSS? https://t.co/jez7b6caDS",6,1,1,0,2022-01-14,9,Friday,5,7,1
1481925371603861505,2022-01-14 09:45:16,Lagu Baby Shark berhasil mencetak rekor di YouTube sebagai video pertama yang disaksikan hingga 10 miliar kali. https://t.co/PlD7fRygkf,166,32,39,35,2022-01-14,9,Friday,5,205,67
1481923968579874820,2022-01-14 09:39:41,Polisi tampak berlarian keluar dari gedung Humas Mabes Polri. Mereka tampak berlari sambil bertanya-tanya perihal gempa. https://t.co/PFV4uem1An,18,4,5,2,2022-01-14,9,Friday,5,23,6
1481923627624845314,2022-01-14 09:38:20,"Gempa berkekuatan magnitudo 6,7 terasa di Cilegon, Banten dan sekitarnya. Warga di Cilegon hingga Merak merasakan gempa cukup kuat. https://t.co/MNJnQRariu",35,4,6,1,2022-01-14,9,Friday,5,41,5
1481923244974301191,2022-01-14 09:36:49,"Jakarta diguncang gempa yang berpusat di selat sunda, magnitudo (M) 6,7. Orang-orang di Balai Kota DKI Jakarta keluar dari gedung dan panik! https://t.co/U0YtLMEL54",26,2,5,0,2022-01-14,9,Friday,5,31,2
1481922437520449540,2022-01-14 09:33:36,"Video aksi pegawai negeri sipil (PNS) wanita di Humbang Hasundutan (Humbahas), Sumatera Utara, sedang berjoget sambil menenggak minuman keras viral. Video itu disebut terjadi saat perayaan ulang tahun Kepala Dinas Kesehatan Humbahas. https://t.co/Q4sgyITiTS https://t.co/rLAt2k2Ew9",1122,829,658,503,2022-01-14,9,Friday,5,1780,1332
1481922365810515970,2022-01-14 09:33:19,Fico Fachriza diamankan karena narkoba dan barang bukti tembakau gorila. Ini pernyataan Fico soal harapan anak bangsa jauhi narkoba:  https://t.co/SrNu4hNUU4,12,3,5,2,2022-01-14,9,Friday,5,17,5
1481921693920673792,2022-01-14 09:30:39,Gempa kencang terasa di DKI Jakarta dengan warga berhamburan keluar gedung-gedung tinggi. Begini reaksi para penghuni gedung tinggi di Jaksel. https://t.co/81K9M0M02G,55,4,13,1,2022-01-14,9,Friday,5,68,5
1481921677151846407,2022-01-14 09:30:35,"Peneliti Universitas Ben Gurion, Israel, membuat uji coba yang unik agar ikan mas dapat nyetir robot akuarium sendiri. Apakah bisa? Lihat videonya berikut ini: https://t.co/NhoIia7whi",7,0,1,0,2022-01-14,9,Friday,5,8,0
1481921406497656834,2022-01-14 09:29:30,Ardhito Pramono tengah jadi sorotan usai tertangkap kasus narkotika jenis ganja. Begini kondisi rumah tempat kejadian perkara penangkapan Ardhito.  https://t.co/VyObY9Bjsg,14,0,2,1,2022-01-14,9,Friday,5,16,1
1481920889809690626,2022-01-14 09:27:27,"Presiden Joko Widodo (Jokowi) meresmikan Bendungan Bintang Bano yang berada di Sumbawa Barat, Nusa Tenggara Barat. Bendungan yang dibangun sejak 2015 ini memiliki daya tampung 76 juta meter kubik. https://t.co/ZmQNZeAunQ",4,0,0,0,2022-01-14,9,Friday,5,4,0
1481920726936530944,2022-01-14 09:26:48,BMKG mengimbau warga hati-hati gempa susulan. https://t.co/tWfZC2YLYV,1022,28,292,101,2022-01-14,9,Friday,5,1314,129
1481920132704317442,2022-01-14 09:24:27,"Meski getaran dari gempa terasa kuat, tetapi BMKG menyebut gempa ini tidak berpotensi tsunami. https://t.co/7kyWRoQO8g",306,7,40,5,2022-01-14,9,Friday,5,346,12
1481919860678529024,2022-01-14 09:23:22,BMKG menyatakan pusat gempa yang terjadi Jumat (14/1/2022) itu berada di kedalaman 10 Km. https://t.co/jCC8BpE9ud,1429,31,181,33,2022-01-14,9,Friday,5,1610,64
1481919769653784577,2022-01-14 09:23:00,Heboh komedian Fico Fachriza ditangkap polisi terkait kasus penyalahgunaan narkoba jenis sintetis atau tembakau gorilla. Narkoba jenis apa itu? https://t.co/skJRkTb6np,10,5,4,2,2022-01-14,9,Friday,5,14,7
1481919755510595591,2022-01-14 09:22:57,Komedian Fico Fahriza ditangkap polisi karena dugaan memakai narkoba tembakau gorila atau biasa disebut ganja sintetis. Apa bedanya dengan ganja biasa? https://t.co/cRSF3LXCcJ,14,5,5,8,2022-01-14,9,Friday,5,19,13
1481919331122438149,2022-01-14 09:21:15,Kementerian Komunikasi dan Informatika merespon soal dugaan kebocoran data pribadi pelamar PT Pertamina Training and Consulting (PTC). https://t.co/gTIFomUPXq,7,0,0,0,2022-01-14,9,Friday,5,7,0
1481919304060788736,2022-01-14 09:21:09,"Berita duka bisa datang dari mana saja, termasuk kerabat dekatmu. Berikan ucapan belasungkawa yang singkat dan sopan kepada keluarga yang ditinggalkan. https://t.co/WUA7ctPyMt",16,0,5,0,2022-01-14,9,Friday,5,21,0
1481918931061329922,2022-01-14 09:19:40,Kampung Susun Bayam bakal dibangun di kawasan JIS. Kampung Susun Bayam bakal ditempati pekerja pendukung operasional JIS. https://t.co/lPU7BDeCa3,15,0,2,0,2022-01-14,9,Friday,5,17,0
1481918378566688770,2022-01-14 09:17:28,"Gempa terasa di Jakarta. Gempa dengan kekuatan M 6,7 berpusat di Banten. https://t.co/upEXDvqP1g",340,28,85,22,2022-01-14,9,Friday,5,425,50
1481917276215459842,2022-01-14 09:13:05,"Di sela kepadatan kegiatannya, Gibran Rakabuming Raka mendadak mendatangi rumah FX Hadi Rudyatmo. Ada apa gerangan? https://t.co/EangpePdZ3",17,1,4,0,2022-01-14,9,Friday,5,21,1
1481917264412741638,2022-01-14 09:13:03,"Gempa besar terjadi di Jakarta. Guncangannya terasa kencang di gedung-gedung tinggi. Data BMKG menyebut ada gempat terjadi dengan kekuatan M 6,6. https://t.co/iCuB0bYErV",1987,133,512,85,2022-01-14,9,Friday,5,2499,218
1481916767303880706,2022-01-14 09:11:04,"Tak terlihat seperti biasanya, penampilan Amanda Manopo dalam salah satu adegan Ikatan Cinta tampak mencuri perhatian. 'Baby bump' nya tampak aneh. Hmm... https://t.co/P7Ndwl6tpT",16,3,2,0,2022-01-14,9,Friday,5,18,3
1481916139131318277,2022-01-14 09:08:34,Andika memastikan TNI mendukung upaya Pemerintah mengusut tuntas kasus itu. https://t.co/QwhBLJQAVS,8,0,1,2,2022-01-14,9,Friday,5,9,2
1481915457884114945,2022-01-14 09:05:52,Yusril Ihza Mahendra menikah dengan Rika Tolentino Kato. Keduanya terlihat harmonis bersama walau terpaut 27 tahun. Intip potret kebersamaan mereka di sini. #detikNetwork  https://t.co/DuXUWDzQi5,15,0,2,0,2022-01-14,9,Friday,5,17,0
1481915456592261124,2022-01-14 09:05:52,"Kemenkes kembali mencatat penambahan kasus varian Omicron di Indonesia. Total kasus menjadi 572 orang, ini gejala yang paling banyak dikeluhkan. https://t.co/m1raypAuIT",13,1,5,0,2022-01-14,9,Friday,5,18,1
1481914733947236353,2022-01-14 09:02:59,#Foto Pasangan guru dan murid ini berbeda usia 11 tahun. Sang murid jatuh cinta pada gurunya sendiri yang kemudian dihamilinya. Intip potret mereka yuk... https://t.co/yFXWhQmpb4,10,2,2,0,2022-01-14,9,Friday,5,12,2
1481914313526976513,2022-01-14 09:01:19,"Pria yang menendang dan membuang sesajen di lokasi erupsi Gunung Semeru, Hadfana Firdaus ditetapkan sebagai tersangka. Hadfana disebut melanggar dua pasal. https://t.co/Ty14bIHIWE",14,6,3,3,2022-01-14,9,Friday,5,17,9
1481913606841286657,2022-01-14 08:58:31,"Jumlah kasus varian Omicron di Indonesia bertambah 66, total menjadi 572 kasus. Dari jumlah tersebut, hampir separuh sudah selesai menjalani isolasi. https://t.co/4FqVIjub78",7,1,0,1,2022-01-14,8,Friday,5,7,2
1481912899211825155,2022-01-14 08:55:42,Indonesia memiliki 34 provinsi. Traveler hafal di mana saja? https://t.co/5ki9UUadjW,17,1,3,2,2022-01-14,8,Friday,5,20,3
1481912229897424896,2022-01-14 08:53:02,"Fico Fachriza sudah lama mengenal narkoba. Empat tahun lalu, sang komika mengaku mengkonsumsi barang terlarang tersebut. #FicoFachriza  https://t.co/3Tfu2gWX10",13,1,1,2,2022-01-14,8,Friday,5,14,3
1481911874249760770,2022-01-14 08:51:38,Reza Arap jadi salah satu kolektor yang turut membeli NFT milik Ghozali Everyday. Sekarang NFT milik Ghozali termasuk jadi yang langka. https://t.co/hwURpft2Cy,8,1,6,1,2022-01-14,8,Friday,5,14,2
1481911258131705859,2022-01-14 08:49:11,Fenomena Bulan Apogee terjadi malam ini. Apa itu Apogee dan seperti apa dampaknya? Simak penjelasannya di sini:  https://t.co/uSJmbZoh2Q,17,0,6,0,2022-01-14,8,Friday,5,23,0
1481910912059686918,2022-01-14 08:47:48,WHO menambahkan dua obat baru melawan COVID-19 usai varian Omicron melonjak di banyak negara. Salah satunya obat yang juga dipakai untuk rematik. https://t.co/DKcfe05BUn,8,0,4,2,2022-01-14,8,Friday,5,12,2
1481910261665652736,2022-01-14 08:45:13,Laga Tunisia vs Mali dinodai insiden wasit yang dua kali mengakhiri laga sebelum waktunya. Sang pengadil dinilai kehilangan konsentrasi akibat kepanasan.  https://t.co/wr1shVyFdT,6,0,2,0,2022-01-14,8,Friday,5,8,0
1481910240148967426,2022-01-14 08:45:08,Mengapa kekerasan seksual pada anak terus terjadi di Indonesia? Saksikan e-Life malam ini mengangkat judul 'Lingkaran Setan Kekerasan Seksual Anak' https://t.co/LlN24QC3Po,7,0,5,0,2022-01-14,8,Friday,5,12,0
1481909457189842944,2022-01-14 08:42:01,Di deretan gambar ini tersembunyi siluet hewan. Hanya saja siluet tersebut mungkin sulit atau tidak bisa dilihat oleh orang yang buta warna. https://t.co/i8m3nHtRm0,21,20,3,1,2022-01-14,8,Friday,5,24,21
1481908594786418690,2022-01-14 08:38:36,"Kecelakaan kapal nelayan terjadi di perairan Pulau Halang, Rokan Hilir, Riau. Dua nelayan yang ada di kapal dilaporkan hilang. https://t.co/7AVrTu2lMx",3,0,1,0,2022-01-14,8,Friday,5,4,0
1481908573353431044,2022-01-14 08:38:31,Video Baby Shark mencetak sejarah Karena sudah ditonton lebih dari 10 miliar kali di YouTube. Serta jadi satu-satunya video yang ditonton lebih dari 10 miliar kali. https://t.co/eqhYlJC461,21,2,7,2,2022-01-14,8,Friday,5,28,4
1481907805821050884,2022-01-14 08:35:28,"Jika perut terasa lapar sementara sudah masuk waktu sholat, manakah yang harus didahulukan antara makan dan sholat? Ini penjelasannya. https://t.co/7Ko0l7hPxi",13,0,3,0,2022-01-14,8,Friday,5,16,0
1481907199794462720,2022-01-14 08:33:03,"Mural yang menghiasi tembok penahan tanah (TPT) di Jalan Siliwangi, Kota Bandung, menjadi sasaran vandalisme. Pelakunya terekam CCTV. https://t.co/7LqgLze2wp",4,0,0,1,2022-01-14,8,Friday,5,4,1
1481906461538140161,2022-01-14 08:30:07,Beredar sebuah video viral tentang pengunjung Istana Boneka yang turun dari perahu dan foto selfie dengan boneka-boneka di sana. Duh! https://t.co/tqkjUmVZiR,5,0,2,1,2022-01-14,8,Friday,5,7,1
1481906440436690944,2022-01-14 08:30:02,Liverpool gagal menaklukkan 10 pemain Arsenal di semifinal Piala Liga Inggris. The Reds dinilai kurang oke di daerah sepertiga lawan.  https://t.co/nvjOxM2xM4,3,0,0,1,2022-01-14,8,Friday,5,3,1
1481905701660340226,2022-01-14 08:27:06,"Kol goreng sering jadi pelengkap makan pecel lele dan ayam penyet. Namun dibalik kelezatannya, kol goreng bisa berdampak buruk bagi kesehatan. https://t.co/QSRlRQlxri",33,11,19,12,2022-01-14,8,Friday,5,52,23
1481905387498582017,2022-01-14 08:25:51,"PT DAS Indonesia Motor, APM Jeep Indonesia memasukkan lini termurahnya di akhir 2021 lalu, yakni Jeep Compass! https://t.co/70bVuROmKD",14,0,2,2,2022-01-14,8,Friday,5,16,2
1481904312825655300,2022-01-14 08:21:35,Bek Persija Jakarta Otavio Dutra mewaspadai striker asing Jose Wilkson dalam lanjutan Liga 1 2021/2022 melawan Persela Lamongan. Ia pun berharap tim kompak.  https://t.co/bZPf2w7UPe,5,0,0,0,2022-01-14,8,Friday,5,5,0
1481903975217700864,2022-01-14 08:20:14,Zaini Mustofa menggugat Ustaz Yusuf Mansur Rp 98 triliun ke PN Jaksel. Apa alasan Zaini menggugat Yusuf Mansur? https://t.co/UNREpoWSOe,24,12,4,1,2022-01-14,8,Friday,5,28,13
1481903276308193280,2022-01-14 08:17:28,Kalina Oktarani mengungkapkan dirinya sudah bercerai dengan Vicky Prasetyo. Perceraian itu disebut-sebut karena hadirnya orang ketiga...  https://t.co/NqzSuS0XRo,4,3,1,1,2022-01-14,8,Friday,5,5,4
1481902958153453570,2022-01-14 08:16:12,Cristiano Ronaldo memperingatkan anak-anak muda di skuad Manchester United. CR7 mengimbau Mason Greenwood cs untuk mau mendengar nasihat dia dan para senior.  https://t.co/3sDM8PQHhA,11,0,3,1,2022-01-14,8,Friday,5,14,1
1481902945549664258,2022-01-14 08:16:09,"Lionel Messi akhirnya tembus klub '300 juta'. Ya, followers Instagram pribadinya tembus 300 juta followers!  https://t.co/j3oG0Nl2K9",1,0,0,0,2022-01-14,8,Friday,5,1,0
1481902589725884418,2022-01-14 08:14:44,Salah satu perusahaan jasa pariwisata ke luar angkasa Virgin Galactic berencana untuk menerbitkan surat utang sebesar US$ 425 juta. https://t.co/iHEbKP693j,2,0,2,0,2022-01-14,8,Friday,5,4,0
1481901983443345408,2022-01-14 08:12:19,Diogo Jota tak terlihat di saat Liverpool menjamu Arsenal di leg I semifinal Piala Liga Inggris. Pemain Portugal itu mendapat pembelaan dari Jamie Carragher.  https://t.co/becU1pkBwv,5,0,0,0,2022-01-14,8,Friday,5,5,0
1481901889658793984,2022-01-14 08:11:57,"Akibat mobil parkir sembarangan, pemadam kebakaran telat ke lokasi kebakaran! https://t.co/fWqvMzErxP",7,0,2,1,2022-01-14,8,Friday,5,9,1
1481900848632504320,2022-01-14 08:07:49,Aktor muda Bryan Domani menanggapi isu perihal narkotika di ruang lingkup artis. Ia mengaku tak pernah mencicipi narkotika.  https://t.co/ORyLAQgcYh,13,8,0,0,2022-01-14,8,Friday,5,13,8
1481900042973810689,2022-01-14 08:04:37,"Persib Bandung lagi mejan di BRI Liga 1. Tagar #ReneOut sampai trending di sosial media, bobotoh minta pelatih Robert Rene Alberts mundur!  https://t.co/hiAiM3FiCP",5,0,1,1,2022-01-14,8,Friday,5,6,1
1481899900669411331,2022-01-14 08:04:03,Clarissa Punipun sudah banyak makan asam garam dalam menghadapi komentar netizen yang tak mengenakkan. Sang cosplayer tak menampik fisiknya kerap dihina.  https://t.co/4BEhKCbmEe,3,0,1,0,2022-01-14,8,Friday,5,4,0
1481899876904583169,2022-01-14 08:03:57,"Persija Jakarta ingin meraih poin penuh saat melawan Persela Lamongan, Sabtu (15/1/2022). Macan Kemayoran ingin memperbaiki posisi di klasemen Liga 1.  https://t.co/MtN5j90ejr",3,0,0,0,2022-01-14,8,Friday,5,3,0
1481898987863031809,2022-01-14 08:00:25,"Setelah lebih dari dua bulan dirilis, berikut total penjualan Hyundai Creta!
 https://t.co/QheneJVwfJ",8,0,0,0,2022-01-14,8,Friday,5,8,0
1481898372692856834,2022-01-14 07:57:59,Kondisi Marc Marquez mulai membaik. Apakah bisa menjajal Sirkuit Mandalika? https://t.co/XNvDJ1Ackr,13,1,0,1,2022-01-14,7,Friday,5,13,2
1481897714556325892,2022-01-14 07:55:22,"Dua musisi asal Indonesia, Rich Brian dan NIKI masuk dalam daftar line up Coachella 2022.  https://t.co/SIMDWebjVp",27,0,3,0,2022-01-14,7,Friday,5,30,0
1481896968863592449,2022-01-14 07:52:24,Menurut peraturan baru mobil berkategori Low Cost and Green Car (LCGC) akan dikenakan pajak 3 persen. https://t.co/8W9IlM10YE,14,1,1,0,2022-01-14,7,Friday,5,15,1
1481896947229339651,2022-01-14 07:52:19,Dusan Vlahovic semakin mengganas bersama Fiorentina. Kubu La Viola mengaku siap melepas striker muda Serbia itu bila ada tawaran yang tepat.  https://t.co/5mKVDgRLfi,5,2,0,0,2022-01-14,7,Friday,5,5,2
1481896609508212739,2022-01-14 07:50:58,"Massa buruh melakukan ibadah salat Jumat di depan Gedung DPR RI, Jumat (14/1). Sholat Jumat berlangsung di sela-sela aksi demo UU Ciptaker. https://t.co/j23i8p4Fjr",14,1,0,0,2022-01-14,7,Friday,5,14,1
1481896591179014145,2022-01-14 07:50:54,Baby Shark kembali memecahkan rekor dunia. Video lagu anak-anak ini jadi video YouTube pertama yang ditonton 10 miliar kali. https://t.co/UROrAPziS9,10,1,4,2,2022-01-14,7,Friday,5,14,3
1481896283443200001,2022-01-14 07:49:40,"Dengan skema pajak baru, Fortuner 4x4 lebih murah, tak sampai Rp 700 juta! https://t.co/f7N4b3r7L5",12,0,0,0,2022-01-14,7,Friday,5,12,0
1481896268020473868,2022-01-14 07:49:37,Katros Garage sebagai bengkel yang melakukan modifikasi memenuhi permintaan Presiden Jokowi. Apa saja? https://t.co/c8dbnjQNlM,6,0,0,0,2022-01-14,7,Friday,5,6,0
1481895647360032770,2022-01-14 07:47:09,"Tim muda Barcelona, Real Madrid dan Atletico Madrid bakal berlaga di Jakarta International Stadium Februari nanti. Laga itu bersamaan dengan soft launching JIS. https://t.co/RcDUlRB00y",41,7,7,3,2022-01-14,7,Friday,5,48,10
1481895002917724164,2022-01-14 07:44:35,"Harimau masuk ke permukiman transmigrasi warga di Mukomuko, Bengkulu. Lima ekor sapi dilaporkan telah dimangsa harimau itu. https://t.co/TYJk5R9pEq",5,1,1,0,2022-01-14,7,Friday,5,6,1
1481894684909789186,2022-01-14 07:43:19,"Pemerintah memperbarui aturan karantina bagi pelaku perjalanan luar negeri warga negara Indonesia (WNI), serta lokasi karantina terpusat terbaru. ini daftarnya: https://t.co/o6Y6tpqcu2",4,0,0,0,2022-01-14,7,Friday,5,4,0
1481893701089734657,2022-01-14 07:39:25,"Hadfana Firdaus, pria yang menendang dan membuang sesajen di lokasi erupsi Semeru minta maaf. Dia meminta maaf pada seluruh masyarakat Indonesia. https://t.co/x0HuSPFPxR",4,4,0,1,2022-01-14,7,Friday,5,4,5
1481893067804352513,2022-01-14 07:36:54,"Presiden KSPI, Said Iqbal, mengatakan sebanyak 4 juta buruh akan mogok nasional jika DPR RI tetap membahas UU Cipta Kerja. https://t.co/dRcrdR3tXZ",59,85,5,7,2022-01-14,7,Friday,5,64,92
1481892374062190594,2022-01-14 07:34:08,"Jadwal Liga Inggris akhir pekan ini menyuguhkan dua laga besar. Manchester City vs Chelsea dan derby London utara, Tottenham Hotspur vs Arsenal sajiannya.  https://t.co/bN7D0UaNQW",4,1,2,0,2022-01-14,7,Friday,5,6,1
1481892352813895681,2022-01-14 07:34:03,"Beredar kabar Raffi Ahmad akan boyong Mesut Ozil main di klub sepak bolanya, RANS Cilegon FC. Begini analisis dosen Komunikasi Bisnis Unair soal hal itu:

via: detikedu https://t.co/ARhO9mUHjt",7,1,3,0,2022-01-14,7,Friday,5,10,1
1481891876118704129,2022-01-14 07:32:10,"Kalina Oktarani ngaku sudah cerai dan keluar dari rumah Vicky Prasetyo. Tapi, Vicky justru mengaku belum mengucap talak. https://t.co/3ofH78hfK6",21,11,2,3,2022-01-14,7,Friday,5,23,14
1481891219890393091,2022-01-14 07:29:33,"Jilbab, hijab dan khimar sering digunakan perempuan muslim termasuk pelajar dan mahasiswa untuk menutup aurat. Apa ya perbedaan ketiganya? https://t.co/BiC4XwaOJl",14,1,6,0,2022-01-14,7,Friday,5,20,1
1481890849357242369,2022-01-14 07:28:05,"""Kok senang sekali orang mau memenjarakan saya,"" kata Edy. https://t.co/TnRIp93u4O",20,17,2,3,2022-01-14,7,Friday,5,22,20
1481890225169309696,2022-01-14 07:25:36,Ghozali Everyday bikin heboh medsos dari transaksi jual digital di Opensea ia dapat cuan miliaran. Lalu apa itu Opensea NFT? Ini penjelasannya:  https://t.co/mZHRzDUhs1,4,1,2,2,2022-01-14,7,Friday,5,6,3
1481890201844785163,2022-01-14 07:25:30,"Jamie Carragher tidak suka lihat Liverpool bak menggantung perpanjangan kontrak Mohamed Salah. Ayolah The Reds, buruan kasih Salah gaji tinggi!  https://t.co/gbjaJDRbUY",3,0,0,1,2022-01-14,7,Friday,5,3,1
1481889904166588417,2022-01-14 07:24:19,"Mengawali 2022, Museum MACAN membuka kembali pameran seni terbarunya yang berjudul Present Continuos/ Sekarang Seterusnya pada 15 Januari 2022. https://t.co/WdbHsB7rTR",4,0,1,1,2022-01-14,7,Friday,5,5,1
1481889244662669312,2022-01-14 07:21:42,"Hafiz Fatur, adik Irwansyah masih menjadi buron Kejaksaan Negeri Kabupaten Bogor. Ini rumah Hafiz Fatur yang disita jadi barang bukti tindak pidana korupsi:  https://t.co/D0TrPm9k3D",6,1,2,0,2022-01-14,7,Friday,5,8,1
1481888665148268544,2022-01-14 07:19:24,Motor skutik masih mendominasi di kalender penjualan 2021! https://t.co/e7F6m1scFK,9,2,0,0,2022-01-14,7,Friday,5,9,2
1481888638166253571,2022-01-14 07:19:18,"BRI Liga 1 2021 menggelar empat pertandingan seru hari ini. Berikut jadwal selengkapnya, termasuk duel klasik antara Persebaya Surabaya vs PSM Makassar.  https://t.co/TStfwPojdn",2,1,0,0,2022-01-14,7,Friday,5,2,1
1481888301099491328,2022-01-14 07:17:57,"Bukan awal yang indah bagi Andriy Shevchenko mengawali karier sebagai pelatih di Liga Italia. Timnya, Genoa terus-terusan kalah terbaru kandas di Coppa Italia.  https://t.co/bdIvNApZXj",3,0,0,0,2022-01-14,7,Friday,5,3,0
1481887999239634945,2022-01-14 07:16:45,"Chandra menegaskan unit kerja yang tak dapat performa positif dan tidak berinovasi, serta bahkan menghalangi kemajuan organisasi akan diganti. https://t.co/0FVw9FAzGj",3,0,0,0,2022-01-14,7,Friday,5,3,0
1481887375987023875,2022-01-14 07:14:17,Xiaomi 12 dan 12 Pro segera dirilis di Indonesia. Tanda-tanda kelahiran ponsel flagship ini kian terlihat jelas. #Xiaomi12  https://t.co/abwDJChrSn,6,1,0,0,2022-01-14,7,Friday,5,6,1
1481887350850727940,2022-01-14 07:14:11,"Scream jadi sajian yang pastinya dinantikan oleh banyak orang. Seperti apa reviewnya? Yuk, simak di sini: #Scream  https://t.co/cARql7my1S",1,1,2,0,2022-01-14,7,Friday,5,3,1
1481887034906193922,2022-01-14 07:12:55,Fico Fachriza pernah membuat pengakuan dirinya menggunakan tembakau sintetis. Seperti apa? https://t.co/EvMwCv2aXW,12,1,1,1,2022-01-14,7,Friday,5,13,2
1481886315964735490,2022-01-14 07:10:04,"Video aksi pegawai negeri sipil (PNS) wanita di Humbang Hasundutan (Humbahas), Sumatera Utara, sedang berjoget sambil menenggak minuman keras viral. Video itu disebut terjadi saat perayaan ulang tahun Kepala Dinas Kesehatan Humbahas. https://t.co/R5pZzKZbLQ",21,12,6,1,2022-01-14,7,Friday,5,27,13
1481886298059198464,2022-01-14 07:10:00,"Hadfana firdaus, pembuang dan penendang sesajen di lokasi terdampak erupsi Semeru tertangkap. Netizen menyambut senang penangkapan Hadfana. https://t.co/uyC4wf1L3k",23,8,1,1,2022-01-14,7,Friday,5,24,9
1481885692296843265,2022-01-14 07:07:35,PT Pupuk Indonesia (Persero) akan melakukan uji coba pengiriman pupuk subsidi menggunakan jalur kereta api (KA). https://t.co/YlhWG4IWTe,7,1,1,0,2022-01-14,7,Friday,5,8,1
1481885026333700096,2022-01-14 07:04:57,"Video PNS wanita di Humbahas, Sumut, berjoget sambil menenggak miras viral. PNS itu akan diperiksa inspektorat. https://t.co/Sgc5dWCgoI",98,40,27,18,2022-01-14,7,Friday,5,125,58
1481884354284597250,2022-01-14 07:02:16,"Lionel Messi mengaku kondisinya makin membaik. Tapi, pesepakbola Argentina itu kaget pemulihannya dari COVID-19 berjalan lambat.  https://t.co/W28m2H64WC",6,0,0,0,2022-01-14,7,Friday,5,6,0
1481883924024471561,2022-01-14 07:00:34,Satgas Covid-19 mengungkapkan alasan pemerintah resmi menghapus daftar 14 negara asal WNA yang sempat dilarang memasuki area Indonesia akibat penularan  varian Omicron. #CNNIndonesia #detiknetwork  https://t.co/QCswq10vUY,4,1,0,0,2022-01-14,7,Friday,5,4,1
1481883907545092101,2022-01-14 07:00:30,Hyundai siap memproduksi mobil listrik Ioniq 5 di pabrik Cikarang tahun ini! https://t.co/qVIGMmE3f3,12,1,2,1,2022-01-14,7,Friday,5,14,2
1481883280484012034,2022-01-14 06:58:00,Gubernur Jawa Barat menjual lukisan di marketplace Non-fungible Token (NFT). Aset digital tersebut berhasil terjual delapan kali lipat dari harga aslinya. https://t.co/OcfwgATTxQ,13,3,2,1,2022-01-14,6,Friday,5,15,4
1481883266168856576,2022-01-14 06:57:57,Oppo Find N begitu mengesankan saat detikINET menjajal singkat ponsel layar lipat ini. Bentuk compact tanpa ada kerutan di lipatan jadi keunggulannya. #OppoFindN  https://t.co/C8feOlHCw2,5,0,0,0,2022-01-14,6,Friday,5,5,0
1481882505569619972,2022-01-14 06:54:56,"#terpopuler Legenda Brasil, Ronaldo Luis Nazario de Lima menyebut lima pemain yang paling suka ditontonnya. Namun, Cristiano Ronaldo tidak masuk dalam daftar!  https://t.co/XCoJtqXPXj",4,2,0,0,2022-01-14,6,Friday,5,4,2
1481881479009423360,2022-01-14 06:50:51,"Beasiswa S2 dan S3 Fulbright 2022 dibuka untuk studi di Amerika Serikat. Cek syarat dan batas waktu pendaftarannya yuk!

via: detikedu https://t.co/bWz3s3OYo1",16,0,5,0,2022-01-14,6,Friday,5,21,0
1481880819937562628,2022-01-14 06:48:14,"Bagi detikers yang ingin mencari rumah di daerah Dramaga, yuk simak liputan tim d'House Hunter yang bakal tayang hari Minggu 16 Januari 2022 besok! https://t.co/wNCY6FgQPN",8,2,1,1,2022-01-14,6,Friday,5,9,3
1481879978874753024,2022-01-14 06:44:53,"Jadi korban tren aneh di TikTok, TikToker ini harus membayari minuman orang lain. Ia kesal, harga minuman yang harus dibayarkan 7 kali lipat dari miliknya! https://t.co/W3oISv6vv8",2,0,2,0,2022-01-14,6,Friday,5,4,0
1481879388190908418,2022-01-14 06:42:32,Artis inisial FF ditangkap polisi terkait narkoba. Kabar tersebut dibenarkan Kabid Humas Polda Metro Jaya Kombes Pol Endra Zulpan. Belakangan diketahui bahwa inisial FF adalah komika Fico Fachriza. https://t.co/tKCdEpFL2s,9,3,2,0,2022-01-14,6,Friday,5,11,3
1481878411555577857,2022-01-14 06:38:39,Pembangunan rumah dinas Bupati Penajam Paser Utara Abdul Gafur pernah menuai sorotan karena menelan anggaran hingga Rp 34 miliar. Hingga saat ini KPK masih mendalaminya. https://t.co/bxFVGkeIsk,7,2,4,0,2022-01-14,6,Friday,5,11,2
1481877819873505280,2022-01-14 06:36:18,"Pria yang menendang dan membuang sesajen di lokasi erupsi Gunung Semeru, Hadfana Firdaus tertangkap di Bantul, DIY. Kini, Hadfana tengah menjalani pemeriksaan di Polda Jatim. https://t.co/SaIAxnWNZS",16,2,1,2,2022-01-14,6,Friday,5,17,4
1481877805357051904,2022-01-14 06:36:15,Lee Jinglei membuat surat terbuka dan tuduhan jika Wang Leehom berusaha masuk ke rumahnya. Hal itu dibantah oleh Wang Leehom.  https://t.co/MT7HpmlZaQ,5,0,0,0,2022-01-14,6,Friday,5,5,0
1481877065292996609,2022-01-14 06:33:18,Menhan Prabowo disebut oleh media asing sempat membahas normalisasi hubungan antara RI dan Israel. Jubir Menhan membantah. https://t.co/IPhPMBjcTx,6,2,2,3,2022-01-14,6,Friday,5,8,5
1481876344124366849,2022-01-14 06:30:27,WNI di Jerman yang masak bakwan menarik perhatian. Ada juga warung sate dengan rating tertinggi hingga pelayan yang masukkan menu tak dipesan ke bon pelanggan. https://t.co/jhD9yV7gBN,9,1,0,1,2022-01-14,6,Friday,5,9,2
1481875717516320768,2022-01-14 06:27:57,"Hafiz Fatur, adik Irwansyah saat ini tengah menjadi buronan atau masuk daftar pencarian orang atas kasus dugaan korupsi Rp 3,1 miliar. https://t.co/sX6YiDDITD",12,1,1,1,2022-01-14,6,Friday,5,13,2
1481875448141422592,2022-01-14 06:26:53,Owen Cheung dan Renci Yeung kini dikabarkan telah tinggal bersama setelah berkencan sejak 2020 lalu. Begini kisah cinta keduanya:  https://t.co/qZMAfsBOHa,5,0,0,0,2022-01-14,6,Friday,5,5,0
1481874866240471044,2022-01-14 06:24:34,"Aliansi buruh menggelar aksi demo di depan Gedung DPR, Jakarta Pusat, Jumat (14/1). Mereka kembali menyuarakan penghapusan UU Cipta Kerja. https://t.co/Qc2TuYphKw",8,0,1,0,2022-01-14,6,Friday,5,9,0
1481874850507628546,2022-01-14 06:24:30,Mencari sate kambing enak di Jakarta memang tak sulit. Di kedai Jaya Agung bisa makan sate kambing yang sudah tersohor enak sejak tahun 1963. https://t.co/0Zy5Ui4R0k,11,0,0,0,2022-01-14,6,Friday,5,11,0
1481874190345117696,2022-01-14 06:21:53,"Banyak hal yang dicontohkan Rasulullah SAW semasa hidupnya. Termasuk urusan makanan, Rasulullah SAW sama sekali tidak pernah mencela makanan. https://t.co/hrGOI3JULN",16,1,5,0,2022-01-14,6,Friday,5,21,1
1481873860752510978,2022-01-14 06:20:34,"Kalian yang sehari-harinya jadi anak kereta (anker), setuju nggak sih kalau tarif KRL dinaikkan? Beri komentarmu di artikel ini ya! https://t.co/FE0T6sAVqL",13,15,1,1,2022-01-14,6,Friday,5,14,16
1481873109229711361,2022-01-14 06:17:35,Arti mimpi makanan menarik disimak. Tiap kondisi atau jenis makanan yang datang di dalam mimpi ternyata mengartikan hal berbeda. Seperti ini maknanya. https://t.co/9I0lWaQTGH,2,0,0,1,2022-01-14,6,Friday,5,2,1
1481872796653346817,2022-01-14 06:16:21,"Salah satu barang yang disita adalah baju merek Zara. Selain itu, ada juga tas belanjaan Sogo, topi merek Dior dan sejumlah kotak barang yang turut disita KPK. https://t.co/Byp9cZY2tu",8,1,1,0,2022-01-14,6,Friday,5,9,1
1481872779565801473,2022-01-14 06:16:17,Polisi mengungkap kondisi Fico Fachriza saat ditangkap di rumahnya. Seperti apa? https://t.co/xNcOZzh7TM,8,4,5,9,2022-01-14,6,Friday,5,13,13
1481872451457925122,2022-01-14 06:14:58,Pramugari pun bisa mendapat penghasilan besar terutama jika bekerja di maskapai ternama atau first class. Gajinya lebih sih tapi..... https://t.co/YcKvIrfpu9,2,0,0,0,2022-01-14,6,Friday,5,2,0
1481872109538316291,2022-01-14 06:13:37,"Disela aksi, mereka menggelar salat Jumat di depan DPR. https://t.co/uo9ZbRDHrv",11,1,0,1,2022-01-14,6,Friday,5,11,2
1481871385844760577,2022-01-14 06:10:44,"Wakil Camat Setiabudi, Jakarta Selatan, Jan Hider Oslannd P menjadi salah satu pejabat terkaya di Indonesia. Hartanya segini nih! https://t.co/8CgkDJIQ2V",36,8,10,2,2022-01-14,6,Friday,5,46,10
1481870969685827584,2022-01-14 06:09:05,Presiden China Xi Jinping menghubungi Presiden Joko Widodo lewat sambungan telepon. Ini yang dibicarakan: https://t.co/Io7nbJKfXe,15,24,6,2,2022-01-14,6,Friday,5,21,26
1481870363516669953,2022-01-14 06:06:41,Gibran menanggapi rencana JoMan melaporkan balik dosen UNJ Ubedillah Badrun. Apa pertimbangan Gibran? https://t.co/5r2a8s0jjA,18,9,0,1,2022-01-14,6,Friday,5,18,10
1481870037694697474,2022-01-14 06:05:23,"Massa buruh yang menggelar demo di depan Gedung DPR RI menutup akses Jalan Gatot Subroto arah Slipi. Akibatnya, kendaraan dialihkan ke busway. https://t.co/SWv5uMUnXC",7,1,1,0,2022-01-14,6,Friday,5,8,1
1481870016408604673,2022-01-14 06:05:18,Presiden Jokowi memberikan target pembangunan jalan bypass dari Bandara Internasional Lombok (BIL) menuju kawasan Mandalika bisa selesai Februari. https://t.co/JmerDevDaN,6,0,0,0,2022-01-14,6,Friday,5,6,0
1481868953202868224,2022-01-14 06:01:04,"Sebuah rumah tinggal di wilayah Kapuk Muara, Penjaringan, Jakut terbakar. Kebakaran diduga akibat korsleting listrik. https://t.co/UVHari0uKk",7,0,0,0,2022-01-14,6,Friday,5,7,0
1481868344781377536,2022-01-14 05:58:39,Anak Daus Mini dan Shelvie kini sudah berusia 3 bulan. Ini alasan Daus Mini menyembunyikan kehamilan sang istri hingga melahirkan:  https://t.co/Fgu3OgalK9,4,0,0,0,2022-01-14,5,Friday,5,4,0
1481867819629305857,2022-01-14 05:56:34,Rekor nih! Kylie Jenner menjadi perempuan pertama yang memiliki 300 juta pengikut di Instagram. #KylieJenner https://t.co/VeqPte3Vrl,16,1,1,3,2022-01-14,5,Friday,5,17,4
1481867169671618563,2022-01-14 05:53:59,Ghozali disebut meraup miliaran rupiah dari menjual foto selfienya sebagai NFT. Chef Arnold Poernomo sebagai penggiat NFT coba meluruskan kesalahpahaman ini:  https://t.co/ofgsdtfROh,29,2,4,0,2022-01-14,5,Friday,5,33,2
1481866471651352578,2022-01-14 05:51:13,Akhir pekan ini Vidi Aldiano akan menikahi Sheila Dara Aisha. Ini potret Vidi Aldiano saat menggelar acara sungkeman hingga siraman:  https://t.co/I3rgQJoa9Q,16,0,3,0,2022-01-14,5,Friday,5,19,0
1481865844321837056,2022-01-14 05:48:43,"Sebelum membuat atau membeli NFT harus diputuskan dulu dari pasar mana kamu belinya, jenis dompet digital apa yang dipake, dan kripto apa yang diperlukan. https://t.co/tMgAO1fpHP",30,2,9,2,2022-01-14,5,Friday,5,39,4
1481865167260504065,2022-01-14 05:46:02,Harga emas Antam hari ini turun. Harga emas Antam 24 karat hari ini turun setelah sempat berturut-turut mengalami kenaikan. Segini harganya kini: https://t.co/fM3gE972GI,9,1,0,2,2022-01-14,5,Friday,5,9,3
1481863630220152833,2022-01-14 05:39:55,#Foto Unik! Bhogali Bihu merupakan festival panen yang digelar warga di kawasan India. Dalam festival itu warga akan berburu beragam ikan di danau. Penasaran? https://t.co/oexS2qcbx3,4,0,0,0,2022-01-14,5,Friday,5,4,0
1481863306117791750,2022-01-14 05:38:38,"Sejak diluncurkannya video klip baru 'Yang Terdalam' milik Noah, banyak yang memparodikan sebagai model video clip. Kocaknya dilakukan sambil minum es teh jumbo. https://t.co/laCWJE40O5",5,1,2,2,2022-01-14,5,Friday,5,7,3
1481863008079028230,2022-01-14 05:37:27,Tercatat ada 14 titik layanan Samling (Samsat Keliling) yang beroperasi pada Jumat (14/1/2022). Ini sebarannya.  https://t.co/DqBit2bx1X,4,0,0,0,2022-01-14,5,Friday,5,4,0
1481862708400164864,2022-01-14 05:36:16,"Di balik kabar Thariq Halilintar yang kembali terpapar Corona untuk ketiga kalinya, Fuji kerap memberikan semangat lewat video call. https://t.co/iEypSDW4Di",9,0,1,2,2022-01-14,5,Friday,5,10,2
1481862038984998912,2022-01-14 05:33:36,"#FOTO ini memang terkesan biasa, tapi awas bisa bikin mata tertipu jika melihatnya sekilas saja. Coba amati seksama, bisa bikin kamu ngakak dan geleng-geleng. https://t.co/fERFdFPcdv",9,1,0,0,2022-01-14,5,Friday,5,9,1
1481861733190938629,2022-01-14 05:32:23,"Kejaksaan Negeri Kabupaten Bogor melakukan penggeledahan rumah Hafiz Fatur, adik dari Irwansyah. Ini hasilnya:  https://t.co/JMyKTr57oS",4,0,0,1,2022-01-14,5,Friday,5,4,1
1481861303824265217,2022-01-14 05:30:41,"Pemerintah mencabut aturan larangan masuk WNA dari 14 negara terkait Omicron. Ada beragam pertimbangan di balik peniadaan aturan terkait, ini penjelasan Satgas: https://t.co/1xOI2UGeHh",7,10,1,3,2022-01-14,5,Friday,5,8,13
1481860979226988546,2022-01-14 05:29:23,Polisi menangkap komika Fico Fahriza terkait kasus narkoba. Fico Fachriza ditangkap karena ganja. https://t.co/QTzi2GX8KI,91,21,20,21,2022-01-14,5,Friday,5,111,42
1481860360613384192,2022-01-14 05:26:56,Seleksi PPPK untuk 2022 akan dibuka lagi. Sedangkan untuk calon aparatur sipil negara (CASN/CPNS) belum pasti. https://t.co/mfO14tGDR8,13,1,3,0,2022-01-14,5,Friday,5,16,1
1481859674362322946,2022-01-14 05:24:12,Kisah Ghozali mendadak kaya karena foto selfie NFT jadi perbincangan se-Indonesia. Apakah Ghozali akan lanjut foto selfie?🤔 https://t.co/GCEOgmqDX7,14,2,0,1,2022-01-14,5,Friday,5,14,3
1481859036098215939,2022-01-14 05:21:40,"Pelaku penendang sesajen di Gunung Semeru, Hadfana Firdaus dibekuk di Bantul, DIY, malam tadi. Begini detik-detik penangkapannya. https://t.co/RvUS6NeEEK",5,1,0,1,2022-01-14,5,Friday,5,5,2
1481858687660703746,2022-01-14 05:20:17,Informasi tersebut viral di media sosial. Dari informasi yang beredar disebutkan Heince hilang sejak 30 Desember 2021. https://t.co/3KLgF77HVI,4,0,0,0,2022-01-14,5,Friday,5,4,0
1481858393337905155,2022-01-14 05:19:07,"Hadfana mengakui apa yang dilakukan itu menyinggung perasaan masyarakat. Untuk itu, dia mohon agar perbuatannya dimaafkan. https://t.co/DctqT9Ptvx",9,13,1,3,2022-01-14,5,Friday,5,10,16
1481858046334844930,2022-01-14 05:17:44,Felicya Angelista dan Caesar Hito masih menikmati masa-masa merawat anak pertama mereka. Keduanya belum ingin memakai jasa pengasuh anak. https://t.co/4i6DrW8Wgt,3,0,0,0,2022-01-14,5,Friday,5,3,0
1481857641097961472,2022-01-14 05:16:07,"Massa buruh yang berdemonstrasi di depan gedung DPR/MPR telah memenuhi badan jalan. Akibatnya, kondisi lalu lintas menuju Grogol macet panjang. https://t.co/65REG8GhQP",18,1,2,0,2022-01-14,5,Friday,5,20,1
1481857195486724103,2022-01-14 05:14:21,Nama tersebut disinggung Anggota Komisi VII Fraksi Demokrat Muhammad Nasir saat membahas pengawasan tambang. Nama itu disebut 'Ratu Batu Bara'. https://t.co/PzKxZHzuo5,7,1,1,0,2022-01-14,5,Friday,5,8,1
1481856868217671680,2022-01-14 05:13:03,"Walaupun sering dianggap jadi pelajaran tersulit, dengan mempelajari matematika banyak manfaat yang didapat lho. Apa saja ya?

via: detikedu https://t.co/d9mS59HzRm",5,0,0,3,2022-01-14,5,Friday,5,5,3
1481856493326643204,2022-01-14 05:11:34,Jokowi berharap bendungan itu dapat mendukung kedaulatan pangan. https://t.co/Qc6qNjWB6D,9,2,0,0,2022-01-14,5,Friday,5,9,2
1481856481402232836,2022-01-14 05:11:31,"Budiono (61) warga asal Depok, Jawa Barat, sudah 15 hari hilang. Budiono merupakan penderita demensia. #detiktif https://t.co/k2qKxaPT8H",3,0,1,0,2022-01-14,5,Friday,5,4,0
1481856156763045891,2022-01-14 05:10:13,Fico Fachriza kini masih diperiksa di Polda Metro Jaya. https://t.co/Z8Anc6oFu4,36,7,14,7,2022-01-14,5,Friday,5,50,14
1481856138819907588,2022-01-14 05:10:09,Ini bukan soal spirit doll yang sedang ramai dibicarakan. Ini hanya boneka beruang biasa yang ada di dalam ruang kelas sebuah Taman Kanak-kanak. Boneka itu... #TawaSetan #Podcast  https://t.co/Jw91GUV303,2,0,0,0,2022-01-14,5,Friday,5,2,0
1481855528997462018,2022-01-14 05:07:44,"Prabowo Subianto disuntik vaksin Nusantara, langsung oleh penggagasnya, eks Menkes RI Terawan. Dikabarkan bakal jadi booster, begini status vaksin tersebut. https://t.co/Kauq8he8XK",4,0,1,1,2022-01-14,5,Friday,5,5,1
1481854373542211585,2022-01-14 05:03:08,Non fungible token alias NFT saat ini lagi booming. Apalagi gara-gara Ghozali yang bisa menjual foto selfienya hingga miliaran rupiah. Berikut faktanya: https://t.co/SI9yPN5ND9,7,0,3,1,2022-01-14,5,Friday,5,10,1
1481853622174601217,2022-01-14 05:00:09,Laporan itu terkait dugaan gratifikasi serta klarifikasi Laporan Harta Kekayaan Penyelenggara Negara (LHKPN). https://t.co/96D2nK7uCM,11,1,1,1,2022-01-14,5,Friday,5,12,2
1481853257861545984,2022-01-14 04:58:42,"11 Januari 2022, dua tahun usia pernikahan Vanessa Angel dan Bibi Ardiansyah. Keluarga Faisal gelar Yasinan untuk doakan mendiang Vanessa dan Bibi.  https://t.co/jJsUAfkR6i",16,0,1,0,2022-01-14,4,Friday,5,17,0
1481852336981090305,2022-01-14 04:55:03,Hanggini menanggapi isu perselingkuhan antara Junior Roberts dan Rebecca Klopper yang sempat ramai diperbincangkan di media sosial. Ini kata Hanggini:  https://t.co/t2HTQxv8Pe,10,0,0,0,2022-01-14,4,Friday,5,10,0
1481852026539720706,2022-01-14 04:53:49,"Kabar mengejutkan datang dari Daus Mini yang baru saja dikaruniai anak kedua. Daus Mini mengaku sengaja menyembunyikan kehamilan istrinya, Shelvie Hana Wijaya. Apa alasannya? https://t.co/bYdRqC6dhq",4,0,0,0,2022-01-14,4,Friday,5,4,0
1481851301021593601,2022-01-14 04:50:56,Liverpool gagal memaksimalkan keuntungan saat ditahan 10 pemain Arsenal 0-0. Juergen Klopp tetap tenang meski tak senang dengan performa Liverpool.  https://t.co/h2rjsTyClR,3,0,0,3,2022-01-14,4,Friday,5,3,3
1481850985056284679,2022-01-14 04:49:40,"Adik mendiang Vanessa Angel, Mayang mengaku kehilangan rasa kepercayaan dirinya. Terlebih saat Mayang sedang melihat dirinya di depan kaca. https://t.co/bhhZC00MGe",19,15,2,3,2022-01-14,4,Friday,5,21,18
1481850615324106758,2022-01-14 04:48:12,"Mantan CEO Twitter, Jack Dorsey, mengatakan dirinya saat ini sedang berencana untuk membangun sistem penambangan bitcoin. https://t.co/kydwhZwoVa",14,0,4,0,2022-01-14,4,Friday,5,18,0
1481849691864281088,2022-01-14 04:44:32,Harry Styles hingga Billie Eilish warnai headline Coachella 2022. Sebelumnya acara itu sudah dua tahun tak berjalan. #Coachella2022  https://t.co/nexW6QZD1m,9,0,0,0,2022-01-14,4,Friday,5,9,0
1481849675653296128,2022-01-14 04:44:28,Anne Ardina blak-blakan soal tarif endorsement. Sang model mengaku mematok harga untuk sebuah produk. Ini kriterianya:  https://t.co/UiJNo68mlZ,6,0,0,0,2022-01-14,4,Friday,5,6,0
1481849010252091392,2022-01-14 04:41:50,AC Milan susah payah menyingkirkan Genoa di babak 16 besar Coppa Italia. Pelatih Stefano Pioli meminta maaf atas performa buruk di babak pertama.  https://t.co/6lgB8xNvYA,4,0,0,0,2022-01-14,4,Friday,5,4,0
1481848359627509763,2022-01-14 04:39:15,Belakangan makin banyak selebriti atau musisi yang terjun ke dunia bisnis. Ini cerita Ruri Repvblik yang usahanya kini makin banyak diminati orang-orang:  https://t.co/NBcXxApOuH,2,0,0,0,2022-01-14,4,Friday,5,2,0
1481847658809544713,2022-01-14 04:36:27,"Cristiano Ronaldo resah, karena MU masih terseok-seok di Liga Inggris. Bagi Ronaldo MU harusnya juara bukan cuma incar posisi tiga besar, Rooney mengamini.  https://t.co/5SDjs3gyw0",9,0,0,0,2022-01-14,4,Friday,5,9,0
1481847645211611137,2022-01-14 04:36:24,"Viral video warga mengerumuni sebuah mobil di Legok, Tangerang. Pengemudi mobil disebut bandar narkoba yang kabur dari kejaran polisi hingga menabrak motor dan rumah warga. https://t.co/f0sEF0Agm1",4,0,0,1,2022-01-14,4,Friday,5,4,1
1481846932070969346,2022-01-14 04:33:34,Bisakah manusia melihat wujud sebenarnya makhluk gaib? Kata Ustaz kali ini akan membahas tentang eksistensi dan keberadaan makhluk gaib. Ini penjelasannya:  https://t.co/zYYfTkRs7s,7,0,0,0,2022-01-14,4,Friday,5,7,0
1481846914198949890,2022-01-14 04:33:30,Liverpool gagal memaksimalkan keuntungan saat ditahan 10 pemain Arsenal 0-0. Juergen Klopp tetap tenang meski tak senang dengan performa Liverpool.   https://t.co/QbzmxPYoKz,5,1,0,0,2022-01-14,4,Friday,5,5,1
1481846403882180610,2022-01-14 04:31:28,"Thariq Halilintar terkonfirmasi positif COVID-19, mengaku jika dirinya sudah terpapar COVID-19 sebanyak 3 kali. Apa sih yang memicu reinfeksi COVID-19? https://t.co/wPH9H6uO1c",10,10,2,1,2022-01-14,4,Friday,5,12,11
1481846053972365316,2022-01-14 04:30:05,"Waduh... Bella Sulian rugi Rp 1,4 M jadi korban penipuan suntik modal alat kesehatan. Ia sempat mau bunuh diri. https://t.co/jmH8Vvzbhq",8,0,1,1,2022-01-14,4,Friday,5,9,1
1481845382229512197,2022-01-14 04:27:25,Arsenal bermain dengan 10 orang melawan Liverpool karena Granit Xhaka diganjar kartu merah. Gelandang asal Swiss itu meminta maaf kepada rekannya.  https://t.co/f2RXDIzo8j,3,0,0,0,2022-01-14,4,Friday,5,3,0
1481845080088584192,2022-01-14 04:26:13,"Pada 2022 suku bunga hipotek di AS mengalami kenaikan, bahkan ke level tertinggi. Nyicil rumah jadi makin mahal. https://t.co/tBLJwowiKp",3,1,0,0,2022-01-14,4,Friday,5,3,1
1481845056436936712,2022-01-14 04:26:07,"Samsung Galaxy S21 FE dapat respon positif di Indonesia. Buktinya seluruh varian yang ditawarkan Samsung saat early bird ludes dipesan, ini spek dan harganya: #GalaxyS21FE  https://t.co/GOy0JSsuf1",3,1,0,0,2022-01-14,4,Friday,5,3,1
1481844360077578244,2022-01-14 04:23:21,"Bagaimana ya rumus menghitung prisma segitiga? Lihat rumus dan contoh soalnya yuk! 

via: detikedu https://t.co/4z26aG6xYL",1,0,2,0,2022-01-14,4,Friday,5,3,0
1481844338430779397,2022-01-14 04:23:16,Seekor burung hantu salju terlihat di sekitar Washington. Ini merupakan kejadian langka! https://t.co/Npd5jW2GMg,3,1,0,0,2022-01-14,4,Friday,5,3,1
1481844078904066054,2022-01-14 04:22:14,"Pria tendang dan membuang sesajen di lokasi erupsi Semeru, Hadfana Firdaus ditetapkan sebagai tersangka. Sebelumnya, Hadfana tertangkap di Bantul, DIY. https://t.co/0wfIbrwIbt",7,3,3,3,2022-01-14,4,Friday,5,10,6
1481844062533599233,2022-01-14 04:22:10,"Fico Fachriza pernah buka-bukaan soal terjerat narkoba. Kala itu, ia bicara di channel YouTubenya. Ini cerita Fico saat terjerat narkoba:  https://t.co/lTgyLkFBhO",5,1,1,1,2022-01-14,4,Friday,5,6,2
1481843706818752512,2022-01-14 04:20:45,Stand Up Komedian Fico Fachriza ditangkap Ditres Narkoba Polda Metro Jaya. Saat ini masih menjalani pemeriksaan. #FicoFachriza  https://t.co/nqXQtSKmpp,58,36,19,59,2022-01-14,4,Friday,5,77,95
1481843435078356994,2022-01-14 04:19:40,Daus Mini tengah bahagia karena dikaruniai putra pertama dari pernikahannya dengan Shelvie Hana Wijaya. Walaupun awalnya Daus menyembunyikan kelahiran putranya. https://t.co/alcZm0X255,7,0,3,0,2022-01-14,4,Friday,5,10,0
1481843413880545288,2022-01-14 04:19:35,"Ardhito Pramono ditangkap polisi terkait kasus narkoba dengan barang bukti berupa ganja seberat 4,8 gram. Terkait dengan penangkapan ini, fakta lain justru terungkap. Ardhito Pramono ternyata sudah menikah dengan Jeanneta Sanfadelia. https://t.co/YzYnUapuvg",8,0,2,0,2022-01-14,4,Friday,5,10,0
1481843043036811267,2022-01-14 04:18:07,"Komisi Pemberantasan Korupsi (KPK) resmi menetapkan Bupati Penajam Paser Utara, Abdul Gafur, sebagai tersangka. Abdul Gafur diduga terlibat dalam kasus pengadaan barang dan jasa serta perizinan. https://t.co/FUf7om2Duw",1,0,1,0,2022-01-14,4,Friday,5,2,0
1481842703847641091,2022-01-14 04:16:46,Fico Fachriza bukan orang baru di dunia stand up comedy. Publik mengenalnya sebagai salah satu komika. Ini potretnya:  https://t.co/VsHmWlMDIW,8,0,1,3,2022-01-14,4,Friday,5,9,3
1481842684146995201,2022-01-14 04:16:41,Kemenangan Manchester United atas Aston Villa 1-0 di Piala FA diiringi kabar kurang sedap. Kiper kedua MU Dean Henderson dikabarkan ngambek usai batal main!  https://t.co/PhgvE3ucMA,2,0,0,1,2022-01-14,4,Friday,5,2,1
1481842037062316036,2022-01-14 04:14:07,"Bupati Penajam Paser Utara, Abdul Gafur, kena OTT KPK terkait kasus pengadaan barang dan jasa serta perizinan. Ia resmi ditetapkan sebagai tersangka. Berikut fakta-faktanya: https://t.co/xXxb5F2QNs",4,0,0,0,2022-01-14,4,Friday,5,4,0
1481841690516332556,2022-01-14 04:12:44,Pebulutangkis Kevin Sanjaya Sukamuljo jadi sorotan para penggemarnya. Hal itu karena postingan di akun Instagram pribadinya yang dinner bareng Valencia Tanoe. Go public nih...  https://t.co/uir1FIMlFZ,1088,18,86,26,2022-01-14,4,Friday,5,1174,44
1481841323669925892,2022-01-14 04:11:17,Timnas Indonesia harus berjuang dengan permasalahan komunikasi. Sejauh ini tim menggunakan lebih dari dua bahasa dalam komunikasi.  https://t.co/G73XA7K2fP,8,3,1,0,2022-01-14,4,Friday,5,9,3
1481840419961028608,2022-01-14 04:07:42,"""Seluruh masyarakat Indonesia yang saya cintai kiranya, apa yang kami lakukan dalam video itu dapat menyinggung perasaan saudara kami mohon maaf yang sedalam-dalamnya,"" katanya. https://t.co/5qayhsFdAC",75,174,12,25,2022-01-14,4,Friday,5,87,199
1481839971791163398,2022-01-14 04:05:55,Polisi menangkap stand up comedian inisial FF terkait kasus narkoba. FF adalah Fico Fachriza. https://t.co/EFOHfVxLAb,6706,1251,1607,2027,2022-01-14,4,Friday,5,8313,3278
1481839805105332228,2022-01-14 04:05:15,"Demi menyukseskan MotoGP 2022 di Mandalika, Pemerintah akan menghadirkan travel bubble khusus untuk turis asing. https://t.co/DQ4Gz9rntW",2,1,1,0,2022-01-14,4,Friday,5,3,1
1481839784389664772,2022-01-14 04:05:10,"Massa yang tergabung dalam aliansi buruh mulai berdatangan di depan Gedung DPR RI, Jakarta Pusat, Jumat (14/1). Aksi demo ini direncanakan dihadiri puluhan ribu massa yang menolak UU Cipta Kerja. https://t.co/ruIJSs8XvZ",6,0,0,0,2022-01-14,4,Friday,5,6,0
1481839471733710854,2022-01-14 04:03:55,"#terpopuler Lee Chong Wei kaget saat tahu Taufik Hidayat pernah coba disuap oleh ofisial Malaysia agar sengaja mengalah saat menghadapi dirinya. Begini katanya.

#badminton   https://t.co/TckQxBhaKU",15,0,3,0,2022-01-14,4,Friday,5,18,0
1481838723297951747,2022-01-14 04:00:57,"Rezeki memang enggak ada yang tahu, ya. Seorang TKW Arab Saudi, Fitria Denafa, bisa mendapatkan gaji hampir Rp40 juga perbulannya, lho. Simak kisahnya, yuk! #detiknetwork  https://t.co/LZos7cDswA",11,2,1,1,2022-01-14,4,Friday,5,12,3
1481837779743031298,2022-01-14 03:57:12,"Massa buruh sudah mulai berdatangan di depan Gedung DPR, Senayan, Jakarta Pusat. Mereka bakal menggelar demo tolak UU Cipta Kerja. https://t.co/XfRAjKC1aj",8,1,0,0,2022-01-14,3,Friday,5,8,1
1481836987724275712,2022-01-14 03:54:03,Polisi kembali menangkap artis terkait pengalahgunaan narkoba. Kini artis dan komedian inisial FF ditangkap terkait kasus narkoba. https://t.co/UZ1bzjSBGm,135,91,21,18,2022-01-14,3,Friday,5,156,109
1481836355411922949,2022-01-14 03:51:32,"Presiden Joko Widodo beserta rombongan melakukan kunjungan kerja ke Mandalika, Lombok Tengah, guna meninjau sejumlah fasilitas untuk MotoGP 2022. Jokowi sempat menjajal jalanan di bandara dengan motor custom. Seperti ini gayanya: https://t.co/oAQBAtOdp0",8,1,0,1,2022-01-14,3,Friday,5,8,2
1481836331663831047,2022-01-14 03:51:27,Model Shakilla Kaif bicara soal kehidupan asmara. Shakilla Kaif ngaku kurang suka pria ganteng. Ia maunya setia dan royal. https://t.co/CN0mqtGPAe,28,19,3,9,2022-01-14,3,Friday,5,31,28
1481835420400988161,2022-01-14 03:47:50,"Komisi Pemberantasan Korupsi (KPK) ungkap kronologi operasi tangkap tangan terhadap Bupati Penajam Paser Utara, Abdul Gafur. Ia ditangkap saat sedang berada di mal di Jakarta Selatan. https://t.co/2NnfwHcepA",6,1,1,0,2022-01-14,3,Friday,5,7,1
1481834451898404866,2022-01-14 03:43:59,"Di mana saja lokasi vaksin booster Tangerang? Cek di sini untuk mengetahui syarat, biaya, hingga cara mendaftar vaksin booster di Tangerang. https://t.co/rKr4H5XGgv",2,0,0,0,2022-01-14,3,Friday,5,2,0
1481834176760496129,2022-01-14 03:42:53,"Zaman tertua di Bumi adalah zaman arkaekum yang berlangsung sejak 2.500 juta tahun lalu. Bagaimana ya sejarah perkembangannya?

via: detikedu https://t.co/jW2qZwivAw",5,0,1,0,2022-01-14,3,Friday,5,6,0
1481833880080551936,2022-01-14 03:41:42,"Seperti ini penampakan Hadfana Firdaus, penendang sesaji di Semeru, beberapa saat setelah ditangkap lalu dibawa ke Mapolsek Banguntapan, Bantul. https://t.co/73yQAFZpDu",39,31,15,5,2022-01-14,3,Friday,5,54,36
1481833206320087047,2022-01-14 03:39:02,"Banjir lahar Gunung Semeru yang terjadi Kamis (13/1) sore menyebabkan jembatan penghubung terputus. Padahal, jembatan tersebut menjadi satu-satunya akses warga di dua dusun. https://t.co/x4cyAPQEtb",5,0,0,0,2022-01-14,3,Friday,5,5,0
1481832936152387586,2022-01-14 03:37:57,Munculnya COVID-19 varian Omicron membuat Pemerintah mengambil langkah tegas. Salah satunya dengan membatasi ASN ke luar negeri. https://t.co/M77l8h64s0,4,2,0,1,2022-01-14,3,Friday,5,4,3
1481832916707692545,2022-01-14 03:37:53,Siapa yang zodiaknya Gemini? Tidak ada yang perlu dikhawatirkan hanya keinginan hati tampaknya masih sulit untuk dikendalikan. Intip kata #RamalanZodiak lainnya: https://t.co/faIqHQwRhI,5,1,1,1,2022-01-14,3,Friday,5,6,2
1481832267785949185,2022-01-14 03:35:18,"Bupati Penajam Paser Utara, Abdul Gafur, resmi ditetapkan sebagai tersangka kasus pengadaan barang jasa dan perizinan. Ia sampaikan pesan kepada masyarakat PPU usai jalani pemeriksaan. https://t.co/3k23QggEog",6,2,0,0,2022-01-14,3,Friday,5,6,2
1481831464681488386,2022-01-14 03:32:06,Bupat PPU Abdul Gafur Mas'ud ditetapkan KPK sebagai tersangka kasus dugaan suap dan telah ditahan. Dia berharap warganya tetap semangat. https://t.co/DWvasCoqBe,6,1,0,2,2022-01-14,3,Friday,5,6,3
1481830745777885188,2022-01-14 03:29:15,Pabrik Marga Mulja di Surabaya telah beroperasi sejak 1948. Pabrik ini produksi mi putih yang kerap diolah jadi hidangan saat Imlek. Seperti apa pembuatannya? https://t.co/ogHQWu2Awm,5,0,0,0,2022-01-14,3,Friday,5,5,0
1481829206107508740,2022-01-14 03:23:08,"Polisi kembali menangkap artis terkait pengalahgunaan narkoba. Setelah Ardhito Pramono, kini artis inisial FF ditangkap terkait kasus narkoba. https://t.co/O6Z9mNm6lS",423,389,87,318,2022-01-14,3,Friday,5,510,707
1481829171101945861,2022-01-14 03:23:00,"Gubernur Jawa Barat Ridwan Kamil menyebut vaksinasi booster bakal digencarkan di daerah yang capaian vaksinasi primernya 100 persen. Sementara daerah yang belum 100 persen, diminta memprioritaskan warga yang belum vaksin dosis 1 dan 2. https://t.co/RiCUBd3lQ3",1,1,0,0,2022-01-14,3,Friday,5,1,1
1481828175172755457,2022-01-14 03:19:02,Aturan terbaru menyebut karantina bagi pelaku perjalanan luar negeri menjadi 7x24 jam. Larangan masuk bagi WNA dari 14 negara juga dihapuskan. https://t.co/0VMv2t6zHj,10,6,6,3,2022-01-14,3,Friday,5,16,9
1481827760381337601,2022-01-14 03:17:23,"Penyanyi dan aktor Ardhito Pramono diamankan polisi. Gegara ini, akhirnya diketahui ternyata Ardhito Pramono sudah beristri. https://t.co/oJlsfdfyx4",9,0,1,5,2022-01-14,3,Friday,5,10,5
1481826698467422209,2022-01-14 03:13:10,"Ghozali, mahasiswa asal Semarang meraup cuan sekitar Rp 1,5 miliar dari menjual foto-foto selfienya untuk koleksi NFT. Penasaran bagaimana Ghozali sukses mendapatkan keuntungan tersebut? Simak jawabannya! https://t.co/W64oDyk0kD",12,0,3,0,2022-01-14,3,Friday,5,15,0
1481825998643552259,2022-01-14 03:10:23,"Prakirawan BMKG memprakirakan sebagian besar wilayah Indonesia berpotensi hujan. Simak prakiraan cuaca selengkapnya yang berlaku untuk hari Jumat, 14 Januari 2022. https://t.co/NArz1o19BX",4,0,2,0,2022-01-14,3,Friday,5,6,0
1481825405640355840,2022-01-14 03:08:02,#Foto Beginilah rupa kamar 308 hotel Grand Inna Samudra Beach Sukabumi. Aneka kesan tim detikcom dapatkan setelah 5 menit berada di dalamnya. https://t.co/rUJvB3zv8J,13,2,3,3,2022-01-14,3,Friday,5,16,5
1481824782098255873,2022-01-14 03:05:33,"#Foto Saking mewahnya, rumah Gilang Juragan 99 juga memiliki sebuah kebun binatang. Wow, ini potretnya... https://t.co/KGSkbdvyW7",8,0,2,0,2022-01-14,3,Friday,5,10,0
1481824046891347973,2022-01-14 03:02:38,"Hafiz Fatur, adik Irwansyah masih kabur. Kemarin, Kejaksaan Negeri Kabupaten Bogor melakukan penggeledahan dan menyita rumah Hafiz Fatur. https://t.co/nE1KtjXiNw",1,1,0,0,2022-01-14,3,Friday,5,1,1
1481823666899935239,2022-01-14 03:01:07,Berikut 5 doa pernikahan Islam untuk pengantin baru agar berkah dan pasangan setia: https://t.co/GMC0A1v25F,18,1,2,0,2022-01-14,3,Friday,5,20,1
1481822697445339149,2022-01-14 02:57:16,Relawan JoMan bakal melaporkan Ubedillah Badrun ke Polda Metro Jaya. Ubedillah heran. https://t.co/x3uwnKI36g,24,36,6,1,2022-01-14,2,Friday,5,30,37
1481822134603235332,2022-01-14 02:55:02,Ustaz Yusuf Mansur kini dihantam gugatan triliunan. Ia memang tengah ditimpa badai kasus. #UstazYusufMansur  https://t.co/QYbz4lDoGZ,7,3,0,0,2022-01-14,2,Friday,5,7,3
1481821560289824768,2022-01-14 02:52:45,"Paris St. Germain otomatis menjadi favorit teratas Liga Champions setelah Lionel Messi bergabung. Namun, Messi diyakini tidak akan cukup membawa PSG juara.  https://t.co/gYeFsVTo5P",14,0,1,1,2022-01-14,2,Friday,5,15,1
1481820880221126658,2022-01-14 02:50:03,Iwan Sumule melaporkan Luhut dan Erick Thohir terkait isu bisnis PCR. Juru bicara Luhut menyerang balik pelapor. https://t.co/M4x5Ui6uOI,16,5,5,2,2022-01-14,2,Friday,5,21,7
1481820314510274566,2022-01-14 02:47:48,"#Foto Bertubi-tubi kabar mengejutkan datang dari Ardhito Pramono. Setelah tertangkap narkoba, kini Ardhito telah menikah. Intip yuk potret sang istri. https://t.co/7UcyZtosC1",5,1,0,2,2022-01-14,2,Friday,5,5,3
1481819977397288961,2022-01-14 02:46:28,Felicya Angelista dan Caesar Hito sedang menikmati perannya sebagai orang tua baru. Keduanya pun untuk tak menggunakan jasa baby sitter. https://t.co/F1KG69m2PU,3,0,0,0,2022-01-14,2,Friday,5,3,0
1481818695060135936,2022-01-14 02:41:22,Pemuda asal Semarang bernama Ghozali bikin heboh usai berhasil menjualan foto selfie-nya sebagai koleksi NFT dan meraup miliaran rupiah. Yuk kenalan dengan sosoknya! https://t.co/qvTSbHPdJt,43,6,4,3,2022-01-14,2,Friday,5,47,9
1481817825153011721,2022-01-14 02:37:55,"Banyak traveler yang mengunjungi kamar 308 dan mengeramatkan terkait Nyi Roro Kidul. Eh, lama-lama berkunjung untuk pesugihan, padahal itu salah besar! https://t.co/Kcj1ik7B2f",7,1,1,0,2022-01-14,2,Friday,5,8,1
1481817450618527748,2022-01-14 02:36:25,Serikat buruh akan menggelar aksi unjuk rasa pagi ini. Mereka akan menyerukan penolakan terhadap Undang-Undang Cipta Kerja. https://t.co/Cx78PPXApG,16,4,2,0,2022-01-14,2,Friday,5,18,4
1481816850203828225,2022-01-14 02:34:02,Pernikahan Kalina Oktarani dengan Vicky Prasetyo ternyata sudah kandas. Kesabaran Kalina sudah habis untuk Vicky Prasetyo. https://t.co/dObfIZVW0F,7,7,1,0,2022-01-14,2,Friday,5,8,7
1481815862332084230,2022-01-14 02:30:07,Deretan idol KPop wanita ini dinilai cantik bak jelmaan Disney Princess. Siapa saja ya?😍 https://t.co/NQiN3u0TJj,6,0,0,0,2022-01-14,2,Friday,5,6,0
1481814977006739460,2022-01-14 02:26:35,Arsenal sukses menahan Liverpool dengan kondisi minus satu pemain. Manajer The Gunners Mikel Arteta sampai takjub dibuatnya!  https://t.co/yDNofEYbDC,28,1,1,0,2022-01-14,2,Friday,5,29,1
1481814023633092611,2022-01-14 02:22:48,Nagita Slavina tengah ramai dibicarakan di media sosial karena video 61 detik mirip dirinya. Ini penjelasan Nagita Slavina dan Raffi Ahmad:  https://t.co/PTO2PBcFHH,17,4,2,2,2022-01-14,2,Friday,5,19,6
1481812168446197761,2022-01-14 02:15:26,Thariq Halilintar ngaku terpapar COVID-19 sepulang dari Turki. Ini adalah ketiga kalinya Thariq terpapar COVID-19. Begini kondisinya:  https://t.co/5KHSQwECmm,78,71,11,24,2022-01-14,2,Friday,5,89,95
1481812160175038464,2022-01-14 02:15:24,Liverpool dan Arsenal bertanding di semifinal Piala Liga Inggris leg pertama. The Gunners sukses menahan imbang 0-0 meskipun harus bermain dengan 10 pemain sejak menit 24. https://t.co/iHeWPHCSTB,5,0,0,0,2022-01-14,2,Friday,5,5,0
1481809929258287110,2022-01-14 02:06:32,"Kapolres Lumajang, AKBP Eka Yekti Hananto mengonfirmasi jika Hadfana Firdaus, pria pembuang dan penendang sesajen di Semeru, berhasil tertangkap. Hadfana ditangkap di Gang Dorowati, Pringgolayan, Banguntapan, Bantul. https://t.co/i21au8Xbky",36,9,9,9,2022-01-14,2,Friday,5,45,18
1481808406285541378,2022-01-14 02:00:29,Wahana Lingkungan Hidup Indonesia (Walhi) menilai pembahasan RUU Ibu Kota Negara (IKN) yang super cepat terkesan dipaksakan dan mengulang inkonstitusionalitas pembentukan UU Cipta Kerja. #CNNIndonesia #detiknetwork  https://t.co/1HagrSS9Dx,7,2,2,0,2022-01-14,2,Friday,5,9,2
1481806658066124802,2022-01-14 01:53:32,Petenis nomor satu Novak Djokovic masih menanti nasibnya terkait saga visa. Unggulan empat Australia Terbuka 2022 Stefanos Tsitsipas geram dengan rivalnya itu.  https://t.co/yyupi3aIYq,2,1,0,0,2022-01-14,1,Friday,5,2,1
1481804793542758401,2022-01-14 01:46:08,Granit Xhaka diganjar kartu merah dalam laga semifinal leg 1 Piala Liga Inggris antara Liverpool vs Arsenal. Lantas apa respons manajer Mikel Arteta?  https://t.co/HgDQ9THz2z,22,1,0,0,2022-01-14,1,Friday,5,22,1
1481804502743363594,2022-01-14 01:44:58,Hendra Setiawan/Mohammad Ahsan mulus ke perempatfinal India Open 2022. Langkah mereka sempat dihantui rasa takut karena adanya kasus positif COVID-19.  https://t.co/AQ35i8aMQs,2,0,2,0,2022-01-14,1,Friday,5,4,0
1481803347934027781,2022-01-14 01:40:23,Thariq Halilintar positif COVID-19 sepulang dari Turki bersama keluarga. Thariq mengeluhkan gejala yang dirasakan hanya seperti flu dan pilek seperti biasa. https://t.co/UFf87VmWGQ,11,3,4,9,2022-01-14,1,Friday,5,15,12
1481802538366218240,2022-01-14 01:37:10,Menko Polhukam Mahfud Md bicara terkait kasus satelit Kemhan atau slot orbit 123 BT. Mahfud mengungkapkan adanya dugaan pelanggaran hukum di balik proyek tersebut yang menyebabkan negara merugi hingga ratusan miliar rupiah. https://t.co/X7h1HPMoWo,6,2,3,1,2022-01-14,1,Friday,5,9,3
1481801361360621573,2022-01-14 01:32:29,"Dua misi Eilipitua Siregar di ONE Championship. Tak hanya ingin bonus uang tunai Rp 750 juta, tapi dia juga ingin foto bareng Khabib Nurmagomedov.  https://t.co/4oDYbm1sX1",13,0,1,0,2022-01-14,1,Friday,5,14,0
1481801038411796485,2022-01-14 01:31:12,Philippe Coutinho bergabung dengan Aston Villa di musim dingin tahun ini. Kabar tersebut membuat mantan manajer Liverpool Brendan Rodgers terkejut!  https://t.co/KBRjOxKvc8,10,0,0,0,2022-01-14,1,Friday,5,10,0
1481799751494426624,2022-01-14 01:26:05,Liverpool gagal mengalahkan Arsenal meski unggul jumlah pemain. Peran Ben White begitu besar dalam meredam The Reds.  https://t.co/K7HAEYilDH,12,0,2,0,2022-01-14,1,Friday,5,14,0
1481799721077415945,2022-01-14 01:25:58,Valentino Rossi masih akan balapan usai pensiun dari MotoGP. Dia mengumumkan bergabung dengan tim balap mobil untuk tampil di GT World Challenge Europe 2022.  https://t.co/aljPAyZHxB,12,2,1,0,2022-01-14,1,Friday,5,13,2
1481799321901219841,2022-01-14 01:24:23,Marc Marquez menunjukkan kemajuan bagus dalam proses penyembuhan diplopia. Marquez bahkan sudah diizinkan untuk menunggangi motor lagi.  https://t.co/UORbTITKOm,5,0,1,0,2022-01-14,1,Friday,5,6,0
1481798553936801792,2022-01-14 01:21:20,Cristiano Ronaldo belum berpikir pensiun dalam waktu. Pesepakbola Portugal itu bahkan bertekad main di level tertinggi sampai usia 42 tahun.  https://t.co/D0xJefBMRY,20,4,5,0,2022-01-14,1,Friday,5,25,4
1481797392676663307,2022-01-14 01:16:43,Liverpool gagal memaksimalkan keunggulan jumlah pemain saat menghadapi Arsenal. The Reds dipaksa bermain imbang tanpa gol.  https://t.co/MLF85YePKi,10,0,0,0,2022-01-14,1,Friday,5,10,0
1481797379728846849,2022-01-14 01:16:40,"Tuan rumah Kamerun menang lagi di Piala Afrika 2021 usai mengalahkan Ethiopia 4-1. Sementara itu, Pantai Gading menundukkan Equatorial Guinea 1-0.  https://t.co/ztrCiVSNLg",4,0,0,0,2022-01-14,1,Friday,5,4,0
1481795870412652545,2022-01-14 01:10:40,Georginio Wijnaldum mengalami kesulitan di awal kariernya bersama Paris St. Germain. Arsenal disarankan agar mendekati Wijnaldum.  https://t.co/cN56uFNEfI,2,1,0,1,2022-01-14,1,Friday,5,2,2
1481795770227597313,2022-01-14 01:10:16,Leonardo Bonucci marah ke staf Inter Milan di Piala Super Italia. Bek Juventus itu bahkan mengeluarkan kalimat ancaman!  https://t.co/9gtQmHhG3q,6,2,0,1,2022-01-14,1,Friday,5,6,3
1481795317884461057,2022-01-14 01:08:28,Athletic Bilbao comeback untuk mengalahkan Atletico Madrid dengan skor 2-1 di Piala Super Spanyol. Bilbao berhak maju ke final untuk berjumpa Real Madrid.  https://t.co/Amf6dSv2q8,12,0,1,0,2022-01-14,1,Friday,5,13,0
1481794727133466627,2022-01-14 01:06:08,PKS mendukung judicial review terkait ambang batas pencalonan presiden atau presidential threshold di Mahkamah Konstitusi. PKS menilai presidential threshold sebesar 20% masih dinilai terlalu tinggi. https://t.co/hOeu0ElJAf,4,2,1,0,2022-01-14,1,Friday,5,5,2
1481792737900908546,2022-01-14 00:58:13,"Setelah DKI Jakarta, provinsi yang menyumbang kasus terbanyak kedua hari ini adalah Jawa Barat dengan 89 kasus, kemudian Banten 54 kasus. https://t.co/6JkE9P9Rxo",10,1,8,0,2022-01-14,0,Friday,5,18,1
1481792073686822914,2022-01-14 00:55:35,Sebelas sekolah di DKI menutup sementara PTM karena guru dan siswanya terpapar Corona. Partai Demokrat meminta pemprov mengkaji ulang kapasitas PTM. https://t.co/MMCwWYZvuA,14,0,7,1,2022-01-14,0,Friday,5,21,1
1481792058457272320,2022-01-14 00:55:31,Seorang pria di Kediri diciduk polisi karena mengancam akan menikam mantan pacarnya. Ancaman itu dilakukan karena pelaku tak terima hubungan asmaranya diakhiri. https://t.co/uozaxiaPli,2,1,2,0,2022-01-14,0,Friday,5,4,1
1481791453043036177,2022-01-14 00:53:07,Seorang kuli bangunan di Surabaya ditangkap polisi karena memperkosa anak di bawah umur. Pelaku diketahui memperkosa korban hingga tiga kali. https://t.co/sPNn0ChTtd,7,8,3,0,2022-01-14,0,Friday,5,10,8
1481791433526894592,2022-01-14 00:53:02,"Mata panda kerap kali membuat penampilan seseorang terlihat lelah dan tua. Namun, tak perlu stres, ini ada 6 cara menghilangkan mata panda secara alami. https://t.co/oMuulhlPu2",17,2,3,0,2022-01-14,0,Friday,5,20,2
1481791091330502656,2022-01-14 00:51:41,"Menteri Pertahanan Prabowo Subianto disuntik vaksin Nusantara. Ia menerima vaksin langsung dari penggagas vaksin Nusantara, dr Terawan Agus Putranto. https://t.co/JEiflkGNvF",30,6,17,6,2022-01-14,0,Friday,5,47,12
1481790511497322503,2022-01-14 00:49:22,"Video pengawal mobil jenazah disergap polisi di Lamongan beredar luas. Ia yang disergap yakni Andrianto (63), warga Bojonegoro. https://t.co/bYLZ2K23Dy",9,1,2,1,2022-01-14,0,Friday,5,11,2
1481790490005680130,2022-01-14 00:49:17,Kementerian Kesehatan RI mulai memberikan vaksin Booster COVID-19 pada kelompok umum (non nakes). Ibu hamil termasuk sasaran penerima vaksin booster. https://t.co/ve9xobHUmt,4,1,3,0,2022-01-14,0,Friday,5,7,1
1481790203513683980,2022-01-14 00:48:09,"Devie mengatakan aktivitas di ruang digital, termasuk media sosial (medsos) juga menuntut perilaku yang beradab. https://t.co/YoYpF1O4u5",7,0,1,0,2022-01-14,0,Friday,5,8,0
1481789641619558400,2022-01-14 00:45:55,"China telah menciptakan apa yang dijuluki Matahari buatan dalam wujud reaktor energi fusi EAST. Kini, ilmuwan negara itu menciptakan pula Bulan buatan. https://t.co/NvLktwbBgm",7,1,3,3,2022-01-14,0,Friday,5,10,4
1481789370243891200,2022-01-14 00:44:50,Seorang pria di Kota Batu terekam CCTV menodongkan pistol. Polisi tengah menyelidiki aksi koboi tersebut. https://t.co/dPXYdtaPSd,5,0,1,0,2022-01-14,0,Friday,5,6,0
1481789077674500096,2022-01-14 00:43:41,Georginio Wijnaldum mengalami kesulitan di awal kariernya bersama Paris St. Germain. Arsenal disarankan agar mendekati Wijnaldum. https://t.co/LyHybImxaw,3,0,0,0,2022-01-14,0,Friday,5,3,0
1481788827215745025,2022-01-14 00:42:41,Senator asal Jawa Timur ini meminta agar Kemendes berbesar hati tak membubarkan UPK NKRI dan mengakuisisi dana mereka. https://t.co/vzHg0jRYVw,5,0,2,0,2022-01-14,0,Friday,5,7,0
1481788810090459143,2022-01-14 00:42:37,"Aipda IS diduga 'cueki' laporan driver ojol, Charly, yang kehilangan motor. Polri menyebut cekcok terjadi karena Aipda IS menganggap Charly tak sabar mengantre. https://t.co/0AoCegENyZ",48,61,6,8,2022-01-14,0,Friday,5,54,69
1481788509488828417,2022-01-14 00:41:25,"Take-Two Interactive, mengumumkan akuisisi besar-besarannya pada salah satu developer game ternama, yaitu Zynga dan nilainya hingga Rp 181 triliun. https://t.co/fFVlXBMVOR",0,1,1,0,2022-01-14,0,Friday,5,1,1
1481788486759948290,2022-01-14 00:41:20,NFT memungkinkan para kreator sampai orang biasa menjual karyanya sebagai aset digital dengan harga bisa sangat mahal. Ini deretan NFT termahal:  https://t.co/BjwDPfAU5J,1,1,1,1,2022-01-14,0,Friday,5,2,2
1481787035845369866,2022-01-14 00:35:34,Timnas Indonesia harus berjuang dengan permasalahan komunikasi. Sejauh ini tim menggunakan lebih dari dua bahasa dalam komunikasi. https://t.co/iy3IpOYHcp,9,0,1,0,2022-01-14,0,Friday,5,10,0
1481786594323480579,2022-01-14 00:33:49,Terduga penendang sesajen bernama Hadfana Firdaus itu drop out dari UIN Sunan Kalijaga Yogya pada 2014 silam. Pihak kampus mencela perbuatannya. https://t.co/OFfCFegllO,84,40,29,7,2022-01-14,0,Friday,5,113,47
1481786481471594500,2022-01-14 00:33:22,"Sebuah penjara di Albuquerque, Amerika Serikat jadi korban ransomware. Kamera keamanan dan mekanisme pengunci pintu otomatis tidak bisa berfungsi. Ngeri! https://t.co/xtVyIbJoks",0,1,2,0,2022-01-14,0,Friday,5,2,1
1481786024409903106,2022-01-14 00:31:33,Seorang perempuan di Jember tewas usai dicekik pacarnya sendiri. Ulah pelaku didasari cemburu karena menduga korban berpacaran dengan pria lain. https://t.co/ywaqzEFIoN,6,8,3,2,2022-01-14,0,Friday,5,9,10
1481784017162850307,2022-01-14 00:23:34,FX Rudi menyebut bahwa Fajar Nugroho mengembalikan bantuan yang diterima dari Gubernur Ganjar Pranowo karena ada intervensi. https://t.co/6nyhrdKsdh,18,15,3,2,2022-01-14,0,Friday,5,21,17
1481783998355496964,2022-01-14 00:23:30,Valentino Rossi masih akan balapan usai pensiun dari MotoGP. Rossi mengumumkan bergabung dengan tim balap mobil untuk tampil di GT World Challenge Europe 2022. https://t.co/oEHIoqjhdq,16,2,1,1,2022-01-14,0,Friday,5,17,3
1481782539467563010,2022-01-14 00:17:42,"JoMan bakal mempolisikan dosen UNJ, Ubedillah. JoMan menilai Ubedilah telah menyebarkan fitnah dan manipulasi terkait pelaporan Gibran dan Kaesang ke KPK. https://t.co/IdPXuwIskk",538,272,82,64,2022-01-14,0,Friday,5,620,336
1481782134859878405,2022-01-14 00:16:05,"Di tengah merebaknya varian Omicron, masker seperti apa yang paling mempan dan paling lemah dalam melawan varian tersebut? Awas salah pilih, begini kata WHO. https://t.co/USw7sIZL5I",8,2,2,2,2022-01-14,0,Friday,5,10,4
1481781562765201413,2022-01-14 00:13:49,"#Terpopuler Di mana saja lokasi vaksin booster Tangerang? Cek di sini untuk mengetahui syarat, biaya, hingga cara mendaftar vaksin booster di Tangerang. https://t.co/EW4kN6nWV5",3,0,1,1,2022-01-14,0,Friday,5,4,1
1481781037067812870,2022-01-14 00:11:44,"Ghozali, mahasiswa asal Semarang viral dan dapat cuan sekitar Rp 1,5 miliar dari menjual foto selfie NFT. Mau buat apa uangnya? Ini kata Ghozali:  https://t.co/TGR8dQp0Io",235,64,38,22,2022-01-14,0,Friday,5,273,86
1481780751569932289,2022-01-14 00:10:35,"Gambar-gambar berikut sekilas tampak biasa saja, tapi sebenarnya ada hal yang janggal. Apakah kamu bisa menemukannya di bawah 10 detik? https://t.co/JUrP84jE2x",5,5,2,1,2022-01-14,0,Friday,5,7,6
1481780202963353601,2022-01-14 00:08:25,iPhone 14 Pro dan iPhone 14 Pro Max kabarnya akan dijual dengan harga yang lebih mahal. Kedua ponsel ini juga sepertinya akan memiliki dua punch hole di layar. #iPhone  https://t.co/jESKVBGJUr,7,0,1,1,2022-01-14,0,Friday,5,8,1
1481780182642003968,2022-01-14 00:08:20,Pemusatan Latihan (TC) timnas wanita di Jakarta masih terus dilakukan sampai keberangkatan. Latihan terus digenjot. Ini foto-fotonya! https://t.co/S2kuzqf0oi,3,0,1,0,2022-01-14,0,Friday,5,4,0
1481778633458991111,2022-01-14 00:02:10,Kementerian kesehatan menambahkan 1 regimen pemberian vaksin booster COVID-19. Total saat ini ada 4 kombinasi vaksin booster yang bisa diberikan. https://t.co/V1eSVOnS71,3,0,3,1,2022-01-14,0,Friday,5,6,1
1481778322065473541,2022-01-14 00:00:56,Hanung Bramantyo alami saraf kejepit. Ia memantapkan hati dan memutuskan untuk menjalani operasi ketimbang minum obat seumur hidup. https://t.co/Hd0DBC2Mkm,7,0,2,0,2022-01-14,0,Friday,5,9,0
